,學年度,學期,設立別 ,學校類別,學校代碼,學校名稱,學制,學生總人數,學期內新增辦理休學人數,男,女,至學期底總休學人數,男,女
,101,1,公立,一般大學,1,國立政治大學,學士班(日間),9782,130,72,58,206,106,100
,101,1,公立,一般大學,1,國立政治大學,碩士班(日間),3596,313,112,201,840,354,486
,101,1,公立,一般大學,1,國立政治大學,碩士在職專班,1636,171,79,92,440,215,225
,101,1,公立,一般大學,1,國立政治大學,博士班,1014,101,68,33,273,172,101
,101,1,公立,一般大學,2,國立清華大學,學士班(日間),6325,142,112,30,184,142,42
,101,1,公立,一般大學,2,國立清華大學,碩士班(日間),3804,140,70,70,218,109,109
,101,1,公立,一般大學,2,國立清華大學,碩士在職專班,291,27,17,10,54,32,22
,101,1,公立,一般大學,2,國立清華大學,博士班,2028,207,166,41,392,307,85
,101,1,公立,一般大學,3,國立臺灣大學,學士班(日間),16915,434,264,170,469,286,183
,101,1,公立,一般大學,3,國立臺灣大學,學士班(進修),29,5,2,3,8,4,4
,101,1,公立,一般大學,3,國立臺灣大學,碩士班(日間),9741,782,394,388,1072,574,498
,101,1,公立,一般大學,3,國立臺灣大學,碩士在職專班,1119,268,154,114,308,186,122
,101,1,公立,一般大學,3,國立臺灣大學,博士班,4889,717,480,237,1025,712,313
,101,1,公立,一般大學,4,國立臺灣師範大學,學士班(日間),7768,122,64,58,171,88,83
,101,1,公立,一般大學,4,國立臺灣師範大學,碩士班(日間),4115,672,233,439,822,301,521
,101,1,公立,一般大學,4,國立臺灣師範大學,碩士在職專班,2037,283,66,217,363,91,272
,101,1,公立,一般大學,4,國立臺灣師範大學,博士班,1387,291,143,148,372,186,186
,101,1,公立,一般大學,5,國立成功大學,學士班(日間),11688,270,179,91,344,231,113
,101,1,公立,一般大學,5,國立成功大學,學士班(進修),2,0,0,0,0,0,0
,101,1,公立,一般大學,5,國立成功大學,碩士班(日間),6404,224,123,101,472,247,225
,101,1,公立,一般大學,5,國立成功大學,碩士在職專班,1303,94,57,37,208,144,64
,101,1,公立,一般大學,5,國立成功大學,博士班,3020,263,194,69,724,525,199
,101,1,公立,一般大學,6,國立中興大學,學士班(日間),8321,177,122,55,229,164,65
,101,1,公立,一般大學,6,國立中興大學,學士班(進修),1145,29,15,14,30,12,18
,101,1,公立,一般大學,6,國立中興大學,碩士班(日間),3419,193,121,72,414,237,177
,101,1,公立,一般大學,6,國立中興大學,碩士在職專班,1845,147,100,47,291,198,93
,101,1,公立,一般大學,6,國立中興大學,博士班,1400,138,99,39,320,242,78
,101,1,公立,一般大學,7,國立交通大學,學士班(日間),5527,134,104,30,159,127,32
,101,1,公立,一般大學,7,國立交通大學,碩士班(日間),5096,220,120,100,326,187,139
,101,1,公立,一般大學,7,國立交通大學,碩士在職專班,1817,268,200,68,401,306,95
,101,1,公立,一般大學,7,國立交通大學,博士班,2184,224,182,42,402,320,82
,101,1,公立,一般大學,8,國立中央大學,學士班(日間),6168,104,73,31,140,97,43
,101,1,公立,一般大學,8,國立中央大學,碩士班(日間),3308,158,77,81,251,127,124
,101,1,公立,一般大學,8,國立中央大學,碩士在職專班,1424,113,72,41,283,192,91
,101,1,公立,一般大學,8,國立中央大學,博士班,1362,139,109,30,290,216,74
,101,1,公立,一般大學,9,國立中山大學,學士班(日間),4628,93,63,30,118,79,39
,101,1,公立,一般大學,9,國立中山大學,碩士班(日間),2904,184,88,96,342,190,152
,101,1,公立,一般大學,9,國立中山大學,碩士在職專班,841,81,37,44,154,65,89
,101,1,公立,一般大學,9,國立中山大學,博士班,1041,127,91,36,264,194,70
,101,1,公立,一般大學,12,國立臺灣海洋大學,學士班(日間),5204,99,79,20,110,79,31
,101,1,公立,一般大學,12,國立臺灣海洋大學,學士班(進修),551,28,18,10,61,40,21
,101,1,公立,一般大學,12,國立臺灣海洋大學,碩士班(日間),1555,78,49,29,137,90,47
,101,1,公立,一般大學,12,國立臺灣海洋大學,碩士在職專班,624,38,29,9,81,55,26
,101,1,公立,一般大學,12,國立臺灣海洋大學,博士班,352,34,26,8,77,54,23
,101,1,公立,一般大學,13,國立中正大學,學士班(日間),6624,119,80,39,164,112,52
,101,1,公立,一般大學,13,國立中正大學,碩士班(日間),2990,210,119,91,362,200,162
,101,1,公立,一般大學,13,國立中正大學,碩士在職專班,1788,215,128,87,318,186,132
,101,1,公立,一般大學,13,國立中正大學,博士班,734,97,65,32,193,132,61
,101,1,公立,一般大學,14,國立高雄師範大學,學士班(日間),3370,47,28,19,60,40,20
,101,1,公立,一般大學,14,國立高雄師範大學,碩士班(日間),1393,328,111,217,469,158,311
,101,1,公立,一般大學,14,國立高雄師範大學,碩士在職專班,1590,122,42,80,237,77,160
,101,1,公立,一般大學,14,國立高雄師範大學,博士班,470,63,26,37,80,32,48
,101,1,公立,一般大學,15,國立彰化師範大學,學士班(日間),4747,45,34,11,70,51,19
,101,1,公立,一般大學,15,國立彰化師範大學,碩士班(日間),1618,160,60,100,276,108,168
,101,1,公立,一般大學,15,國立彰化師範大學,碩士在職專班,1477,80,34,46,142,59,83
,101,1,公立,一般大學,15,國立彰化師範大學,博士班,439,45,26,19,88,43,45
,101,1,公立,一般大學,16,國立陽明大學,學士班(日間),2051,68,35,33,79,42,37
,101,1,公立,一般大學,16,國立陽明大學,碩士班(日間),1324,127,42,85,240,91,149
,101,1,公立,一般大學,16,國立陽明大學,碩士在職專班,125,23,8,15,46,15,31
,101,1,公立,一般大學,16,國立陽明大學,博士班,1079,151,73,78,305,148,157
,101,1,公立,一般大學,17,國立臺北大學,學士班(日間),5618,77,41,36,108,59,49
,101,1,公立,一般大學,17,國立臺北大學,學士班(進修),2260,117,55,62,199,103,96
,101,1,公立,一般大學,17,國立臺北大學,碩士班(日間),1359,159,72,87,248,113,135
,101,1,公立,一般大學,17,國立臺北大學,碩士在職專班,469,22,11,11,69,35,34
,101,1,公立,一般大學,17,國立臺北大學,博士班,173,21,15,6,42,33,9
,101,1,公立,一般大學,18,國立嘉義大學,學士班(日間),7768,123,78,45,210,137,73
,101,1,公立,一般大學,18,國立嘉義大學,學士班(進修),2219,112,54,58,272,157,115
,101,1,公立,一般大學,18,國立嘉義大學,碩士班(日間),1768,115,52,63,270,126,144
,101,1,公立,一般大學,18,國立嘉義大學,碩士在職專班,1070,70,32,38,183,82,101
,101,1,公立,一般大學,18,國立嘉義大學,博士班,208,17,11,6,36,24,12
,101,1,公立,一般大學,19,國立高雄大學,學士班(日間),4167,66,36,30,88,53,35
,101,1,公立,一般大學,19,國立高雄大學,學士班(進修),220,14,12,2,40,24,16
,101,1,公立,一般大學,19,國立高雄大學,碩士班(日間),646,48,32,16,102,67,35
,101,1,公立,一般大學,19,國立高雄大學,碩士在職專班,513,48,37,11,130,100,30
,101,1,公立,一般大學,19,國立高雄大學,博士班,13,0,0,0,2,2,0
,101,1,公立,一般大學,20,國立東華大學,學士班(日間),6970,128,73,55,212,132,80
,101,1,公立,一般大學,20,國立東華大學,學士班(進修),6,2,2,0,4,4,0
,101,1,公立,一般大學,20,國立東華大學,碩士班(日間),2389,195,80,115,552,256,296
,101,1,公立,一般大學,20,國立東華大學,碩士在職專班,619,64,31,33,179,94,85
,101,1,公立,一般大學,20,國立東華大學,博士班,372,46,26,20,120,73,47
,101,1,公立,一般大學,21,國立暨南國際大學,學士班(日間),3934,38,25,13,55,34,21
,101,1,公立,一般大學,21,國立暨南國際大學,學士班(進修),3,2,0,2,3,0,3
,101,1,公立,一般大學,21,國立暨南國際大學,碩士班(日間),1247,140,50,90,207,87,120
,101,1,公立,一般大學,21,國立暨南國際大學,碩士在職專班,338,19,11,8,37,20,17
,101,1,公立,一般大學,21,國立暨南國際大學,博士班,316,42,16,26,69,33,36
,101,1,公立,一般大學,28,國立臺北藝術大學,五專,87,1,1,0,1,1,0
,101,1,公立,一般大學,28,國立臺北藝術大學,學士班(日間),1481,37,22,15,44,25,19
,101,1,公立,一般大學,28,國立臺北藝術大學,碩士班(日間),932,149,48,101,249,93,156
,101,1,公立,一般大學,28,國立臺北藝術大學,碩士在職專班,140,27,10,17,33,11,22
,101,1,公立,一般大學,28,國立臺北藝術大學,博士班,51,10,3,7,15,5,10
,101,1,公立,一般大學,29,國立臺灣藝術大學,學士班(日間),2266,46,13,33,75,28,47
,101,1,公立,一般大學,29,國立臺灣藝術大學,學士班(進修),1895,83,26,57,157,50,107
,101,1,公立,一般大學,29,國立臺灣藝術大學,碩士班(日間),758,88,37,51,168,79,89
,101,1,公立,一般大學,29,國立臺灣藝術大學,碩士在職專班,402,34,9,25,63,18,45
,101,1,公立,一般大學,29,國立臺灣藝術大學,博士班,54,4,2,2,8,4,4
,101,1,公立,一般大學,30,國立臺東大學,學士班(日間),3433,100,56,44,161,98,63
,101,1,公立,一般大學,30,國立臺東大學,學士班(進修),178,10,6,4,14,8,6
,101,1,公立,一般大學,30,國立臺東大學,碩士班(日間),338,67,24,43,109,41,68
,101,1,公立,一般大學,30,國立臺東大學,碩士在職專班,848,34,13,21,69,34,35
,101,1,公立,一般大學,30,國立臺東大學,博士班,42,8,0,8,12,2,10
,101,1,公立,一般大學,31,國立宜蘭大學,學士班(日間),4170,56,41,15,98,77,21
,101,1,公立,一般大學,31,國立宜蘭大學,學士班(進修),653,35,31,4,111,96,15
,101,1,公立,一般大學,31,國立宜蘭大學,碩士班(日間),558,22,16,6,40,29,11
,101,1,公立,一般大學,31,國立宜蘭大學,碩士在職專班,171,10,7,3,12,9,3
,101,1,公立,一般大學,31,國立宜蘭大學,博士班,12,0,0,0,0,0,0
,101,1,公立,一般大學,32,國立聯合大學,學士班(日間),6143,134,111,23,215,181,34
,101,1,公立,一般大學,32,國立聯合大學,學士班(進修),1454,89,60,29,137,92,45
,101,1,公立,一般大學,32,國立聯合大學,碩士班(日間),449,15,11,4,28,20,8
,101,1,公立,一般大學,32,國立聯合大學,博士班,9,1,1,0,2,2,0
,101,1,公立,一般大學,35,國立臺南藝術大學,五專,158,0,0,0,1,1,0
,101,1,公立,一般大學,35,國立臺南藝術大學,學士班(日間),724,15,8,7,33,10,23
,101,1,公立,一般大學,35,國立臺南藝術大學,學士班(進修),40,3,2,1,4,3,1
,101,1,公立,一般大學,35,國立臺南藝術大學,碩士班(日間),566,75,23,52,156,65,91
,101,1,公立,一般大學,35,國立臺南藝術大學,碩士在職專班,50,7,2,5,15,4,11
,101,1,公立,一般大學,35,國立臺南藝術大學,博士班,38,7,3,4,17,10,7
,101,1,公立,一般大學,36,國立臺南大學,學士班(日間),3865,49,25,24,82,48,34
,101,1,公立,一般大學,36,國立臺南大學,學士班(進修),431,10,6,4,23,14,9
,101,1,公立,一般大學,36,國立臺南大學,碩士班(日間),1162,126,49,77,247,95,152
,101,1,公立,一般大學,36,國立臺南大學,碩士在職專班,805,53,14,39,123,42,81
,101,1,公立,一般大學,36,國立臺南大學,博士班,174,19,12,7,26,16,10
,101,1,公立,一般大學,37,國立臺北教育大學,學士班(日間),3173,62,34,28,77,42,35
,101,1,公立,一般大學,37,國立臺北教育大學,碩士班(日間),1138,205,53,152,280,89,191
,101,1,公立,一般大學,37,國立臺北教育大學,碩士在職專班,1210,113,35,78,216,67,149
,101,1,公立,一般大學,37,國立臺北教育大學,博士班,139,27,21,6,41,25,16
,101,1,公立,一般大學,38,國立新竹教育大學,學士班(日間),2499,20,9,11,52,21,31
,101,1,公立,一般大學,38,國立新竹教育大學,碩士班(日間),763,78,18,60,164,51,113
,101,1,公立,一般大學,38,國立新竹教育大學,碩士在職專班,613,36,4,32,49,10,39
,101,1,公立,一般大學,38,國立新竹教育大學,博士班,72,9,1,8,17,5,12
,101,1,公立,一般大學,39,國立臺中教育大學,學士班(日間),3330,52,22,30,67,28,39
,101,1,公立,一般大學,39,國立臺中教育大學,碩士班(日間),816,86,29,57,123,50,73
,101,1,公立,一般大學,39,國立臺中教育大學,碩士在職專班,701,54,15,39,83,24,59
,101,1,公立,一般大學,39,國立臺中教育大學,博士班,117,9,4,5,19,8,11
,101,1,公立,一般大學,40,國立屏東教育大學,學士班(日間),3229,43,25,18,63,37,26
,101,1,公立,一般大學,40,國立屏東教育大學,碩士班(日間),790,88,29,59,164,61,103
,101,1,公立,一般大學,40,國立屏東教育大學,碩士在職專班,672,31,5,26,55,9,46
,101,1,公立,一般大學,40,國立屏東教育大學,博士班,56,5,3,2,6,3,3
,101,1,公立,一般大學,44,國立體育大學,學士班(日間),1476,44,32,12,94,75,19
,101,1,公立,一般大學,44,國立體育大學,學士班(進修),93,13,11,2,20,15,5
,101,1,公立,一般大學,44,國立體育大學,碩士班(日間),365,45,20,25,88,41,47
,101,1,公立,一般大學,44,國立體育大學,碩士在職專班,214,19,12,7,31,18,13
,101,1,公立,一般大學,44,國立體育大學,博士班,130,10,5,5,20,12,8
,101,1,公立,一般大學,48,國立金門大學,學士班(日間),2654,64,34,30,78,44,34
,101,1,公立,一般大學,48,國立金門大學,學士班(進修),818,31,19,12,71,47,24
,101,1,公立,一般大學,48,國立金門大學,碩士班(日間),226,13,7,6,29,19,10
,101,1,公立,一般大學,49,國立臺灣體育運動大學,學士班(日間),2449,99,74,25,223,165,58
,101,1,公立,一般大學,49,國立臺灣體育運動大學,學士班(進修),402,23,16,7,43,28,15
,101,1,公立,一般大學,49,國立臺灣體育運動大學,碩士班(日間),257,73,38,35,132,65,67
,101,1,公立,一般大學,49,國立臺灣體育運動大學,碩士在職專班,92,1,1,0,5,3,2
,101,1,公立,一般大學,3001,臺北市立教育大學,學士班(日間),2888,64,40,24,88,53,35
,101,1,公立,一般大學,3001,臺北市立教育大學,碩士班(日間),860,131,39,92,210,65,145
,101,1,公立,一般大學,3001,臺北市立教育大學,碩士在職專班,847,38,9,29,73,18,55
,101,1,公立,一般大學,3001,臺北市立教育大學,博士班,205,24,14,10,43,26,17
,101,1,公立,一般大學,3102,臺北市立體育學院,學士班(日間),1866,58,46,12,103,74,29
,101,1,公立,一般大學,3102,臺北市立體育學院,碩士班(日間),281,35,15,20,51,28,23
,101,1,公立,一般大學,3102,臺北市立體育學院,碩士在職專班,143,3,1,2,9,5,4
,101,1,公立,一般大學,3102,臺北市立體育學院,博士班,23,1,1,0,1,1,0
,101,1,公立,技專校院,22,國立臺灣科技大學,學士班(日間),5537,66,47,19,128,95,33
,101,1,公立,技專校院,22,國立臺灣科技大學,學士班(進修),68,6,2,4,13,5,8
,101,1,公立,技專校院,22,國立臺灣科技大學,碩士班(日間),3039,106,61,45,187,116,71
,101,1,公立,技專校院,22,國立臺灣科技大學,碩士在職專班,805,116,90,26,183,146,37
,101,1,公立,技專校院,22,國立臺灣科技大學,博士班,1058,155,108,47,258,199,59
,101,1,公立,技專校院,23,國立雲林科技大學,學士班(日間),6217,46,24,22,107,68,39
,101,1,公立,技專校院,23,國立雲林科技大學,碩士班(日間),2056,70,43,27,132,77,55
,101,1,公立,技專校院,23,國立雲林科技大學,碩士在職專班,782,53,36,17,110,71,39
,101,1,公立,技專校院,23,國立雲林科技大學,博士班,478,63,45,18,122,89,33
,101,1,公立,技專校院,24,國立屏東科技大學,學士班(日間),7599,119,70,49,166,100,66
,101,1,公立,技專校院,24,國立屏東科技大學,學士班(進修),1410,60,32,28,54,31,23
,101,1,公立,技專校院,24,國立屏東科技大學,碩士班(日間),1697,194,106,88,234,129,105
,101,1,公立,技專校院,24,國立屏東科技大學,碩士在職專班,667,64,44,20,65,44,21
,101,1,公立,技專校院,24,國立屏東科技大學,博士班,209,35,27,8,53,40,13
,101,1,公立,技專校院,25,國立臺北科技大學,學士班(日間),5760,106,80,26,187,142,45
,101,1,公立,技專校院,25,國立臺北科技大學,學士班(進修),1126,52,36,16,75,51,24
,101,1,公立,技專校院,25,國立臺北科技大學,碩士班(日間),2535,130,87,43,168,114,54
,101,1,公立,技專校院,25,國立臺北科技大學,碩士在職專班,1112,172,133,39,218,172,46
,101,1,公立,技專校院,25,國立臺北科技大學,博士班,721,88,72,16,135,108,27
,101,1,公立,技專校院,26,國立高雄第一科技大學,學士班(日間),5392,78,46,32,115,69,46
,101,1,公立,技專校院,26,國立高雄第一科技大學,碩士班(日間),1217,60,24,36,111,51,60
,101,1,公立,技專校院,26,國立高雄第一科技大學,碩士在職專班,814,94,62,32,141,100,41
,101,1,公立,技專校院,26,國立高雄第一科技大學,博士班,220,36,23,13,45,28,17
,101,1,公立,技專校院,27,國立高雄應用科技大學,學士班(日間),7462,94,72,22,128,94,34
,101,1,公立,技專校院,27,國立高雄應用科技大學,學士班(進修),1733,93,71,22,126,93,33
,101,1,公立,技專校院,27,國立高雄應用科技大學,碩士班(日間),1345,74,53,21,96,68,28
,101,1,公立,技專校院,27,國立高雄應用科技大學,碩士在職專班,1301,161,131,30,226,180,46
,101,1,公立,技專校院,27,國立高雄應用科技大學,博士班,233,20,20,0,28,28,0
,101,1,公立,技專校院,33,國立虎尾科技大學,學士班(日間),7703,104,80,24,256,208,48
,101,1,公立,技專校院,33,國立虎尾科技大學,學士班(進修),1368,42,28,14,71,48,23
,101,1,公立,技專校院,33,國立虎尾科技大學,碩士班(日間),1069,47,41,6,121,105,16
,101,1,公立,技專校院,33,國立虎尾科技大學,碩士在職專班,428,36,26,10,35,25,10
,101,1,公立,技專校院,33,國立虎尾科技大學,博士班,27,4,4,0,8,8,0
,101,1,公立,技專校院,34,國立高雄海洋科技大學,五專,480,8,7,1,9,8,1
,101,1,公立,技專校院,34,國立高雄海洋科技大學,學士班(日間),4996,84,60,24,181,135,46
,101,1,公立,技專校院,34,國立高雄海洋科技大學,學士班(進修),1782,121,79,42,106,65,41
,101,1,公立,技專校院,34,國立高雄海洋科技大學,碩士班(日間),357,17,14,3,49,33,16
,101,1,公立,技專校院,34,國立高雄海洋科技大學,碩士在職專班,185,33,25,8,24,16,8
,101,1,公立,技專校院,42,國立澎湖科技大學,二專(進修),28,4,3,1,4,3,1
,101,1,公立,技專校院,42,國立澎湖科技大學,學士班(日間),2563,45,27,18,70,46,24
,101,1,公立,技專校院,42,國立澎湖科技大學,學士班(進修),316,20,14,6,26,20,6
,101,1,公立,技專校院,42,國立澎湖科技大學,碩士班(日間),98,12,6,6,17,10,7
,101,1,公立,技專校院,42,國立澎湖科技大學,碩士在職專班,36,3,2,1,3,2,1
,101,1,公立,技專校院,43,國立勤益科技大學,二專(日間),161,5,3,2,7,6,1
,101,1,公立,技專校院,43,國立勤益科技大學,二專(進修),28,13,12,1,17,16,1
,101,1,公立,技專校院,43,國立勤益科技大學,學士班(日間),6365,125,87,38,253,177,76
,101,1,公立,技專校院,43,國立勤益科技大學,學士班(進修),3143,126,107,19,144,123,21
,101,1,公立,技專校院,43,國立勤益科技大學,碩士班(日間),712,34,26,8,56,42,14
,101,1,公立,技專校院,43,國立勤益科技大學,碩士在職專班,227,28,22,6,43,33,10
,101,1,公立,技專校院,43,國立勤益科技大學,博士班,3,0,0,0,0,0,0
,101,1,公立,技專校院,46,國立臺北護理健康大學,學士班(日間),2769,39,9,30,88,17,71
,101,1,公立,技專校院,46,國立臺北護理健康大學,學士班(進修),639,38,0,38,78,1,77
,101,1,公立,技專校院,46,國立臺北護理健康大學,碩士班(日間),624,100,10,90,219,32,187
,101,1,公立,技專校院,46,國立臺北護理健康大學,碩士在職專班,162,16,1,15,33,5,28
,101,1,公立,技專校院,46,國立臺北護理健康大學,博士班,64,4,0,4,9,0,9
,101,1,公立,技專校院,47,國立高雄餐旅大學,五專,229,4,3,1,9,5,4
,101,1,公立,技專校院,47,國立高雄餐旅大學,學士班(日間),3140,50,15,35,93,32,61
,101,1,公立,技專校院,47,國立高雄餐旅大學,學士班(進修),1236,15,8,7,42,21,21
,101,1,公立,技專校院,47,國立高雄餐旅大學,碩士班(日間),198,22,12,10,44,17,27
,101,1,公立,技專校院,47,國立高雄餐旅大學,碩士在職專班,80,0,0,0,0,0,0
,101,1,公立,技專校院,47,國立高雄餐旅大學,博士班,8,0,0,0,0,0,0
,101,1,公立,技專校院,50,國立臺中科技大學,二專(日間),295,12,1,11,20,1,19
,101,1,公立,技專校院,50,國立臺中科技大學,二專(進修),171,25,3,22,27,3,24
,101,1,公立,技專校院,50,國立臺中科技大學,五專,3732,39,12,27,66,19,47
,101,1,公立,技專校院,50,國立臺中科技大學,學士班(日間),5644,70,26,44,151,59,92
,101,1,公立,技專校院,50,國立臺中科技大學,學士班(進修),2517,126,37,89,162,47,115
,101,1,公立,技專校院,50,國立臺中科技大學,碩士班(日間),365,21,12,9,44,24,20
,101,1,公立,技專校院,50,國立臺中科技大學,碩士在職專班,139,3,1,2,7,2,5
,101,1,公立,技專校院,136,國立屏東商業技術學院,學士班(日間),2969,41,14,27,76,28,48
,101,1,公立,技專校院,136,國立屏東商業技術學院,學士班(進修),832,39,18,21,84,35,49
,101,1,公立,技專校院,136,國立屏東商業技術學院,碩士班(日間),256,24,12,12,60,29,31
,101,1,公立,技專校院,136,國立屏東商業技術學院,碩士在職專班,24,1,1,0,4,2,2
,101,1,公立,技專校院,142,國立臺北商業技術學院,二專(進修),418,15,3,12,52,18,34
,101,1,公立,技專校院,142,國立臺北商業技術學院,五專,2038,64,21,43,60,20,40
,101,1,公立,技專校院,142,國立臺北商業技術學院,學士班(日間),2146,31,8,23,69,19,50
,101,1,公立,技專校院,142,國立臺北商業技術學院,學士班(進修),1804,48,15,33,78,31,47
,101,1,公立,技專校院,142,國立臺北商業技術學院,碩士班(日間),149,12,8,4,30,16,14
,101,1,公立,技專校院,142,國立臺北商業技術學院,碩士在職專班,29,3,2,1,7,5,2
,101,1,公立,技專校院,144,國立臺灣戲曲學院,二專(日間),1,0,0,0,0,0,0
,101,1,公立,技專校院,144,國立臺灣戲曲學院,學士班(日間),492,15,4,11,35,16,19
,101,1,公立,技專校院,221,國立臺南護理專科學校,二專(日間),93,1,0,1,4,0,4
,101,1,公立,技專校院,221,國立臺南護理專科學校,二專(進修),98,3,1,2,12,3,9
,101,1,公立,技專校院,221,國立臺南護理專科學校,五專,1675,8,0,8,16,1,15
,101,1,公立,技專校院,222,國立臺東專科學校,二專(日間),431,12,10,2,36,27,9
,101,1,公立,技專校院,222,國立臺東專科學校,二專(進修),202,10,8,2,19,15,4
,101,1,公立,技專校院,222,國立臺東專科學校,五專,452,36,17,19,53,26,27
,101,1,私立,一般大學,1001,東海大學,學士班(日間),13578,246,146,100,514,309,205
,101,1,私立,一般大學,1001,東海大學,學士班(進修),834,70,40,30,233,151,82
,101,1,私立,一般大學,1001,東海大學,碩士班(日間),1790,124,62,62,369,192,177
,101,1,私立,一般大學,1001,東海大學,碩士在職專班,798,65,23,42,161,85,76
,101,1,私立,一般大學,1001,東海大學,博士班,240,21,15,6,64,41,23
,101,1,私立,一般大學,1002,輔仁大學,學士班(日間),17829,414,224,190,665,349,316
,101,1,私立,一般大學,1002,輔仁大學,學士班(進修),4722,245,95,150,446,184,262
,101,1,私立,一般大學,1002,輔仁大學,碩士班(日間),2225,286,105,181,649,277,372
,101,1,私立,一般大學,1002,輔仁大學,碩士在職專班,1563,103,43,60,364,178,186
,101,1,私立,一般大學,1002,輔仁大學,博士班,417,55,27,28,153,79,74
,101,1,私立,一般大學,1003,東吳大學,學士班(日間),11793,280,135,145,380,190,190
,101,1,私立,一般大學,1003,東吳大學,學士班(進修),1351,104,43,61,169,67,102
,101,1,私立,一般大學,1003,東吳大學,碩士班(日間),1261,192,98,94,271,141,130
,101,1,私立,一般大學,1003,東吳大學,碩士在職專班,1187,137,62,75,234,101,133
,101,1,私立,一般大學,1003,東吳大學,博士班,92,7,3,4,14,9,5
,101,1,私立,一般大學,1004,中原大學,學士班(日間),12582,214,153,61,414,301,113
,101,1,私立,一般大學,1004,中原大學,學士班(進修),6,0,0,0,7,6,1
,101,1,私立,一般大學,1004,中原大學,碩士班(日間),2004,110,66,44,301,186,115
,101,1,私立,一般大學,1004,中原大學,碩士在職專班,1284,73,47,26,261,171,90
,101,1,私立,一般大學,1004,中原大學,博士班,387,16,14,2,81,65,16
,101,1,私立,一般大學,1005,淡江大學,學士班(日間),21025,418,255,163,850,534,316
,101,1,私立,一般大學,1005,淡江大學,學士班(進修),2742,131,67,64,331,155,176
,101,1,私立,一般大學,1005,淡江大學,碩士班(日間),2473,144,74,70,402,216,186
,101,1,私立,一般大學,1005,淡江大學,碩士在職專班,1340,89,48,41,242,126,116
,101,1,私立,一般大學,1005,淡江大學,博士班,533,65,48,17,146,101,45
,101,1,私立,一般大學,1006,中國文化大學,學士班(日間),20488,376,222,154,634,379,255
,101,1,私立,一般大學,1006,中國文化大學,學士班(進修),2783,254,112,142,616,291,325
,101,1,私立,一般大學,1006,中國文化大學,碩士班(日間),2016,138,74,64,356,206,150
,101,1,私立,一般大學,1006,中國文化大學,碩士在職專班,658,74,28,46,177,88,89
,101,1,私立,一般大學,1006,中國文化大學,博士班,523,41,26,15,98,59,39
,101,1,私立,一般大學,1007,逢甲大學,學士班(日間),16460,344,264,80,416,320,96
,101,1,私立,一般大學,1007,逢甲大學,學士班(進修),849,86,45,41,116,62,54
,101,1,私立,一般大學,1007,逢甲大學,碩士班(日間),1847,131,89,42,174,117,57
,101,1,私立,一般大學,1007,逢甲大學,碩士在職專班,1217,126,84,42,179,121,58
,101,1,私立,一般大學,1007,逢甲大學,博士班,411,61,47,14,92,67,25
,101,1,私立,一般大學,1008,靜宜大學,學士班(日間),11083,238,122,116,377,204,173
,101,1,私立,一般大學,1008,靜宜大學,學士班(進修),153,9,6,3,13,9,4
,101,1,私立,一般大學,1008,靜宜大學,碩士班(日間),733,72,33,39,119,57,62
,101,1,私立,一般大學,1008,靜宜大學,碩士在職專班,322,22,9,13,44,21,23
,101,1,私立,一般大學,1008,靜宜大學,博士班,38,1,0,1,3,2,1
,101,1,私立,一般大學,1009,長庚大學,學士班(日間),5054,120,68,52,161,77,84
,101,1,私立,一般大學,1009,長庚大學,碩士班(日間),1452,80,35,45,195,89,106
,101,1,私立,一般大學,1009,長庚大學,碩士在職專班,457,41,26,15,103,68,35
,101,1,私立,一般大學,1009,長庚大學,博士班,543,34,20,14,74,43,31
,101,1,私立,一般大學,1010,元智大學,學士班(日間),7073,65,40,25,108,71,37
,101,1,私立,一般大學,1010,元智大學,學士班(進修),2,0,0,0,0,0,0
,101,1,私立,一般大學,1010,元智大學,碩士班(日間),1332,44,27,17,100,64,36
,101,1,私立,一般大學,1010,元智大學,碩士在職專班,1161,57,41,16,181,133,48
,101,1,私立,一般大學,1010,元智大學,博士班,341,21,17,4,67,50,17
,101,1,私立,一般大學,1011,中華大學,學士班(日間),6871,157,114,43,286,214,72
,101,1,私立,一般大學,1011,中華大學,學士班(進修),452,29,22,7,37,27,10
,101,1,私立,一般大學,1011,中華大學,碩士班(日間),794,47,38,9,126,104,22
,101,1,私立,一般大學,1011,中華大學,碩士在職專班,352,16,13,3,59,53,6
,101,1,私立,一般大學,1011,中華大學,博士班,145,21,14,7,51,38,13
,101,1,私立,一般大學,1012,大葉大學,學士班(日間),7465,179,104,75,270,181,89
,101,1,私立,一般大學,1012,大葉大學,學士班(進修),745,36,28,8,53,40,13
,101,1,私立,一般大學,1012,大葉大學,碩士班(日間),966,39,29,10,85,62,23
,101,1,私立,一般大學,1012,大葉大學,碩士在職專班,928,32,15,17,59,32,27
,101,1,私立,一般大學,1012,大葉大學,博士班,159,14,9,5,33,25,8
,101,1,私立,一般大學,1013,華梵大學,學士班(日間),2918,136,82,54,208,127,81
,101,1,私立,一般大學,1013,華梵大學,碩士班(日間),393,62,44,18,109,75,34
,101,1,私立,一般大學,1013,華梵大學,碩士在職專班,447,51,32,19,116,85,31
,101,1,私立,一般大學,1013,華梵大學,博士班,49,12,8,4,19,13,6
,101,1,私立,一般大學,1014,義守大學,學士班(日間),12009,78,62,16,117,89,28
,101,1,私立,一般大學,1014,義守大學,學士班(進修),2669,112,70,42,217,139,78
,101,1,私立,一般大學,1014,義守大學,碩士班(日間),714,6,5,1,21,20,1
,101,1,私立,一般大學,1014,義守大學,碩士在職專班,645,4,0,4,25,17,8
,101,1,私立,一般大學,1014,義守大學,博士班,127,12,10,2,27,20,7
,101,1,私立,一般大學,1015,世新大學,學士班(日間),9528,162,73,89,278,134,144
,101,1,私立,一般大學,1015,世新大學,學士班(進修),251,12,4,8,23,8,15
,101,1,私立,一般大學,1015,世新大學,碩士班(日間),844,105,63,42,171,99,72
,101,1,私立,一般大學,1015,世新大學,碩士在職專班,1124,196,104,92,306,150,156
,101,1,私立,一般大學,1015,世新大學,博士班,72,7,3,4,10,5,5
,101,1,私立,一般大學,1016,銘傳大學,學士班(日間),16902,344,174,170,571,311,260
,101,1,私立,一般大學,1016,銘傳大學,學士班(進修),29,1,0,1,2,1,1
,101,1,私立,一般大學,1016,銘傳大學,碩士班(日間),887,60,32,28,119,63,56
,101,1,私立,一般大學,1016,銘傳大學,碩士在職專班,923,64,21,43,104,37,67
,101,1,私立,一般大學,1016,銘傳大學,博士班,56,7,3,4,12,4,8
,101,1,私立,一般大學,1017,實踐大學,學士班(日間),12279,216,88,128,315,135,180
,101,1,私立,一般大學,1017,實踐大學,學士班(進修),2909,124,45,79,196,64,132
,101,1,私立,一般大學,1017,實踐大學,碩士班(日間),414,40,16,24,69,33,36
,101,1,私立,一般大學,1017,實踐大學,碩士在職專班,187,15,7,8,28,15,13
,101,1,私立,一般大學,1017,實踐大學,博士班,3,0,0,0,0,0,0
,101,1,私立,一般大學,1019,高雄醫學大學,學士班(日間),5589,148,75,73,183,90,93
,101,1,私立,一般大學,1019,高雄醫學大學,學士班(進修),187,8,0,8,13,0,13
,101,1,私立,一般大學,1019,高雄醫學大學,碩士班(日間),632,102,39,63,139,48,91
,101,1,私立,一般大學,1019,高雄醫學大學,碩士在職專班,183,32,11,21,55,19,36
,101,1,私立,一般大學,1019,高雄醫學大學,博士班,344,40,17,23,82,37,45
,101,1,私立,一般大學,1020,南華大學,學士班(日間),3511,114,76,38,224,146,78
,101,1,私立,一般大學,1020,南華大學,學士班(進修),176,7,6,1,16,14,2
,101,1,私立,一般大學,1020,南華大學,碩士班(日間),852,103,54,49,179,88,91
,101,1,私立,一般大學,1020,南華大學,碩士在職專班,590,56,30,26,86,47,39
,101,1,私立,一般大學,1020,南華大學,博士班,25,1,0,1,5,2,3
,101,1,私立,一般大學,1021,真理大學,學士班(日間),7936,165,93,72,297,184,113
,101,1,私立,一般大學,1021,真理大學,學士班(進修),1006,38,18,20,58,25,33
,101,1,私立,一般大學,1021,真理大學,碩士班(日間),166,11,7,4,15,10,5
,101,1,私立,一般大學,1021,真理大學,碩士在職專班,14,2,1,1,2,1,1
,101,1,私立,一般大學,1022,大同大學,學士班(日間),3694,55,46,9,217,174,43
,101,1,私立,一般大學,1022,大同大學,碩士班(日間),659,20,14,6,84,59,25
,101,1,私立,一般大學,1022,大同大學,碩士在職專班,564,41,27,14,246,191,55
,101,1,私立,一般大學,1022,大同大學,博士班,169,23,22,1,65,56,9
,101,1,私立,一般大學,1027,慈濟大學,學士班(日間),2809,48,20,28,19,7,12
,101,1,私立,一般大學,1027,慈濟大學,碩士班(日間),380,44,11,33,44,20,24
,101,1,私立,一般大學,1027,慈濟大學,碩士在職專班,44,2,1,1,3,0,3
,101,1,私立,一般大學,1027,慈濟大學,博士班,110,19,10,9,15,11,4
,101,1,私立,一般大學,1028,臺北醫學大學,學士班(日間),4507,88,38,50,115,52,63
,101,1,私立,一般大學,1028,臺北醫學大學,學士班(進修),324,21,0,21,34,0,34
,101,1,私立,一般大學,1028,臺北醫學大學,碩士班(日間),690,46,18,28,77,24,53
,101,1,私立,一般大學,1028,臺北醫學大學,碩士在職專班,227,14,2,12,27,3,24
,101,1,私立,一般大學,1028,臺北醫學大學,博士班,360,25,18,7,69,40,29
,101,1,私立,一般大學,1029,中山醫學大學,學士班(日間),6490,132,64,68,180,89,91
,101,1,私立,一般大學,1029,中山醫學大學,學士班(進修),349,8,4,4,16,9,7
,101,1,私立,一般大學,1029,中山醫學大學,碩士班(日間),528,37,15,22,57,24,33
,101,1,私立,一般大學,1029,中山醫學大學,碩士在職專班,91,5,4,1,7,4,3
,101,1,私立,一般大學,1029,中山醫學大學,博士班,235,15,8,7,36,20,16
,101,1,私立,一般大學,1033,長榮大學,學士班(日間),8584,241,136,105,264,153,111
,101,1,私立,一般大學,1033,長榮大學,學士班(進修),523,61,35,26,69,39,30
,101,1,私立,一般大學,1033,長榮大學,碩士班(日間),562,84,48,36,84,52,32
,101,1,私立,一般大學,1033,長榮大學,碩士在職專班,233,23,11,12,28,16,12
,101,1,私立,一般大學,1033,長榮大學,博士班,36,12,10,2,14,12,2
,101,1,私立,一般大學,1035,中國醫藥大學,學士班(日間),6458,168,86,82,157,80,77
,101,1,私立,一般大學,1035,中國醫藥大學,學士班(進修),139,15,14,1,19,2,17
,101,1,私立,一般大學,1035,中國醫藥大學,碩士班(日間),561,63,32,31,89,42,47
,101,1,私立,一般大學,1035,中國醫藥大學,碩士在職專班,67,3,2,1,3,2,1
,101,1,私立,一般大學,1035,中國醫藥大學,博士班,317,44,33,11,60,43,17
,101,1,私立,一般大學,1039,玄奘大學,學士班(日間),3650,230,115,115,304,157,147
,101,1,私立,一般大學,1039,玄奘大學,學士班(進修),1518,337,173,164,425,229,196
,101,1,私立,一般大學,1039,玄奘大學,碩士班(日間),463,116,69,47,142,83,59
,101,1,私立,一般大學,1039,玄奘大學,碩士在職專班,350,36,19,17,47,22,25
,101,1,私立,一般大學,1039,玄奘大學,博士班,29,1,1,0,1,1,0
,101,1,私立,一般大學,1048,亞洲大學,學士班(日間),9261,184,108,76,402,239,163
,101,1,私立,一般大學,1048,亞洲大學,學士班(進修),1513,74,44,30,180,114,66
,101,1,私立,一般大學,1048,亞洲大學,碩士班(日間),739,75,44,31,144,83,61
,101,1,私立,一般大學,1048,亞洲大學,碩士在職專班,472,30,14,16,43,22,21
,101,1,私立,一般大學,1048,亞洲大學,博士班,134,10,3,7,19,9,10
,101,1,私立,一般大學,1049,開南大學,學士班(日間),8020,164,108,56,367,240,127
,101,1,私立,一般大學,1049,開南大學,學士班(進修),1344,79,47,32,168,105,63
,101,1,私立,一般大學,1049,開南大學,碩士班(日間),343,14,6,8,55,26,29
,101,1,私立,一般大學,1049,開南大學,碩士在職專班,384,4,2,2,21,12,9
,101,1,私立,一般大學,1050,佛光大學,學士班(日間),2262,63,27,36,105,56,49
,101,1,私立,一般大學,1050,佛光大學,碩士班(日間),835,72,31,41,229,112,117
,101,1,私立,一般大學,1050,佛光大學,碩士在職專班,276,21,13,8,40,23,17
,101,1,私立,一般大學,1050,佛光大學,博士班,32,1,0,1,3,0,3
,101,1,私立,一般大學,1058,明道大學,學士班(日間),3346,70,37,33,120,72,48
,101,1,私立,一般大學,1058,明道大學,學士班(進修),2292,103,64,39,165,106,59
,101,1,私立,一般大學,1058,明道大學,碩士班(日間),265,16,12,4,34,25,9
,101,1,私立,一般大學,1058,明道大學,碩士在職專班,49,3,3,0,8,4,4
,101,1,私立,一般大學,1059,康寧大學,學士班(日間),1121,70,46,24,185,134,51
,101,1,私立,一般大學,1059,康寧大學,學士班(進修),400,29,16,13,154,117,37
,101,1,私立,一般大學,1059,康寧大學,碩士班(日間),223,12,8,4,52,40,12
,101,1,私立,一般大學,1059,康寧大學,碩士在職專班,162,12,7,5,27,15,12
,101,1,私立,一般大學,1067,台灣首府大學,學士班(日間),3722,83,55,28,155,97,58
,101,1,私立,一般大學,1067,台灣首府大學,學士班(進修),1533,70,48,22,114,77,37
,101,1,私立,一般大學,1067,台灣首府大學,碩士班(日間),81,3,2,1,9,4,5
,101,1,私立,一般大學,1125,興國管理學院,學士班(日間),199,5,4,1,5,5,0
,101,1,私立,一般大學,1125,興國管理學院,學士班(進修),1197,6,6,0,4,4,0
,101,1,私立,一般大學,1176,稻江科技暨管理學院,學士班(日間),1562,43,24,19,90,54,36
,101,1,私立,一般大學,1176,稻江科技暨管理學院,學士班(進修),1156,25,17,8,66,38,28
,101,1,私立,一般大學,1176,稻江科技暨管理學院,碩士班(日間),51,7,6,1,16,11,5
,101,1,私立,一般大學,1195,馬偕醫學院,學士班(日間),335,10,5,5,11,5,6
,101,1,私立,一般大學,1195,馬偕醫學院,碩士班(日間),2,1,0,1,1,0,1
,101,1,私立,一般大學,1R01,法鼓佛教學院,學士班(日間),54,0,0,0,0,0,0
,101,1,私立,一般大學,1R01,法鼓佛教學院,碩士班(日間),63,3,1,2,12,5,7
,101,1,私立,一般大學,1R01,法鼓佛教學院,博士班,3,0,0,0,0,0,0
,101,1,私立,一般大學,1R02,基督教台灣浸會神學院,碩士班(日間),39,2,0,2,5,0,5
,101,1,私立,一般大學,1R03,臺北基督學院,學士班(日間),41,1,0,1,1,0,1
,101,1,私立,技專校院,1018,朝陽科技大學,學士班(日間),11041,196,113,83,371,206,165
,101,1,私立,技專校院,1018,朝陽科技大學,學士班(進修),3853,183,78,105,375,182,193
,101,1,私立,技專校院,1018,朝陽科技大學,碩士班(日間),1007,60,29,31,141,82,59
,101,1,私立,技專校院,1018,朝陽科技大學,碩士在職專班,580,19,8,11,88,57,31
,101,1,私立,技專校院,1018,朝陽科技大學,博士班,72,6,5,1,13,12,1
,101,1,私立,技專校院,1023,南臺科技大學,學士班(日間),13094,146,87,59,304,191,113
,101,1,私立,技專校院,1023,南臺科技大學,學士班(進修),4929,180,108,72,941,508,433
,101,1,私立,技專校院,1023,南臺科技大學,碩士班(日間),1257,87,62,25,214,143,71
,101,1,私立,技專校院,1023,南臺科技大學,碩士在職專班,544,39,13,26,160,86,74
,101,1,私立,技專校院,1023,南臺科技大學,博士班,44,3,2,1,8,7,1
,101,1,私立,技專校院,1024,崑山科技大學,學士班(日間),8578,236,136,100,481,310,171
,101,1,私立,技專校院,1024,崑山科技大學,學士班(進修),3560,266,172,94,700,451,249
,101,1,私立,技專校院,1024,崑山科技大學,碩士班(日間),589,36,27,9,94,76,18
,101,1,私立,技專校院,1024,崑山科技大學,碩士在職專班,213,11,8,3,29,25,4
,101,1,私立,技專校院,1024,崑山科技大學,博士班,26,0,0,0,2,2,0
,101,1,私立,技專校院,1025,嘉南藥理大學,學士班(日間),12702,218,86,132,515,252,263
,101,1,私立,技專校院,1025,嘉南藥理大學,學士班(進修),3743,230,116,114,692,410,282
,101,1,私立,技專校院,1025,嘉南藥理大學,碩士班(日間),357,46,31,15,93,68,25
,101,1,私立,技專校院,1025,嘉南藥理大學,碩士在職專班,183,22,10,12,54,25,29
,101,1,私立,技專校院,1026,樹德科技大學,二專(日間),0,1,1,0,1,1,0
,101,1,私立,技專校院,1026,樹德科技大學,學士班(日間),8103,255,163,92,350,218,132
,101,1,私立,技專校院,1026,樹德科技大學,學士班(進修),2352,189,116,73,248,155,93
,101,1,私立,技專校院,1026,樹德科技大學,碩士班(日間),429,49,31,18,69,40,29
,101,1,私立,技專校院,1026,樹德科技大學,碩士在職專班,628,28,15,13,39,23,16
,101,1,私立,技專校院,1026,樹德科技大學,博士班,16,3,2,1,5,4,1
,101,1,私立,技專校院,1030,龍華科技大學,二專(日間),44,0,0,0,0,0,0
,101,1,私立,技專校院,1030,龍華科技大學,學士班(日間),6346,97,69,28,236,174,62
,101,1,私立,技專校院,1030,龍華科技大學,學士班(進修),4111,174,118,56,359,251,108
,101,1,私立,技專校院,1030,龍華科技大學,碩士班(日間),308,7,5,2,23,17,6
,101,1,私立,技專校院,1030,龍華科技大學,碩士在職專班,110,4,3,1,7,5,2
,101,1,私立,技專校院,1031,輔英科技大學,二專(進修),13,1,1,0,1,1,0
,101,1,私立,技專校院,1031,輔英科技大學,五專,3429,61,8,53,109,18,91
,101,1,私立,技專校院,1031,輔英科技大學,學士班(日間),5261,178,95,83,337,203,134
,101,1,私立,技專校院,1031,輔英科技大學,學士班(進修),1509,115,72,43,207,113,94
,101,1,私立,技專校院,1031,輔英科技大學,碩士班(日間),133,19,3,16,38,4,34
,101,1,私立,技專校院,1031,輔英科技大學,碩士在職專班,26,8,1,7,15,1,14
,101,1,私立,技專校院,1032,明新科技大學,二專(日間),9,0,0,0,0,0,0
,101,1,私立,技專校院,1032,明新科技大學,二專(進修),172,0,0,0,0,0,0
,101,1,私立,技專校院,1032,明新科技大學,學士班(日間),8583,173,101,72,745,441,304
,101,1,私立,技專校院,1032,明新科技大學,學士班(進修),4244,242,164,78,382,248,134
,101,1,私立,技專校院,1032,明新科技大學,碩士班(日間),451,35,27,8,121,89,32
,101,1,私立,技專校院,1032,明新科技大學,碩士在職專班,226,22,19,3,30,26,4
,101,1,私立,技專校院,1034,弘光科技大學,五專,391,6,1,5,16,1,15
,101,1,私立,技專校院,1034,弘光科技大學,學士班(日間),7618,132,51,81,307,124,183
,101,1,私立,技專校院,1034,弘光科技大學,學士班(進修),4396,202,79,123,521,209,312
,101,1,私立,技專校院,1034,弘光科技大學,碩士班(日間),223,19,10,9,52,24,28
,101,1,私立,技專校院,1034,弘光科技大學,碩士在職專班,109,14,5,9,34,12,22
,101,1,私立,技專校院,1036,健行科技大學,二專(日間),138,2,2,0,3,3,0
,101,1,私立,技專校院,1036,健行科技大學,學士班(日間),8701,176,129,47,379,288,91
,101,1,私立,技專校院,1036,健行科技大學,學士班(進修),3858,259,185,74,462,330,132
,101,1,私立,技專校院,1036,健行科技大學,碩士班(日間),389,17,15,2,39,32,7
,101,1,私立,技專校院,1036,健行科技大學,碩士在職專班,136,7,6,1,16,12,4
,101,1,私立,技專校院,1037,正修科技大學,二專(日間),114,4,4,0,5,5,0
,101,1,私立,技專校院,1037,正修科技大學,二專(進修),31,4,3,1,17,13,4
,101,1,私立,技專校院,1037,正修科技大學,五專,6,3,2,1,16,14,2
,101,1,私立,技專校院,1037,正修科技大學,學士班(日間),9183,186,117,69,472,325,147
,101,1,私立,技專校院,1037,正修科技大學,學士班(進修),6772,393,233,160,791,494,297
,101,1,私立,技專校院,1037,正修科技大學,碩士班(日間),371,12,9,3,40,34,6
,101,1,私立,技專校院,1037,正修科技大學,碩士在職專班,75,9,4,5,21,12,9
,101,1,私立,技專校院,1037,正修科技大學,博士班,8,1,1,0,3,3,0
,101,1,私立,技專校院,1038,萬能科技大學,二專(日間),21,0,0,0,0,0,0
,101,1,私立,技專校院,1038,萬能科技大學,學士班(日間),5383,108,68,40,430,301,129
,101,1,私立,技專校院,1038,萬能科技大學,學士班(進修),4856,136,80,56,271,174,97
,101,1,私立,技專校院,1038,萬能科技大學,碩士班(日間),131,11,9,2,31,23,8
,101,1,私立,技專校院,1038,萬能科技大學,碩士在職專班,143,2,1,1,2,1,1
,101,1,私立,技專校院,1040,建國科技大學,二專(日間),55,0,0,0,0,0,0
,101,1,私立,技專校院,1040,建國科技大學,二專(進修),88,3,2,1,12,11,1
,101,1,私立,技專校院,1040,建國科技大學,學士班(日間),7007,133,81,52,251,180,71
,101,1,私立,技專校院,1040,建國科技大學,學士班(進修),2039,98,69,29,130,90,40
,101,1,私立,技專校院,1040,建國科技大學,碩士班(日間),225,10,7,3,19,16,3
,101,1,私立,技專校院,1041,明志科技大學,二專(進修),47,4,3,1,5,3,2
,101,1,私立,技專校院,1041,明志科技大學,五專,40,0,0,0,0,0,0
,101,1,私立,技專校院,1041,明志科技大學,學士班(日間),3197,37,27,10,56,43,13
,101,1,私立,技專校院,1041,明志科技大學,學士班(進修),407,27,18,9,34,22,12
,101,1,私立,技專校院,1041,明志科技大學,碩士班(日間),437,22,22,0,34,31,3
,101,1,私立,技專校院,1041,明志科技大學,碩士在職專班,51,7,7,0,9,9,0
,101,1,私立,技專校院,1042,高苑科技大學,二專(日間),70,0,0,0,1,1,0
,101,1,私立,技專校院,1042,高苑科技大學,五專,158,2,2,0,2,2,0
,101,1,私立,技專校院,1042,高苑科技大學,學士班(日間),5376,92,70,22,111,88,23
,101,1,私立,技專校院,1042,高苑科技大學,學士班(進修),1468,56,44,12,75,55,20
,101,1,私立,技專校院,1042,高苑科技大學,碩士班(日間),162,8,5,3,11,7,4
,101,1,私立,技專校院,1042,高苑科技大學,碩士在職專班,263,6,5,1,8,7,1
,101,1,私立,技專校院,1043,大仁科技大學,二專(日間),1,0,0,0,1,1,0
,101,1,私立,技專校院,1043,大仁科技大學,二專(進修),2,1,1,0,18,18,0
,101,1,私立,技專校院,1043,大仁科技大學,五專,326,28,11,17,46,19,27
,101,1,私立,技專校院,1043,大仁科技大學,學士班(日間),6078,179,100,79,395,240,155
,101,1,私立,技專校院,1043,大仁科技大學,學士班(進修),2052,96,49,47,381,226,155
,101,1,私立,技專校院,1043,大仁科技大學,碩士班(日間),93,9,7,2,27,16,11
,101,1,私立,技專校院,1043,大仁科技大學,碩士在職專班,141,11,4,7,30,18,12
,101,1,私立,技專校院,1044,聖約翰科技大學,學士班(日間),6068,165,118,47,357,278,79
,101,1,私立,技專校院,1044,聖約翰科技大學,學士班(進修),865,73,52,21,198,139,59
,101,1,私立,技專校院,1044,聖約翰科技大學,碩士班(日間),251,19,17,2,32,27,5
,101,1,私立,技專校院,1044,聖約翰科技大學,碩士在職專班,132,8,6,2,16,12,4
,101,1,私立,技專校院,1045,嶺東科技大學,學士班(日間),7011,100,54,46,177,95,82
,101,1,私立,技專校院,1045,嶺東科技大學,學士班(進修),2994,150,79,71,280,147,133
,101,1,私立,技專校院,1045,嶺東科技大學,碩士班(日間),266,17,11,6,41,24,17
,101,1,私立,技專校院,1045,嶺東科技大學,碩士在職專班,138,6,2,4,11,6,5
,101,1,私立,技專校院,1046,中國科技大學,二專(進修),0,0,0,0,2,2,0
,101,1,私立,技專校院,1046,中國科技大學,五專,8,2,1,1,10,7,3
,101,1,私立,技專校院,1046,中國科技大學,學士班(日間),8300,184,83,101,332,178,154
,101,1,私立,技專校院,1046,中國科技大學,學士班(進修),3369,168,103,65,362,211,151
,101,1,私立,技專校院,1046,中國科技大學,碩士班(日間),161,15,10,5,27,16,11
,101,1,私立,技專校院,1046,中國科技大學,碩士在職專班,13,1,1,0,1,1,0
,101,1,私立,技專校院,1047,中臺科技大學,五專,123,1,0,1,6,4,2
,101,1,私立,技專校院,1047,中臺科技大學,學士班(日間),6355,166,67,99,400,180,220
,101,1,私立,技專校院,1047,中臺科技大學,學士班(進修),3379,234,86,148,587,244,343
,101,1,私立,技專校院,1047,中臺科技大學,碩士班(日間),212,17,7,10,51,27,24
,101,1,私立,技專校院,1047,中臺科技大學,碩士在職專班,348,27,8,19,48,15,33
,101,1,私立,技專校院,1047,中臺科技大學,博士班,14,0,0,0,1,1,0
,101,1,私立,技專校院,1051,台南應用科技大學,二專(進修),28,0,0,0,0,0,0
,101,1,私立,技專校院,1051,台南應用科技大學,五專,1386,28,4,24,66,10,56
,101,1,私立,技專校院,1051,台南應用科技大學,學士班(日間),8487,136,46,90,400,122,278
,101,1,私立,技專校院,1051,台南應用科技大學,學士班(進修),3029,183,70,113,341,125,216
,101,1,私立,技專校院,1051,台南應用科技大學,碩士班(日間),175,17,2,15,42,8,34
,101,1,私立,技專校院,1051,台南應用科技大學,碩士在職專班,180,19,6,13,29,6,23
,101,1,私立,技專校院,1052,遠東科技大學,二專(進修),73,4,4,0,13,13,0
,101,1,私立,技專校院,1052,遠東科技大學,五專,2,2,1,1,5,4,1
,101,1,私立,技專校院,1052,遠東科技大學,學士班(日間),8152,164,106,58,399,283,116
,101,1,私立,技專校院,1052,遠東科技大學,學士班(進修),748,41,38,3,116,103,13
,101,1,私立,技專校院,1052,遠東科技大學,碩士班(日間),180,11,8,3,31,26,5
,101,1,私立,技專校院,1052,遠東科技大學,碩士在職專班,38,3,3,0,3,3,0
,101,1,私立,技專校院,1053,元培醫事科技大學,學士班(日間),6112,152,100,52,265,178,87
,101,1,私立,技專校院,1053,元培醫事科技大學,學士班(進修),1651,66,36,30,121,59,62
,101,1,私立,技專校院,1053,元培醫事科技大學,碩士班(日間),174,8,7,1,16,11,5
,101,1,私立,技專校院,1053,元培醫事科技大學,碩士在職專班,24,1,0,1,1,0,1
,101,1,私立,技專校院,1054,景文科技大學,二專(進修),16,4,2,2,17,14,3
,101,1,私立,技專校院,1054,景文科技大學,學士班(日間),5977,101,48,53,233,118,115
,101,1,私立,技專校院,1054,景文科技大學,學士班(進修),2495,136,65,71,265,144,121
,101,1,私立,技專校院,1054,景文科技大學,碩士班(日間),59,6,4,2,8,5,3
,101,1,私立,技專校院,1054,景文科技大學,碩士在職專班,97,6,4,2,12,9,3
,101,1,私立,技專校院,1055,中華醫事科技大學,二專(日間),109,9,2,7,11,4,7
,101,1,私立,技專校院,1055,中華醫事科技大學,五專,1954,42,9,33,54,17,37
,101,1,私立,技專校院,1055,中華醫事科技大學,學士班(日間),4891,95,56,39,170,101,69
,101,1,私立,技專校院,1055,中華醫事科技大學,學士班(進修),2468,99,43,56,264,119,145
,101,1,私立,技專校院,1055,中華醫事科技大學,碩士班(日間),80,1,1,0,8,6,2
,101,1,私立,技專校院,1056,東南科技大學,二專(日間),83,4,2,2,11,9,2
,101,1,私立,技專校院,1056,東南科技大學,二專(進修),1,2,2,0,18,16,2
,101,1,私立,技專校院,1056,東南科技大學,學士班(日間),6448,272,206,66,549,433,116
,101,1,私立,技專校院,1056,東南科技大學,學士班(進修),615,113,90,23,122,103,19
,101,1,私立,技專校院,1056,東南科技大學,碩士班(日間),119,3,2,1,9,8,1
,101,1,私立,技專校院,1056,東南科技大學,碩士在職專班,68,6,6,0,11,11,0
,101,1,私立,技專校院,1057,德明財經科技大學,二專(日間),4,5,3,2,5,3,2
,101,1,私立,技專校院,1057,德明財經科技大學,二專(進修),3,3,2,1,12,8,4
,101,1,私立,技專校院,1057,德明財經科技大學,學士班(日間),6324,109,44,65,227,98,129
,101,1,私立,技專校院,1057,德明財經科技大學,學士班(進修),2247,154,70,84,279,129,150
,101,1,私立,技專校院,1057,德明財經科技大學,碩士班(日間),97,6,3,3,20,11,9
,101,1,私立,技專校院,1057,德明財經科技大學,碩士在職專班,49,3,1,2,7,4,3
,101,1,私立,技專校院,1060,南開科技大學,二專(進修),2,0,0,0,2,2,0
,101,1,私立,技專校院,1060,南開科技大學,五專,1344,28,23,5,75,62,13
,101,1,私立,技專校院,1060,南開科技大學,學士班(日間),3658,81,58,23,177,133,44
,101,1,私立,技專校院,1060,南開科技大學,學士班(進修),1215,71,57,14,134,96,38
,101,1,私立,技專校院,1060,南開科技大學,碩士班(日間),104,5,5,0,14,13,1
,101,1,私立,技專校院,1060,南開科技大學,碩士在職專班,154,1,0,1,3,0,3
,101,1,私立,技專校院,1061,中華科技大學,二專(進修),95,2,2,0,24,20,4
,101,1,私立,技專校院,1061,中華科技大學,學士班(日間),6585,135,87,48,464,309,155
,101,1,私立,技專校院,1061,中華科技大學,學士班(進修),1733,104,73,31,407,301,106
,101,1,私立,技專校院,1061,中華科技大學,碩士班(日間),245,19,18,1,78,66,12
,101,1,私立,技專校院,1061,中華科技大學,碩士在職專班,144,14,11,3,43,38,5
,101,1,私立,技專校院,1062,僑光科技大學,二專(日間),133,8,3,5,8,3,5
,101,1,私立,技專校院,1062,僑光科技大學,二專(進修),47,2,2,0,2,2,0
,101,1,私立,技專校院,1062,僑光科技大學,五專,1084,36,18,18,61,33,28
,101,1,私立,技專校院,1062,僑光科技大學,學士班(日間),5294,114,56,58,193,98,95
,101,1,私立,技專校院,1062,僑光科技大學,學士班(進修),3660,203,88,115,393,196,197
,101,1,私立,技專校院,1062,僑光科技大學,碩士班(日間),73,5,3,2,7,5,2
,101,1,私立,技專校院,1062,僑光科技大學,碩士在職專班,50,0,0,0,0,0,0
,101,1,私立,技專校院,1063,育達科技大學,學士班(日間),4932,278,159,119,518,308,210
,101,1,私立,技專校院,1063,育達科技大學,學士班(進修),2266,273,176,97,513,343,170
,101,1,私立,技專校院,1063,育達科技大學,碩士班(日間),132,5,5,0,23,18,5
,101,1,私立,技專校院,1063,育達科技大學,碩士在職專班,93,7,6,1,11,8,3
,101,1,私立,技專校院,1064,美和科技大學,五專,1990,39,7,32,67,14,53
,101,1,私立,技專校院,1064,美和科技大學,學士班(日間),3627,93,49,44,230,123,107
,101,1,私立,技專校院,1064,美和科技大學,學士班(進修),2264,103,43,60,254,107,147
,101,1,私立,技專校院,1064,美和科技大學,碩士班(日間),73,7,4,3,10,5,5
,101,1,私立,技專校院,1064,美和科技大學,碩士在職專班,70,8,5,3,16,9,7
,101,1,私立,技專校院,1065,吳鳳科技大學,二專(日間),63,3,1,2,15,6,9
,101,1,私立,技專校院,1065,吳鳳科技大學,二專(進修),217,16,8,8,64,42,22
,101,1,私立,技專校院,1065,吳鳳科技大學,五專,2,2,2,0,4,4,0
,101,1,私立,技專校院,1065,吳鳳科技大學,學士班(日間),4220,123,77,46,275,184,91
,101,1,私立,技專校院,1065,吳鳳科技大學,學士班(進修),1070,94,74,20,265,217,48
,101,1,私立,技專校院,1065,吳鳳科技大學,碩士班(日間),54,3,3,0,13,11,2
,101,1,私立,技專校院,1065,吳鳳科技大學,碩士在職專班,79,2,2,0,5,5,0
,101,1,私立,技專校院,1066,環球科技大學,二專(日間),193,14,11,3,41,27,14
,101,1,私立,技專校院,1066,環球科技大學,二專(進修),433,9,7,2,9,7,2
,101,1,私立,技專校院,1066,環球科技大學,學士班(日間),4270,144,82,62,270,147,123
,101,1,私立,技專校院,1066,環球科技大學,學士班(進修),1440,38,27,11,38,27,11
,101,1,私立,技專校院,1066,環球科技大學,碩士班(日間),117,8,5,3,23,14,9
,101,1,私立,技專校院,1066,環球科技大學,碩士在職專班,20,0,0,0,0,0,0
,101,1,私立,技專校院,1068,中州科技大學,二專(日間),1,0,0,0,0,0,0
,101,1,私立,技專校院,1068,中州科技大學,二專(進修),0,0,0,0,1,1,0
,101,1,私立,技專校院,1068,中州科技大學,學士班(日間),3946,107,72,35,173,119,54
,101,1,私立,技專校院,1068,中州科技大學,學士班(進修),2017,58,40,18,100,74,26
,101,1,私立,技專校院,1068,中州科技大學,碩士班(日間),119,7,6,1,10,9,1
,101,1,私立,技專校院,1068,中州科技大學,碩士在職專班,20,1,0,1,2,0,2
,101,1,私立,技專校院,1069,修平科技大學,二專(進修),126,7,5,2,47,41,6
,101,1,私立,技專校院,1069,修平科技大學,學士班(日間),5255,52,27,25,344,236,108
,101,1,私立,技專校院,1069,修平科技大學,學士班(進修),1272,30,20,10,265,223,42
,101,1,私立,技專校院,1069,修平科技大學,碩士班(日間),54,4,4,0,9,9,0
,101,1,私立,技專校院,1070,長庚科技大學,五專,2302,26,0,26,32,0,32
,101,1,私立,技專校院,1070,長庚科技大學,學士班(日間),3561,50,5,45,66,6,60
,101,1,私立,技專校院,1070,長庚科技大學,學士班(進修),2091,100,4,96,148,4,144
,101,1,私立,技專校院,1070,長庚科技大學,碩士在職專班,37,4,0,4,5,0,5
,101,1,私立,技專校院,1071,臺北城市科技大學,二專(日間),231,9,6,3,24,13,11
,101,1,私立,技專校院,1071,臺北城市科技大學,二專(進修),230,19,13,6,21,15,6
,101,1,私立,技專校院,1071,臺北城市科技大學,五專,1662,49,35,14,120,96,24
,101,1,私立,技專校院,1071,臺北城市科技大學,學士班(日間),6240,190,116,74,432,302,130
,101,1,私立,技專校院,1071,臺北城市科技大學,學士班(進修),1369,98,71,27,124,94,30
,101,1,私立,技專校院,1071,臺北城市科技大學,碩士班(日間),91,9,6,3,19,15,4
,101,1,私立,技專校院,1071,臺北城市科技大學,碩士在職專班,0,0,0,0,1,1,0
,101,1,私立,技專校院,1072,大華科技大學,二專(日間),4,0,0,0,0,0,0
,101,1,私立,技專校院,1072,大華科技大學,二專(進修),87,0,0,0,0,0,0
,101,1,私立,技專校院,1072,大華科技大學,五專,1472,57,39,18,88,61,27
,101,1,私立,技專校院,1072,大華科技大學,學士班(日間),2154,82,55,27,134,94,40
,101,1,私立,技專校院,1072,大華科技大學,學士班(進修),1340,43,24,19,94,65,29
,101,1,私立,技專校院,1072,大華科技大學,碩士班(日間),24,1,1,0,2,2,0
,101,1,私立,技專校院,1072,大華科技大學,碩士在職專班,15,0,0,0,0,0,0
,101,1,私立,技專校院,1073,醒吾科技大學,二專(日間),61,0,0,0,0,0,0
,101,1,私立,技專校院,1073,醒吾科技大學,二專(進修),6,0,0,0,0,0,0
,101,1,私立,技專校院,1073,醒吾科技大學,五專,1366,47,15,32,39,11,28
,101,1,私立,技專校院,1073,醒吾科技大學,學士班(日間),5190,184,73,111,150,56,94
,101,1,私立,技專校院,1073,醒吾科技大學,學士班(進修),1687,102,66,36,301,201,100
,101,1,私立,技專校院,1073,醒吾科技大學,碩士班(日間),63,3,1,2,3,1,2
,101,1,私立,技專校院,1073,醒吾科技大學,碩士在職專班,17,4,2,2,4,2,2
,101,1,私立,技專校院,1147,文藻外語學院,五專,1722,23,7,16,47,15,32
,101,1,私立,技專校院,1147,文藻外語學院,學士班(日間),5330,152,51,101,281,96,185
,101,1,私立,技專校院,1147,文藻外語學院,學士班(進修),1945,165,54,111,327,127,200
,101,1,私立,技專校院,1147,文藻外語學院,碩士班(日間),86,3,0,3,16,3,13
,101,1,私立,技專校院,1147,文藻外語學院,碩士在職專班,56,12,5,7,26,7,19
,101,1,私立,技專校院,1148,大漢技術學院,二專(日間),0,2,2,0,4,4,0
,101,1,私立,技專校院,1148,大漢技術學院,二專(進修),164,0,0,0,0,0,0
,101,1,私立,技專校院,1148,大漢技術學院,學士班(日間),1246,43,32,11,89,69,20
,101,1,私立,技專校院,1148,大漢技術學院,學士班(進修),1058,22,21,1,41,31,10
,101,1,私立,技專校院,1148,大漢技術學院,碩士班(日間),35,0,0,0,0,0,0
,101,1,私立,技專校院,1150,慈濟技術學院,五專,1113,8,1,7,21,3,18
,101,1,私立,技專校院,1150,慈濟技術學院,學士班(日間),1220,31,14,17,46,23,23
,101,1,私立,技專校院,1150,慈濟技術學院,學士班(進修),92,17,0,17,28,0,28
,101,1,私立,技專校院,1150,慈濟技術學院,碩士班(日間),17,1,0,1,4,3,1
,101,1,私立,技專校院,1154,永達技術學院,二專(日間),23,0,0,0,0,0,0
,101,1,私立,技專校院,1154,永達技術學院,二專(進修),115,5,3,2,13,9,4
,101,1,私立,技專校院,1154,永達技術學院,五專,159,13,12,1,83,75,8
,101,1,私立,技專校院,1154,永達技術學院,學士班(日間),501,42,34,8,149,119,30
,101,1,私立,技專校院,1154,永達技術學院,學士班(進修),472,33,27,6,39,33,6
,101,1,私立,技專校院,1154,永達技術學院,碩士班(日間),25,2,2,0,2,2,0
,101,1,私立,技專校院,1159,和春技術學院,二專(日間),0,0,0,0,2,1,1
,101,1,私立,技專校院,1159,和春技術學院,二專(進修),205,18,15,3,29,24,5
,101,1,私立,技專校院,1159,和春技術學院,五專,366,18,8,10,21,11,10
,101,1,私立,技專校院,1159,和春技術學院,學士班(日間),1857,91,67,24,188,134,54
,101,1,私立,技專校院,1159,和春技術學院,學士班(進修),826,50,45,5,109,91,18
,101,1,私立,技專校院,1159,和春技術學院,碩士班(日間),10,0,0,0,6,6,0
,101,1,私立,技專校院,1164,致理技術學院,二專(日間),308,8,7,1,18,15,3
,101,1,私立,技專校院,1164,致理技術學院,二專(進修),4,1,0,1,2,0,2
,101,1,私立,技專校院,1164,致理技術學院,五專,1409,25,6,19,45,15,30
,101,1,私立,技專校院,1164,致理技術學院,學士班(日間),5630,94,32,62,195,72,123
,101,1,私立,技專校院,1164,致理技術學院,學士班(進修),3439,141,50,91,296,118,178
,101,1,私立,技專校院,1164,致理技術學院,碩士班(日間),23,2,0,2,4,1,3
,101,1,私立,技專校院,1164,致理技術學院,碩士在職專班,28,0,0,0,3,1,2
,101,1,私立,技專校院,1166,亞東技術學院,二專(日間),1,0,0,0,0,0,0
,101,1,私立,技專校院,1166,亞東技術學院,學士班(日間),4574,90,74,16,170,140,30
,101,1,私立,技專校院,1166,亞東技術學院,學士班(進修),1013,52,28,24,148,86,62
,101,1,私立,技專校院,1166,亞東技術學院,碩士班(日間),96,3,3,0,14,13,1
,101,1,私立,技專校院,1166,亞東技術學院,碩士在職專班,0,1,1,0,1,1,0
,101,1,私立,技專校院,1168,桃園創新技術學院,二專(日間),315,0,0,0,0,0,0
,101,1,私立,技專校院,1168,桃園創新技術學院,學士班(日間),5064,141,80,61,338,235,103
,101,1,私立,技專校院,1168,桃園創新技術學院,學士班(進修),1778,129,82,47,426,305,121
,101,1,私立,技專校院,1168,桃園創新技術學院,碩士班(日間),21,1,1,0,1,1,0
,101,1,私立,技專校院,1179,德霖技術學院,二專(日間),206,0,0,0,0,0,0
,101,1,私立,技專校院,1179,德霖技術學院,二專(進修),508,15,6,9,17,8,9
,101,1,私立,技專校院,1179,德霖技術學院,五專,1906,97,79,18,133,111,22
,101,1,私立,技專校院,1179,德霖技術學院,學士班(日間),3553,164,102,62,266,183,83
,101,1,私立,技專校院,1179,德霖技術學院,學士班(進修),2283,107,77,30,137,102,35
,101,1,私立,技專校院,1181,南榮技術學院,二專(日間),1,0,0,0,0,0,0
,101,1,私立,技專校院,1181,南榮技術學院,二專(進修),186,5,5,0,9,6,3
,101,1,私立,技專校院,1181,南榮技術學院,五專,306,12,10,2,13,11,2
,101,1,私立,技專校院,1181,南榮技術學院,學士班(日間),1517,33,26,7,57,41,16
,101,1,私立,技專校院,1181,南榮技術學院,學士班(進修),887,31,27,4,46,40,6
,101,1,私立,技專校院,1181,南榮技術學院,碩士班(日間),28,1,1,0,2,2,0
,101,1,私立,技專校院,1181,南榮技術學院,碩士在職專班,20,1,1,0,2,2,0
,101,1,私立,技專校院,1182,蘭陽技術學院,二專(日間),20,1,0,1,3,1,2
,101,1,私立,技專校院,1182,蘭陽技術學院,二專(進修),122,1,1,0,1,1,0
,101,1,私立,技專校院,1182,蘭陽技術學院,五專,1182,51,37,14,79,59,20
,101,1,私立,技專校院,1182,蘭陽技術學院,學士班(日間),2107,45,25,20,94,61,33
,101,1,私立,技專校院,1182,蘭陽技術學院,學士班(進修),133,1,1,0,1,1,0
,101,1,私立,技專校院,1183,黎明技術學院,二專(進修),149,5,0,5,89,62,27
,101,1,私立,技專校院,1183,黎明技術學院,五專,930,26,23,3,66,61,5
,101,1,私立,技專校院,1183,黎明技術學院,學士班(日間),2492,57,33,24,227,154,73
,101,1,私立,技專校院,1183,黎明技術學院,學士班(進修),1218,84,65,19,320,255,65
,101,1,私立,技專校院,1184,東方設計學院,二專(日間),10,3,1,2,31,22,9
,101,1,私立,技專校院,1184,東方設計學院,二專(進修),4,3,2,1,13,10,3
,101,1,私立,技專校院,1184,東方設計學院,五專,1268,43,22,21,136,63,73
,101,1,私立,技專校院,1184,東方設計學院,學士班(日間),2253,104,52,52,264,177,87
,101,1,私立,技專校院,1184,東方設計學院,學士班(進修),241,25,21,4,67,59,8
,101,1,私立,技專校院,1184,東方設計學院,碩士班(日間),32,8,5,3,16,10,6
,101,1,私立,技專校院,1184,東方設計學院,碩士在職專班,43,8,3,5,24,12,12
,101,1,私立,技專校院,1185,經國管理暨健康學院,二專(進修),18,1,0,1,1,0,1
,101,1,私立,技專校院,1185,經國管理暨健康學院,五專,1483,57,13,44,96,26,70
,101,1,私立,技專校院,1185,經國管理暨健康學院,學士班(日間),1946,113,48,65,188,84,104
,101,1,私立,技專校院,1185,經國管理暨健康學院,學士班(進修),769,34,12,22,79,35,44
,101,1,私立,技專校院,1185,經國管理暨健康學院,碩士班(日間),23,4,2,2,8,2,6
,101,1,私立,技專校院,1185,經國管理暨健康學院,碩士在職專班,44,1,0,1,1,0,1
,101,1,私立,技專校院,1187,崇右技術學院,二專(進修),1,1,1,0,1,1,0
,101,1,私立,技專校院,1187,崇右技術學院,五專,1126,66,35,31,126,72,54
,101,1,私立,技專校院,1187,崇右技術學院,學士班(日間),2384,106,50,56,167,83,84
,101,1,私立,技專校院,1187,崇右技術學院,學士班(進修),6,3,2,1,5,4,1
,101,1,私立,技專校院,1188,大同技術學院,二專(日間),3,0,0,0,20,16,4
,101,1,私立,技專校院,1188,大同技術學院,二專(進修),60,5,3,2,54,31,23
,101,1,私立,技專校院,1188,大同技術學院,五專,194,9,9,0,39,27,12
,101,1,私立,技專校院,1188,大同技術學院,學士班(日間),2161,72,50,22,335,196,139
,101,1,私立,技專校院,1188,大同技術學院,學士班(進修),1041,43,21,22,287,137,150
,101,1,私立,技專校院,1189,亞太創意技術學院,二專(日間),14,7,5,2,23,20,3
,101,1,私立,技專校院,1189,亞太創意技術學院,二專(進修),150,0,0,0,3,3,0
,101,1,私立,技專校院,1189,亞太創意技術學院,學士班(日間),2130,69,41,28,175,108,67
,101,1,私立,技專校院,1189,亞太創意技術學院,學士班(進修),118,1,0,1,7,3,4
,101,1,私立,技專校院,1189,亞太創意技術學院,碩士班(日間),15,0,0,0,0,0,0
,101,1,私立,技專校院,1190,高鳳數位內容學院,五專,61,1,0,1,1,0,1
,101,1,私立,技專校院,1190,高鳳數位內容學院,學士班(日間),550,35,20,15,82,51,31
,101,1,私立,技專校院,1190,高鳳數位內容學院,學士班(進修),219,5,3,2,28,18,10
,101,1,私立,技專校院,1191,華夏技術學院,二專(日間),0,0,0,0,55,50,5
,101,1,私立,技專校院,1191,華夏技術學院,二專(進修),545,25,15,10,353,259,94
,101,1,私立,技專校院,1191,華夏技術學院,五專,577,16,13,3,443,380,63
,101,1,私立,技專校院,1191,華夏技術學院,學士班(日間),2914,97,56,41,478,289,189
,101,1,私立,技專校院,1191,華夏技術學院,學士班(進修),1570,118,78,40,620,417,203
,101,1,私立,技專校院,1191,華夏技術學院,碩士在職專班,40,4,4,0,4,4,0
,101,1,私立,技專校院,1192,臺灣觀光學院,二專(日間),31,10,7,3,37,29,8
,101,1,私立,技專校院,1192,臺灣觀光學院,二專(進修),180,0,0,0,0,0,0
,101,1,私立,技專校院,1192,臺灣觀光學院,五專,178,11,7,4,22,12,10
,101,1,私立,技專校院,1192,臺灣觀光學院,學士班(日間),1628,45,33,12,85,54,31
,101,1,私立,技專校院,1192,臺灣觀光學院,學士班(進修),249,5,4,1,5,4,1
,101,1,私立,技專校院,1197,台北海洋技術學院,二專(日間),502,15,12,3,53,47,6
,101,1,私立,技專校院,1197,台北海洋技術學院,二專(進修),277,6,5,1,23,18,5
,101,1,私立,技專校院,1197,台北海洋技術學院,五專,1319,18,13,5,56,43,13
,101,1,私立,技專校院,1197,台北海洋技術學院,學士班(日間),3788,79,44,35,223,153,70
,101,1,私立,技專校院,1197,台北海洋技術學院,學士班(進修),603,14,9,5,69,46,23
,101,1,私立,技專校院,1281,康寧醫護暨管理專科學校,二專(日間),162,7,1,6,10,1,9
,101,1,私立,技專校院,1281,康寧醫護暨管理專科學校,二專(進修),344,24,8,16,29,9,20
,101,1,私立,技專校院,1281,康寧醫護暨管理專科學校,五專,2723,48,11,37,107,28,79
,101,1,私立,技專校院,1282,馬偕醫護管理專科學校,二專(日間),218,7,1,6,20,1,19
,101,1,私立,技專校院,1282,馬偕醫護管理專科學校,二專(進修),343,13,1,12,47,4,43
,101,1,私立,技專校院,1282,馬偕醫護管理專科學校,五專,3039,36,5,31,63,8,55
,101,1,私立,技專校院,1283,仁德醫護管理專科學校,二專(日間),2,0,0,0,0,0,0
,101,1,私立,技專校院,1283,仁德醫護管理專科學校,二專(進修),782,6,5,1,10,9,1
,101,1,私立,技專校院,1283,仁德醫護管理專科學校,五專,5667,73,31,42,96,45,51
,101,1,私立,技專校院,1284,樹人醫護管理專科學校,二專(進修),414,23,19,4,35,25,10
,101,1,私立,技專校院,1284,樹人醫護管理專科學校,五專,5821,138,41,97,227,76,151
,101,1,私立,技專校院,1285,慈惠醫護管理專科學校,二專(日間),184,5,1,4,11,6,5
,101,1,私立,技專校院,1285,慈惠醫護管理專科學校,二專(進修),340,15,7,8,28,14,14
,101,1,私立,技專校院,1285,慈惠醫護管理專科學校,五專,5617,134,39,95,255,74,181
,101,1,私立,技專校院,1286,耕莘健康管理專科學校,二專(日間),4,1,0,1,14,4,10
,101,1,私立,技專校院,1286,耕莘健康管理專科學校,二專(進修),164,8,2,6,23,2,21
,101,1,私立,技專校院,1286,耕莘健康管理專科學校,五專,4480,88,21,67,140,28,112
,101,1,私立,技專校院,1287,敏惠醫護管理專科學校,二專(日間),1,0,0,0,0,0,0
,101,1,私立,技專校院,1287,敏惠醫護管理專科學校,五專,3713,44,11,33,44,11,33
,101,1,私立,技專校院,1288,高美醫護管理專科學校,二專(進修),186,0,0,0,0,0,0
,101,1,私立,技專校院,1288,高美醫護管理專科學校,五專,772,20,6,14,20,6,14
,101,1,私立,技專校院,1289,育英醫護管理專科學校,五專,2030,30,3,27,79,14,65
,101,1,私立,技專校院,1290,崇仁醫護管理專科學校,二專(日間),29,2,1,1,2,1,1
,101,1,私立,技專校院,1290,崇仁醫護管理專科學校,二專(進修),43,3,0,3,6,1,5
,101,1,私立,技專校院,1290,崇仁醫護管理專科學校,五專,2950,14,4,10,47,9,38
,101,1,私立,技專校院,1291,聖母醫護管理專科學校,五專,3718,78,35,43,123,55,68
,101,1,私立,技專校院,1292,新生醫護管理專科學校,二專(日間),21,3,0,3,5,1,4
,101,1,私立,技專校院,1292,新生醫護管理專科學校,二專(進修),28,0,0,0,0,0,0
,101,1,私立,技專校院,1292,新生醫護管理專科學校,五專,5335,79,15,64,169,26,143
,101,2,公立,一般大學,1,國立政治大學,學士班(日間),9782,78,42,36,233,119,114
,101,2,公立,一般大學,1,國立政治大學,碩士班(日間),3596,204,95,109,759,335,424
,101,2,公立,一般大學,1,國立政治大學,碩士在職專班,1636,119,67,52,426,216,210
,101,2,公立,一般大學,1,國立政治大學,博士班,1014,96,51,45,292,174,118
,101,2,公立,一般大學,2,國立清華大學,學士班(日間),6325,78,65,13,203,158,45
,101,2,公立,一般大學,2,國立清華大學,碩士班(日間),3804,117,52,65,236,114,122
,101,2,公立,一般大學,2,國立清華大學,碩士在職專班,291,24,16,8,48,28,20
,101,2,公立,一般大學,2,國立清華大學,博士班,2028,173,132,41,372,297,75
,101,2,公立,一般大學,3,國立臺灣大學,學士班(日間),16915,196,129,67,546,337,209
,101,2,公立,一般大學,3,國立臺灣大學,學士班(進修),29,7,4,3,9,6,3
,101,2,公立,一般大學,3,國立臺灣大學,碩士班(日間),9741,543,277,266,1055,585,470
,101,2,公立,一般大學,3,國立臺灣大學,碩士在職專班,1119,160,101,59,216,136,80
,101,2,公立,一般大學,3,國立臺灣大學,博士班,4889,645,430,215,1040,720,320
,101,2,公立,一般大學,4,國立臺灣師範大學,學士班(日間),7768,60,29,31,181,91,90
,101,2,公立,一般大學,4,國立臺灣師範大學,碩士班(日間),4115,344,127,217,799,306,493
,101,2,公立,一般大學,4,國立臺灣師範大學,碩士在職專班,2037,231,56,175,370,96,274
,101,2,公立,一般大學,4,國立臺灣師範大學,博士班,1387,202,92,110,350,170,180
,101,2,公立,一般大學,5,國立成功大學,學士班(日間),11688,85,57,28,354,233,121
,101,2,公立,一般大學,5,國立成功大學,學士班(進修),2,0,0,0,0,0,0
,101,2,公立,一般大學,5,國立成功大學,碩士班(日間),6404,110,54,56,474,247,227
,101,2,公立,一般大學,5,國立成功大學,碩士在職專班,1303,58,41,17,198,130,68
,101,2,公立,一般大學,5,國立成功大學,博士班,3020,200,154,46,710,527,183
,101,2,公立,一般大學,6,國立中興大學,學士班(日間),8321,59,45,14,239,172,67
,101,2,公立,一般大學,6,國立中興大學,學士班(進修),1145,22,15,7,36,11,25
,101,2,公立,一般大學,6,國立中興大學,碩士班(日間),3419,83,40,43,403,221,182
,101,2,公立,一般大學,6,國立中興大學,碩士在職專班,1845,101,69,32,332,226,106
,101,2,公立,一般大學,6,國立中興大學,博士班,1400,93,71,22,326,244,82
,101,2,公立,一般大學,7,國立交通大學,學士班(日間),5527,57,43,14,178,137,41
,101,2,公立,一般大學,7,國立交通大學,碩士班(日間),5096,128,70,58,328,191,137
,101,2,公立,一般大學,7,國立交通大學,碩士在職專班,1817,251,196,55,413,324,89
,101,2,公立,一般大學,7,國立交通大學,博士班,2184,194,145,49,404,319,85
,101,2,公立,一般大學,8,國立中央大學,學士班(日間),6168,52,46,6,147,103,44
,101,2,公立,一般大學,8,國立中央大學,碩士班(日間),3308,83,44,39,228,122,106
,101,2,公立,一般大學,8,國立中央大學,碩士在職專班,1424,84,62,22,263,177,86
,101,2,公立,一般大學,8,國立中央大學,博士班,1362,100,76,24,274,213,61
,101,2,公立,一般大學,9,國立中山大學,學士班(日間),4628,31,25,6,111,79,32
,101,2,公立,一般大學,9,國立中山大學,碩士班(日間),2904,100,69,31,357,211,146
,101,2,公立,一般大學,9,國立中山大學,碩士在職專班,841,59,35,24,166,78,88
,101,2,公立,一般大學,9,國立中山大學,博士班,1041,104,68,36,258,180,78
,101,2,公立,一般大學,12,國立臺灣海洋大學,學士班(日間),5204,48,38,10,86,72,14
,101,2,公立,一般大學,12,國立臺灣海洋大學,學士班(進修),551,17,8,9,44,25,19
,101,2,公立,一般大學,12,國立臺灣海洋大學,碩士班(日間),1555,33,20,13,113,74,39
,101,2,公立,一般大學,12,國立臺灣海洋大學,碩士在職專班,624,18,13,5,75,50,25
,101,2,公立,一般大學,12,國立臺灣海洋大學,博士班,352,32,27,5,78,63,15
,101,2,公立,一般大學,13,國立中正大學,學士班(日間),6624,49,41,8,150,99,51
,101,2,公立,一般大學,13,國立中正大學,碩士班(日間),2990,129,54,75,366,196,170
,101,2,公立,一般大學,13,國立中正大學,碩士在職專班,1788,123,74,49,292,172,120
,101,2,公立,一般大學,13,國立中正大學,博士班,734,94,64,30,195,135,60
,101,2,公立,一般大學,14,國立高雄師範大學,學士班(日間),3370,15,10,5,61,41,20
,101,2,公立,一般大學,14,國立高雄師範大學,碩士班(日間),1393,87,36,51,379,134,245
,101,2,公立,一般大學,14,國立高雄師範大學,碩士在職專班,1590,113,36,77,234,76,158
,101,2,公立,一般大學,14,國立高雄師範大學,博士班,470,36,13,23,104,35,69
,101,2,公立,一般大學,15,國立彰化師範大學,學士班(日間),4747,25,17,8,74,54,20
,101,2,公立,一般大學,15,國立彰化師範大學,碩士班(日間),1618,70,29,41,260,107,153
,101,2,公立,一般大學,15,國立彰化師範大學,碩士在職專班,1477,56,33,23,128,66,62
,101,2,公立,一般大學,15,國立彰化師範大學,博士班,439,38,26,12,99,57,42
,101,2,公立,一般大學,16,國立陽明大學,學士班(日間),2051,9,6,3,69,39,30
,101,2,公立,一般大學,16,國立陽明大學,碩士班(日間),1324,73,28,45,188,75,113
,101,2,公立,一般大學,16,國立陽明大學,碩士在職專班,125,17,3,14,31,10,21
,101,2,公立,一般大學,16,國立陽明大學,博士班,1079,127,65,62,238,126,112
,101,2,公立,一般大學,17,國立臺北大學,學士班(日間),5618,49,30,19,114,61,53
,101,2,公立,一般大學,17,國立臺北大學,學士班(進修),2260,76,47,29,213,114,99
,101,2,公立,一般大學,17,國立臺北大學,碩士班(日間),1359,110,57,53,234,116,118
,101,2,公立,一般大學,17,國立臺北大學,碩士在職專班,469,31,10,21,70,27,43
,101,2,公立,一般大學,17,國立臺北大學,博士班,173,14,12,2,37,28,9
,101,2,公立,一般大學,18,國立嘉義大學,學士班(日間),7768,58,42,16,226,154,72
,101,2,公立,一般大學,18,國立嘉義大學,學士班(進修),2219,80,48,32,285,164,121
,101,2,公立,一般大學,18,國立嘉義大學,碩士班(日間),1768,77,34,43,273,127,146
,101,2,公立,一般大學,18,國立嘉義大學,碩士在職專班,1070,54,18,36,187,73,114
,101,2,公立,一般大學,18,國立嘉義大學,博士班,208,19,12,7,44,29,15
,101,2,公立,一般大學,19,國立高雄大學,學士班(日間),4167,26,18,8,92,46,46
,101,2,公立,一般大學,19,國立高雄大學,學士班(進修),220,12,8,4,40,24,16
,101,2,公立,一般大學,19,國立高雄大學,碩士班(日間),646,17,8,9,95,56,39
,101,2,公立,一般大學,19,國立高雄大學,碩士在職專班,513,33,24,9,117,89,28
,101,2,公立,一般大學,19,國立高雄大學,博士班,13,0,0,0,2,2,0
,101,2,公立,一般大學,20,國立東華大學,學士班(日間),6970,95,67,28,256,169,87
,101,2,公立,一般大學,20,國立東華大學,學士班(進修),6,2,2,0,6,6,0
,101,2,公立,一般大學,20,國立東華大學,碩士班(日間),2389,119,53,66,542,246,296
,101,2,公立,一般大學,20,國立東華大學,碩士在職專班,619,46,17,29,183,89,94
,101,2,公立,一般大學,20,國立東華大學,博士班,372,39,27,12,134,88,46
,101,2,公立,一般大學,21,國立暨南國際大學,學士班(日間),3934,29,18,11,68,40,28
,101,2,公立,一般大學,21,國立暨南國際大學,學士班(進修),3,1,0,1,3,0,3
,101,2,公立,一般大學,21,國立暨南國際大學,碩士班(日間),1247,97,36,61,203,89,114
,101,2,公立,一般大學,21,國立暨南國際大學,碩士在職專班,338,27,11,16,40,17,23
,101,2,公立,一般大學,21,國立暨南國際大學,博士班,316,41,22,19,68,33,35
,101,2,公立,一般大學,28,國立臺北藝術大學,五專,87,0,0,0,1,1,0
,101,2,公立,一般大學,28,國立臺北藝術大學,學士班(日間),1481,26,9,17,60,27,33
,101,2,公立,一般大學,28,國立臺北藝術大學,碩士班(日間),932,124,38,86,271,99,172
,101,2,公立,一般大學,28,國立臺北藝術大學,碩士在職專班,140,15,2,13,35,10,25
,101,2,公立,一般大學,28,國立臺北藝術大學,博士班,51,7,1,6,15,4,11
,101,2,公立,一般大學,29,國立臺灣藝術大學,學士班(日間),2266,24,8,16,82,30,52
,101,2,公立,一般大學,29,國立臺灣藝術大學,學士班(進修),1895,26,7,19,141,45,96
,101,2,公立,一般大學,29,國立臺灣藝術大學,碩士班(日間),758,40,15,25,141,63,78
,101,2,公立,一般大學,29,國立臺灣藝術大學,碩士在職專班,402,23,7,16,72,20,52
,101,2,公立,一般大學,29,國立臺灣藝術大學,博士班,54,2,0,2,10,4,6
,101,2,公立,一般大學,30,國立臺東大學,學士班(日間),3433,55,29,26,176,100,76
,101,2,公立,一般大學,30,國立臺東大學,學士班(進修),178,2,0,2,19,7,12
,101,2,公立,一般大學,30,國立臺東大學,碩士班(日間),338,31,10,21,105,39,66
,101,2,公立,一般大學,30,國立臺東大學,碩士在職專班,848,17,8,9,57,22,35
,101,2,公立,一般大學,30,國立臺東大學,博士班,42,13,6,7,16,8,8
,101,2,公立,一般大學,31,國立宜蘭大學,學士班(日間),4170,35,22,13,105,78,27
,101,2,公立,一般大學,31,國立宜蘭大學,學士班(進修),653,26,23,3,119,105,14
,101,2,公立,一般大學,31,國立宜蘭大學,碩士班(日間),558,13,10,3,34,23,11
,101,2,公立,一般大學,31,國立宜蘭大學,碩士在職專班,171,7,5,2,17,12,5
,101,2,公立,一般大學,31,國立宜蘭大學,博士班,12,1,0,1,1,0,1
,101,2,公立,一般大學,32,國立聯合大學,學士班(日間),6143,69,57,12,219,185,34
,101,2,公立,一般大學,32,國立聯合大學,學士班(進修),1454,48,29,19,145,99,46
,101,2,公立,一般大學,32,國立聯合大學,碩士班(日間),449,5,3,2,28,19,9
,101,2,公立,一般大學,32,國立聯合大學,博士班,9,1,1,0,3,3,0
,101,2,公立,一般大學,35,國立臺南藝術大學,五專,158,2,0,2,2,0,2
,101,2,公立,一般大學,35,國立臺南藝術大學,學士班(日間),724,8,3,5,38,14,24
,101,2,公立,一般大學,35,國立臺南藝術大學,學士班(進修),40,0,0,0,3,2,1
,101,2,公立,一般大學,35,國立臺南藝術大學,碩士班(日間),566,68,25,43,173,71,102
,101,2,公立,一般大學,35,國立臺南藝術大學,碩士在職專班,50,4,0,4,17,2,15
,101,2,公立,一般大學,35,國立臺南藝術大學,博士班,38,4,3,1,15,9,6
,101,2,公立,一般大學,36,國立臺南大學,學士班(日間),3865,28,17,11,83,48,35
,101,2,公立,一般大學,36,國立臺南大學,學士班(進修),431,3,3,0,18,10,8
,101,2,公立,一般大學,36,國立臺南大學,碩士班(日間),1162,76,23,53,245,85,160
,101,2,公立,一般大學,36,國立臺南大學,碩士在職專班,805,28,10,18,115,42,73
,101,2,公立,一般大學,36,國立臺南大學,博士班,174,13,5,8,29,15,14
,101,2,公立,一般大學,37,國立臺北教育大學,學士班(日間),3173,33,19,14,81,42,39
,101,2,公立,一般大學,37,國立臺北教育大學,碩士班(日間),1138,113,36,77,274,89,185
,101,2,公立,一般大學,37,國立臺北教育大學,碩士在職專班,1210,56,20,36,145,44,101
,101,2,公立,一般大學,37,國立臺北教育大學,博士班,139,19,10,9,41,22,19
,101,2,公立,一般大學,38,國立新竹教育大學,學士班(日間),2499,16,3,13,51,19,32
,101,2,公立,一般大學,38,國立新竹教育大學,碩士班(日間),763,51,16,35,165,50,115
,101,2,公立,一般大學,38,國立新竹教育大學,碩士在職專班,613,22,5,17,33,6,27
,101,2,公立,一般大學,38,國立新竹教育大學,博士班,72,3,1,2,16,6,10
,101,2,公立,一般大學,39,國立臺中教育大學,學士班(日間),3330,32,16,16,91,41,50
,101,2,公立,一般大學,39,國立臺中教育大學,碩士班(日間),816,29,10,19,119,50,69
,101,2,公立,一般大學,39,國立臺中教育大學,碩士在職專班,701,13,3,10,78,19,59
,101,2,公立,一般大學,39,國立臺中教育大學,博士班,117,3,2,1,16,7,9
,101,2,公立,一般大學,40,國立屏東教育大學,學士班(日間),3229,31,17,14,70,43,27
,101,2,公立,一般大學,40,國立屏東教育大學,碩士班(日間),790,94,34,60,178,63,115
,101,2,公立,一般大學,40,國立屏東教育大學,碩士在職專班,672,21,4,17,52,7,45
,101,2,公立,一般大學,40,國立屏東教育大學,博士班,56,4,2,2,5,3,2
,101,2,公立,一般大學,44,國立體育大學,學士班(日間),1476,24,20,4,99,80,19
,101,2,公立,一般大學,44,國立體育大學,學士班(進修),93,2,2,0,17,14,3
,101,2,公立,一般大學,44,國立體育大學,碩士班(日間),365,26,19,7,96,55,41
,101,2,公立,一般大學,44,國立體育大學,碩士在職專班,214,15,11,4,39,25,14
,101,2,公立,一般大學,44,國立體育大學,博士班,130,7,5,2,18,12,6
,101,2,公立,一般大學,48,國立金門大學,學士班(日間),2654,34,21,13,112,63,49
,101,2,公立,一般大學,48,國立金門大學,學士班(進修),818,16,9,7,76,51,25
,101,2,公立,一般大學,48,國立金門大學,碩士班(日間),226,11,6,5,48,25,23
,101,2,公立,一般大學,49,國立臺灣體育運動大學,學士班(日間),2449,70,55,15,166,129,37
,101,2,公立,一般大學,49,國立臺灣體育運動大學,學士班(進修),402,12,10,2,34,25,9
,101,2,公立,一般大學,49,國立臺灣體育運動大學,碩士班(日間),257,20,11,9,78,39,39
,101,2,公立,一般大學,49,國立臺灣體育運動大學,碩士在職專班,92,1,1,0,2,2,0
,101,2,公立,一般大學,3001,臺北市立教育大學,學士班(日間),2888,38,16,22,116,63,53
,101,2,公立,一般大學,3001,臺北市立教育大學,碩士班(日間),860,62,18,44,233,68,165
,101,2,公立,一般大學,3001,臺北市立教育大學,碩士在職專班,847,35,14,21,91,30,61
,101,2,公立,一般大學,3001,臺北市立教育大學,博士班,205,20,4,16,51,23,28
,101,2,公立,一般大學,3102,臺北市立體育學院,學士班(日間),1866,34,26,8,102,81,21
,101,2,公立,一般大學,3102,臺北市立體育學院,碩士班(日間),281,11,3,8,42,21,21
,101,2,公立,一般大學,3102,臺北市立體育學院,碩士在職專班,143,2,2,0,7,4,3
,101,2,公立,一般大學,3102,臺北市立體育學院,博士班,23,1,1,0,2,2,0
,101,2,公立,技專校院,22,國立臺灣科技大學,學士班(日間),5537,40,31,9,45,19,26
,101,2,公立,技專校院,22,國立臺灣科技大學,學士班(進修),68,5,1,4,17,11,6
,101,2,公立,技專校院,22,國立臺灣科技大學,碩士班(日間),3039,61,40,21,177,109,68
,101,2,公立,技專校院,22,國立臺灣科技大學,碩士在職專班,805,69,57,12,159,128,31
,101,2,公立,技專校院,22,國立臺灣科技大學,博士班,1058,139,111,28,258,201,57
,101,2,公立,技專校院,23,國立雲林科技大學,學士班(日間),6217,46,32,14,176,107,69
,101,2,公立,技專校院,23,國立雲林科技大學,碩士班(日間),2056,46,22,24,256,154,102
,101,2,公立,技專校院,23,國立雲林科技大學,碩士在職專班,782,31,22,9,148,90,58
,101,2,公立,技專校院,23,國立雲林科技大學,博士班,478,36,25,11,164,122,42
,101,2,公立,技專校院,24,國立屏東科技大學,學士班(日間),7599,64,46,18,155,105,50
,101,2,公立,技專校院,24,國立屏東科技大學,學士班(進修),1410,21,11,10,30,21,9
,101,2,公立,技專校院,24,國立屏東科技大學,碩士班(日間),1697,98,60,38,253,149,104
,101,2,公立,技專校院,24,國立屏東科技大學,碩士在職專班,667,25,19,6,32,23,9
,101,2,公立,技專校院,24,國立屏東科技大學,博士班,209,16,11,5,48,34,14
,101,2,公立,技專校院,25,國立臺北科技大學,學士班(日間),5760,93,64,29,204,152,52
,101,2,公立,技專校院,25,國立臺北科技大學,學士班(進修),1126,21,18,3,61,44,17
,101,2,公立,技專校院,25,國立臺北科技大學,碩士班(日間),2535,66,48,18,183,143,40
,101,2,公立,技專校院,25,國立臺北科技大學,碩士在職專班,1112,130,111,19,205,166,39
,101,2,公立,技專校院,25,國立臺北科技大學,博士班,721,66,51,15,144,123,21
,101,2,公立,技專校院,26,國立高雄第一科技大學,學士班(日間),5392,36,24,12,131,78,53
,101,2,公立,技專校院,26,國立高雄第一科技大學,碩士班(日間),1217,30,22,8,116,62,54
,101,2,公立,技專校院,26,國立高雄第一科技大學,碩士在職專班,814,55,46,9,147,108,39
,101,2,公立,技專校院,26,國立高雄第一科技大學,博士班,220,20,15,5,44,34,10
,101,2,公立,技專校院,27,國立高雄應用科技大學,學士班(日間),7462,52,38,14,123,93,30
,101,2,公立,技專校院,27,國立高雄應用科技大學,學士班(進修),1733,61,47,14,129,97,32
,101,2,公立,技專校院,27,國立高雄應用科技大學,碩士班(日間),1345,34,29,5,103,78,25
,101,2,公立,技專校院,27,國立高雄應用科技大學,碩士在職專班,1301,63,47,16,225,178,47
,101,2,公立,技專校院,27,國立高雄應用科技大學,博士班,233,15,14,1,35,34,1
,101,2,公立,技專校院,33,國立虎尾科技大學,學士班(日間),7703,50,42,8,243,198,45
,101,2,公立,技專校院,33,國立虎尾科技大學,學士班(進修),1368,14,12,2,57,43,14
,101,2,公立,技專校院,33,國立虎尾科技大學,碩士班(日間),1069,19,18,1,110,94,16
,101,2,公立,技專校院,33,國立虎尾科技大學,碩士在職專班,428,30,27,3,38,33,5
,101,2,公立,技專校院,33,國立虎尾科技大學,博士班,27,1,1,0,9,9,0
,101,2,公立,技專校院,34,國立高雄海洋科技大學,五專,480,1,1,0,9,9,0
,101,2,公立,技專校院,34,國立高雄海洋科技大學,學士班(日間),4996,58,46,12,190,146,44
,101,2,公立,技專校院,34,國立高雄海洋科技大學,學士班(進修),1782,20,15,5,64,40,24
,101,2,公立,技專校院,34,國立高雄海洋科技大學,碩士班(日間),357,9,8,1,40,30,10
,101,2,公立,技專校院,34,國立高雄海洋科技大學,碩士在職專班,185,1,1,0,13,11,2
,101,2,公立,技專校院,42,國立澎湖科技大學,二專(進修),28,4,1,3,6,2,4
,101,2,公立,技專校院,42,國立澎湖科技大學,學士班(日間),2563,34,25,9,68,43,25
,101,2,公立,技專校院,42,國立澎湖科技大學,學士班(進修),316,3,2,1,17,10,7
,101,2,公立,技專校院,42,國立澎湖科技大學,碩士班(日間),98,7,7,0,14,9,5
,101,2,公立,技專校院,42,國立澎湖科技大學,碩士在職專班,36,1,0,1,2,1,1
,101,2,公立,技專校院,43,國立勤益科技大學,二專(日間),161,0,0,0,5,4,1
,101,2,公立,技專校院,43,國立勤益科技大學,二專(進修),28,2,2,0,10,9,1
,101,2,公立,技專校院,43,國立勤益科技大學,學士班(日間),6365,61,49,12,258,190,68
,101,2,公立,技專校院,43,國立勤益科技大學,學士班(進修),3143,64,49,15,165,133,32
,101,2,公立,技專校院,43,國立勤益科技大學,碩士班(日間),712,17,15,2,53,44,9
,101,2,公立,技專校院,43,國立勤益科技大學,碩士在職專班,227,24,19,5,32,27,5
,101,2,公立,技專校院,43,國立勤益科技大學,博士班,3,0,0,0,0,0,0
,101,2,公立,技專校院,46,國立臺北護理健康大學,學士班(日間),2769,16,3,13,84,16,68
,101,2,公立,技專校院,46,國立臺北護理健康大學,學士班(進修),639,19,0,19,90,1,89
,101,2,公立,技專校院,46,國立臺北護理健康大學,碩士班(日間),624,49,6,43,209,25,184
,101,2,公立,技專校院,46,國立臺北護理健康大學,碩士在職專班,162,12,0,12,34,3,31
,101,2,公立,技專校院,46,國立臺北護理健康大學,博士班,64,7,0,7,11,0,11
,101,2,公立,技專校院,47,國立高雄餐旅大學,五專,229,1,1,0,10,6,4
,101,2,公立,技專校院,47,國立高雄餐旅大學,學士班(日間),3140,17,8,9,81,29,52
,101,2,公立,技專校院,47,國立高雄餐旅大學,學士班(進修),1236,6,3,3,44,23,21
,101,2,公立,技專校院,47,國立高雄餐旅大學,碩士班(日間),198,5,3,2,47,19,28
,101,2,公立,技專校院,47,國立高雄餐旅大學,碩士在職專班,80,2,2,0,2,2,0
,101,2,公立,技專校院,47,國立高雄餐旅大學,博士班,8,0,0,0,0,0,0
,101,2,公立,技專校院,50,國立臺中科技大學,二專(日間),295,5,1,4,19,2,17
,101,2,公立,技專校院,50,國立臺中科技大學,二專(進修),171,10,0,10,17,0,17
,101,2,公立,技專校院,50,國立臺中科技大學,五專,3732,22,6,16,73,23,50
,101,2,公立,技專校院,50,國立臺中科技大學,學士班(日間),5644,45,14,31,140,52,88
,101,2,公立,技專校院,50,國立臺中科技大學,學士班(進修),2517,71,25,46,116,43,73
,101,2,公立,技專校院,50,國立臺中科技大學,碩士班(日間),365,11,5,6,44,25,19
,101,2,公立,技專校院,50,國立臺中科技大學,碩士在職專班,139,5,2,3,10,3,7
,101,2,公立,技專校院,136,國立屏東商業技術學院,學士班(日間),2969,27,12,15,78,32,46
,101,2,公立,技專校院,136,國立屏東商業技術學院,學士班(進修),832,23,11,12,81,34,47
,101,2,公立,技專校院,136,國立屏東商業技術學院,碩士班(日間),256,16,10,6,68,35,33
,101,2,公立,技專校院,136,國立屏東商業技術學院,碩士在職專班,24,1,0,1,3,2,1
,101,2,公立,技專校院,142,國立臺北商業技術學院,二專(進修),418,20,6,14,49,14,35
,101,2,公立,技專校院,142,國立臺北商業技術學院,五專,2038,20,6,14,76,28,48
,101,2,公立,技專校院,142,國立臺北商業技術學院,學士班(日間),2146,18,8,10,53,21,32
,101,2,公立,技專校院,142,國立臺北商業技術學院,學士班(進修),1804,28,16,12,76,33,43
,101,2,公立,技專校院,142,國立臺北商業技術學院,碩士班(日間),149,4,4,0,17,10,7
,101,2,公立,技專校院,142,國立臺北商業技術學院,碩士在職專班,29,1,1,0,5,4,1
,101,2,公立,技專校院,144,國立臺灣戲曲學院,二專(日間),1,0,0,0,0,0,0
,101,2,公立,技專校院,144,國立臺灣戲曲學院,學士班(日間),492,7,3,4,37,16,21
,101,2,公立,技專校院,221,國立臺南護理專科學校,二專(日間),93,1,0,1,3,0,3
,101,2,公立,技專校院,221,國立臺南護理專科學校,二專(進修),98,5,1,4,14,3,11
,101,2,公立,技專校院,221,國立臺南護理專科學校,五專,1675,13,0,13,26,1,25
,101,2,公立,技專校院,222,國立臺東專科學校,二專(日間),431,10,7,3,22,17,5
,101,2,公立,技專校院,222,國立臺東專科學校,二專(進修),202,9,5,4,32,20,12
,101,2,公立,技專校院,222,國立臺東專科學校,五專,452,9,5,4,43,22,21
,101,2,私立,一般大學,1001,東海大學,學士班(日間),13578,160,95,65,523,318,205
,101,2,私立,一般大學,1001,東海大學,學士班(進修),834,48,32,16,221,143,78
,101,2,私立,一般大學,1001,東海大學,碩士班(日間),1790,114,61,53,383,204,179
,101,2,私立,一般大學,1001,東海大學,碩士在職專班,798,47,30,17,161,86,75
,101,2,私立,一般大學,1001,東海大學,博士班,240,26,19,7,68,46,22
,101,2,私立,一般大學,1002,輔仁大學,學士班(日間),17829,200,125,75,638,353,285
,101,2,私立,一般大學,1002,輔仁大學,學士班(進修),4722,151,64,87,458,191,267
,101,2,私立,一般大學,1002,輔仁大學,碩士班(日間),2225,257,112,145,660,284,376
,101,2,私立,一般大學,1002,輔仁大學,碩士在職專班,1563,106,43,63,384,173,211
,101,2,私立,一般大學,1002,輔仁大學,博士班,417,58,22,36,169,79,90
,101,2,私立,一般大學,1003,東吳大學,學士班(日間),11793,110,67,43,350,185,165
,101,2,私立,一般大學,1003,東吳大學,學士班(進修),1351,52,19,33,153,62,91
,101,2,私立,一般大學,1003,東吳大學,碩士班(日間),1261,154,67,87,273,137,136
,101,2,私立,一般大學,1003,東吳大學,碩士在職專班,1187,118,47,71,253,108,145
,101,2,私立,一般大學,1003,東吳大學,博士班,92,5,2,3,13,6,7
,101,2,私立,一般大學,1004,中原大學,學士班(日間),12582,124,94,30,420,306,114
,101,2,私立,一般大學,1004,中原大學,學士班(進修),6,2,2,0,8,8,0
,101,2,私立,一般大學,1004,中原大學,碩士班(日間),2004,77,43,34,313,188,125
,101,2,私立,一般大學,1004,中原大學,碩士在職專班,1284,70,52,18,251,166,85
,101,2,私立,一般大學,1004,中原大學,博士班,387,32,26,6,96,79,17
,101,2,私立,一般大學,1005,淡江大學,學士班(日間),21025,235,160,75,788,507,281
,101,2,私立,一般大學,1005,淡江大學,學士班(進修),2742,89,61,28,322,177,145
,101,2,私立,一般大學,1005,淡江大學,碩士班(日間),2473,107,59,48,406,220,186
,101,2,私立,一般大學,1005,淡江大學,碩士在職專班,1340,73,40,33,268,142,126
,101,2,私立,一般大學,1005,淡江大學,博士班,533,29,26,3,130,97,33
,101,2,私立,一般大學,1006,中國文化大學,學士班(日間),20488,237,118,119,675,386,289
,101,2,私立,一般大學,1006,中國文化大學,學士班(進修),2783,180,94,86,580,287,293
,101,2,私立,一般大學,1006,中國文化大學,碩士班(日間),2016,127,82,45,372,224,148
,101,2,私立,一般大學,1006,中國文化大學,碩士在職專班,658,33,14,19,159,71,88
,101,2,私立,一般大學,1006,中國文化大學,博士班,523,25,12,13,83,44,39
,101,2,私立,一般大學,1007,逢甲大學,學士班(日間),16460,157,122,35,373,285,88
,101,2,私立,一般大學,1007,逢甲大學,學士班(進修),849,51,35,16,111,66,45
,101,2,私立,一般大學,1007,逢甲大學,碩士班(日間),1847,80,52,28,172,119,53
,101,2,私立,一般大學,1007,逢甲大學,碩士在職專班,1217,82,53,29,158,103,55
,101,2,私立,一般大學,1007,逢甲大學,博士班,411,44,35,9,84,68,16
,101,2,私立,一般大學,1008,靜宜大學,學士班(日間),11083,169,104,65,381,217,164
,101,2,私立,一般大學,1008,靜宜大學,學士班(進修),153,3,3,0,11,8,3
,101,2,私立,一般大學,1008,靜宜大學,碩士班(日間),733,58,23,35,133,60,73
,101,2,私立,一般大學,1008,靜宜大學,碩士在職專班,322,11,5,6,37,16,21
,101,2,私立,一般大學,1008,靜宜大學,博士班,38,2,1,1,2,1,1
,101,2,私立,一般大學,1009,長庚大學,學士班(日間),5054,27,15,12,164,81,83
,101,2,私立,一般大學,1009,長庚大學,碩士班(日間),1452,60,24,36,189,74,115
,101,2,私立,一般大學,1009,長庚大學,碩士在職專班,457,32,27,5,95,65,30
,101,2,私立,一般大學,1009,長庚大學,博士班,543,24,18,6,77,47,30
,101,2,私立,一般大學,1010,元智大學,學士班(日間),7073,50,34,16,128,78,50
,101,2,私立,一般大學,1010,元智大學,學士班(進修),2,0,0,0,0,0,0
,101,2,私立,一般大學,1010,元智大學,碩士班(日間),1332,47,28,19,117,77,40
,101,2,私立,一般大學,1010,元智大學,碩士在職專班,1161,52,30,22,163,110,53
,101,2,私立,一般大學,1010,元智大學,博士班,341,31,23,8,72,53,19
,101,2,私立,一般大學,1011,中華大學,學士班(日間),6871,111,83,28,293,224,69
,101,2,私立,一般大學,1011,中華大學,學士班(進修),452,14,12,2,40,30,10
,101,2,私立,一般大學,1011,中華大學,碩士班(日間),794,39,26,13,129,99,30
,101,2,私立,一般大學,1011,中華大學,碩士在職專班,352,17,16,1,56,52,4
,101,2,私立,一般大學,1011,中華大學,博士班,145,9,5,4,43,30,13
,101,2,私立,一般大學,1012,大葉大學,學士班(日間),7465,90,60,30,299,197,102
,101,2,私立,一般大學,1012,大葉大學,學士班(進修),745,22,15,7,62,46,16
,101,2,私立,一般大學,1012,大葉大學,碩士班(日間),966,34,26,8,94,70,24
,101,2,私立,一般大學,1012,大葉大學,碩士在職專班,928,20,11,9,56,32,24
,101,2,私立,一般大學,1012,大葉大學,博士班,159,5,5,0,26,23,3
,101,2,私立,一般大學,1013,華梵大學,學士班(日間),2918,75,56,19,221,148,73
,101,2,私立,一般大學,1013,華梵大學,碩士班(日間),393,63,47,16,122,87,35
,101,2,私立,一般大學,1013,華梵大學,碩士在職專班,447,62,47,15,110,79,31
,101,2,私立,一般大學,1013,華梵大學,博士班,49,9,8,1,23,17,6
,101,2,私立,一般大學,1014,義守大學,學士班(日間),12009,46,31,15,126,91,35
,101,2,私立,一般大學,1014,義守大學,學士班(進修),2669,52,38,14,218,144,74
,101,2,私立,一般大學,1014,義守大學,碩士班(日間),714,17,16,1,27,25,2
,101,2,私立,一般大學,1014,義守大學,碩士在職專班,645,12,9,3,32,22,10
,101,2,私立,一般大學,1014,義守大學,博士班,127,10,7,3,23,17,6
,101,2,私立,一般大學,1015,世新大學,學士班(日間),9528,156,78,78,298,146,152
,101,2,私立,一般大學,1015,世新大學,學士班(進修),251,11,6,5,23,10,13
,101,2,私立,一般大學,1015,世新大學,碩士班(日間),844,120,65,55,170,92,78
,101,2,私立,一般大學,1015,世新大學,碩士在職專班,1124,110,46,64,375,177,198
,101,2,私立,一般大學,1015,世新大學,博士班,72,10,3,7,14,6,8
,101,2,私立,一般大學,1016,銘傳大學,學士班(日間),16902,235,140,95,557,312,245
,101,2,私立,一般大學,1016,銘傳大學,學士班(進修),29,0,0,0,1,1,0
,101,2,私立,一般大學,1016,銘傳大學,碩士班(日間),887,38,20,18,107,56,51
,101,2,私立,一般大學,1016,銘傳大學,碩士在職專班,923,34,13,21,104,39,65
,101,2,私立,一般大學,1016,銘傳大學,博士班,56,9,3,6,19,7,12
,101,2,私立,一般大學,1017,實踐大學,學士班(日間),12279,136,60,76,337,145,192
,101,2,私立,一般大學,1017,實踐大學,學士班(進修),2909,91,32,59,209,76,133
,101,2,私立,一般大學,1017,實踐大學,碩士班(日間),414,33,17,16,67,34,33
,101,2,私立,一般大學,1017,實踐大學,碩士在職專班,187,10,8,2,29,18,11
,101,2,私立,一般大學,1017,實踐大學,博士班,3,0,0,0,0,0,0
,101,2,私立,一般大學,1019,高雄醫學大學,學士班(日間),5589,41,19,22,187,89,98
,101,2,私立,一般大學,1019,高雄醫學大學,學士班(進修),187,4,0,4,13,0,13
,101,2,私立,一般大學,1019,高雄醫學大學,碩士班(日間),632,53,20,33,147,53,94
,101,2,私立,一般大學,1019,高雄醫學大學,碩士在職專班,183,18,4,14,39,10,29
,101,2,私立,一般大學,1019,高雄醫學大學,博士班,344,40,19,21,89,48,41
,101,2,私立,一般大學,1020,南華大學,學士班(日間),3511,84,58,26,258,175,83
,101,2,私立,一般大學,1020,南華大學,學士班(進修),176,5,3,2,17,14,3
,101,2,私立,一般大學,1020,南華大學,碩士班(日間),852,63,32,31,179,91,88
,101,2,私立,一般大學,1020,南華大學,碩士在職專班,590,27,15,12,82,48,34
,101,2,私立,一般大學,1020,南華大學,博士班,25,1,1,0,6,3,3
,101,2,私立,一般大學,1021,真理大學,學士班(日間),7936,121,77,44,284,179,105
,101,2,私立,一般大學,1021,真理大學,學士班(進修),1006,29,14,15,62,31,31
,101,2,私立,一般大學,1021,真理大學,碩士班(日間),166,14,6,8,21,10,11
,101,2,私立,一般大學,1021,真理大學,碩士在職專班,14,1,1,0,3,2,1
,101,2,私立,一般大學,1022,大同大學,學士班(日間),3694,36,28,8,219,173,46
,101,2,私立,一般大學,1022,大同大學,碩士班(日間),659,23,18,5,90,67,23
,101,2,私立,一般大學,1022,大同大學,碩士在職專班,564,47,39,8,267,213,54
,101,2,私立,一般大學,1022,大同大學,博士班,169,13,11,2,68,58,10
,101,2,私立,一般大學,1027,慈濟大學,學士班(日間),2809,20,13,7,73,33,40
,101,2,私立,一般大學,1027,慈濟大學,碩士班(日間),380,38,11,27,85,28,57
,101,2,私立,一般大學,1027,慈濟大學,碩士在職專班,44,4,3,1,6,4,2
,101,2,私立,一般大學,1027,慈濟大學,博士班,110,10,2,8,33,15,18
,101,2,私立,一般大學,1028,臺北醫學大學,學士班(日間),4507,16,6,10,81,35,46
,101,2,私立,一般大學,1028,臺北醫學大學,學士班(進修),324,2,0,2,17,0,17
,101,2,私立,一般大學,1028,臺北醫學大學,碩士班(日間),690,16,6,10,58,19,39
,101,2,私立,一般大學,1028,臺北醫學大學,碩士在職專班,227,15,3,12,38,4,34
,101,2,私立,一般大學,1028,臺北醫學大學,博士班,360,13,6,7,30,15,15
,101,2,私立,一般大學,1029,中山醫學大學,學士班(日間),6490,38,23,15,174,89,85
,101,2,私立,一般大學,1029,中山醫學大學,學士班(進修),349,4,1,3,12,5,7
,101,2,私立,一般大學,1029,中山醫學大學,碩士班(日間),528,16,9,7,57,26,31
,101,2,私立,一般大學,1029,中山醫學大學,碩士在職專班,91,2,0,2,8,4,4
,101,2,私立,一般大學,1029,中山醫學大學,博士班,235,12,8,4,35,19,16
,101,2,私立,一般大學,1033,長榮大學,學士班(日間),8584,219,137,82,353,222,131
,101,2,私立,一般大學,1033,長榮大學,學士班(進修),523,76,47,29,89,53,36
,101,2,私立,一般大學,1033,長榮大學,碩士班(日間),562,73,36,37,105,56,49
,101,2,私立,一般大學,1033,長榮大學,碩士在職專班,233,24,13,11,38,20,18
,101,2,私立,一般大學,1033,長榮大學,博士班,36,11,9,2,16,12,4
,101,2,私立,一般大學,1035,中國醫藥大學,學士班(日間),6458,32,15,17,99,45,54
,101,2,私立,一般大學,1035,中國醫藥大學,學士班(進修),139,8,1,7,16,1,15
,101,2,私立,一般大學,1035,中國醫藥大學,碩士班(日間),561,35,16,19,41,17,24
,101,2,私立,一般大學,1035,中國醫藥大學,碩士在職專班,67,4,1,3,4,1,3
,101,2,私立,一般大學,1035,中國醫藥大學,博士班,317,19,11,8,25,17,8
,101,2,私立,一般大學,1039,玄奘大學,學士班(日間),3650,93,46,47,326,159,167
,101,2,私立,一般大學,1039,玄奘大學,學士班(進修),1518,100,59,41,458,244,214
,101,2,私立,一般大學,1039,玄奘大學,碩士班(日間),463,56,27,29,159,94,65
,101,2,私立,一般大學,1039,玄奘大學,碩士在職專班,350,27,6,21,62,21,41
,101,2,私立,一般大學,1039,玄奘大學,博士班,29,0,0,0,1,1,0
,101,2,私立,一般大學,1048,亞洲大學,學士班(日間),9261,134,89,45,465,287,178
,101,2,私立,一般大學,1048,亞洲大學,學士班(進修),1513,80,52,28,224,141,83
,101,2,私立,一般大學,1048,亞洲大學,碩士班(日間),739,44,23,21,146,82,64
,101,2,私立,一般大學,1048,亞洲大學,碩士在職專班,472,18,10,8,52,27,25
,101,2,私立,一般大學,1048,亞洲大學,博士班,134,11,5,6,26,11,15
,101,2,私立,一般大學,1049,開南大學,學士班(日間),8020,157,93,64,431,281,150
,101,2,私立,一般大學,1049,開南大學,學士班(進修),1344,55,38,17,178,113,65
,101,2,私立,一般大學,1049,開南大學,碩士班(日間),343,32,15,17,70,34,36
,101,2,私立,一般大學,1049,開南大學,碩士在職專班,384,10,6,4,22,11,11
,101,2,私立,一般大學,1050,佛光大學,學士班(日間),2262,32,21,11,107,63,44
,101,2,私立,一般大學,1050,佛光大學,碩士班(日間),835,76,37,39,233,111,122
,101,2,私立,一般大學,1050,佛光大學,碩士在職專班,276,12,8,4,37,24,13
,101,2,私立,一般大學,1050,佛光大學,博士班,32,0,0,0,3,0,3
,101,2,私立,一般大學,1058,明道大學,學士班(日間),3346,38,17,21,118,60,58
,101,2,私立,一般大學,1058,明道大學,學士班(進修),2292,56,36,20,205,130,75
,101,2,私立,一般大學,1058,明道大學,碩士班(日間),265,17,10,7,38,26,12
,101,2,私立,一般大學,1058,明道大學,碩士在職專班,49,2,2,0,6,4,2
,101,2,私立,一般大學,1059,康寧大學,學士班(日間),1121,69,44,25,227,175,52
,101,2,私立,一般大學,1059,康寧大學,學士班(進修),400,36,30,6,116,92,24
,101,2,私立,一般大學,1059,康寧大學,碩士班(日間),223,12,10,2,56,41,15
,101,2,私立,一般大學,1059,康寧大學,碩士在職專班,162,3,3,0,17,9,8
,101,2,私立,一般大學,1067,台灣首府大學,學士班(日間),3722,81,43,38,214,123,91
,101,2,私立,一般大學,1067,台灣首府大學,學士班(進修),1533,27,18,9,140,95,45
,101,2,私立,一般大學,1067,台灣首府大學,碩士班(日間),81,1,1,0,5,2,3
,101,2,私立,一般大學,1125,興國管理學院,學士班(日間),199,5,3,2,0,0,0
,101,2,私立,一般大學,1125,興國管理學院,學士班(進修),1197,15,9,6,1,1,0
,101,2,私立,一般大學,1176,稻江科技暨管理學院,學士班(日間),1562,30,19,11,94,62,32
,101,2,私立,一般大學,1176,稻江科技暨管理學院,學士班(進修),1156,10,4,6,70,45,25
,101,2,私立,一般大學,1176,稻江科技暨管理學院,碩士班(日間),51,2,1,1,11,7,4
,101,2,私立,一般大學,1195,馬偕醫學院,學士班(日間),335,3,1,2,11,4,7
,101,2,私立,一般大學,1195,馬偕醫學院,碩士班(日間),2,0,0,0,1,0,1
,101,2,私立,一般大學,1R01,法鼓佛教學院,學士班(日間),54,0,0,0,0,0,0
,101,2,私立,一般大學,1R01,法鼓佛教學院,碩士班(日間),63,7,1,6,9,1,8
,101,2,私立,一般大學,1R01,法鼓佛教學院,博士班,3,0,0,0,0,0,0
,101,2,私立,一般大學,1R02,基督教台灣浸會神學院,碩士班(日間),39,0,0,0,0,0,0
,101,2,私立,一般大學,1R03,臺北基督學院,學士班(日間),41,5,3,2,5,3,2
,101,2,私立,技專校院,1018,朝陽科技大學,學士班(日間),11041,94,65,29,338,197,141
,101,2,私立,技專校院,1018,朝陽科技大學,學士班(進修),3853,136,72,64,376,181,195
,101,2,私立,技專校院,1018,朝陽科技大學,碩士班(日間),1007,58,26,32,133,75,58
,101,2,私立,技專校院,1018,朝陽科技大學,碩士在職專班,580,35,18,17,99,61,38
,101,2,私立,技專校院,1018,朝陽科技大學,博士班,72,2,2,0,12,12,0
,101,2,私立,技專校院,1023,南臺科技大學,學士班(日間),13094,96,61,35,327,210,117
,101,2,私立,技專校院,1023,南臺科技大學,學士班(進修),4929,108,69,39,492,295,197
,101,2,私立,技專校院,1023,南臺科技大學,碩士班(日間),1257,64,42,22,228,153,75
,101,2,私立,技專校院,1023,南臺科技大學,碩士在職專班,544,23,14,9,84,43,41
,101,2,私立,技專校院,1023,南臺科技大學,博士班,44,0,0,0,5,4,1
,101,2,私立,技專校院,1024,崑山科技大學,學士班(日間),8578,136,89,47,424,294,130
,101,2,私立,技專校院,1024,崑山科技大學,學士班(進修),3560,173,111,62,717,461,256
,101,2,私立,技專校院,1024,崑山科技大學,碩士班(日間),589,28,19,9,87,70,17
,101,2,私立,技專校院,1024,崑山科技大學,碩士在職專班,213,10,7,3,26,20,6
,101,2,私立,技專校院,1024,崑山科技大學,博士班,26,2,2,0,3,3,0
,101,2,私立,技專校院,1025,嘉南藥理大學,學士班(日間),12702,110,55,55,491,246,245
,101,2,私立,技專校院,1025,嘉南藥理大學,學士班(進修),3743,127,64,63,754,428,326
,101,2,私立,技專校院,1025,嘉南藥理大學,碩士班(日間),357,22,13,9,107,76,31
,101,2,私立,技專校院,1025,嘉南藥理大學,碩士在職專班,183,5,2,3,49,23,26
,101,2,私立,技專校院,1026,樹德科技大學,二專(日間),0,1,1,0,1,1,0
,101,2,私立,技專校院,1026,樹德科技大學,學士班(日間),8103,210,135,75,334,223,111
,101,2,私立,技專校院,1026,樹德科技大學,學士班(進修),2352,117,79,38,218,138,80
,101,2,私立,技專校院,1026,樹德科技大學,碩士班(日間),429,39,25,14,63,40,23
,101,2,私立,技專校院,1026,樹德科技大學,碩士在職專班,628,14,13,1,28,20,8
,101,2,私立,技專校院,1026,樹德科技大學,博士班,16,2,2,0,3,2,1
,101,2,私立,技專校院,1030,龍華科技大學,二專(日間),44,0,0,0,0,0,0
,101,2,私立,技專校院,1030,龍華科技大學,學士班(日間),6346,69,53,16,291,226,65
,101,2,私立,技專校院,1030,龍華科技大學,學士班(進修),4111,117,86,31,312,225,87
,101,2,私立,技專校院,1030,龍華科技大學,碩士班(日間),308,10,8,2,33,26,7
,101,2,私立,技專校院,1030,龍華科技大學,碩士在職專班,110,4,2,2,9,6,3
,101,2,私立,技專校院,1031,輔英科技大學,二專(進修),13,0,0,0,1,1,0
,101,2,私立,技專校院,1031,輔英科技大學,五專,3429,20,1,19,84,14,70
,101,2,私立,技專校院,1031,輔英科技大學,學士班(日間),5261,76,40,36,333,195,138
,101,2,私立,技專校院,1031,輔英科技大學,學士班(進修),1509,42,22,20,207,111,96
,101,2,私立,技專校院,1031,輔英科技大學,碩士班(日間),133,16,7,9,41,10,31
,101,2,私立,技專校院,1031,輔英科技大學,碩士在職專班,26,0,0,0,13,1,12
,101,2,私立,技專校院,1032,明新科技大學,二專(日間),9,0,0,0,0,0,0
,101,2,私立,技專校院,1032,明新科技大學,二專(進修),172,0,0,0,0,0,0
,101,2,私立,技專校院,1032,明新科技大學,學士班(日間),8583,115,80,35,788,473,315
,101,2,私立,技專校院,1032,明新科技大學,學士班(進修),4244,157,116,41,408,286,122
,101,2,私立,技專校院,1032,明新科技大學,碩士班(日間),451,17,13,4,135,98,37
,101,2,私立,技專校院,1032,明新科技大學,碩士在職專班,226,7,6,1,32,27,5
,101,2,私立,技專校院,1034,弘光科技大學,五專,391,3,0,3,11,1,10
,101,2,私立,技專校院,1034,弘光科技大學,學士班(日間),7618,78,31,47,323,133,190
,101,2,私立,技專校院,1034,弘光科技大學,學士班(進修),4396,96,37,59,526,202,324
,101,2,私立,技專校院,1034,弘光科技大學,碩士班(日間),223,10,2,8,55,25,30
,101,2,私立,技專校院,1034,弘光科技大學,碩士在職專班,109,4,1,3,28,8,20
,101,2,私立,技專校院,1036,健行科技大學,二專(日間),138,0,0,0,1,1,0
,101,2,私立,技專校院,1036,健行科技大學,學士班(日間),8701,160,114,46,418,317,101
,101,2,私立,技專校院,1036,健行科技大學,學士班(進修),3858,203,140,63,218,154,64
,101,2,私立,技專校院,1036,健行科技大學,碩士班(日間),389,14,12,2,38,34,4
,101,2,私立,技專校院,1036,健行科技大學,碩士在職專班,136,6,5,1,16,13,3
,101,2,私立,技專校院,1037,正修科技大學,二專(日間),114,1,1,0,5,5,0
,101,2,私立,技專校院,1037,正修科技大學,二專(進修),31,4,4,0,12,9,3
,101,2,私立,技專校院,1037,正修科技大學,五專,6,0,0,0,8,6,2
,101,2,私立,技專校院,1037,正修科技大學,學士班(日間),9183,153,106,47,271,183,88
,101,2,私立,技專校院,1037,正修科技大學,學士班(進修),6772,281,182,99,835,529,306
,101,2,私立,技專校院,1037,正修科技大學,碩士班(日間),371,4,3,1,33,30,3
,101,2,私立,技專校院,1037,正修科技大學,碩士在職專班,75,7,6,1,26,18,8
,101,2,私立,技專校院,1037,正修科技大學,博士班,8,0,0,0,3,3,0
,101,2,私立,技專校院,1038,萬能科技大學,二專(日間),21,0,0,0,0,0,0
,101,2,私立,技專校院,1038,萬能科技大學,學士班(日間),5383,37,24,13,417,293,124
,101,2,私立,技專校院,1038,萬能科技大學,學士班(進修),4856,67,39,28,260,160,100
,101,2,私立,技專校院,1038,萬能科技大學,碩士班(日間),131,8,7,1,37,28,9
,101,2,私立,技專校院,1038,萬能科技大學,碩士在職專班,143,2,1,1,4,3,1
,101,2,私立,技專校院,1040,建國科技大學,二專(日間),55,0,0,0,0,0,0
,101,2,私立,技專校院,1040,建國科技大學,二專(進修),88,4,4,0,9,8,1
,101,2,私立,技專校院,1040,建國科技大學,學士班(日間),7007,70,43,27,262,179,83
,101,2,私立,技專校院,1040,建國科技大學,學士班(進修),2039,38,26,12,138,98,40
,101,2,私立,技專校院,1040,建國科技大學,碩士班(日間),225,9,9,0,21,18,3
,101,2,私立,技專校院,1041,明志科技大學,二專(進修),47,3,0,3,4,0,4
,101,2,私立,技專校院,1041,明志科技大學,五專,40,1,1,0,1,1,0
,101,2,私立,技專校院,1041,明志科技大學,學士班(日間),3197,15,13,2,49,36,13
,101,2,私立,技專校院,1041,明志科技大學,學士班(進修),407,11,8,3,38,25,13
,101,2,私立,技專校院,1041,明志科技大學,碩士班(日間),437,11,10,1,30,29,1
,101,2,私立,技專校院,1041,明志科技大學,碩士在職專班,51,2,2,0,10,10,0
,101,2,私立,技專校院,1042,高苑科技大學,二專(日間),70,0,0,0,0,0,0
,101,2,私立,技專校院,1042,高苑科技大學,五專,158,1,1,0,1,1,0
,101,2,私立,技專校院,1042,高苑科技大學,學士班(日間),5376,56,43,13,77,62,15
,101,2,私立,技專校院,1042,高苑科技大學,學士班(進修),1468,40,37,3,81,68,13
,101,2,私立,技專校院,1042,高苑科技大學,碩士班(日間),162,4,3,1,7,6,1
,101,2,私立,技專校院,1042,高苑科技大學,碩士在職專班,263,4,1,3,8,4,4
,101,2,私立,技專校院,1043,大仁科技大學,二專(日間),1,0,0,0,0,0,0
,101,2,私立,技專校院,1043,大仁科技大學,二專(進修),2,0,0,0,0,0,0
,101,2,私立,技專校院,1043,大仁科技大學,五專,326,13,4,9,28,12,16
,101,2,私立,技專校院,1043,大仁科技大學,學士班(日間),6078,124,71,53,451,275,176
,101,2,私立,技專校院,1043,大仁科技大學,學士班(進修),2052,43,28,15,266,142,124
,101,2,私立,技專校院,1043,大仁科技大學,碩士班(日間),93,11,7,4,31,21,10
,101,2,私立,技專校院,1043,大仁科技大學,碩士在職專班,141,3,2,1,34,21,13
,101,2,私立,技專校院,1044,聖約翰科技大學,學士班(日間),6068,154,114,40,412,314,98
,101,2,私立,技專校院,1044,聖約翰科技大學,學士班(進修),865,36,23,13,167,116,51
,101,2,私立,技專校院,1044,聖約翰科技大學,碩士班(日間),251,10,6,4,36,27,9
,101,2,私立,技專校院,1044,聖約翰科技大學,碩士在職專班,132,4,4,0,15,12,3
,101,2,私立,技專校院,1045,嶺東科技大學,學士班(日間),7011,60,28,32,184,97,87
,101,2,私立,技專校院,1045,嶺東科技大學,學士班(進修),2994,81,46,35,282,156,126
,101,2,私立,技專校院,1045,嶺東科技大學,碩士班(日間),266,13,6,7,35,21,14
,101,2,私立,技專校院,1045,嶺東科技大學,碩士在職專班,138,3,0,3,9,2,7
,101,2,私立,技專校院,1046,中國科技大學,二專(進修),0,0,0,0,1,1,0
,101,2,私立,技專校院,1046,中國科技大學,五專,8,1,0,1,5,3,2
,101,2,私立,技專校院,1046,中國科技大學,學士班(日間),8300,130,60,70,346,173,173
,101,2,私立,技專校院,1046,中國科技大學,學士班(進修),3369,137,74,63,346,201,145
,101,2,私立,技專校院,1046,中國科技大學,碩士班(日間),161,11,8,3,29,20,9
,101,2,私立,技專校院,1046,中國科技大學,碩士在職專班,13,1,0,1,2,1,1
,101,2,私立,技專校院,1047,中臺科技大學,五專,123,1,0,1,5,3,2
,101,2,私立,技專校院,1047,中臺科技大學,學士班(日間),6355,95,43,52,389,179,210
,101,2,私立,技專校院,1047,中臺科技大學,學士班(進修),3379,148,51,97,642,266,376
,101,2,私立,技專校院,1047,中臺科技大學,碩士班(日間),212,6,2,4,46,22,24
,101,2,私立,技專校院,1047,中臺科技大學,碩士在職專班,348,33,10,23,77,23,54
,101,2,私立,技專校院,1047,中臺科技大學,博士班,14,0,0,0,1,1,0
,101,2,私立,技專校院,1051,台南應用科技大學,二專(進修),28,0,0,0,0,0,0
,101,2,私立,技專校院,1051,台南應用科技大學,五專,1386,6,2,4,45,9,36
,101,2,私立,技專校院,1051,台南應用科技大學,學士班(日間),8487,92,31,61,359,118,241
,101,2,私立,技專校院,1051,台南應用科技大學,學士班(進修),3029,128,52,76,346,147,199
,101,2,私立,技專校院,1051,台南應用科技大學,碩士班(日間),175,8,2,6,35,8,27
,101,2,私立,技專校院,1051,台南應用科技大學,碩士在職專班,180,15,3,12,34,6,28
,101,2,私立,技專校院,1052,遠東科技大學,二專(進修),73,2,1,1,14,13,1
,101,2,私立,技專校院,1052,遠東科技大學,五專,2,0,0,0,4,3,1
,101,2,私立,技專校院,1052,遠東科技大學,學士班(日間),8152,137,95,42,455,321,134
,101,2,私立,技專校院,1052,遠東科技大學,學士班(進修),748,19,16,3,110,95,15
,101,2,私立,技專校院,1052,遠東科技大學,碩士班(日間),180,8,7,1,29,24,5
,101,2,私立,技專校院,1052,遠東科技大學,碩士在職專班,38,1,1,0,4,4,0
,101,2,私立,技專校院,1053,元培醫事科技大學,學士班(日間),6112,91,57,34,257,173,84
,101,2,私立,技專校院,1053,元培醫事科技大學,學士班(進修),1651,33,21,12,101,57,44
,101,2,私立,技專校院,1053,元培醫事科技大學,碩士班(日間),174,4,3,1,16,13,3
,101,2,私立,技專校院,1053,元培醫事科技大學,碩士在職專班,24,0,0,0,1,0,1
,101,2,私立,技專校院,1054,景文科技大學,二專(進修),16,1,0,1,12,9,3
,101,2,私立,技專校院,1054,景文科技大學,學士班(日間),5977,66,40,26,204,105,99
,101,2,私立,技專校院,1054,景文科技大學,學士班(進修),2495,74,44,30,261,143,118
,101,2,私立,技專校院,1054,景文科技大學,碩士班(日間),59,0,0,0,8,5,3
,101,2,私立,技專校院,1054,景文科技大學,碩士在職專班,97,2,2,0,11,8,3
,101,2,私立,技專校院,1055,中華醫事科技大學,二專(日間),109,9,2,7,11,4,7
,101,2,私立,技專校院,1055,中華醫事科技大學,五專,1954,43,10,33,55,17,38
,101,2,私立,技專校院,1055,中華醫事科技大學,學士班(日間),4891,96,57,39,173,102,71
,101,2,私立,技專校院,1055,中華醫事科技大學,學士班(進修),2468,107,50,57,332,150,182
,101,2,私立,技專校院,1055,中華醫事科技大學,碩士班(日間),80,1,1,0,8,6,2
,101,2,私立,技專校院,1056,東南科技大學,二專(日間),83,1,1,0,10,9,1
,101,2,私立,技專校院,1056,東南科技大學,二專(進修),1,1,1,0,2,2,0
,101,2,私立,技專校院,1056,東南科技大學,學士班(日間),6448,151,113,38,654,518,136
,101,2,私立,技專校院,1056,東南科技大學,學士班(進修),615,55,42,13,173,141,32
,101,2,私立,技專校院,1056,東南科技大學,碩士班(日間),119,3,3,0,12,12,0
,101,2,私立,技專校院,1056,東南科技大學,碩士在職專班,68,9,8,1,20,19,1
,101,2,私立,技專校院,1057,德明財經科技大學,二專(日間),4,1,0,1,6,3,3
,101,2,私立,技專校院,1057,德明財經科技大學,二專(進修),3,0,0,0,8,5,3
,101,2,私立,技專校院,1057,德明財經科技大學,學士班(日間),6324,68,38,30,235,109,126
,101,2,私立,技專校院,1057,德明財經科技大學,學士班(進修),2247,70,38,32,272,124,148
,101,2,私立,技專校院,1057,德明財經科技大學,碩士班(日間),97,10,10,0,27,20,7
,101,2,私立,技專校院,1057,德明財經科技大學,碩士在職專班,49,1,1,0,6,4,2
,101,2,私立,技專校院,1060,南開科技大學,二專(進修),2,0,0,0,0,0,0
,101,2,私立,技專校院,1060,南開科技大學,五專,1344,16,14,2,46,38,8
,101,2,私立,技專校院,1060,南開科技大學,學士班(日間),3658,46,37,9,132,102,30
,101,2,私立,技專校院,1060,南開科技大學,學士班(進修),1215,48,31,17,96,65,31
,101,2,私立,技專校院,1060,南開科技大學,碩士班(日間),104,1,1,0,10,9,1
,101,2,私立,技專校院,1060,南開科技大學,碩士在職專班,154,5,2,3,7,2,5
,101,2,私立,技專校院,1061,中華科技大學,二專(進修),95,11,2,9,15,5,10
,101,2,私立,技專校院,1061,中華科技大學,學士班(日間),6585,111,71,40,546,357,189
,101,2,私立,技專校院,1061,中華科技大學,學士班(進修),1733,82,61,21,391,278,113
,101,2,私立,技專校院,1061,中華科技大學,碩士班(日間),245,15,10,5,87,71,16
,101,2,私立,技專校院,1061,中華科技大學,碩士在職專班,144,14,11,3,36,29,7
,101,2,私立,技專校院,1062,僑光科技大學,二專(日間),133,2,2,0,7,5,2
,101,2,私立,技專校院,1062,僑光科技大學,二專(進修),47,0,0,0,1,1,0
,101,2,私立,技專校院,1062,僑光科技大學,五專,1084,8,5,3,48,27,21
,101,2,私立,技專校院,1062,僑光科技大學,學士班(日間),5294,46,18,28,155,86,69
,101,2,私立,技專校院,1062,僑光科技大學,學士班(進修),3660,86,44,42,333,167,166
,101,2,私立,技專校院,1062,僑光科技大學,碩士班(日間),73,1,1,0,7,5,2
,101,2,私立,技專校院,1062,僑光科技大學,碩士在職專班,50,6,1,5,6,1,5
,101,2,私立,技專校院,1063,育達科技大學,學士班(日間),4932,355,202,153,535,317,218
,101,2,私立,技專校院,1063,育達科技大學,學士班(進修),2266,190,120,70,536,358,178
,101,2,私立,技專校院,1063,育達科技大學,碩士班(日間),132,4,4,0,16,13,3
,101,2,私立,技專校院,1063,育達科技大學,碩士在職專班,93,3,2,1,10,7,3
,101,2,私立,技專校院,1064,美和科技大學,五專,1990,19,4,15,64,12,52
,101,2,私立,技專校院,1064,美和科技大學,學士班(日間),3627,70,30,40,268,137,131
,101,2,私立,技專校院,1064,美和科技大學,學士班(進修),2264,73,31,42,300,125,175
,101,2,私立,技專校院,1064,美和科技大學,碩士班(日間),73,2,1,1,11,6,5
,101,2,私立,技專校院,1064,美和科技大學,碩士在職專班,70,2,1,1,13,7,6
,101,2,私立,技專校院,1065,吳鳳科技大學,二專(日間),63,3,2,1,12,5,7
,101,2,私立,技專校院,1065,吳鳳科技大學,二專(進修),217,4,3,1,48,32,16
,101,2,私立,技專校院,1065,吳鳳科技大學,五專,2,1,1,0,4,4,0
,101,2,私立,技專校院,1065,吳鳳科技大學,學士班(日間),4220,90,67,23,276,202,74
,101,2,私立,技專校院,1065,吳鳳科技大學,學士班(進修),1070,56,43,13,269,211,58
,101,2,私立,技專校院,1065,吳鳳科技大學,碩士班(日間),54,1,1,0,9,8,1
,101,2,私立,技專校院,1065,吳鳳科技大學,碩士在職專班,79,3,1,2,6,4,2
,101,2,私立,技專校院,1066,環球科技大學,二專(日間),193,5,2,3,43,28,15
,101,2,私立,技專校院,1066,環球科技大學,二專(進修),433,4,3,1,8,6,2
,101,2,私立,技專校院,1066,環球科技大學,學士班(日間),4270,60,33,27,314,178,136
,101,2,私立,技專校院,1066,環球科技大學,學士班(進修),1440,10,9,1,19,16,3
,101,2,私立,技專校院,1066,環球科技大學,碩士班(日間),117,4,1,3,21,11,10
,101,2,私立,技專校院,1066,環球科技大學,碩士在職專班,20,1,1,0,1,1,0
,101,2,私立,技專校院,1068,中州科技大學,二專(日間),1,0,0,0,0,0,0
,101,2,私立,技專校院,1068,中州科技大學,學士班(日間),3946,53,39,14,188,128,60
,101,2,私立,技專校院,1068,中州科技大學,學士班(進修),2017,33,25,8,107,80,27
,101,2,私立,技專校院,1068,中州科技大學,碩士班(日間),119,2,2,0,9,8,1
,101,2,私立,技專校院,1068,中州科技大學,碩士在職專班,20,2,1,1,3,1,2
,101,2,私立,技專校院,1069,修平科技大學,二專(進修),126,4,3,1,47,42,5
,101,2,私立,技專校院,1069,修平科技大學,學士班(日間),5255,136,99,37,406,281,125
,101,2,私立,技專校院,1069,修平科技大學,學士班(進修),1272,60,48,12,283,235,48
,101,2,私立,技專校院,1069,修平科技大學,碩士班(日間),54,4,4,0,13,13,0
,101,2,私立,技專校院,1070,長庚科技大學,五專,2302,13,1,12,22,1,21
,101,2,私立,技專校院,1070,長庚科技大學,學士班(日間),3561,25,2,23,67,7,60
,101,2,私立,技專校院,1070,長庚科技大學,學士班(進修),2091,61,0,61,154,4,150
,101,2,私立,技專校院,1070,長庚科技大學,碩士在職專班,37,3,0,3,6,0,6
,101,2,私立,技專校院,1071,臺北城市科技大學,二專(日間),231,3,3,0,24,14,10
,101,2,私立,技專校院,1071,臺北城市科技大學,二專(進修),230,24,18,6,42,32,10
,101,2,私立,技專校院,1071,臺北城市科技大學,五專,1662,39,25,14,109,85,24
,101,2,私立,技專校院,1071,臺北城市科技大學,學士班(日間),6240,158,102,56,467,333,134
,101,2,私立,技專校院,1071,臺北城市科技大學,學士班(進修),1369,75,63,12,193,149,44
,101,2,私立,技專校院,1071,臺北城市科技大學,碩士班(日間),91,7,7,0,20,17,3
,101,2,私立,技專校院,1072,大華科技大學,二專(日間),4,0,0,0,0,0,0
,101,2,私立,技專校院,1072,大華科技大學,二專(進修),87,0,0,0,0,0,0
,101,2,私立,技專校院,1072,大華科技大學,五專,1472,35,18,17,107,66,41
,101,2,私立,技專校院,1072,大華科技大學,學士班(日間),2154,43,33,10,130,96,34
,101,2,私立,技專校院,1072,大華科技大學,學士班(進修),1340,51,39,12,100,68,32
,101,2,私立,技專校院,1072,大華科技大學,碩士班(日間),24,4,4,0,4,4,0
,101,2,私立,技專校院,1072,大華科技大學,碩士在職專班,15,0,0,0,2,2,0
,101,2,私立,技專校院,1073,醒吾科技大學,二專(日間),61,0,0,0,0,0,0
,101,2,私立,技專校院,1073,醒吾科技大學,二專(進修),6,0,0,0,0,0,0
,101,2,私立,技專校院,1073,醒吾科技大學,五專,1366,18,5,13,48,10,38
,101,2,私立,技專校院,1073,醒吾科技大學,學士班(日間),5190,123,63,60,213,91,122
,101,2,私立,技專校院,1073,醒吾科技大學,學士班(進修),1687,110,77,33,346,231,115
,101,2,私立,技專校院,1073,醒吾科技大學,碩士班(日間),63,2,1,1,5,2,3
,101,2,私立,技專校院,1073,醒吾科技大學,碩士在職專班,17,2,2,0,5,3,2
,101,2,私立,技專校院,1147,文藻外語學院,五專,1722,10,6,4,20,10,10
,101,2,私立,技專校院,1147,文藻外語學院,學士班(日間),5330,55,14,41,98,32,66
,101,2,私立,技專校院,1147,文藻外語學院,學士班(進修),1945,77,29,48,300,121,179
,101,2,私立,技專校院,1147,文藻外語學院,碩士班(日間),86,8,1,7,13,1,12
,101,2,私立,技專校院,1147,文藻外語學院,碩士在職專班,56,7,0,7,14,2,12
,101,2,私立,技專校院,1148,大漢技術學院,二專(進修),164,2,2,0,2,2,0
,101,2,私立,技專校院,1148,大漢技術學院,學士班(日間),1246,18,15,3,87,73,14
,101,2,私立,技專校院,1148,大漢技術學院,學士班(進修),1058,16,12,4,56,42,14
,101,2,私立,技專校院,1148,大漢技術學院,碩士班(日間),35,0,0,0,1,1,0
,101,2,私立,技專校院,1150,慈濟技術學院,五專,1113,4,2,2,20,2,18
,101,2,私立,技專校院,1150,慈濟技術學院,學士班(日間),1220,16,10,6,45,21,24
,101,2,私立,技專校院,1150,慈濟技術學院,學士班(進修),92,4,0,4,30,0,30
,101,2,私立,技專校院,1150,慈濟技術學院,碩士班(日間),17,4,3,1,7,5,2
,101,2,私立,技專校院,1154,永達技術學院,二專(日間),23,2,1,1,2,1,1
,101,2,私立,技專校院,1154,永達技術學院,二專(進修),115,1,0,1,1,0,1
,101,2,私立,技專校院,1154,永達技術學院,五專,159,2,1,1,35,28,7
,101,2,私立,技專校院,1154,永達技術學院,學士班(日間),501,13,11,2,120,98,22
,101,2,私立,技專校院,1154,永達技術學院,學士班(進修),472,16,13,3,45,39,6
,101,2,私立,技專校院,1154,永達技術學院,碩士班(日間),25,0,0,0,0,0,0
,101,2,私立,技專校院,1159,和春技術學院,二專(進修),205,11,10,1,13,11,2
,101,2,私立,技專校院,1159,和春技術學院,五專,366,5,3,2,19,11,8
,101,2,私立,技專校院,1159,和春技術學院,學士班(日間),1857,46,29,17,180,128,52
,101,2,私立,技專校院,1159,和春技術學院,學士班(進修),826,44,35,9,60,48,12
,101,2,私立,技專校院,1159,和春技術學院,碩士班(日間),10,0,0,0,3,3,0
,101,2,私立,技專校院,1164,致理技術學院,二專(日間),308,2,2,0,18,15,3
,101,2,私立,技專校院,1164,致理技術學院,二專(進修),4,0,0,0,1,0,1
,101,2,私立,技專校院,1164,致理技術學院,五專,1409,12,3,9,47,16,31
,101,2,私立,技專校院,1164,致理技術學院,學士班(日間),5630,49,23,26,184,79,105
,101,2,私立,技專校院,1164,致理技術學院,學士班(進修),3439,69,31,38,290,128,162
,101,2,私立,技專校院,1164,致理技術學院,碩士班(日間),23,2,1,1,6,2,4
,101,2,私立,技專校院,1164,致理技術學院,碩士在職專班,28,2,1,1,4,2,2
,101,2,私立,技專校院,1166,亞東技術學院,二專(日間),1,0,0,0,0,0,0
,101,2,私立,技專校院,1166,亞東技術學院,學士班(日間),4574,74,53,21,203,165,38
,101,2,私立,技專校院,1166,亞東技術學院,學士班(進修),1013,18,9,9,127,72,55
,101,2,私立,技專校院,1166,亞東技術學院,碩士班(日間),96,5,4,1,15,13,2
,101,2,私立,技專校院,1166,亞東技術學院,碩士在職專班,0,1,0,1,2,1,1
,101,2,私立,技專校院,1168,桃園創新技術學院,二專(日間),315,0,0,0,0,0,0
,101,2,私立,技專校院,1168,桃園創新技術學院,學士班(日間),5064,113,70,43,358,244,114
,101,2,私立,技專校院,1168,桃園創新技術學院,學士班(進修),1778,77,56,21,408,292,116
,101,2,私立,技專校院,1168,桃園創新技術學院,碩士班(日間),21,1,1,0,2,2,0
,101,2,私立,技專校院,1179,德霖技術學院,二專(日間),206,0,0,0,0,0,0
,101,2,私立,技專校院,1179,德霖技術學院,二專(進修),508,17,15,2,35,23,12
,101,2,私立,技專校院,1179,德霖技術學院,五專,1906,28,21,7,123,107,16
,101,2,私立,技專校院,1179,德霖技術學院,學士班(日間),3553,111,69,42,300,210,90
,101,2,私立,技專校院,1179,德霖技術學院,學士班(進修),2283,73,48,25,204,139,65
,101,2,私立,技專校院,1181,南榮技術學院,二專(日間),1,0,0,0,0,0,0
,101,2,私立,技專校院,1181,南榮技術學院,二專(進修),186,4,2,2,10,6,4
,101,2,私立,技專校院,1181,南榮技術學院,五專,306,3,2,1,15,13,2
,101,2,私立,技專校院,1181,南榮技術學院,學士班(日間),1517,12,8,4,44,31,13
,101,2,私立,技專校院,1181,南榮技術學院,學士班(進修),887,17,9,8,45,34,11
,101,2,私立,技專校院,1181,南榮技術學院,碩士班(日間),28,1,1,0,3,3,0
,101,2,私立,技專校院,1181,南榮技術學院,碩士在職專班,20,3,2,1,4,3,1
,101,2,私立,技專校院,1182,蘭陽技術學院,二專(日間),20,2,1,1,2,1,1
,101,2,私立,技專校院,1182,蘭陽技術學院,二專(進修),122,1,1,0,1,1,0
,101,2,私立,技專校院,1182,蘭陽技術學院,五專,1182,42,29,13,91,65,26
,101,2,私立,技專校院,1182,蘭陽技術學院,學士班(日間),2107,45,36,9,99,73,26
,101,2,私立,技專校院,1182,蘭陽技術學院,學士班(進修),133,0,0,0,0,0,0
,101,2,私立,技專校院,1183,黎明技術學院,二專(進修),149,2,1,1,36,16,20
,101,2,私立,技專校院,1183,黎明技術學院,五專,930,13,13,0,70,65,5
,101,2,私立,技專校院,1183,黎明技術學院,學士班(日間),2492,51,32,19,243,158,85
,101,2,私立,技專校院,1183,黎明技術學院,學士班(進修),1218,29,25,4,282,238,44
,101,2,私立,技專校院,1184,東方設計學院,二專(日間),10,0,0,0,28,20,8
,101,2,私立,技專校院,1184,東方設計學院,二專(進修),4,10,5,5,29,15,14
,101,2,私立,技專校院,1184,東方設計學院,五專,1268,34,17,17,156,74,82
,101,2,私立,技專校院,1184,東方設計學院,學士班(日間),2253,61,39,22,268,166,102
,101,2,私立,技專校院,1184,東方設計學院,學士班(進修),241,21,14,7,89,74,15
,101,2,私立,技專校院,1184,東方設計學院,碩士班(日間),32,3,1,2,18,10,8
,101,2,私立,技專校院,1184,東方設計學院,碩士在職專班,43,5,3,2,29,15,14
,101,2,私立,技專校院,1185,經國管理暨健康學院,二專(進修),18,0,0,0,0,0,0
,101,2,私立,技專校院,1185,經國管理暨健康學院,五專,1483,28,9,19,93,26,67
,101,2,私立,技專校院,1185,經國管理暨健康學院,學士班(日間),1946,74,26,48,215,92,123
,101,2,私立,技專校院,1185,經國管理暨健康學院,學士班(進修),769,29,15,14,77,33,44
,101,2,私立,技專校院,1185,經國管理暨健康學院,碩士班(日間),23,0,0,0,5,2,3
,101,2,私立,技專校院,1185,經國管理暨健康學院,碩士在職專班,44,0,0,0,1,0,1
,101,2,私立,技專校院,1187,崇右技術學院,二專(進修),1,0,0,0,1,1,0
,101,2,私立,技專校院,1187,崇右技術學院,五專,1126,47,21,26,76,42,34
,101,2,私立,技專校院,1187,崇右技術學院,學士班(日間),2384,71,32,39,161,74,87
,101,2,私立,技專校院,1187,崇右技術學院,學士班(進修),6,0,0,0,5,4,1
,101,2,私立,技專校院,1188,大同技術學院,二專(日間),3,0,0,0,19,15,4
,101,2,私立,技專校院,1188,大同技術學院,二專(進修),60,3,2,1,46,25,21
,101,2,私立,技專校院,1188,大同技術學院,五專,194,5,3,2,43,29,14
,101,2,私立,技專校院,1188,大同技術學院,學士班(日間),2161,68,41,27,394,233,161
,101,2,私立,技專校院,1188,大同技術學院,學士班(進修),1041,70,45,25,346,180,166
,101,2,私立,技專校院,1189,亞太創意技術學院,二專(日間),14,0,0,0,19,16,3
,101,2,私立,技專校院,1189,亞太創意技術學院,二專(進修),150,0,0,0,2,2,0
,101,2,私立,技專校院,1189,亞太創意技術學院,學士班(日間),2130,34,23,11,180,119,61
,101,2,私立,技專校院,1189,亞太創意技術學院,學士班(進修),118,0,0,0,4,1,3
,101,2,私立,技專校院,1189,亞太創意技術學院,碩士班(日間),15,0,0,0,0,0,0
,101,2,私立,技專校院,1190,高鳳數位內容學院,五專,61,1,0,1,2,0,2
,101,2,私立,技專校院,1190,高鳳數位內容學院,學士班(日間),550,14,7,7,77,49,28
,101,2,私立,技專校院,1190,高鳳數位內容學院,學士班(進修),219,2,2,0,25,16,9
,101,2,私立,技專校院,1191,華夏技術學院,二專(日間),0,0,0,0,55,50,5
,101,2,私立,技專校院,1191,華夏技術學院,二專(進修),545,13,12,1,363,270,93
,101,2,私立,技專校院,1191,華夏技術學院,五專,577,27,26,1,466,402,64
,101,2,私立,技專校院,1191,華夏技術學院,學士班(日間),2914,59,37,22,524,316,208
,101,2,私立,技專校院,1191,華夏技術學院,學士班(進修),1570,64,48,16,676,457,219
,101,2,私立,技專校院,1191,華夏技術學院,碩士在職專班,40,0,0,0,4,4,0
,101,2,私立,技專校院,1192,臺灣觀光學院,二專(日間),31,2,1,1,33,25,8
,101,2,私立,技專校院,1192,臺灣觀光學院,二專(進修),180,2,1,1,2,1,1
,101,2,私立,技專校院,1192,臺灣觀光學院,五專,178,6,3,3,26,14,12
,101,2,私立,技專校院,1192,臺灣觀光學院,學士班(日間),1628,21,8,13,96,56,40
,101,2,私立,技專校院,1192,臺灣觀光學院,學士班(進修),249,8,5,3,8,5,3
,101,2,私立,技專校院,1197,台北海洋技術學院,二專(日間),502,22,20,2,69,62,7
,101,2,私立,技專校院,1197,台北海洋技術學院,二專(進修),277,7,5,2,15,12,3
,101,2,私立,技專校院,1197,台北海洋技術學院,五專,1319,47,34,13,83,62,21
,101,2,私立,技專校院,1197,台北海洋技術學院,學士班(日間),3788,112,82,30,299,221,78
,101,2,私立,技專校院,1197,台北海洋技術學院,學士班(進修),603,18,12,6,47,36,11
,101,2,私立,技專校院,1281,康寧醫護暨管理專科學校,二專(日間),162,2,1,1,6,2,4
,101,2,私立,技專校院,1281,康寧醫護暨管理專科學校,二專(進修),344,7,0,7,24,6,18
,101,2,私立,技專校院,1281,康寧醫護暨管理專科學校,五專,2723,22,9,13,82,23,59
,101,2,私立,技專校院,1282,馬偕醫護管理專科學校,二專(日間),218,2,0,2,21,1,20
,101,2,私立,技專校院,1282,馬偕醫護管理專科學校,二專(進修),343,7,1,6,45,4,41
,101,2,私立,技專校院,1282,馬偕醫護管理專科學校,五專,3039,14,2,12,58,10,48
,101,2,私立,技專校院,1283,仁德醫護管理專科學校,二專(日間),2,0,0,0,0,0,0
,101,2,私立,技專校院,1283,仁德醫護管理專科學校,二專(進修),782,2,2,0,8,7,1
,101,2,私立,技專校院,1283,仁德醫護管理專科學校,五專,5667,54,19,35,78,37,41
,101,2,私立,技專校院,1284,樹人醫護管理專科學校,二專(進修),414,15,9,6,38,28,10
,101,2,私立,技專校院,1284,樹人醫護管理專科學校,五專,5821,100,33,67,207,67,140
,101,2,私立,技專校院,1285,慈惠醫護管理專科學校,二專(日間),184,8,7,1,15,10,5
,101,2,私立,技專校院,1285,慈惠醫護管理專科學校,二專(進修),340,7,3,4,36,18,18
,101,2,私立,技專校院,1285,慈惠醫護管理專科學校,五專,5617,93,35,58,209,72,137
,101,2,私立,技專校院,1286,耕莘健康管理專科學校,二專(日間),4,1,0,1,8,3,5
,101,2,私立,技專校院,1286,耕莘健康管理專科學校,二專(進修),164,3,0,3,14,2,12
,101,2,私立,技專校院,1286,耕莘健康管理專科學校,五專,4480,43,12,31,142,34,108
,101,2,私立,技專校院,1287,敏惠醫護管理專科學校,二專(日間),1,0,0,0,0,0,0
,101,2,私立,技專校院,1287,敏惠醫護管理專科學校,五專,3713,40,5,35,38,5,33
,101,2,私立,技專校院,1288,高美醫護管理專科學校,二專(進修),186,1,1,0,1,1,0
,101,2,私立,技專校院,1288,高美醫護管理專科學校,五專,772,7,1,6,7,1,6
,101,2,私立,技專校院,1289,育英醫護管理專科學校,五專,2030,35,3,32,38,6,32
,101,2,私立,技專校院,1290,崇仁醫護管理專科學校,二專(日間),29,0,0,0,2,1,1
,101,2,私立,技專校院,1290,崇仁醫護管理專科學校,二專(進修),43,0,0,0,2,0,2
,101,2,私立,技專校院,1290,崇仁醫護管理專科學校,五專,2950,28,2,26,43,6,37
,101,2,私立,技專校院,1291,聖母醫護管理專科學校,五專,3718,59,20,39,97,38,59
,101,2,私立,技專校院,1292,新生醫護管理專科學校,二專(日間),21,2,0,2,5,0,5
,101,2,私立,技專校院,1292,新生醫護管理專科學校,二專(進修),28,1,0,1,1,0,1
,101,2,私立,技專校院,1292,新生醫護管理專科學校,五專,5335,33,5,28,137,26,111
,102,1,公立,一般大學,1,國立政治大學,學士班(日間),9644,145,65,80,253,122,131
,102,1,公立,一般大學,1,國立政治大學,碩士班(日間),3708,302,124,178,777,341,436
,102,1,公立,一般大學,1,國立政治大學,碩士在職專班,1599,155,86,69,445,228,217
,102,1,公立,一般大學,1,國立政治大學,博士班,976,123,78,45,325,195,130
,102,1,公立,一般大學,2,國立清華大學,學士班(日間),6372,151,117,34,195,145,50
,102,1,公立,一般大學,2,國立清華大學,碩士班(日間),3873,166,74,92,257,118,139
,102,1,公立,一般大學,2,國立清華大學,碩士在職專班,295,22,11,11,48,29,19
,102,1,公立,一般大學,2,國立清華大學,博士班,1909,169,121,48,340,256,84
,102,1,公立,一般大學,3,國立臺灣大學,學士班(日間),16575,484,284,200,584,349,235
,102,1,公立,一般大學,3,國立臺灣大學,學士班(進修),13,5,3,2,8,6,2
,102,1,公立,一般大學,3,國立臺灣大學,碩士班(日間),9806,733,383,350,1069,590,479
,102,1,公立,一般大學,3,國立臺灣大學,碩士在職專班,1183,257,159,98,303,185,118
,102,1,公立,一般大學,3,國立臺灣大學,博士班,4591,629,398,231,1012,673,339
,102,1,公立,一般大學,4,國立臺灣師範大學,學士班(日間),7786,172,95,77,208,112,96
,102,1,公立,一般大學,4,國立臺灣師範大學,碩士班(日間),3941,701,237,464,850,306,544
,102,1,公立,一般大學,4,國立臺灣師範大學,碩士在職專班,1894,175,51,124,379,96,283
,102,1,公立,一般大學,4,國立臺灣師範大學,博士班,1372,287,124,163,381,169,212
,102,1,公立,一般大學,5,國立成功大學,學士班(日間),11501,265,167,98,345,216,129
,102,1,公立,一般大學,5,國立成功大學,碩士班(日間),6507,216,105,111,494,255,239
,102,1,公立,一般大學,5,國立成功大學,碩士在職專班,1270,81,52,29,199,125,74
,102,1,公立,一般大學,5,國立成功大學,博士班,2701,238,174,64,681,510,171
,102,1,公立,一般大學,6,國立中興大學,學士班(日間),8172,160,102,58,210,140,70
,102,1,公立,一般大學,6,國立中興大學,學士班(進修),1073,32,12,20,51,23,28
,102,1,公立,一般大學,6,國立中興大學,碩士班(日間),3339,229,136,93,419,241,178
,102,1,公立,一般大學,6,國立中興大學,碩士在職專班,1736,160,113,47,356,246,110
,102,1,公立,一般大學,6,國立中興大學,博士班,1277,120,86,34,316,228,88
,102,1,公立,一般大學,7,國立交通大學,學士班(日間),5453,145,108,37,170,125,45
,102,1,公立,一般大學,7,國立交通大學,碩士班(日間),5220,205,107,98,301,172,129
,102,1,公立,一般大學,7,國立交通大學,碩士在職專班,1696,294,234,60,434,340,94
,102,1,公立,一般大學,7,國立交通大學,博士班,2092,243,191,52,414,325,89
,102,1,公立,一般大學,8,國立中央大學,學士班(日間),6119,102,66,36,145,98,47
,102,1,公立,一般大學,8,國立中央大學,碩士班(日間),3298,155,83,72,253,140,113
,102,1,公立,一般大學,8,國立中央大學,碩士在職專班,1378,107,79,28,251,180,71
,102,1,公立,一般大學,8,國立中央大學,博士班,1262,139,113,26,290,230,60
,102,1,公立,一般大學,9,國立中山大學,學士班(日間),4577,84,62,22,121,87,34
,102,1,公立,一般大學,9,國立中山大學,碩士班(日間),2948,160,96,64,343,216,127
,102,1,公立,一般大學,9,國立中山大學,碩士在職專班,849,76,40,36,162,84,78
,102,1,公立,一般大學,9,國立中山大學,博士班,962,111,73,38,249,170,79
,102,1,公立,一般大學,12,國立臺灣海洋大學,學士班(日間),5230,60,43,17,80,60,20
,102,1,公立,一般大學,12,國立臺灣海洋大學,學士班(進修),572,17,11,6,42,23,19
,102,1,公立,一般大學,12,國立臺灣海洋大學,碩士班(日間),1542,82,61,21,145,106,39
,102,1,公立,一般大學,12,國立臺灣海洋大學,碩士在職專班,568,34,23,11,65,46,19
,102,1,公立,一般大學,12,國立臺灣海洋大學,博士班,328,37,30,7,69,54,15
,102,1,公立,一般大學,13,國立中正大學,學士班(日間),6618,111,81,30,154,108,46
,102,1,公立,一般大學,13,國立中正大學,碩士班(日間),2932,212,104,108,362,182,180
,102,1,公立,一般大學,13,國立中正大學,碩士在職專班,1772,196,97,99,308,164,144
,102,1,公立,一般大學,13,國立中正大學,博士班,667,82,48,34,165,105,60
,102,1,公立,一般大學,14,國立高雄師範大學,學士班(日間),3413,48,31,17,55,35,20
,102,1,公立,一般大學,14,國立高雄師範大學,碩士班(日間),1403,196,79,117,382,140,242
,102,1,公立,一般大學,14,國立高雄師範大學,碩士在職專班,1414,132,46,86,233,78,155
,102,1,公立,一般大學,14,國立高雄師範大學,博士班,471,40,19,21,98,37,61
,102,1,公立,一般大學,15,國立彰化師範大學,學士班(日間),4815,13,6,7,61,46,15
,102,1,公立,一般大學,15,國立彰化師範大學,碩士班(日間),1587,54,27,27,227,94,133
,102,1,公立,一般大學,15,國立彰化師範大學,碩士在職專班,1278,76,35,41,145,65,80
,102,1,公立,一般大學,15,國立彰化師範大學,博士班,441,12,7,5,67,36,31
,102,1,公立,一般大學,16,國立陽明大學,學士班(日間),2079,59,31,28,63,34,29
,102,1,公立,一般大學,16,國立陽明大學,碩士班(日間),1266,73,23,50,187,76,111
,102,1,公立,一般大學,16,國立陽明大學,碩士在職專班,124,29,4,25,34,6,28
,102,1,公立,一般大學,16,國立陽明大學,博士班,1044,83,46,37,228,128,100
,102,1,公立,一般大學,17,國立臺北大學,學士班(日間),5649,87,49,38,120,64,56
,102,1,公立,一般大學,17,國立臺北大學,學士班(進修),2064,132,70,62,259,137,122
,102,1,公立,一般大學,17,國立臺北大學,碩士班(日間),1349,159,82,77,273,145,128
,102,1,公立,一般大學,17,國立臺北大學,碩士在職專班,454,33,17,16,71,32,39
,102,1,公立,一般大學,17,國立臺北大學,博士班,188,27,20,7,42,30,12
,102,1,公立,一般大學,18,國立嘉義大學,學士班(日間),7828,98,59,39,206,140,66
,102,1,公立,一般大學,18,國立嘉義大學,學士班(進修),2143,69,47,22,258,154,104
,102,1,公立,一般大學,18,國立嘉義大學,碩士班(日間),1682,116,57,59,267,128,139
,102,1,公立,一般大學,18,國立嘉義大學,碩士在職專班,1033,88,38,50,211,87,124
,102,1,公立,一般大學,18,國立嘉義大學,博士班,200,22,11,11,51,30,21
,102,1,公立,一般大學,19,國立高雄大學,學士班(日間),4088,61,38,23,97,58,39
,102,1,公立,一般大學,19,國立高雄大學,學士班(進修),205,15,10,5,34,22,12
,102,1,公立,一般大學,19,國立高雄大學,碩士班(日間),678,48,32,16,108,66,42
,102,1,公立,一般大學,19,國立高雄大學,碩士在職專班,502,60,36,24,136,94,42
,102,1,公立,一般大學,19,國立高雄大學,博士班,15,3,2,1,4,3,1
,102,1,公立,一般大學,20,國立東華大學,學士班(日間),7095,107,63,44,222,148,74
,102,1,公立,一般大學,20,國立東華大學,學士班(進修),3,0,0,0,3,3,0
,102,1,公立,一般大學,20,國立東華大學,碩士班(日間),2112,196,88,108,562,256,306
,102,1,公立,一般大學,20,國立東華大學,碩士在職專班,608,62,36,26,170,84,86
,102,1,公立,一般大學,20,國立東華大學,博士班,368,40,24,16,130,82,48
,102,1,公立,一般大學,21,國立暨南國際大學,學士班(日間),4012,53,29,24,76,46,30
,102,1,公立,一般大學,21,國立暨南國際大學,學士班(進修),3,0,0,0,0,0,0
,102,1,公立,一般大學,21,國立暨南國際大學,碩士班(日間),1192,114,45,69,199,89,110
,102,1,公立,一般大學,21,國立暨南國際大學,碩士在職專班,380,30,19,11,46,26,20
,102,1,公立,一般大學,21,國立暨南國際大學,博士班,313,45,23,22,74,39,35
,102,1,公立,一般大學,28,國立臺北藝術大學,五專,85,0,0,0,0,0,0
,102,1,公立,一般大學,28,國立臺北藝術大學,學士班(日間),1587,46,18,28,74,32,42
,102,1,公立,一般大學,28,國立臺北藝術大學,碩士班(日間),928,205,69,136,328,118,210
,102,1,公立,一般大學,28,國立臺北藝術大學,碩士在職專班,126,32,11,21,49,17,32
,102,1,公立,一般大學,28,國立臺北藝術大學,博士班,56,8,3,5,16,5,11
,102,1,公立,一般大學,29,國立臺灣藝術大學,學士班(日間),2212,33,9,24,85,32,53
,102,1,公立,一般大學,29,國立臺灣藝術大學,學士班(進修),1904,63,12,51,143,39,104
,102,1,公立,一般大學,29,國立臺灣藝術大學,碩士班(日間),716,93,23,70,170,58,112
,102,1,公立,一般大學,29,國立臺灣藝術大學,碩士在職專班,382,35,8,27,75,20,55
,102,1,公立,一般大學,29,國立臺灣藝術大學,博士班,66,4,0,4,12,3,9
,102,1,公立,一般大學,30,國立臺東大學,學士班(日間),3517,89,52,37,222,126,96
,102,1,公立,一般大學,30,國立臺東大學,學士班(進修),195,42,36,6,61,41,20
,102,1,公立,一般大學,30,國立臺東大學,碩士班(日間),342,58,24,34,139,58,81
,102,1,公立,一般大學,30,國立臺東大學,碩士在職專班,750,46,20,26,89,39,50
,102,1,公立,一般大學,30,國立臺東大學,博士班,44,6,3,3,16,8,8
,102,1,公立,一般大學,31,國立宜蘭大學,學士班(日間),4229,65,45,20,115,81,34
,102,1,公立,一般大學,31,國立宜蘭大學,學士班(進修),593,22,16,6,97,85,12
,102,1,公立,一般大學,31,國立宜蘭大學,碩士班(日間),524,19,14,5,34,26,8
,102,1,公立,一般大學,31,國立宜蘭大學,碩士在職專班,176,11,10,1,22,19,3
,102,1,公立,一般大學,31,國立宜蘭大學,博士班,9,2,1,1,2,1,1
,102,1,公立,一般大學,32,國立聯合大學,學士班(日間),6168,115,90,25,202,168,34
,102,1,公立,一般大學,32,國立聯合大學,學士班(進修),1482,86,54,32,137,90,47
,102,1,公立,一般大學,32,國立聯合大學,碩士班(日間),482,14,14,0,25,22,3
,102,1,公立,一般大學,32,國立聯合大學,博士班,7,0,0,0,1,1,0
,102,1,公立,一般大學,35,國立臺南藝術大學,五專,156,6,4,2,11,5,6
,102,1,公立,一般大學,35,國立臺南藝術大學,學士班(日間),748,17,5,12,31,11,20
,102,1,公立,一般大學,35,國立臺南藝術大學,學士班(進修),18,2,1,1,4,2,2
,102,1,公立,一般大學,35,國立臺南藝術大學,碩士班(日間),553,79,24,55,181,62,119
,102,1,公立,一般大學,35,國立臺南藝術大學,碩士在職專班,49,11,2,9,22,4,18
,102,1,公立,一般大學,35,國立臺南藝術大學,博士班,46,8,2,6,15,7,8
,102,1,公立,一般大學,36,國立臺南大學,學士班(日間),3810,47,25,22,66,35,31
,102,1,公立,一般大學,36,國立臺南大學,學士班(進修),368,15,6,9,20,10,10
,102,1,公立,一般大學,36,國立臺南大學,碩士班(日間),1082,144,51,93,279,95,184
,102,1,公立,一般大學,36,國立臺南大學,碩士在職專班,758,57,17,40,125,38,87
,102,1,公立,一般大學,36,國立臺南大學,博士班,176,12,10,2,30,18,12
,102,1,公立,一般大學,37,國立臺北教育大學,學士班(日間),3224,69,31,38,97,45,52
,102,1,公立,一般大學,37,國立臺北教育大學,碩士班(日間),1092,223,63,160,348,108,240
,102,1,公立,一般大學,37,國立臺北教育大學,碩士在職專班,1182,103,29,74,169,50,119
,102,1,公立,一般大學,37,國立臺北教育大學,博士班,143,21,7,14,38,17,21
,102,1,公立,一般大學,38,國立新竹教育大學,學士班(日間),2513,33,9,24,60,19,41
,102,1,公立,一般大學,38,國立新竹教育大學,碩士班(日間),772,72,21,51,178,53,125
,102,1,公立,一般大學,38,國立新竹教育大學,碩士在職專班,573,39,10,29,54,12,42
,102,1,公立,一般大學,38,國立新竹教育大學,博士班,75,7,4,3,16,7,9
,102,1,公立,一般大學,39,國立臺中教育大學,學士班(日間),3349,53,21,32,81,35,46
,102,1,公立,一般大學,39,國立臺中教育大學,碩士班(日間),831,106,34,72,163,62,101
,102,1,公立,一般大學,39,國立臺中教育大學,碩士在職專班,711,48,13,35,82,21,61
,102,1,公立,一般大學,39,國立臺中教育大學,博士班,129,6,3,3,9,6,3
,102,1,公立,一般大學,40,國立屏東教育大學,學士班(日間),3255,44,25,19,56,33,23
,102,1,公立,一般大學,40,國立屏東教育大學,碩士班(日間),762,118,35,83,178,60,118
,102,1,公立,一般大學,40,國立屏東教育大學,碩士在職專班,570,47,12,35,57,13,44
,102,1,公立,一般大學,40,國立屏東教育大學,博士班,52,5,2,3,6,3,3
,102,1,公立,一般大學,44,國立體育大學,學士班(日間),1483,37,31,6,91,76,15
,102,1,公立,一般大學,44,國立體育大學,學士班(進修),96,9,6,3,24,19,5
,102,1,公立,一般大學,44,國立體育大學,碩士班(日間),350,74,45,29,116,67,49
,102,1,公立,一般大學,44,國立體育大學,碩士在職專班,208,26,12,14,44,24,20
,102,1,公立,一般大學,44,國立體育大學,博士班,124,15,12,3,23,18,5
,102,1,公立,一般大學,48,國立金門大學,學士班(日間),2892,58,35,23,108,63,45
,102,1,公立,一般大學,48,國立金門大學,學士班(進修),832,29,23,6,26,14,12
,102,1,公立,一般大學,48,國立金門大學,碩士班(日間),197,18,9,9,41,19,22
,102,1,公立,一般大學,48,國立金門大學,碩士在職專班,18,0,0,0,0,0,0
,102,1,公立,一般大學,49,國立臺灣體育運動大學,學士班(日間),2410,58,40,18,114,76,38
,102,1,公立,一般大學,49,國立臺灣體育運動大學,學士班(進修),398,23,14,9,27,17,10
,102,1,公立,一般大學,49,國立臺灣體育運動大學,碩士班(日間),272,46,27,19,104,50,54
,102,1,公立,一般大學,49,國立臺灣體育運動大學,碩士在職專班,96,1,1,0,2,2,0
,102,1,公立,一般大學,3002,臺北市立大學,學士班(日間),4834,102,67,35,206,133,73
,102,1,公立,一般大學,3002,臺北市立大學,碩士班(日間),1158,150,38,112,295,88,207
,102,1,公立,一般大學,3002,臺北市立大學,碩士在職專班,917,64,22,42,121,44,77
,102,1,公立,一般大學,3002,臺北市立大學,博士班,218,24,9,15,57,25,32
,102,1,公立,技專校院,22,國立臺灣科技大學,學士班(日間),5445,80,54,26,146,105,41
,102,1,公立,技專校院,22,國立臺灣科技大學,學士班(進修),41,6,2,4,13,3,10
,102,1,公立,技專校院,22,國立臺灣科技大學,碩士班(日間),3115,136,80,56,210,132,78
,102,1,公立,技專校院,22,國立臺灣科技大學,碩士在職專班,791,100,73,27,168,130,38
,102,1,公立,技專校院,22,國立臺灣科技大學,博士班,1025,161,119,42,272,211,61
,102,1,公立,技專校院,23,國立雲林科技大學,學士班(日間),6203,61,35,26,153,94,59
,102,1,公立,技專校院,23,國立雲林科技大學,碩士班(日間),1984,136,84,52,275,160,115
,102,1,公立,技專校院,23,國立雲林科技大學,碩士在職專班,741,66,44,22,150,100,50
,102,1,公立,技專校院,23,國立雲林科技大學,博士班,480,47,31,16,148,108,40
,102,1,公立,技專校院,24,國立屏東科技大學,學士班(日間),7636,101,58,43,157,93,64
,102,1,公立,技專校院,24,國立屏東科技大學,學士班(進修),1473,55,31,24,48,28,20
,102,1,公立,技專校院,24,國立屏東科技大學,碩士班(日間),1584,111,66,45,226,135,91
,102,1,公立,技專校院,24,國立屏東科技大學,碩士在職專班,636,66,46,20,47,28,19
,102,1,公立,技專校院,24,國立屏東科技大學,博士班,229,28,21,7,53,37,16
,102,1,公立,技專校院,25,國立臺北科技大學,學士班(日間),5876,161,119,42,252,182,70
,102,1,公立,技專校院,25,國立臺北科技大學,學士班(進修),1056,56,40,16,66,48,18
,102,1,公立,技專校院,25,國立臺北科技大學,碩士班(日間),2609,145,103,42,157,119,38
,102,1,公立,技專校院,25,國立臺北科技大學,碩士在職專班,1192,174,138,36,216,174,42
,102,1,公立,技專校院,25,國立臺北科技大學,博士班,713,110,82,28,142,107,35
,102,1,公立,技專校院,26,國立高雄第一科技大學,學士班(日間),5512,72,50,22,107,71,36
,102,1,公立,技專校院,26,國立高雄第一科技大學,碩士班(日間),1197,65,36,29,99,56,43
,102,1,公立,技專校院,26,國立高雄第一科技大學,碩士在職專班,787,69,53,16,118,88,30
,102,1,公立,技專校院,26,國立高雄第一科技大學,博士班,216,29,19,10,44,34,10
,102,1,公立,技專校院,27,國立高雄應用科技大學,學士班(日間),7515,88,64,24,146,109,37
,102,1,公立,技專校院,27,國立高雄應用科技大學,學士班(進修),1689,68,51,17,146,107,39
,102,1,公立,技專校院,27,國立高雄應用科技大學,碩士班(日間),1367,80,51,29,126,84,42
,102,1,公立,技專校院,27,國立高雄應用科技大學,碩士在職專班,1314,105,80,25,266,205,61
,102,1,公立,技專校院,27,國立高雄應用科技大學,博士班,261,21,17,4,41,37,4
,102,1,公立,技專校院,33,國立虎尾科技大學,學士班(日間),7775,135,97,38,286,226,60
,102,1,公立,技專校院,33,國立虎尾科技大學,學士班(進修),1257,30,22,8,49,40,9
,102,1,公立,技專校院,33,國立虎尾科技大學,碩士班(日間),1027,45,34,11,125,106,19
,102,1,公立,技專校院,33,國立虎尾科技大學,碩士在職專班,390,33,21,12,33,21,12
,102,1,公立,技專校院,33,國立虎尾科技大學,博士班,29,3,3,0,4,4,0
,102,1,公立,技專校院,34,國立高雄海洋科技大學,五專,483,9,8,1,13,12,1
,102,1,公立,技專校院,34,國立高雄海洋科技大學,學士班(日間),4938,85,52,33,188,133,55
,102,1,公立,技專校院,34,國立高雄海洋科技大學,學士班(進修),1798,118,84,34,116,79,37
,102,1,公立,技專校院,34,國立高雄海洋科技大學,碩士班(日間),360,23,17,6,39,32,7
,102,1,公立,技專校院,34,國立高雄海洋科技大學,碩士在職專班,189,34,23,11,30,21,9
,102,1,公立,技專校院,42,國立澎湖科技大學,二專(進修),33,5,4,1,7,5,2
,102,1,公立,技專校院,42,國立澎湖科技大學,學士班(日間),2512,42,25,17,66,42,24
,102,1,公立,技專校院,42,國立澎湖科技大學,學士班(進修),308,15,11,4,17,13,4
,102,1,公立,技專校院,42,國立澎湖科技大學,碩士班(日間),111,9,6,3,15,11,4
,102,1,公立,技專校院,42,國立澎湖科技大學,碩士在職專班,44,8,4,4,9,4,5
,102,1,公立,技專校院,43,國立勤益科技大學,二專(日間),194,4,4,0,7,6,1
,102,1,公立,技專校院,43,國立勤益科技大學,二專(進修),18,7,7,0,7,7,0
,102,1,公立,技專校院,43,國立勤益科技大學,學士班(日間),6590,98,67,31,267,191,76
,102,1,公立,技專校院,43,國立勤益科技大學,學士班(進修),3366,151,121,30,207,162,45
,102,1,公立,技專校院,43,國立勤益科技大學,碩士班(日間),643,48,39,9,62,50,12
,102,1,公立,技專校院,43,國立勤益科技大學,碩士在職專班,224,36,32,4,41,36,5
,102,1,公立,技專校院,43,國立勤益科技大學,博士班,7,0,0,0,0,0,0
,102,1,公立,技專校院,46,國立臺北護理健康大學,學士班(日間),2814,32,9,23,84,24,60
,102,1,公立,技專校院,46,國立臺北護理健康大學,學士班(進修),666,34,0,34,98,0,98
,102,1,公立,技專校院,46,國立臺北護理健康大學,碩士班(日間),625,73,10,63,202,27,175
,102,1,公立,技專校院,46,國立臺北護理健康大學,碩士在職專班,181,20,1,19,43,2,41
,102,1,公立,技專校院,46,國立臺北護理健康大學,博士班,63,9,1,8,15,1,14
,102,1,公立,技專校院,47,國立高雄餐旅大學,二專(進修),305,0,0,0,0,0,0
,102,1,公立,技專校院,47,國立高雄餐旅大學,五專,215,3,3,0,7,6,1
,102,1,公立,技專校院,47,國立高雄餐旅大學,學士班(日間),3268,49,13,36,104,35,69
,102,1,公立,技專校院,47,國立高雄餐旅大學,學士班(進修),1187,20,8,12,48,23,25
,102,1,公立,技專校院,47,國立高雄餐旅大學,碩士班(日間),209,14,9,5,41,21,20
,102,1,公立,技專校院,47,國立高雄餐旅大學,碩士在職專班,78,10,5,5,7,4,3
,102,1,公立,技專校院,47,國立高雄餐旅大學,博士班,12,0,0,0,0,0,0
,102,1,公立,技專校院,50,國立臺中科技大學,二專(日間),254,12,1,11,21,2,19
,102,1,公立,技專校院,50,國立臺中科技大學,二專(進修),214,15,0,15,18,0,18
,102,1,公立,技專校院,50,國立臺中科技大學,五專,3799,52,16,36,81,24,57
,102,1,公立,技專校院,50,國立臺中科技大學,學士班(日間),6015,73,26,47,148,54,94
,102,1,公立,技專校院,50,國立臺中科技大學,學士班(進修),2777,148,55,93,184,66,118
,102,1,公立,技專校院,50,國立臺中科技大學,碩士班(日間),382,25,17,8,36,20,16
,102,1,公立,技專校院,50,國立臺中科技大學,碩士在職專班,121,5,4,1,9,6,3
,102,1,公立,技專校院,136,國立屏東商業技術學院,學士班(日間),3090,32,15,17,96,39,57
,102,1,公立,技專校院,136,國立屏東商業技術學院,學士班(進修),718,34,14,20,80,37,43
,102,1,公立,技專校院,136,國立屏東商業技術學院,碩士班(日間),225,28,15,13,64,36,28
,102,1,公立,技專校院,136,國立屏東商業技術學院,碩士在職專班,21,4,2,2,6,4,2
,102,1,公立,技專校院,142,國立臺北商業技術學院,二專(進修),592,12,3,9,39,12,27
,102,1,公立,技專校院,142,國立臺北商業技術學院,五專,2021,13,4,9,54,20,34
,102,1,公立,技專校院,142,國立臺北商業技術學院,學士班(日間),2440,12,6,6,39,18,21
,102,1,公立,技專校院,142,國立臺北商業技術學院,學士班(進修),1616,54,20,34,104,45,59
,102,1,公立,技專校院,142,國立臺北商業技術學院,碩士班(日間),158,2,0,2,9,3,6
,102,1,公立,技專校院,142,國立臺北商業技術學院,碩士在職專班,29,3,3,0,7,6,1
,102,1,公立,技專校院,144,國立臺灣戲曲學院,學士班(日間),490,20,8,12,40,18,22
,102,1,公立,技專校院,144,國立臺灣戲曲學院,學士班(進修),27,2,1,1,2,1,1
,102,1,公立,技專校院,221,國立臺南護理專科學校,二專(日間),96,0,0,0,1,0,1
,102,1,公立,技專校院,221,國立臺南護理專科學校,二專(進修),93,11,1,10,21,2,19
,102,1,公立,技專校院,221,國立臺南護理專科學校,五專,1719,17,1,16,30,1,29
,102,1,公立,技專校院,222,國立臺東專科學校,二專(日間),413,28,18,10,48,31,17
,102,1,公立,技專校院,222,國立臺東專科學校,二專(進修),175,26,19,7,0,0,0
,102,1,公立,技專校院,222,國立臺東專科學校,五專,561,23,14,9,62,33,29
,102,1,私立,一般大學,1001,東海大學,學士班(日間),13605,275,163,112,559,344,215
,102,1,私立,一般大學,1001,東海大學,學士班(進修),750,68,38,30,195,128,67
,102,1,私立,一般大學,1001,東海大學,碩士班(日間),1707,113,41,72,367,189,178
,102,1,私立,一般大學,1001,東海大學,碩士在職專班,802,62,26,36,168,83,85
,102,1,私立,一般大學,1001,東海大學,博士班,230,31,18,13,73,47,26
,102,1,私立,一般大學,1002,輔仁大學,學士班(日間),17818,393,203,190,673,363,310
,102,1,私立,一般大學,1002,輔仁大學,學士班(進修),4669,200,88,112,422,179,243
,102,1,私立,一般大學,1002,輔仁大學,碩士班(日間),2185,290,120,170,666,297,369
,102,1,私立,一般大學,1002,輔仁大學,碩士在職專班,1568,123,64,59,396,187,209
,102,1,私立,一般大學,1002,輔仁大學,博士班,421,61,28,33,176,85,91
,102,1,私立,一般大學,1003,東吳大學,學士班(日間),11861,271,139,132,354,190,164
,102,1,私立,一般大學,1003,東吳大學,學士班(進修),1268,110,41,69,174,64,110
,102,1,私立,一般大學,1003,東吳大學,碩士班(日間),1200,198,101,97,269,138,131
,102,1,私立,一般大學,1003,東吳大學,碩士在職專班,1198,138,41,97,244,86,158
,102,1,私立,一般大學,1003,東吳大學,博士班,93,13,4,9,15,4,11
,102,1,私立,一般大學,1004,中原大學,學士班(日間),12715,220,153,67,450,331,119
,102,1,私立,一般大學,1004,中原大學,學士班(進修),2,0,0,0,2,2,0
,102,1,私立,一般大學,1004,中原大學,碩士班(日間),1907,118,71,47,344,209,135
,102,1,私立,一般大學,1004,中原大學,碩士在職專班,1167,92,61,31,274,183,91
,102,1,私立,一般大學,1004,中原大學,博士班,376,25,17,8,95,76,19
,102,1,私立,一般大學,1005,淡江大學,學士班(日間),20868,460,285,175,879,556,323
,102,1,私立,一般大學,1005,淡江大學,學士班(進修),2582,132,57,75,326,177,149
,102,1,私立,一般大學,1005,淡江大學,碩士班(日間),2252,148,82,66,405,225,180
,102,1,私立,一般大學,1005,淡江大學,碩士在職專班,1269,80,39,41,250,127,123
,102,1,私立,一般大學,1005,淡江大學,博士班,513,58,32,26,142,100,42
,102,1,私立,一般大學,1006,中國文化大學,學士班(日間),20641,458,264,194,715,404,311
,102,1,私立,一般大學,1006,中國文化大學,學士班(進修),2676,237,111,126,591,289,302
,102,1,私立,一般大學,1006,中國文化大學,碩士班(日間),1856,159,78,81,372,210,162
,102,1,私立,一般大學,1006,中國文化大學,碩士在職專班,636,56,24,32,144,57,87
,102,1,私立,一般大學,1006,中國文化大學,博士班,528,37,25,12,79,49,30
,102,1,私立,一般大學,1007,逢甲大學,學士班(日間),16670,311,248,63,383,306,77
,102,1,私立,一般大學,1007,逢甲大學,學士班(進修),905,84,54,30,108,70,38
,102,1,私立,一般大學,1007,逢甲大學,碩士班(日間),1740,126,86,40,167,114,53
,102,1,私立,一般大學,1007,逢甲大學,碩士在職專班,1130,135,82,53,179,113,66
,102,1,私立,一般大學,1007,逢甲大學,博士班,403,62,47,15,84,66,18
,102,1,私立,一般大學,1008,靜宜大學,學士班(日間),11011,243,125,118,400,222,178
,102,1,私立,一般大學,1008,靜宜大學,學士班(進修),103,7,6,1,12,9,3
,102,1,私立,一般大學,1008,靜宜大學,碩士班(日間),694,68,28,40,131,56,75
,102,1,私立,一般大學,1008,靜宜大學,碩士在職專班,328,13,5,8,29,11,18
,102,1,私立,一般大學,1008,靜宜大學,博士班,37,5,2,3,6,2,4
,102,1,私立,一般大學,1009,長庚大學,學士班(日間),5086,103,59,44,116,61,55
,102,1,私立,一般大學,1009,長庚大學,碩士班(日間),1385,70,26,44,181,72,109
,102,1,私立,一般大學,1009,長庚大學,碩士在職專班,380,36,17,19,105,63,42
,102,1,私立,一般大學,1009,長庚大學,博士班,546,33,18,15,81,50,31
,102,1,私立,一般大學,1010,元智大學,學士班(日間),7107,82,62,20,132,89,43
,102,1,私立,一般大學,1010,元智大學,學士班(進修),1,0,0,0,0,0,0
,102,1,私立,一般大學,1010,元智大學,碩士班(日間),1197,41,23,18,113,71,42
,102,1,私立,一般大學,1010,元智大學,碩士在職專班,1027,54,30,24,154,100,54
,102,1,私立,一般大學,1010,元智大學,博士班,333,22,15,7,63,43,20
,102,1,私立,一般大學,1011,中華大學,學士班(日間),7092,168,121,47,320,243,77
,102,1,私立,一般大學,1011,中華大學,學士班(進修),394,14,10,4,36,27,9
,102,1,私立,一般大學,1011,中華大學,碩士班(日間),691,39,31,8,117,92,25
,102,1,私立,一般大學,1011,中華大學,碩士在職專班,284,28,18,10,65,53,12
,102,1,私立,一般大學,1011,中華大學,博士班,135,13,10,3,36,26,10
,102,1,私立,一般大學,1012,大葉大學,學士班(日間),7924,184,122,62,339,238,101
,102,1,私立,一般大學,1012,大葉大學,學士班(進修),988,50,38,12,89,67,22
,102,1,私立,一般大學,1012,大葉大學,碩士班(日間),843,40,14,26,98,60,38
,102,1,私立,一般大學,1012,大葉大學,碩士在職專班,861,29,11,18,68,34,34
,102,1,私立,一般大學,1012,大葉大學,博士班,160,21,11,10,40,27,13
,102,1,私立,一般大學,1013,華梵大學,學士班(日間),2830,98,59,39,209,137,72
,102,1,私立,一般大學,1013,華梵大學,碩士班(日間),341,14,7,7,99,70,29
,102,1,私立,一般大學,1013,華梵大學,碩士在職專班,416,23,15,8,97,71,26
,102,1,私立,一般大學,1013,華梵大學,博士班,48,4,1,3,19,4,15
,102,1,私立,一般大學,1014,義守大學,學士班(日間),12515,99,75,24,146,112,34
,102,1,私立,一般大學,1014,義守大學,學士班(進修),2533,102,72,30,236,166,70
,102,1,私立,一般大學,1014,義守大學,碩士班(日間),625,18,13,5,31,25,6
,102,1,私立,一般大學,1014,義守大學,碩士在職專班,625,15,12,3,38,28,10
,102,1,私立,一般大學,1014,義守大學,博士班,135,10,6,4,22,14,8
,102,1,私立,一般大學,1015,世新大學,學士班(日間),9678,165,78,87,279,136,143
,102,1,私立,一般大學,1015,世新大學,學士班(進修),198,3,0,3,18,8,10
,102,1,私立,一般大學,1015,世新大學,碩士班(日間),794,83,44,39,169,85,84
,102,1,私立,一般大學,1015,世新大學,碩士在職專班,1043,96,46,50,280,129,151
,102,1,私立,一般大學,1015,世新大學,博士班,73,6,3,3,15,7,8
,102,1,私立,一般大學,1016,銘傳大學,學士班(日間),17254,361,156,205,600,292,308
,102,1,私立,一般大學,1016,銘傳大學,學士班(進修),13,1,0,1,1,0,1
,102,1,私立,一般大學,1016,銘傳大學,碩士班(日間),845,75,50,25,117,70,47
,102,1,私立,一般大學,1016,銘傳大學,碩士在職專班,898,57,19,38,113,42,71
,102,1,私立,一般大學,1016,銘傳大學,博士班,62,6,4,2,17,8,9
,102,1,私立,一般大學,1017,實踐大學,學士班(日間),12342,250,122,128,366,179,187
,102,1,私立,一般大學,1017,實踐大學,學士班(進修),2765,149,48,101,225,70,155
,102,1,私立,一般大學,1017,實踐大學,碩士班(日間),411,39,19,20,67,32,35
,102,1,私立,一般大學,1017,實踐大學,碩士在職專班,201,14,9,5,27,17,10
,102,1,私立,一般大學,1017,實踐大學,博士班,4,2,0,2,2,0,2
,102,1,私立,一般大學,1019,高雄醫學大學,學士班(日間),5629,140,71,69,186,88,98
,102,1,私立,一般大學,1019,高雄醫學大學,學士班(進修),166,5,2,3,12,2,10
,102,1,私立,一般大學,1019,高雄醫學大學,碩士班(日間),641,68,22,46,139,49,90
,102,1,私立,一般大學,1019,高雄醫學大學,碩士在職專班,232,19,2,17,42,8,34
,102,1,私立,一般大學,1019,高雄醫學大學,博士班,341,45,22,23,96,54,42
,102,1,私立,一般大學,1020,南華大學,學士班(日間),3663,130,86,44,282,193,89
,102,1,私立,一般大學,1020,南華大學,學士班(進修),112,13,8,5,19,14,5
,102,1,私立,一般大學,1020,南華大學,碩士班(日間),769,102,48,54,201,100,101
,102,1,私立,一般大學,1020,南華大學,碩士在職專班,546,55,24,31,102,57,45
,102,1,私立,一般大學,1020,南華大學,博士班,27,1,1,0,5,3,2
,102,1,私立,一般大學,1021,真理大學,學士班(日間),7970,235,152,83,363,243,120
,102,1,私立,一般大學,1021,真理大學,學士班(進修),853,48,28,20,80,45,35
,102,1,私立,一般大學,1021,真理大學,碩士班(日間),163,11,7,4,23,11,12
,102,1,私立,一般大學,1021,真理大學,碩士在職專班,7,1,0,1,2,1,1
,102,1,私立,一般大學,1022,大同大學,學士班(日間),3692,56,45,11,258,207,51
,102,1,私立,一般大學,1022,大同大學,碩士班(日間),568,22,17,5,101,78,23
,102,1,私立,一般大學,1022,大同大學,碩士在職專班,502,40,33,7,274,220,54
,102,1,私立,一般大學,1022,大同大學,博士班,157,0,0,0,68,58,10
,102,1,私立,一般大學,1027,慈濟大學,學士班(日間),2868,44,20,24,65,32,33
,102,1,私立,一般大學,1027,慈濟大學,碩士班(日間),344,40,13,27,85,29,56
,102,1,私立,一般大學,1027,慈濟大學,碩士在職專班,33,7,3,4,10,5,5
,102,1,私立,一般大學,1027,慈濟大學,博士班,107,11,7,4,29,16,13
,102,1,私立,一般大學,1028,臺北醫學大學,學士班(日間),4571,107,53,54,145,68,77
,102,1,私立,一般大學,1028,臺北醫學大學,學士班(進修),234,4,0,4,12,0,12
,102,1,私立,一般大學,1028,臺北醫學大學,碩士班(日間),676,35,15,20,75,31,44
,102,1,私立,一般大學,1028,臺北醫學大學,碩士在職專班,240,17,3,14,40,5,35
,102,1,私立,一般大學,1028,臺北醫學大學,博士班,381,24,10,14,59,26,33
,102,1,私立,一般大學,1029,中山醫學大學,學士班(日間),6387,127,54,73,168,76,92
,102,1,私立,一般大學,1029,中山醫學大學,學士班(進修),356,10,5,5,14,6,8
,102,1,私立,一般大學,1029,中山醫學大學,碩士班(日間),511,31,12,19,56,27,29
,102,1,私立,一般大學,1029,中山醫學大學,碩士在職專班,103,7,3,4,10,3,7
,102,1,私立,一般大學,1029,中山醫學大學,博士班,236,19,10,9,35,21,14
,102,1,私立,一般大學,1033,長榮大學,學士班(日間),8763,212,130,82,277,183,94
,102,1,私立,一般大學,1033,長榮大學,學士班(進修),528,23,16,7,27,18,9
,102,1,私立,一般大學,1033,長榮大學,碩士班(日間),534,64,27,37,82,38,44
,102,1,私立,一般大學,1033,長榮大學,碩士在職專班,207,17,8,9,25,12,13
,102,1,私立,一般大學,1033,長榮大學,博士班,33,10,6,4,14,9,5
,102,1,私立,一般大學,1035,中國醫藥大學,學士班(日間),6366,180,91,89,181,91,90
,102,1,私立,一般大學,1035,中國醫藥大學,學士班(進修),103,12,0,12,22,0,22
,102,1,私立,一般大學,1035,中國醫藥大學,碩士班(日間),520,56,29,27,62,33,29
,102,1,私立,一般大學,1035,中國醫藥大學,碩士在職專班,71,0,0,0,1,1,0
,102,1,私立,一般大學,1035,中國醫藥大學,博士班,330,53,32,21,58,36,22
,102,1,私立,一般大學,1039,玄奘大學,學士班(日間),3839,133,67,66,342,173,169
,102,1,私立,一般大學,1039,玄奘大學,學士班(進修),1422,108,54,54,412,219,193
,102,1,私立,一般大學,1039,玄奘大學,碩士班(日間),405,44,18,26,156,82,74
,102,1,私立,一般大學,1039,玄奘大學,碩士在職專班,298,13,6,7,54,19,35
,102,1,私立,一般大學,1039,玄奘大學,博士班,23,0,0,0,0,0,0
,102,1,私立,一般大學,1048,亞洲大學,學士班(日間),9394,248,153,95,567,345,222
,102,1,私立,一般大學,1048,亞洲大學,學士班(進修),1418,95,63,32,256,158,98
,102,1,私立,一般大學,1048,亞洲大學,碩士班(日間),670,74,35,39,176,91,85
,102,1,私立,一般大學,1048,亞洲大學,碩士在職專班,468,28,11,17,64,27,37
,102,1,私立,一般大學,1048,亞洲大學,博士班,149,15,4,11,38,14,24
,102,1,私立,一般大學,1049,開南大學,學士班(日間),7978,185,115,70,449,293,156
,102,1,私立,一般大學,1049,開南大學,學士班(進修),1297,72,48,24,177,118,59
,102,1,私立,一般大學,1049,開南大學,碩士班(日間),319,26,14,12,73,37,36
,102,1,私立,一般大學,1049,開南大學,碩士在職專班,386,11,6,5,30,16,14
,102,1,私立,一般大學,1050,佛光大學,學士班(日間),2577,61,31,30,100,58,42
,102,1,私立,一般大學,1050,佛光大學,碩士班(日間),712,61,29,32,185,84,101
,102,1,私立,一般大學,1050,佛光大學,碩士在職專班,262,18,11,7,37,22,15
,102,1,私立,一般大學,1050,佛光大學,博士班,40,3,2,1,4,2,2
,102,1,私立,一般大學,1058,明道大學,學士班(日間),3468,79,56,23,122,81,41
,102,1,私立,一般大學,1058,明道大學,學士班(進修),2008,51,39,12,168,109,59
,102,1,私立,一般大學,1058,明道大學,碩士班(日間),218,30,19,11,54,35,19
,102,1,私立,一般大學,1058,明道大學,碩士在職專班,50,4,2,2,8,6,2
,102,1,私立,一般大學,1058,明道大學,博士班,3,0,0,0,0,0,0
,102,1,私立,一般大學,1059,康寧大學,學士班(日間),1123,90,64,26,236,179,57
,102,1,私立,一般大學,1059,康寧大學,學士班(進修),483,90,44,46,135,75,60
,102,1,私立,一般大學,1059,康寧大學,碩士班(日間),195,13,6,7,49,28,21
,102,1,私立,一般大學,1059,康寧大學,碩士在職專班,145,8,4,4,19,10,9
,102,1,私立,一般大學,1067,台灣首府大學,學士班(日間),3609,99,64,35,170,100,70
,102,1,私立,一般大學,1067,台灣首府大學,學士班(進修),1175,38,27,11,77,50,27
,102,1,私立,一般大學,1067,台灣首府大學,碩士班(日間),78,5,4,1,7,6,1
,102,1,私立,一般大學,1125,興國管理學院,學士班(日間),287,6,2,4,7,2,5
,102,1,私立,一般大學,1125,興國管理學院,學士班(進修),1282,11,7,4,8,8,0
,102,1,私立,一般大學,1176,稻江科技暨管理學院,學士班(日間),1729,48,28,20,116,75,41
,102,1,私立,一般大學,1176,稻江科技暨管理學院,學士班(進修),957,24,12,12,74,45,29
,102,1,私立,一般大學,1176,稻江科技暨管理學院,碩士班(日間),53,0,0,0,7,4,3
,102,1,私立,一般大學,1176,稻江科技暨管理學院,碩士在職專班,31,0,0,0,0,0,0
,102,1,私立,一般大學,1195,馬偕醫學院,學士班(日間),419,7,4,3,9,4,5
,102,1,私立,一般大學,1195,馬偕醫學院,碩士班(日間),9,2,0,2,2,0,2
,102,1,私立,一般大學,1R01,法鼓佛教學院,學士班(日間),49,0,0,0,0,0,0
,102,1,私立,一般大學,1R01,法鼓佛教學院,碩士班(日間),69,4,2,2,9,3,6
,102,1,私立,一般大學,1R01,法鼓佛教學院,博士班,6,0,0,0,0,0,0
,102,1,私立,一般大學,1R02,基督教台灣浸會神學院,碩士班(日間),53,0,0,0,1,0,1
,102,1,私立,一般大學,1R03,臺北基督學院,學士班(日間),71,3,1,2,10,6,4
,102,1,私立,技專校院,1018,朝陽科技大學,學士班(日間),11395,195,116,79,363,220,143
,102,1,私立,技專校院,1018,朝陽科技大學,學士班(進修),3674,182,95,87,395,200,195
,102,1,私立,技專校院,1018,朝陽科技大學,碩士班(日間),891,78,40,38,157,87,70
,102,1,私立,技專校院,1018,朝陽科技大學,碩士在職專班,537,32,19,13,94,54,40
,102,1,私立,技專校院,1018,朝陽科技大學,博士班,75,10,6,4,18,14,4
,102,1,私立,技專校院,1023,南臺科技大學,學士班(日間),13209,196,123,73,377,239,138
,102,1,私立,技專校院,1023,南臺科技大學,學士班(進修),4628,197,123,74,531,342,189
,102,1,私立,技專校院,1023,南臺科技大學,碩士班(日間),1085,70,53,17,211,143,68
,102,1,私立,技專校院,1023,南臺科技大學,碩士在職專班,501,39,23,16,94,50,44
,102,1,私立,技專校院,1023,南臺科技大學,博士班,50,4,4,0,6,6,0
,102,1,私立,技專校院,1024,崑山科技大學,學士班(日間),8522,231,126,105,541,352,189
,102,1,私立,技專校院,1024,崑山科技大學,學士班(進修),3513,244,162,82,761,488,273
,102,1,私立,技專校院,1024,崑山科技大學,碩士班(日間),539,44,28,16,112,87,25
,102,1,私立,技專校院,1024,崑山科技大學,碩士在職專班,197,16,14,2,38,31,7
,102,1,私立,技專校院,1024,崑山科技大學,博士班,26,4,4,0,6,6,0
,102,1,私立,技專校院,1025,嘉南藥理大學,學士班(日間),12937,193,87,106,548,273,275
,102,1,私立,技專校院,1025,嘉南藥理大學,學士班(進修),3522,202,125,77,622,365,257
,102,1,私立,技專校院,1025,嘉南藥理大學,碩士班(日間),327,29,18,11,101,68,33
,102,1,私立,技專校院,1025,嘉南藥理大學,碩士在職專班,201,19,13,6,42,21,21
,102,1,私立,技專校院,1026,樹德科技大學,二專(日間),0,1,1,0,1,1,0
,102,1,私立,技專校院,1026,樹德科技大學,學士班(日間),8235,290,169,121,287,168,119
,102,1,私立,技專校院,1026,樹德科技大學,學士班(進修),2224,161,107,54,161,107,54
,102,1,私立,技專校院,1026,樹德科技大學,碩士班(日間),439,57,35,22,57,35,22
,102,1,私立,技專校院,1026,樹德科技大學,碩士在職專班,540,24,11,13,24,11,13
,102,1,私立,技專校院,1026,樹德科技大學,博士班,15,7,2,5,7,2,5
,102,1,私立,技專校院,1030,龍華科技大學,二專(日間),58,0,0,0,0,0,0
,102,1,私立,技專校院,1030,龍華科技大學,學士班(日間),6567,132,92,40,305,231,74
,102,1,私立,技專校院,1030,龍華科技大學,學士班(進修),4010,164,104,60,311,211,100
,102,1,私立,技專校院,1030,龍華科技大學,碩士班(日間),290,5,4,1,36,29,7
,102,1,私立,技專校院,1030,龍華科技大學,碩士在職專班,102,3,0,3,6,3,3
,102,1,私立,技專校院,1031,輔英科技大學,二專(進修),12,0,0,0,1,1,0
,102,1,私立,技專校院,1031,輔英科技大學,五專,3175,39,5,34,84,14,70
,102,1,私立,技專校院,1031,輔英科技大學,學士班(日間),5432,195,100,95,333,195,138
,102,1,私立,技專校院,1031,輔英科技大學,學士班(進修),1216,67,41,26,199,111,88
,102,1,私立,技專校院,1031,輔英科技大學,碩士班(日間),112,11,2,9,41,10,31
,102,1,私立,技專校院,1031,輔英科技大學,碩士在職專班,40,5,0,5,12,1,11
,102,1,私立,技專校院,1032,明新科技大學,二專(日間),20,0,0,0,0,0,0
,102,1,私立,技專校院,1032,明新科技大學,二專(進修),153,1,0,1,0,0,0
,102,1,私立,技專校院,1032,明新科技大學,學士班(日間),8785,188,113,75,902,535,367
,102,1,私立,技專校院,1032,明新科技大學,學士班(進修),3850,201,128,73,412,287,125
,102,1,私立,技專校院,1032,明新科技大學,碩士班(日間),387,28,19,9,149,107,42
,102,1,私立,技專校院,1032,明新科技大學,碩士在職專班,231,11,9,2,26,22,4
,102,1,私立,技專校院,1034,弘光科技大學,五專,321,4,0,4,8,1,7
,102,1,私立,技專校院,1034,弘光科技大學,學士班(日間),7813,131,53,78,338,141,197
,102,1,私立,技專校院,1034,弘光科技大學,學士班(進修),4367,181,62,119,507,203,304
,102,1,私立,技專校院,1034,弘光科技大學,碩士班(日間),224,25,9,16,64,30,34
,102,1,私立,技專校院,1034,弘光科技大學,碩士在職專班,97,20,6,14,34,10,24
,102,1,私立,技專校院,1036,健行科技大學,二專(日間),155,9,9,0,9,9,0
,102,1,私立,技專校院,1036,健行科技大學,學士班(日間),8412,157,114,43,421,323,98
,102,1,私立,技專校院,1036,健行科技大學,學士班(進修),3743,156,112,44,231,173,58
,102,1,私立,技專校院,1036,健行科技大學,碩士班(日間),320,22,20,2,48,44,4
,102,1,私立,技專校院,1036,健行科技大學,碩士在職專班,132,5,5,0,14,13,1
,102,1,私立,技專校院,1037,正修科技大學,二專(日間),56,7,5,2,6,4,2
,102,1,私立,技專校院,1037,正修科技大學,二專(進修),7,4,3,1,9,8,1
,102,1,私立,技專校院,1037,正修科技大學,五專,2,0,0,0,0,0,0
,102,1,私立,技專校院,1037,正修科技大學,學士班(日間),9648,250,175,75,387,251,136
,102,1,私立,技專校院,1037,正修科技大學,學士班(進修),6861,430,280,150,864,577,287
,102,1,私立,技專校院,1037,正修科技大學,碩士班(日間),332,18,16,2,32,27,5
,102,1,私立,技專校院,1037,正修科技大學,碩士在職專班,96,14,10,4,32,23,9
,102,1,私立,技專校院,1037,正修科技大學,博士班,11,0,0,0,0,0,0
,102,1,私立,技專校院,1038,萬能科技大學,二專(日間),15,0,0,0,0,0,0
,102,1,私立,技專校院,1038,萬能科技大學,學士班(日間),5999,54,36,18,409,287,122
,102,1,私立,技專校院,1038,萬能科技大學,學士班(進修),4541,69,43,26,319,205,114
,102,1,私立,技專校院,1038,萬能科技大學,碩士班(日間),125,7,5,2,42,32,10
,102,1,私立,技專校院,1038,萬能科技大學,碩士在職專班,139,2,1,1,9,7,2
,102,1,私立,技專校院,1040,建國科技大學,二專(日間),76,0,0,0,0,0,0
,102,1,私立,技專校院,1040,建國科技大學,二專(進修),35,2,2,0,8,7,1
,102,1,私立,技專校院,1040,建國科技大學,學士班(日間),7382,139,87,52,270,190,80
,102,1,私立,技專校院,1040,建國科技大學,學士班(進修),1837,78,50,28,141,97,44
,102,1,私立,技專校院,1040,建國科技大學,碩士班(日間),218,6,3,3,18,14,4
,102,1,私立,技專校院,1041,明志科技大學,二專(進修),21,1,0,1,2,0,2
,102,1,私立,技專校院,1041,明志科技大學,五專,38,1,0,1,1,0,1
,102,1,私立,技專校院,1041,明志科技大學,學士班(日間),3356,30,26,4,52,43,9
,102,1,私立,技專校院,1041,明志科技大學,學士班(進修),432,16,11,5,35,24,11
,102,1,私立,技專校院,1041,明志科技大學,碩士班(日間),437,16,14,2,21,18,3
,102,1,私立,技專校院,1041,明志科技大學,碩士在職專班,52,8,8,0,11,11,0
,102,1,私立,技專校院,1042,高苑科技大學,二專(日間),42,1,1,0,1,1,0
,102,1,私立,技專校院,1042,高苑科技大學,五專,5,0,0,0,1,1,0
,102,1,私立,技專校院,1042,高苑科技大學,學士班(日間),5701,123,88,35,141,105,36
,102,1,私立,技專校院,1042,高苑科技大學,學士班(進修),1302,44,31,13,94,78,16
,102,1,私立,技專校院,1042,高苑科技大學,碩士班(日間),141,5,4,1,5,4,1
,102,1,私立,技專校院,1042,高苑科技大學,碩士在職專班,277,4,3,1,10,6,4
,102,1,私立,技專校院,1043,大仁科技大學,二專(進修),1,0,0,0,0,0,0
,102,1,私立,技專校院,1043,大仁科技大學,五專,141,10,4,6,29,13,16
,102,1,私立,技專校院,1043,大仁科技大學,學士班(日間),5918,217,132,85,510,316,194
,102,1,私立,技專校院,1043,大仁科技大學,學士班(進修),1888,122,76,46,335,179,156
,102,1,私立,技專校院,1043,大仁科技大學,碩士班(日間),84,9,9,0,33,24,9
,102,1,私立,技專校院,1043,大仁科技大學,碩士在職專班,136,6,2,4,33,18,15
,102,1,私立,技專校院,1044,聖約翰科技大學,學士班(日間),5592,159,107,52,399,296,103
,102,1,私立,技專校院,1044,聖約翰科技大學,學士班(進修),624,49,40,9,132,101,31
,102,1,私立,技專校院,1044,聖約翰科技大學,碩士班(日間),215,15,13,2,38,31,7
,102,1,私立,技專校院,1044,聖約翰科技大學,碩士在職專班,108,6,5,1,15,12,3
,102,1,私立,技專校院,1045,嶺東科技大學,二專(日間),23,0,0,0,0,0,0
,102,1,私立,技專校院,1045,嶺東科技大學,學士班(日間),7520,78,45,33,161,92,69
,102,1,私立,技專校院,1045,嶺東科技大學,學士班(進修),2694,164,95,69,305,177,128
,102,1,私立,技專校院,1045,嶺東科技大學,碩士班(日間),229,14,6,8,30,15,15
,102,1,私立,技專校院,1045,嶺東科技大學,碩士在職專班,117,9,7,2,15,8,7
,102,1,私立,技專校院,1046,中國科技大學,五專,1,1,1,0,2,1,1
,102,1,私立,技專校院,1046,中國科技大學,學士班(日間),8755,232,112,120,402,212,190
,102,1,私立,技專校院,1046,中國科技大學,學士班(進修),2965,205,134,71,392,235,157
,102,1,私立,技專校院,1046,中國科技大學,碩士班(日間),137,9,4,5,24,15,9
,102,1,私立,技專校院,1046,中國科技大學,碩士在職專班,17,0,0,0,1,0,1
,102,1,私立,技專校院,1047,中臺科技大學,五專,12,1,0,1,3,1,2
,102,1,私立,技專校院,1047,中臺科技大學,學士班(日間),6325,154,85,69,421,211,210
,102,1,私立,技專校院,1047,中臺科技大學,學士班(進修),3108,179,69,110,670,290,380
,102,1,私立,技專校院,1047,中臺科技大學,碩士班(日間),197,19,8,11,48,25,23
,102,1,私立,技專校院,1047,中臺科技大學,碩士在職專班,293,11,2,9,71,22,49
,102,1,私立,技專校院,1047,中臺科技大學,博士班,17,1,1,0,2,2,0
,102,1,私立,技專校院,1051,台南應用科技大學,二專(進修),8,1,0,1,1,0,1
,102,1,私立,技專校院,1051,台南應用科技大學,五專,1222,20,6,14,49,12,37
,102,1,私立,技專校院,1051,台南應用科技大學,學士班(日間),8615,162,65,97,453,161,292
,102,1,私立,技專校院,1051,台南應用科技大學,學士班(進修),2866,159,65,94,322,136,186
,102,1,私立,技專校院,1051,台南應用科技大學,碩士班(日間),155,24,4,20,52,11,41
,102,1,私立,技專校院,1051,台南應用科技大學,碩士在職專班,163,20,4,16,36,10,26
,102,1,私立,技專校院,1052,遠東科技大學,二專(進修),52,3,3,0,13,12,1
,102,1,私立,技專校院,1052,遠東科技大學,五專,0,0,0,0,3,2,1
,102,1,私立,技專校院,1052,遠東科技大學,學士班(日間),8267,180,134,46,509,366,143
,102,1,私立,技專校院,1052,遠東科技大學,學士班(進修),687,19,17,2,89,79,10
,102,1,私立,技專校院,1052,遠東科技大學,碩士班(日間),184,12,8,4,32,25,7
,102,1,私立,技專校院,1052,遠東科技大學,碩士在職專班,41,2,2,0,5,5,0
,102,1,私立,技專校院,1053,元培醫事科技大學,學士班(日間),5871,126,81,45,244,160,84
,102,1,私立,技專校院,1053,元培醫事科技大學,學士班(進修),1416,56,35,21,101,65,36
,102,1,私立,技專校院,1053,元培醫事科技大學,碩士班(日間),200,17,10,7,22,15,7
,102,1,私立,技專校院,1053,元培醫事科技大學,碩士在職專班,22,0,0,0,0,0,0
,102,1,私立,技專校院,1054,景文科技大學,二專(進修),6,0,0,0,4,4,0
,102,1,私立,技專校院,1054,景文科技大學,學士班(日間),5902,86,41,45,164,84,80
,102,1,私立,技專校院,1054,景文科技大學,學士班(進修),2457,134,76,58,247,145,102
,102,1,私立,技專校院,1054,景文科技大學,碩士班(日間),50,6,1,5,9,2,7
,102,1,私立,技專校院,1054,景文科技大學,碩士在職專班,106,12,6,6,18,12,6
,102,1,私立,技專校院,1055,中華醫事科技大學,二專(日間),79,4,3,1,9,5,4
,102,1,私立,技專校院,1055,中華醫事科技大學,五專,1961,20,12,8,49,18,31
,102,1,私立,技專校院,1055,中華醫事科技大學,學士班(日間),5080,63,31,32,210,119,91
,102,1,私立,技專校院,1055,中華醫事科技大學,學士班(進修),2013,107,50,57,330,149,181
,102,1,私立,技專校院,1055,中華醫事科技大學,碩士班(日間),64,4,2,2,10,8,2
,102,1,私立,技專校院,1056,東南科技大學,二專(日間),55,7,5,2,11,8,3
,102,1,私立,技專校院,1056,東南科技大學,二專(進修),1,0,0,0,1,1,0
,102,1,私立,技專校院,1056,東南科技大學,學士班(日間),6719,278,211,67,747,589,158
,102,1,私立,技專校院,1056,東南科技大學,學士班(進修),527,42,28,14,174,137,37
,102,1,私立,技專校院,1056,東南科技大學,碩士班(日間),120,12,11,1,20,19,1
,102,1,私立,技專校院,1056,東南科技大學,碩士在職專班,68,4,3,1,20,18,2
,102,1,私立,技專校院,1057,德明財經科技大學,二專(日間),1,3,1,2,8,4,4
,102,1,私立,技專校院,1057,德明財經科技大學,二專(進修),0,0,0,0,6,4,2
,102,1,私立,技專校院,1057,德明財經科技大學,學士班(日間),6818,137,63,74,265,133,132
,102,1,私立,技專校院,1057,德明財經科技大學,學士班(進修),2043,90,47,43,290,137,153
,102,1,私立,技專校院,1057,德明財經科技大學,碩士班(日間),71,5,4,1,26,20,6
,102,1,私立,技專校院,1057,德明財經科技大學,碩士在職專班,54,2,1,1,7,4,3
,102,1,私立,技專校院,1060,南開科技大學,二專(日間),11,0,0,0,0,0,0
,102,1,私立,技專校院,1060,南開科技大學,五專,1265,53,44,9,81,69,12
,102,1,私立,技專校院,1060,南開科技大學,學士班(日間),3706,105,80,25,187,145,42
,102,1,私立,技專校院,1060,南開科技大學,學士班(進修),1237,67,44,23,111,71,40
,102,1,私立,技專校院,1060,南開科技大學,碩士班(日間),113,5,5,0,11,11,0
,102,1,私立,技專校院,1060,南開科技大學,碩士在職專班,160,3,0,3,9,1,8
,102,1,私立,技專校院,1061,中華科技大學,二專(進修),55,2,1,1,18,7,11
,102,1,私立,技專校院,1061,中華科技大學,學士班(日間),6856,191,138,53,706,475,231
,102,1,私立,技專校院,1061,中華科技大學,學士班(進修),1476,132,99,33,509,362,147
,102,1,私立,技專校院,1061,中華科技大學,碩士班(日間),288,14,9,5,96,76,20
,102,1,私立,技專校院,1061,中華科技大學,碩士在職專班,120,20,18,2,55,47,8
,102,1,私立,技專校院,1062,僑光科技大學,二專(日間),167,2,2,0,5,5,0
,102,1,私立,技專校院,1062,僑光科技大學,二專(進修),60,1,1,0,1,1,0
,102,1,私立,技專校院,1062,僑光科技大學,五專,784,35,13,22,50,22,28
,102,1,私立,技專校院,1062,僑光科技大學,學士班(日間),5829,78,39,39,154,82,72
,102,1,私立,技專校院,1062,僑光科技大學,學士班(進修),3682,148,85,63,286,167,119
,102,1,私立,技專校院,1062,僑光科技大學,碩士班(日間),90,2,2,0,5,5,0
,102,1,私立,技專校院,1062,僑光科技大學,碩士在職專班,61,1,1,0,6,1,5
,102,1,私立,技專校院,1063,育達科技大學,學士班(日間),4491,200,117,83,561,340,221
,102,1,私立,技專校院,1063,育達科技大學,學士班(進修),2072,216,148,68,555,374,181
,102,1,私立,技專校院,1063,育達科技大學,碩士班(日間),109,5,3,2,11,6,5
,102,1,私立,技專校院,1063,育達科技大學,碩士在職專班,106,8,7,1,11,9,2
,102,1,私立,技專校院,1064,美和科技大學,五專,1899,47,12,35,88,22,66
,102,1,私立,技專校院,1064,美和科技大學,學士班(日間),3766,113,66,47,311,170,141
,102,1,私立,技專校院,1064,美和科技大學,學士班(進修),1984,90,42,48,310,141,169
,102,1,私立,技專校院,1064,美和科技大學,碩士班(日間),88,6,2,4,12,6,6
,102,1,私立,技專校院,1064,美和科技大學,碩士在職專班,74,8,4,4,15,7,8
,102,1,私立,技專校院,1065,吳鳳科技大學,二專(日間),45,6,5,1,10,7,3
,102,1,私立,技專校院,1065,吳鳳科技大學,二專(進修),81,12,11,1,41,30,11
,102,1,私立,技專校院,1065,吳鳳科技大學,五專,0,0,0,0,2,2,0
,102,1,私立,技專校院,1065,吳鳳科技大學,學士班(日間),4243,118,76,42,279,201,78
,102,1,私立,技專校院,1065,吳鳳科技大學,學士班(進修),1123,82,65,17,237,185,52
,102,1,私立,技專校院,1065,吳鳳科技大學,碩士班(日間),45,2,2,0,6,6,0
,102,1,私立,技專校院,1065,吳鳳科技大學,碩士在職專班,79,3,2,1,8,5,3
,102,1,私立,技專校院,1066,環球科技大學,二專(日間),104,11,4,7,38,22,16
,102,1,私立,技專校院,1066,環球科技大學,二專(進修),506,25,16,9,24,15,9
,102,1,私立,技專校院,1066,環球科技大學,學士班(日間),4077,145,89,56,363,203,160
,102,1,私立,技專校院,1066,環球科技大學,學士班(進修),1435,19,12,7,25,16,9
,102,1,私立,技專校院,1066,環球科技大學,碩士班(日間),112,5,4,1,19,11,8
,102,1,私立,技專校院,1066,環球科技大學,碩士在職專班,31,0,0,0,0,0,0
,102,1,私立,技專校院,1068,中州科技大學,二專(日間),22,1,1,0,1,1,0
,102,1,私立,技專校院,1068,中州科技大學,學士班(日間),3577,94,63,31,189,131,58
,102,1,私立,技專校院,1068,中州科技大學,學士班(進修),1831,66,45,21,107,76,31
,102,1,私立,技專校院,1068,中州科技大學,碩士班(日間),80,0,0,0,4,4,0
,102,1,私立,技專校院,1068,中州科技大學,碩士在職專班,34,2,2,0,3,2,1
,102,1,私立,技專校院,1069,修平科技大學,二專(日間),15,0,0,0,0,0,0
,102,1,私立,技專校院,1069,修平科技大學,二專(進修),53,10,9,1,48,42,6
,102,1,私立,技專校院,1069,修平科技大學,學士班(日間),5491,159,106,53,451,314,137
,102,1,私立,技專校院,1069,修平科技大學,學士班(進修),1035,82,67,15,276,222,54
,102,1,私立,技專校院,1069,修平科技大學,碩士班(日間),64,5,4,1,16,15,1
,102,1,私立,技專校院,1070,長庚科技大學,五專,1984,21,0,21,25,1,24
,102,1,私立,技專校院,1070,長庚科技大學,學士班(日間),3654,41,4,37,59,5,54
,102,1,私立,技專校院,1070,長庚科技大學,學士班(進修),2012,110,5,105,151,5,146
,102,1,私立,技專校院,1070,長庚科技大學,碩士班(日間),10,0,0,0,0,0,0
,102,1,私立,技專校院,1070,長庚科技大學,碩士在職專班,37,4,0,4,6,0,6
,102,1,私立,技專校院,1071,臺北城市科技大學,二專(日間),187,18,14,4,33,26,7
,102,1,私立,技專校院,1071,臺北城市科技大學,二專(進修),146,21,15,6,54,42,12
,102,1,私立,技專校院,1071,臺北城市科技大學,五專,1664,50,37,13,115,89,26
,102,1,私立,技專校院,1071,臺北城市科技大學,學士班(日間),6810,213,154,59,548,395,153
,102,1,私立,技專校院,1071,臺北城市科技大學,學士班(進修),1046,103,73,30,235,176,59
,102,1,私立,技專校院,1071,臺北城市科技大學,碩士班(日間),95,8,5,3,19,14,5
,102,1,私立,技專校院,1071,臺北城市科技大學,碩士在職專班,0,2,2,0,2,2,0
,102,1,私立,技專校院,1072,大華科技大學,二專(日間),1,0,0,0,0,0,0
,102,1,私立,技專校院,1072,大華科技大學,二專(進修),63,0,0,0,0,0,0
,102,1,私立,技專校院,1072,大華科技大學,五專,1468,58,37,21,104,61,43
,102,1,私立,技專校院,1072,大華科技大學,學士班(日間),1868,83,63,20,144,110,34
,102,1,私立,技專校院,1072,大華科技大學,學士班(進修),1283,39,27,12,95,70,25
,102,1,私立,技專校院,1072,大華科技大學,碩士班(日間),29,5,5,0,7,7,0
,102,1,私立,技專校院,1072,大華科技大學,碩士在職專班,14,0,0,0,0,0,0
,102,1,私立,技專校院,1073,醒吾科技大學,二專(日間),54,0,0,0,0,0,0
,102,1,私立,技專校院,1073,醒吾科技大學,二專(進修),2,0,0,0,0,0,0
,102,1,私立,技專校院,1073,醒吾科技大學,五專,1412,39,16,23,76,21,55
,102,1,私立,技專校院,1073,醒吾科技大學,學士班(日間),5545,131,70,61,316,151,165
,102,1,私立,技專校院,1073,醒吾科技大學,學士班(進修),1437,82,53,29,304,197,107
,102,1,私立,技專校院,1073,醒吾科技大學,碩士班(日間),70,8,5,3,13,7,6
,102,1,私立,技專校院,1073,醒吾科技大學,碩士在職專班,28,0,0,0,3,1,2
,102,1,私立,技專校院,1074,南榮科技大學,二專(進修),252,5,4,1,10,8,2
,102,1,私立,技專校院,1074,南榮科技大學,五專,329,2,2,0,4,3,1
,102,1,私立,技專校院,1074,南榮科技大學,學士班(日間),1456,32,22,10,54,39,15
,102,1,私立,技專校院,1074,南榮科技大學,學士班(進修),950,27,23,4,45,35,10
,102,1,私立,技專校院,1074,南榮科技大學,碩士班(日間),24,1,1,0,1,1,0
,102,1,私立,技專校院,1074,南榮科技大學,碩士在職專班,19,0,0,0,4,3,1
,102,1,私立,技專校院,1075,文藻外語大學,五專,1734,32,6,26,40,10,30
,102,1,私立,技專校院,1075,文藻外語大學,學士班(日間),5335,111,39,72,261,93,168
,102,1,私立,技專校院,1075,文藻外語大學,學士班(進修),1915,195,69,126,348,134,214
,102,1,私立,技專校院,1075,文藻外語大學,碩士班(日間),90,13,3,10,19,4,15
,102,1,私立,技專校院,1075,文藻外語大學,碩士在職專班,62,3,1,2,20,5,15
,102,1,私立,技專校院,1148,大漢技術學院,二專(進修),201,2,1,1,4,3,1
,102,1,私立,技專校院,1148,大漢技術學院,學士班(日間),1068,40,32,8,60,48,12
,102,1,私立,技專校院,1148,大漢技術學院,學士班(進修),909,18,12,6,72,52,20
,102,1,私立,技專校院,1148,大漢技術學院,碩士班(日間),55,2,1,1,2,1,1
,102,1,私立,技專校院,1150,慈濟技術學院,五專,1154,15,0,15,22,1,21
,102,1,私立,技專校院,1150,慈濟技術學院,學士班(日間),1286,32,15,17,58,27,31
,102,1,私立,技專校院,1150,慈濟技術學院,學士班(進修),94,7,0,7,20,0,20
,102,1,私立,技專校院,1150,慈濟技術學院,碩士班(日間),15,1,1,0,5,4,1
,102,1,私立,技專校院,1154,永達技術學院,二專(日間),12,0,0,0,0,0,0
,102,1,私立,技專校院,1154,永達技術學院,二專(進修),79,1,1,0,1,1,0
,102,1,私立,技專校院,1154,永達技術學院,五專,129,13,12,1,45,43,2
,102,1,私立,技專校院,1154,永達技術學院,學士班(日間),258,17,14,3,140,116,24
,102,1,私立,技專校院,1154,永達技術學院,學士班(進修),365,24,21,3,69,61,8
,102,1,私立,技專校院,1154,永達技術學院,碩士班(日間),20,1,1,0,3,3,0
,102,1,私立,技專校院,1159,和春技術學院,二專(進修),181,8,6,2,41,33,8
,102,1,私立,技專校院,1159,和春技術學院,五專,387,25,15,10,32,18,14
,102,1,私立,技專校院,1159,和春技術學院,學士班(日間),1603,80,46,34,181,121,60
,102,1,私立,技專校院,1159,和春技術學院,學士班(進修),790,43,36,7,141,118,23
,102,1,私立,技專校院,1159,和春技術學院,碩士班(日間),10,1,1,0,2,2,0
,102,1,私立,技專校院,1164,致理技術學院,二專(日間),321,18,14,4,34,29,5
,102,1,私立,技專校院,1164,致理技術學院,二專(進修),0,0,0,0,1,0,1
,102,1,私立,技專校院,1164,致理技術學院,五專,1498,23,5,18,52,17,35
,102,1,私立,技專校院,1164,致理技術學院,學士班(日間),6238,119,53,66,250,113,137
,102,1,私立,技專校院,1164,致理技術學院,學士班(進修),3269,172,61,111,285,113,172
,102,1,私立,技專校院,1164,致理技術學院,碩士班(日間),20,3,0,3,8,1,7
,102,1,私立,技專校院,1164,致理技術學院,碩士在職專班,29,0,0,0,4,2,2
,102,1,私立,技專校院,1166,亞東技術學院,二專(日間),23,0,0,0,0,0,0
,102,1,私立,技專校院,1166,亞東技術學院,學士班(日間),4886,90,64,26,236,179,57
,102,1,私立,技專校院,1166,亞東技術學院,學士班(進修),566,28,17,11,114,72,42
,102,1,私立,技專校院,1166,亞東技術學院,碩士班(日間),82,6,6,0,18,16,2
,102,1,私立,技專校院,1166,亞東技術學院,碩士在職專班,0,2,0,2,4,1,3
,102,1,私立,技專校院,1168,桃園創新技術學院,二專(日間),350,0,0,0,0,0,0
,102,1,私立,技專校院,1168,桃園創新技術學院,學士班(日間),4855,149,83,66,369,249,120
,102,1,私立,技專校院,1168,桃園創新技術學院,學士班(進修),1447,121,77,44,414,285,129
,102,1,私立,技專校院,1168,桃園創新技術學院,碩士班(日間),29,1,1,0,3,3,0
,102,1,私立,技專校院,1179,德霖技術學院,二專(日間),214,0,0,0,0,0,0
,102,1,私立,技專校院,1179,德霖技術學院,二專(進修),477,23,12,11,47,29,18
,102,1,私立,技專校院,1179,德霖技術學院,五專,1902,85,63,22,153,123,30
,102,1,私立,技專校院,1179,德霖技術學院,學士班(日間),3481,145,96,49,330,222,108
,102,1,私立,技專校院,1179,德霖技術學院,學士班(進修),2147,106,85,21,211,156,55
,102,1,私立,技專校院,1182,蘭陽技術學院,二專(日間),42,0,0,0,2,1,1
,102,1,私立,技專校院,1182,蘭陽技術學院,二專(進修),38,1,0,1,2,1,1
,102,1,私立,技專校院,1182,蘭陽技術學院,五專,1025,42,29,13,86,61,25
,102,1,私立,技專校院,1182,蘭陽技術學院,學士班(日間),1604,44,33,11,101,79,22
,102,1,私立,技專校院,1182,蘭陽技術學院,學士班(進修),53,1,1,0,1,1,0
,102,1,私立,技專校院,1183,黎明技術學院,二專(進修),133,6,0,6,42,16,26
,102,1,私立,技專校院,1183,黎明技術學院,五專,947,19,17,2,70,64,6
,102,1,私立,技專校院,1183,黎明技術學院,學士班(日間),2586,94,65,29,238,155,83
,102,1,私立,技專校院,1183,黎明技術學院,學士班(進修),1005,72,60,12,251,218,33
,102,1,私立,技專校院,1184,東方設計學院,二專(日間),22,7,7,0,19,13,6
,102,1,私立,技專校院,1184,東方設計學院,五專,1451,70,45,25,142,71,71
,102,1,私立,技專校院,1184,東方設計學院,學士班(日間),2201,154,100,54,285,186,99
,102,1,私立,技專校院,1184,東方設計學院,學士班(進修),171,22,13,9,83,69,14
,102,1,私立,技專校院,1184,東方設計學院,碩士班(日間),33,1,1,0,15,11,4
,102,1,私立,技專校院,1184,東方設計學院,碩士在職專班,43,11,4,7,37,16,21
,102,1,私立,技專校院,1185,經國管理暨健康學院,五專,1557,65,23,42,115,39,76
,102,1,私立,技專校院,1185,經國管理暨健康學院,學士班(日間),1844,59,27,32,194,90,104
,102,1,私立,技專校院,1185,經國管理暨健康學院,學士班(進修),619,41,18,23,72,31,41
,102,1,私立,技專校院,1185,經國管理暨健康學院,碩士班(日間),23,3,1,2,5,2,3
,102,1,私立,技專校院,1185,經國管理暨健康學院,碩士在職專班,41,2,0,2,2,0,2
,102,1,私立,技專校院,1187,崇右技術學院,二專(進修),0,0,0,0,1,1,0
,102,1,私立,技專校院,1187,崇右技術學院,五專,1089,60,26,34,91,41,50
,102,1,私立,技專校院,1187,崇右技術學院,學士班(日間),2435,113,59,54,176,88,88
,102,1,私立,技專校院,1187,崇右技術學院,學士班(進修),1,0,0,0,1,1,0
,102,1,私立,技專校院,1187,崇右技術學院,碩士班(日間),14,1,0,1,1,0,1
,102,1,私立,技專校院,1188,大同技術學院,二專(日間),1,0,0,0,19,15,4
,102,1,私立,技專校院,1188,大同技術學院,二專(進修),70,8,5,3,63,36,27
,102,1,私立,技專校院,1188,大同技術學院,五專,229,18,11,7,60,40,20
,102,1,私立,技專校院,1188,大同技術學院,學士班(日間),1977,87,52,35,405,232,173
,102,1,私立,技專校院,1188,大同技術學院,學士班(進修),939,38,18,20,370,190,180
,102,1,私立,技專校院,1189,亞太創意技術學院,二專(日間),0,0,0,0,9,7,2
,102,1,私立,技專校院,1189,亞太創意技術學院,二專(進修),186,3,0,3,3,0,3
,102,1,私立,技專校院,1189,亞太創意技術學院,學士班(日間),1757,36,19,17,163,101,62
,102,1,私立,技專校院,1189,亞太創意技術學院,學士班(進修),149,1,0,1,4,0,4
,102,1,私立,技專校院,1189,亞太創意技術學院,碩士班(日間),47,1,0,1,1,0,1
,102,1,私立,技專校院,1190,高鳳數位內容學院,五專,95,0,0,0,0,0,0
,102,1,私立,技專校院,1190,高鳳數位內容學院,學士班(日間),351,0,0,0,0,0,0
,102,1,私立,技專校院,1190,高鳳數位內容學院,學士班(進修),166,0,0,0,0,0,0
,102,1,私立,技專校院,1191,華夏技術學院,二專(日間),0,0,0,0,31,27,4
,102,1,私立,技專校院,1191,華夏技術學院,二專(進修),446,32,14,18,264,188,76
,102,1,私立,技專校院,1191,華夏技術學院,五專,477,9,9,0,223,196,27
,102,1,私立,技專校院,1191,華夏技術學院,學士班(日間),3171,101,59,42,454,272,182
,102,1,私立,技專校院,1191,華夏技術學院,學士班(進修),1256,80,55,25,526,369,157
,102,1,私立,技專校院,1191,華夏技術學院,碩士班(日間),8,0,0,0,0,0,0
,102,1,私立,技專校院,1191,華夏技術學院,碩士在職專班,56,2,2,0,5,5,0
,102,1,私立,技專校院,1192,臺灣觀光學院,二專(日間),18,8,6,2,32,23,9
,102,1,私立,技專校院,1192,臺灣觀光學院,二專(進修),139,1,0,1,1,0,1
,102,1,私立,技專校院,1192,臺灣觀光學院,五專,172,14,5,9,30,14,16
,102,1,私立,技專校院,1192,臺灣觀光學院,學士班(日間),1397,61,42,19,124,79,45
,102,1,私立,技專校院,1192,臺灣觀光學院,學士班(進修),236,1,1,0,1,1,0
,102,1,私立,技專校院,1192,臺灣觀光學院,碩士班(日間),9,4,2,2,4,2,2
,102,1,私立,技專校院,1197,台北海洋技術學院,二專(日間),387,48,33,15,109,89,20
,102,1,私立,技專校院,1197,台北海洋技術學院,二專(進修),167,19,16,3,32,26,6
,102,1,私立,技專校院,1197,台北海洋技術學院,五專,1377,34,20,14,107,75,32
,102,1,私立,技專校院,1197,台北海洋技術學院,學士班(日間),4053,102,71,31,367,273,94
,102,1,私立,技專校院,1197,台北海洋技術學院,學士班(進修),389,30,24,6,75,58,17
,102,1,私立,技專校院,1281,康寧醫護暨管理專科學校,二專(日間),128,5,2,3,11,4,7
,102,1,私立,技專校院,1281,康寧醫護暨管理專科學校,二專(進修),276,12,3,9,25,7,18
,102,1,私立,技專校院,1281,康寧醫護暨管理專科學校,五專,2820,62,26,36,94,35,59
,102,1,私立,技專校院,1282,馬偕醫護管理專科學校,二專(日間),132,3,0,3,16,1,15
,102,1,私立,技專校院,1282,馬偕醫護管理專科學校,二專(進修),216,10,3,7,37,7,30
,102,1,私立,技專校院,1282,馬偕醫護管理專科學校,五專,3455,36,8,28,67,12,55
,102,1,私立,技專校院,1283,仁德醫護管理專科學校,二專(日間),1,0,0,0,0,0,0
,102,1,私立,技專校院,1283,仁德醫護管理專科學校,二專(進修),634,4,1,3,3,2,1
,102,1,私立,技專校院,1283,仁德醫護管理專科學校,五專,5879,100,26,74,126,38,88
,102,1,私立,技專校院,1284,樹人醫護管理專科學校,二專(進修),399,28,20,8,46,33,13
,102,1,私立,技專校院,1284,樹人醫護管理專科學校,五專,6285,130,50,80,198,75,123
,102,1,私立,技專校院,1285,慈惠醫護管理專科學校,二專(日間),197,12,9,3,22,17,5
,102,1,私立,技專校院,1285,慈惠醫護管理專科學校,二專(進修),310,12,3,9,39,16,23
,102,1,私立,技專校院,1285,慈惠醫護管理專科學校,五專,5972,121,33,88,236,70,166
,102,1,私立,技專校院,1286,耕莘健康管理專科學校,二專(日間),0,0,0,0,4,0,4
,102,1,私立,技專校院,1286,耕莘健康管理專科學校,二專(進修),97,2,0,2,6,1,5
,102,1,私立,技專校院,1286,耕莘健康管理專科學校,五專,4705,100,20,80,142,30,112
,102,1,私立,技專校院,1287,敏惠醫護管理專科學校,五專,3852,61,13,48,74,18,56
,102,1,私立,技專校院,1288,高美醫護管理專科學校,二專(進修),166,0,0,0,0,0,0
,102,1,私立,技專校院,1288,高美醫護管理專科學校,五專,768,17,2,15,13,1,12
,102,1,私立,技專校院,1289,育英醫護管理專科學校,五專,2045,37,1,36,90,5,85
,102,1,私立,技專校院,1290,崇仁醫護管理專科學校,二專(日間),13,6,1,5,13,1,12
,102,1,私立,技專校院,1290,崇仁醫護管理專科學校,二專(進修),41,1,0,1,2,0,2
,102,1,私立,技專校院,1290,崇仁醫護管理專科學校,五專,3143,17,6,11,28,8,20
,102,1,私立,技專校院,1291,聖母醫護管理專科學校,五專,3797,102,40,62,125,49,76
,102,1,私立,技專校院,1292,新生醫護管理專科學校,二專(日間),0,1,0,1,6,0,6
,102,1,私立,技專校院,1292,新生醫護管理專科學校,二專(進修),57,0,0,0,1,0,1
,102,1,私立,技專校院,1292,新生醫護管理專科學校,五專,5732,91,13,78,173,23,150
,102,2,公立,一般大學,1,國立政治大學,學士班(日間),9644,82,45,37,264,135,129
,102,2,公立,一般大學,1,國立政治大學,碩士班(日間),3708,241,112,129,802,353,449
,102,2,公立,一般大學,1,國立政治大學,碩士在職專班,1599,123,66,57,434,225,209
,102,2,公立,一般大學,1,國立政治大學,博士班,976,116,70,46,347,214,133
,102,2,公立,一般大學,2,國立清華大學,學士班(日間),6372,86,72,14,207,160,47
,102,2,公立,一般大學,2,國立清華大學,碩士班(日間),3873,109,45,64,268,121,147
,102,2,公立,一般大學,2,國立清華大學,碩士在職專班,295,22,13,9,45,25,20
,102,2,公立,一般大學,2,國立清華大學,博士班,1909,165,125,40,342,262,80
,102,2,公立,一般大學,3,國立臺灣大學,學士班(日間),16575,463,319,144,633,399,234
,102,2,公立,一般大學,3,國立臺灣大學,學士班(進修),13,2,0,2,3,2,1
,102,2,公立,一般大學,3,國立臺灣大學,碩士班(日間),9806,542,297,245,1099,603,496
,102,2,公立,一般大學,3,國立臺灣大學,碩士在職專班,1183,141,84,57,217,130,87
,102,2,公立,一般大學,3,國立臺灣大學,博士班,4591,573,400,173,1033,718,315
,102,2,公立,一般大學,4,國立臺灣師範大學,學士班(日間),7786,84,48,36,237,133,104
,102,2,公立,一般大學,4,國立臺灣師範大學,碩士班(日間),3941,363,113,250,789,277,512
,102,2,公立,一般大學,4,國立臺灣師範大學,碩士在職專班,1894,255,66,189,396,106,290
,102,2,公立,一般大學,4,國立臺灣師範大學,博士班,1372,218,99,119,383,170,213
,102,2,公立,一般大學,5,國立成功大學,學士班(日間),11501,85,58,27,360,226,134
,102,2,公立,一般大學,5,國立成功大學,碩士班(日間),6507,143,81,62,499,269,230
,102,2,公立,一般大學,5,國立成功大學,碩士在職專班,1270,67,45,22,200,120,80
,102,2,公立,一般大學,5,國立成功大學,博士班,2701,184,128,56,663,487,176
,102,2,公立,一般大學,6,國立中興大學,學士班(日間),8172,89,69,20,231,156,75
,102,2,公立,一般大學,6,國立中興大學,學士班(進修),1073,19,10,9,51,26,25
,102,2,公立,一般大學,6,國立中興大學,碩士班(日間),3339,76,42,34,399,234,165
,102,2,公立,一般大學,6,國立中興大學,碩士在職專班,1736,97,61,36,373,250,123
,102,2,公立,一般大學,6,國立中興大學,博士班,1277,80,67,13,320,239,81
,102,2,公立,一般大學,7,國立交通大學,學士班(日間),5453,58,52,6,173,128,45
,102,2,公立,一般大學,7,國立交通大學,碩士班(日間),5220,149,87,62,313,180,133
,102,2,公立,一般大學,7,國立交通大學,碩士在職專班,1696,234,189,45,419,330,89
,102,2,公立,一般大學,7,國立交通大學,博士班,2092,192,154,38,411,322,89
,102,2,公立,一般大學,8,國立中央大學,學士班(日間),6119,49,38,11,147,99,48
,102,2,公立,一般大學,8,國立中央大學,碩士班(日間),3298,95,49,46,270,152,118
,102,2,公立,一般大學,8,國立中央大學,碩士在職專班,1378,98,69,29,258,179,79
,102,2,公立,一般大學,8,國立中央大學,博士班,1262,100,81,19,289,235,54
,102,2,公立,一般大學,9,國立中山大學,學士班(日間),4577,29,20,9,111,81,30
,102,2,公立,一般大學,9,國立中山大學,碩士班(日間),2948,111,66,45,338,209,129
,102,2,公立,一般大學,9,國立中山大學,碩士在職專班,849,50,29,21,159,87,72
,102,2,公立,一般大學,9,國立中山大學,博士班,962,95,65,30,248,173,75
,102,2,公立,一般大學,12,國立臺灣海洋大學,學士班(日間),5230,35,31,4,59,46,13
,102,2,公立,一般大學,12,國立臺灣海洋大學,學士班(進修),572,17,11,6,40,26,14
,102,2,公立,一般大學,12,國立臺灣海洋大學,碩士班(日間),1542,21,15,6,97,71,26
,102,2,公立,一般大學,12,國立臺灣海洋大學,碩士在職專班,568,26,14,12,67,43,24
,102,2,公立,一般大學,12,國立臺灣海洋大學,博士班,328,20,18,2,58,45,13
,102,2,公立,一般大學,13,國立中正大學,學士班(日間),6618,68,48,20,163,114,49
,102,2,公立,一般大學,13,國立中正大學,碩士班(日間),2932,146,64,82,376,192,184
,102,2,公立,一般大學,13,國立中正大學,碩士在職專班,1772,149,83,66,318,173,145
,102,2,公立,一般大學,13,國立中正大學,博士班,667,72,53,19,153,107,46
,102,2,公立,一般大學,14,國立高雄師範大學,學士班(日間),3413,20,9,11,59,34,25
,102,2,公立,一般大學,14,國立高雄師範大學,碩士班(日間),1403,91,29,62,366,121,245
,102,2,公立,一般大學,14,國立高雄師範大學,碩士在職專班,1414,124,46,78,283,100,183
,102,2,公立,一般大學,14,國立高雄師範大學,博士班,471,19,3,16,87,31,56
,102,2,公立,一般大學,15,國立彰化師範大學,學士班(日間),4815,24,16,8,71,55,16
,102,2,公立,一般大學,15,國立彰化師範大學,碩士班(日間),1587,80,39,41,274,113,161
,102,2,公立,一般大學,15,國立彰化師範大學,碩士在職專班,1278,56,32,24,129,67,62
,102,2,公立,一般大學,15,國立彰化師範大學,博士班,441,31,14,17,94,45,49
,102,2,公立,一般大學,16,國立陽明大學,學士班(日間),2079,7,2,5,66,36,30
,102,2,公立,一般大學,16,國立陽明大學,碩士班(日間),1266,42,11,31,176,64,112
,102,2,公立,一般大學,16,國立陽明大學,碩士在職專班,124,10,4,6,34,8,26
,102,2,公立,一般大學,16,國立陽明大學,博士班,1044,88,44,44,256,138,118
,102,2,公立,一般大學,17,國立臺北大學,學士班(日間),5649,56,44,12,138,86,52
,102,2,公立,一般大學,17,國立臺北大學,學士班(進修),2064,55,27,28,246,128,118
,102,2,公立,一般大學,17,國立臺北大學,碩士班(日間),1349,84,37,47,267,131,136
,102,2,公立,一般大學,17,國立臺北大學,碩士在職專班,454,24,8,16,67,28,39
,102,2,公立,一般大學,17,國立臺北大學,博士班,188,15,13,2,40,28,12
,102,2,公立,一般大學,18,國立嘉義大學,學士班(日間),7828,50,37,13,224,157,67
,102,2,公立,一般大學,18,國立嘉義大學,學士班(進修),2143,60,46,14,269,170,99
,102,2,公立,一般大學,18,國立嘉義大學,碩士班(日間),1682,71,38,33,280,146,134
,102,2,公立,一般大學,18,國立嘉義大學,碩士在職專班,1033,43,16,27,217,87,130
,102,2,公立,一般大學,18,國立嘉義大學,博士班,200,15,9,6,60,34,26
,102,2,公立,一般大學,19,國立高雄大學,學士班(日間),4088,37,30,7,97,65,32
,102,2,公立,一般大學,19,國立高雄大學,學士班(進修),205,9,7,2,34,21,13
,102,2,公立,一般大學,19,國立高雄大學,碩士班(日間),678,27,20,7,114,74,40
,102,2,公立,一般大學,19,國立高雄大學,碩士在職專班,502,34,21,13,135,86,49
,102,2,公立,一般大學,19,國立高雄大學,博士班,15,1,1,0,3,3,0
,102,2,公立,一般大學,20,國立東華大學,學士班(日間),7095,112,83,29,259,182,77
,102,2,公立,一般大學,20,國立東華大學,學士班(進修),3,1,1,0,4,4,0
,102,2,公立,一般大學,20,國立東華大學,碩士班(日間),2112,182,84,98,566,262,304
,102,2,公立,一般大學,20,國立東華大學,碩士在職專班,608,42,22,20,169,85,84
,102,2,公立,一般大學,20,國立東華大學,博士班,368,39,27,12,118,75,43
,102,2,公立,一般大學,21,國立暨南國際大學,學士班(日間),4012,12,6,6,66,40,26
,102,2,公立,一般大學,21,國立暨南國際大學,學士班(進修),3,0,0,0,0,0,0
,102,2,公立,一般大學,21,國立暨南國際大學,碩士班(日間),1192,76,31,45,184,82,102
,102,2,公立,一般大學,21,國立暨南國際大學,碩士在職專班,380,13,10,3,36,23,13
,102,2,公立,一般大學,21,國立暨南國際大學,博士班,313,28,18,10,70,36,34
,102,2,公立,一般大學,28,國立臺北藝術大學,五專,85,1,1,0,1,1,0
,102,2,公立,一般大學,28,國立臺北藝術大學,學士班(日間),1587,25,14,11,78,39,39
,102,2,公立,一般大學,28,國立臺北藝術大學,碩士班(日間),928,121,50,71,293,103,190
,102,2,公立,一般大學,28,國立臺北藝術大學,碩士在職專班,126,12,3,9,43,14,29
,102,2,公立,一般大學,28,國立臺北藝術大學,博士班,56,10,1,9,20,4,16
,102,2,公立,一般大學,29,國立臺灣藝術大學,學士班(日間),2212,10,4,6,70,25,45
,102,2,公立,一般大學,29,國立臺灣藝術大學,學士班(進修),1904,34,11,23,134,36,98
,102,2,公立,一般大學,29,國立臺灣藝術大學,碩士班(日間),716,40,22,18,151,64,87
,102,2,公立,一般大學,29,國立臺灣藝術大學,碩士在職專班,382,27,4,23,86,19,67
,102,2,公立,一般大學,29,國立臺灣藝術大學,博士班,66,5,2,3,11,4,7
,102,2,公立,一般大學,30,國立臺東大學,學士班(日間),3517,43,26,17,235,139,96
,102,2,公立,一般大學,30,國立臺東大學,學士班(進修),195,1,0,1,39,23,16
,102,2,公立,一般大學,30,國立臺東大學,碩士班(日間),342,36,14,22,159,65,94
,102,2,公立,一般大學,30,國立臺東大學,碩士在職專班,750,90,35,55,120,55,65
,102,2,公立,一般大學,30,國立臺東大學,博士班,44,3,1,2,11,7,4
,102,2,公立,一般大學,31,國立宜蘭大學,學士班(日間),4229,49,40,9,128,97,31
,102,2,公立,一般大學,31,國立宜蘭大學,學士班(進修),593,15,12,3,88,77,11
,102,2,公立,一般大學,31,國立宜蘭大學,碩士班(日間),524,11,9,2,34,27,7
,102,2,公立,一般大學,31,國立宜蘭大學,碩士在職專班,176,12,10,2,27,23,4
,102,2,公立,一般大學,31,國立宜蘭大學,博士班,9,0,0,0,2,1,1
,102,2,公立,一般大學,32,國立聯合大學,學士班(日間),6168,61,53,8,197,162,35
,102,2,公立,一般大學,32,國立聯合大學,學士班(進修),1482,83,60,23,162,110,52
,102,2,公立,一般大學,32,國立聯合大學,碩士班(日間),482,12,6,6,28,22,6
,102,2,公立,一般大學,32,國立聯合大學,博士班,7,2,2,0,2,2,0
,102,2,公立,一般大學,35,國立臺南藝術大學,五專,156,1,0,1,3,1,2
,102,2,公立,一般大學,35,國立臺南藝術大學,學士班(日間),748,6,3,3,35,14,21
,102,2,公立,一般大學,35,國立臺南藝術大學,學士班(進修),18,0,0,0,2,0,2
,102,2,公立,一般大學,35,國立臺南藝術大學,碩士班(日間),553,57,27,30,195,75,120
,102,2,公立,一般大學,35,國立臺南藝術大學,碩士在職專班,49,6,2,4,24,6,18
,102,2,公立,一般大學,35,國立臺南藝術大學,博士班,46,5,3,2,15,8,7
,102,2,公立,一般大學,36,國立臺南大學,學士班(日間),3810,33,16,17,72,35,37
,102,2,公立,一般大學,36,國立臺南大學,學士班(進修),368,3,2,1,17,9,8
,102,2,公立,一般大學,36,國立臺南大學,碩士班(日間),1082,44,22,22,265,101,164
,102,2,公立,一般大學,36,國立臺南大學,碩士在職專班,758,41,15,26,114,36,78
,102,2,公立,一般大學,36,國立臺南大學,博士班,176,10,7,3,32,21,11
,102,2,公立,一般大學,37,國立臺北教育大學,學士班(日間),3224,28,16,12,100,50,50
,102,2,公立,一般大學,37,國立臺北教育大學,碩士班(日間),1092,103,36,67,314,106,208
,102,2,公立,一般大學,37,國立臺北教育大學,碩士在職專班,1182,82,19,63,171,44,127
,102,2,公立,一般大學,37,國立臺北教育大學,博士班,143,23,11,12,41,17,24
,102,2,公立,一般大學,38,國立新竹教育大學,學士班(日間),2513,14,7,7,60,22,38
,102,2,公立,一般大學,38,國立新竹教育大學,碩士班(日間),772,58,13,45,179,49,130
,102,2,公立,一般大學,38,國立新竹教育大學,碩士在職專班,573,25,5,20,50,11,39
,102,2,公立,一般大學,38,國立新竹教育大學,博士班,75,4,1,3,14,6,8
,102,2,公立,一般大學,39,國立臺中教育大學,學士班(日間),3349,19,13,6,70,36,34
,102,2,公立,一般大學,39,國立臺中教育大學,碩士班(日間),831,42,14,28,158,61,97
,102,2,公立,一般大學,39,國立臺中教育大學,碩士在職專班,711,18,2,16,80,18,62
,102,2,公立,一般大學,39,國立臺中教育大學,博士班,129,7,3,4,16,9,7
,102,2,公立,一般大學,40,國立屏東教育大學,學士班(日間),3255,16,7,9,51,26,25
,102,2,公立,一般大學,40,國立屏東教育大學,碩士班(日間),762,77,33,44,177,66,111
,102,2,公立,一般大學,40,國立屏東教育大學,碩士在職專班,570,26,7,19,62,16,46
,102,2,公立,一般大學,40,國立屏東教育大學,博士班,52,3,2,1,6,4,2
,102,2,公立,一般大學,44,國立體育大學,學士班(日間),1483,20,15,5,81,66,15
,102,2,公立,一般大學,44,國立體育大學,學士班(進修),96,2,2,0,25,20,5
,102,2,公立,一般大學,44,國立體育大學,碩士班(日間),350,20,11,9,116,68,48
,102,2,公立,一般大學,44,國立體育大學,碩士在職專班,208,13,8,5,48,27,21
,102,2,公立,一般大學,44,國立體育大學,博士班,124,8,6,2,18,11,7
,102,2,公立,一般大學,48,國立金門大學,學士班(日間),2892,53,38,15,106,74,32
,102,2,公立,一般大學,48,國立金門大學,學士班(進修),832,26,18,8,12,6,6
,102,2,公立,一般大學,48,國立金門大學,碩士班(日間),197,13,8,5,36,22,14
,102,2,公立,一般大學,48,國立金門大學,碩士在職專班,18,0,0,0,0,0,0
,102,2,公立,一般大學,49,國立臺灣體育運動大學,學士班(日間),2410,58,42,16,168,119,49
,102,2,公立,一般大學,49,國立臺灣體育運動大學,學士班(進修),398,9,7,2,33,26,7
,102,2,公立,一般大學,49,國立臺灣體育運動大學,碩士班(日間),272,14,8,6,98,48,50
,102,2,公立,一般大學,49,國立臺灣體育運動大學,碩士在職專班,96,1,1,0,3,3,0
,102,2,公立,一般大學,3002,臺北市立大學,學士班(日間),4834,90,61,29,213,145,68
,102,2,公立,一般大學,3002,臺北市立大學,碩士班(日間),1158,87,29,58,287,92,195
,102,2,公立,一般大學,3002,臺北市立大學,碩士在職專班,917,29,8,21,122,42,80
,102,2,公立,一般大學,3002,臺北市立大學,博士班,218,14,5,9,50,21,29
,102,2,公立,技專校院,22,國立臺灣科技大學,學士班(日間),5445,68,54,14,158,115,43
,102,2,公立,技專校院,22,國立臺灣科技大學,學士班(進修),41,6,1,5,13,3,10
,102,2,公立,技專校院,22,國立臺灣科技大學,碩士班(日間),3115,55,39,16,193,120,73
,102,2,公立,技專校院,22,國立臺灣科技大學,碩士在職專班,791,100,75,25,172,131,41
,102,2,公立,技專校院,22,國立臺灣科技大學,博士班,1025,133,107,26,276,218,58
,102,2,公立,技專校院,23,國立雲林科技大學,學士班(日間),6203,39,25,14,148,90,58
,102,2,公立,技專校院,23,國立雲林科技大學,碩士班(日間),1984,47,29,18,275,162,113
,102,2,公立,技專校院,23,國立雲林科技大學,碩士在職專班,741,27,13,14,142,92,50
,102,2,公立,技專校院,23,國立雲林科技大學,博士班,480,31,20,11,141,100,41
,102,2,公立,技專校院,24,國立屏東科技大學,學士班(日間),7636,45,30,15,165,104,61
,102,2,公立,技專校院,24,國立屏東科技大學,學士班(進修),1473,30,17,13,114,67,47
,102,2,公立,技專校院,24,國立屏東科技大學,碩士班(日間),1584,54,30,24,229,128,101
,102,2,公立,技專校院,24,國立屏東科技大學,碩士在職專班,636,20,16,4,105,71,34
,102,2,公立,技專校院,24,國立屏東科技大學,博士班,229,10,5,5,57,37,20
,102,2,公立,技專校院,25,國立臺北科技大學,學士班(日間),5876,74,59,15,188,143,45
,102,2,公立,技專校院,25,國立臺北科技大學,學士班(進修),1056,37,30,7,79,62,17
,102,2,公立,技專校院,25,國立臺北科技大學,碩士班(日間),2609,65,48,17,156,113,43
,102,2,公立,技專校院,25,國立臺北科技大學,碩士在職專班,1192,145,116,29,218,171,47
,102,2,公立,技專校院,25,國立臺北科技大學,博士班,713,79,65,14,114,86,28
,102,2,公立,技專校院,26,國立高雄第一科技大學,學士班(日間),5512,59,40,19,149,99,50
,102,2,公立,技專校院,26,國立高雄第一科技大學,碩士班(日間),1197,32,21,11,116,68,48
,102,2,公立,技專校院,26,國立高雄第一科技大學,碩士在職專班,787,52,43,9,151,116,35
,102,2,公立,技專校院,26,國立高雄第一科技大學,博士班,216,18,16,2,55,44,11
,102,2,公立,技專校院,27,國立高雄應用科技大學,學士班(日間),7515,60,41,19,166,120,46
,102,2,公立,技專校院,27,國立高雄應用科技大學,學士班(進修),1689,37,24,13,157,107,50
,102,2,公立,技專校院,27,國立高雄應用科技大學,碩士班(日間),1367,26,22,4,145,102,43
,102,2,公立,技專校院,27,國立高雄應用科技大學,碩士在職專班,1314,39,30,9,214,162,52
,102,2,公立,技專校院,27,國立高雄應用科技大學,博士班,261,11,10,1,35,32,3
,102,2,公立,技專校院,33,國立虎尾科技大學,學士班(日間),7775,42,36,6,316,252,64
,102,2,公立,技專校院,33,國立虎尾科技大學,學士班(進修),1257,43,39,4,74,64,10
,102,2,公立,技專校院,33,國立虎尾科技大學,碩士班(日間),1027,23,16,7,142,116,26
,102,2,公立,技專校院,33,國立虎尾科技大學,碩士在職專班,390,23,18,5,32,23,9
,102,2,公立,技專校院,33,國立虎尾科技大學,博士班,29,3,3,0,7,7,0
,102,2,公立,技專校院,34,國立高雄海洋科技大學,五專,483,2,1,1,12,11,1
,102,2,公立,技專校院,34,國立高雄海洋科技大學,學士班(日間),4938,43,35,8,183,132,51
,102,2,公立,技專校院,34,國立高雄海洋科技大學,學士班(進修),1798,31,20,11,94,64,30
,102,2,公立,技專校院,34,國立高雄海洋科技大學,碩士班(日間),360,15,11,4,46,36,10
,102,2,公立,技專校院,34,國立高雄海洋科技大學,碩士在職專班,189,10,9,1,27,20,7
,102,2,公立,技專校院,42,國立澎湖科技大學,二專(進修),33,0,0,0,4,3,1
,102,2,公立,技專校院,42,國立澎湖科技大學,學士班(日間),2512,17,12,5,48,32,16
,102,2,公立,技專校院,42,國立澎湖科技大學,學士班(進修),308,4,2,2,9,6,3
,102,2,公立,技專校院,42,國立澎湖科技大學,碩士班(日間),111,8,6,2,14,11,3
,102,2,公立,技專校院,42,國立澎湖科技大學,碩士在職專班,44,2,1,1,3,1,2
,102,2,公立,技專校院,43,國立勤益科技大學,二專(日間),194,0,0,0,7,6,1
,102,2,公立,技專校院,43,國立勤益科技大學,二專(進修),18,0,0,0,0,0,0
,102,2,公立,技專校院,43,國立勤益科技大學,學士班(日間),6590,67,53,14,288,211,77
,102,2,公立,技專校院,43,國立勤益科技大學,學士班(進修),3366,78,64,14,184,150,34
,102,2,公立,技專校院,43,國立勤益科技大學,碩士班(日間),643,32,31,1,91,82,9
,102,2,公立,技專校院,43,國立勤益科技大學,碩士在職專班,224,12,12,0,2,2,0
,102,2,公立,技專校院,43,國立勤益科技大學,博士班,7,0,0,0,0,0,0
,102,2,公立,技專校院,46,國立臺北護理健康大學,學士班(日間),2814,18,3,15,82,22,60
,102,2,公立,技專校院,46,國立臺北護理健康大學,學士班(進修),666,7,0,7,90,0,90
,102,2,公立,技專校院,46,國立臺北護理健康大學,碩士班(日間),625,59,10,49,183,29,154
,102,2,公立,技專校院,46,國立臺北護理健康大學,碩士在職專班,181,21,1,20,46,2,44
,102,2,公立,技專校院,46,國立臺北護理健康大學,博士班,63,13,0,13,22,1,21
,102,2,公立,技專校院,47,國立高雄餐旅大學,二專(進修),305,0,0,0,0,0,0
,102,2,公立,技專校院,47,國立高雄餐旅大學,五專,215,2,2,0,8,7,1
,102,2,公立,技專校院,47,國立高雄餐旅大學,學士班(日間),3268,9,4,5,95,33,62
,102,2,公立,技專校院,47,國立高雄餐旅大學,學士班(進修),1187,4,2,2,30,14,16
,102,2,公立,技專校院,47,國立高雄餐旅大學,碩士班(日間),209,5,2,3,42,19,23
,102,2,公立,技專校院,47,國立高雄餐旅大學,碩士在職專班,78,2,0,2,12,6,6
,102,2,公立,技專校院,47,國立高雄餐旅大學,博士班,12,2,0,2,2,0,2
,102,2,公立,技專校院,50,國立臺中科技大學,二專(日間),254,5,2,3,20,2,18
,102,2,公立,技專校院,50,國立臺中科技大學,二專(進修),214,11,1,10,23,1,22
,102,2,公立,技專校院,50,國立臺中科技大學,五專,3799,22,6,16,70,22,48
,102,2,公立,技專校院,50,國立臺中科技大學,學士班(日間),6015,42,13,29,131,43,88
,102,2,公立,技專校院,50,國立臺中科技大學,學士班(進修),2777,71,24,47,189,72,117
,102,2,公立,技專校院,50,國立臺中科技大學,碩士班(日間),382,17,9,8,49,27,22
,102,2,公立,技專校院,50,國立臺中科技大學,碩士在職專班,121,4,2,2,10,7,3
,102,2,公立,技專校院,136,國立屏東商業技術學院,學士班(日間),3090,15,6,9,92,38,54
,102,2,公立,技專校院,136,國立屏東商業技術學院,學士班(進修),718,21,10,11,75,33,42
,102,2,公立,技專校院,136,國立屏東商業技術學院,碩士班(日間),225,13,5,8,64,33,31
,102,2,公立,技專校院,136,國立屏東商業技術學院,碩士在職專班,21,0,0,0,6,4,2
,102,2,公立,技專校院,142,國立臺北商業技術學院,二專(進修),592,11,3,8,24,8,16
,102,2,公立,技專校院,142,國立臺北商業技術學院,五專,2021,21,5,16,59,17,42
,102,2,公立,技專校院,142,國立臺北商業技術學院,學士班(日間),2440,35,15,20,62,26,36
,102,2,公立,技專校院,142,國立臺北商業技術學院,學士班(進修),1616,41,14,27,111,43,68
,102,2,公立,技專校院,142,國立臺北商業技術學院,碩士班(日間),158,2,1,1,12,5,7
,102,2,公立,技專校院,142,國立臺北商業技術學院,碩士在職專班,29,5,2,3,9,7,2
,102,2,公立,技專校院,144,國立臺灣戲曲學院,學士班(日間),490,10,6,4,39,20,19
,102,2,公立,技專校院,144,國立臺灣戲曲學院,學士班(進修),27,1,0,1,3,1,2
,102,2,公立,技專校院,221,國立臺南護理專科學校,二專(日間),96,4,1,3,5,1,4
,102,2,公立,技專校院,221,國立臺南護理專科學校,二專(進修),93,3,0,3,21,2,19
,102,2,公立,技專校院,221,國立臺南護理專科學校,五專,1719,19,1,18,30,1,29
,102,2,公立,技專校院,222,國立臺東專科學校,二專(日間),413,12,6,6,38,27,11
,102,2,公立,技專校院,222,國立臺東專科學校,二專(進修),175,6,3,3,22,14,8
,102,2,公立,技專校院,222,國立臺東專科學校,五專,561,11,6,5,21,14,7
,102,2,私立,一般大學,1001,東海大學,學士班(日間),13605,131,81,50,514,314,200
,102,2,私立,一般大學,1001,東海大學,學士班(進修),750,34,19,15,186,113,73
,102,2,私立,一般大學,1001,東海大學,碩士班(日間),1707,117,63,54,386,198,188
,102,2,私立,一般大學,1001,東海大學,碩士在職專班,802,52,24,28,177,81,96
,102,2,私立,一般大學,1001,東海大學,博士班,230,21,12,9,67,42,25
,102,2,私立,一般大學,1002,輔仁大學,學士班(日間),17818,209,120,89,674,364,310
,102,2,私立,一般大學,1002,輔仁大學,學士班(進修),4669,139,51,88,426,172,254
,102,2,私立,一般大學,1002,輔仁大學,碩士班(日間),2185,262,119,143,678,300,378
,102,2,私立,一般大學,1002,輔仁大學,碩士在職專班,1568,101,46,55,405,194,211
,102,2,私立,一般大學,1002,輔仁大學,博士班,421,56,24,32,183,91,92
,102,2,私立,一般大學,1003,東吳大學,學士班(日間),11861,134,77,57,360,199,161
,102,2,私立,一般大學,1003,東吳大學,學士班(進修),1268,36,14,22,140,54,86
,102,2,私立,一般大學,1003,東吳大學,碩士班(日間),1200,156,81,75,272,140,132
,102,2,私立,一般大學,1003,東吳大學,碩士在職專班,1198,86,40,46,232,89,143
,102,2,私立,一般大學,1003,東吳大學,博士班,93,9,3,6,19,6,13
,102,2,私立,一般大學,1004,中原大學,學士班(日間),12715,136,96,40,435,326,109
,102,2,私立,一般大學,1004,中原大學,學士班(進修),2,0,0,0,1,1,0
,102,2,私立,一般大學,1004,中原大學,碩士班(日間),1907,60,35,25,316,186,130
,102,2,私立,一般大學,1004,中原大學,碩士在職專班,1167,69,50,19,279,188,91
,102,2,私立,一般大學,1004,中原大學,博士班,376,26,20,6,92,71,21
,102,2,私立,一般大學,1005,淡江大學,學士班(日間),20868,256,167,89,834,545,289
,102,2,私立,一般大學,1005,淡江大學,學士班(進修),2582,93,48,45,325,185,140
,102,2,私立,一般大學,1005,淡江大學,碩士班(日間),2252,117,64,53,422,242,180
,102,2,私立,一般大學,1005,淡江大學,碩士在職專班,1269,67,34,33,250,122,128
,102,2,私立,一般大學,1005,淡江大學,博士班,513,40,26,14,146,105,41
,102,2,私立,一般大學,1006,中國文化大學,學士班(日間),20641,236,140,96,726,425,301
,102,2,私立,一般大學,1006,中國文化大學,學士班(進修),2676,161,77,84,520,245,275
,102,2,私立,一般大學,1006,中國文化大學,碩士班(日間),1856,120,68,52,368,207,161
,102,2,私立,一般大學,1006,中國文化大學,碩士在職專班,636,36,17,19,139,60,79
,102,2,私立,一般大學,1006,中國文化大學,博士班,528,24,10,14,72,37,35
,102,2,私立,一般大學,1007,逢甲大學,學士班(日間),16670,174,139,35,395,314,81
,102,2,私立,一般大學,1007,逢甲大學,學士班(進修),905,35,20,15,101,63,38
,102,2,私立,一般大學,1007,逢甲大學,碩士班(日間),1740,78,54,24,175,122,53
,102,2,私立,一般大學,1007,逢甲大學,碩士在職專班,1130,73,39,34,164,97,67
,102,2,私立,一般大學,1007,逢甲大學,博士班,403,43,32,11,80,60,20
,102,2,私立,一般大學,1008,靜宜大學,學士班(日間),11011,147,90,57,400,237,163
,102,2,私立,一般大學,1008,靜宜大學,學士班(進修),103,8,2,6,15,7,8
,102,2,私立,一般大學,1008,靜宜大學,碩士班(日間),694,57,26,31,133,55,78
,102,2,私立,一般大學,1008,靜宜大學,碩士在職專班,328,12,8,4,30,11,19
,102,2,私立,一般大學,1008,靜宜大學,博士班,37,4,4,0,8,5,3
,102,2,私立,一般大學,1009,長庚大學,學士班(日間),5086,38,23,15,125,68,57
,102,2,私立,一般大學,1009,長庚大學,碩士班(日間),1385,42,18,24,189,79,110
,102,2,私立,一般大學,1009,長庚大學,碩士在職專班,380,37,24,13,111,66,45
,102,2,私立,一般大學,1009,長庚大學,博士班,546,29,18,11,93,57,36
,102,2,私立,一般大學,1010,元智大學,學士班(日間),7107,61,50,11,150,108,42
,102,2,私立,一般大學,1010,元智大學,學士班(進修),1,0,0,0,0,0,0
,102,2,私立,一般大學,1010,元智大學,碩士班(日間),1197,31,23,8,99,64,35
,102,2,私立,一般大學,1010,元智大學,碩士在職專班,1027,53,37,16,149,101,48
,102,2,私立,一般大學,1010,元智大學,博士班,333,27,20,7,71,50,21
,102,2,私立,一般大學,1011,中華大學,學士班(日間),7092,69,45,24,300,226,74
,102,2,私立,一般大學,1011,中華大學,學士班(進修),394,4,3,1,35,26,9
,102,2,私立,一般大學,1011,中華大學,碩士班(日間),691,26,21,5,115,90,25
,102,2,私立,一般大學,1011,中華大學,碩士在職專班,284,9,6,3,51,39,12
,102,2,私立,一般大學,1011,中華大學,博士班,135,9,6,3,37,25,12
,102,2,私立,一般大學,1012,大葉大學,學士班(日間),7924,65,51,14,330,246,84
,102,2,私立,一般大學,1012,大葉大學,學士班(進修),988,30,20,10,107,77,30
,102,2,私立,一般大學,1012,大葉大學,碩士班(日間),843,31,20,11,114,69,45
,102,2,私立,一般大學,1012,大葉大學,碩士在職專班,861,12,8,4,56,33,23
,102,2,私立,一般大學,1012,大葉大學,博士班,160,16,10,6,47,30,17
,102,2,私立,一般大學,1013,華梵大學,學士班(日間),2830,53,30,23,136,89,47
,102,2,私立,一般大學,1013,華梵大學,碩士班(日間),341,49,36,13,46,32,14
,102,2,私立,一般大學,1013,華梵大學,碩士在職專班,416,37,25,12,49,35,14
,102,2,私立,一般大學,1013,華梵大學,博士班,48,10,7,3,18,11,7
,102,2,私立,一般大學,1014,義守大學,學士班(日間),12515,41,29,12,136,106,30
,102,2,私立,一般大學,1014,義守大學,學士班(進修),2533,49,34,15,248,171,77
,102,2,私立,一般大學,1014,義守大學,碩士班(日間),625,14,12,2,37,29,8
,102,2,私立,一般大學,1014,義守大學,碩士在職專班,625,15,9,6,49,35,14
,102,2,私立,一般大學,1014,義守大學,博士班,135,6,5,1,17,11,6
,102,2,私立,一般大學,1015,世新大學,學士班(日間),9678,135,68,67,292,147,145
,102,2,私立,一般大學,1015,世新大學,學士班(進修),198,4,1,3,11,3,8
,102,2,私立,一般大學,1015,世新大學,碩士班(日間),794,97,59,38,176,92,84
,102,2,私立,一般大學,1015,世新大學,碩士在職專班,1043,77,47,30,265,138,127
,102,2,私立,一般大學,1015,世新大學,博士班,73,11,3,8,19,9,10
,102,2,私立,一般大學,1016,銘傳大學,學士班(日間),17254,216,135,81,546,293,253
,102,2,私立,一般大學,1016,銘傳大學,學士班(進修),13,0,0,0,0,0,0
,102,2,私立,一般大學,1016,銘傳大學,碩士班(日間),845,41,21,20,114,70,44
,102,2,私立,一般大學,1016,銘傳大學,碩士在職專班,898,31,16,15,117,45,72
,102,2,私立,一般大學,1016,銘傳大學,博士班,62,7,5,2,14,8,6
,102,2,私立,一般大學,1017,實踐大學,學士班(日間),12342,138,64,74,388,194,194
,102,2,私立,一般大學,1017,實踐大學,學士班(進修),2765,91,34,57,228,77,151
,102,2,私立,一般大學,1017,實踐大學,碩士班(日間),411,40,22,18,75,42,33
,102,2,私立,一般大學,1017,實踐大學,碩士在職專班,201,31,21,10,48,31,17
,102,2,私立,一般大學,1017,實踐大學,博士班,4,1,0,1,2,0,2
,102,2,私立,一般大學,1019,高雄醫學大學,學士班(日間),5629,27,12,15,181,89,92
,102,2,私立,一般大學,1019,高雄醫學大學,學士班(進修),166,0,0,0,12,2,10
,102,2,私立,一般大學,1019,高雄醫學大學,碩士班(日間),641,28,10,18,127,47,80
,102,2,私立,一般大學,1019,高雄醫學大學,碩士在職專班,232,20,6,14,51,12,39
,102,2,私立,一般大學,1019,高雄醫學大學,博士班,341,25,12,13,90,50,40
,102,2,私立,一般大學,1020,南華大學,學士班(日間),3663,54,34,20,238,152,86
,102,2,私立,一般大學,1020,南華大學,學士班(進修),112,6,6,0,17,14,3
,102,2,私立,一般大學,1020,南華大學,碩士班(日間),769,86,45,41,205,103,102
,102,2,私立,一般大學,1020,南華大學,碩士在職專班,546,43,22,21,108,58,50
,102,2,私立,一般大學,1020,南華大學,博士班,27,1,1,0,6,4,2
,102,2,私立,一般大學,1021,真理大學,學士班(日間),7970,69,52,17,287,201,86
,102,2,私立,一般大學,1021,真理大學,學士班(進修),853,32,22,10,79,52,27
,102,2,私立,一般大學,1021,真理大學,碩士班(日間),163,10,5,5,17,10,7
,102,2,私立,一般大學,1021,真理大學,碩士在職專班,7,0,0,0,1,0,1
,102,2,私立,一般大學,1022,大同大學,學士班(日間),3692,44,36,8,211,167,44
,102,2,私立,一般大學,1022,大同大學,碩士班(日間),568,9,8,1,97,78,19
,102,2,私立,一般大學,1022,大同大學,碩士在職專班,502,43,37,6,286,235,51
,102,2,私立,一般大學,1022,大同大學,博士班,157,13,10,3,64,54,10
,102,2,私立,一般大學,1027,慈濟大學,學士班(日間),2868,19,6,13,67,26,41
,102,2,私立,一般大學,1027,慈濟大學,碩士班(日間),344,25,9,16,70,24,46
,102,2,私立,一般大學,1027,慈濟大學,碩士在職專班,33,1,0,1,10,4,6
,102,2,私立,一般大學,1027,慈濟大學,博士班,107,14,4,10,34,17,17
,102,2,私立,一般大學,1028,臺北醫學大學,學士班(日間),4571,36,16,20,157,73,84
,102,2,私立,一般大學,1028,臺北醫學大學,學士班(進修),234,0,0,0,7,0,7
,102,2,私立,一般大學,1028,臺北醫學大學,碩士班(日間),676,19,10,9,74,33,41
,102,2,私立,一般大學,1028,臺北醫學大學,碩士在職專班,240,17,2,15,48,7,41
,102,2,私立,一般大學,1028,臺北醫學大學,博士班,381,20,13,7,62,32,30
,102,2,私立,一般大學,1029,中山醫學大學,學士班(日間),6387,49,29,20,190,93,97
,102,2,私立,一般大學,1029,中山醫學大學,學士班(進修),356,4,2,2,14,7,7
,102,2,私立,一般大學,1029,中山醫學大學,碩士班(日間),511,12,4,8,45,20,25
,102,2,私立,一般大學,1029,中山醫學大學,碩士在職專班,103,2,0,2,9,3,6
,102,2,私立,一般大學,1029,中山醫學大學,博士班,236,13,8,5,35,20,15
,102,2,私立,一般大學,1033,長榮大學,學士班(日間),8763,86,52,34,217,152,65
,102,2,私立,一般大學,1033,長榮大學,學士班(進修),528,10,7,3,19,13,6
,102,2,私立,一般大學,1033,長榮大學,碩士班(日間),534,36,19,17,75,37,38
,102,2,私立,一般大學,1033,長榮大學,碩士在職專班,207,18,9,9,31,14,17
,102,2,私立,一般大學,1033,長榮大學,博士班,33,3,2,1,11,8,3
,102,2,私立,一般大學,1035,中國醫藥大學,學士班(日間),6366,61,39,22,217,116,101
,102,2,私立,一般大學,1035,中國醫藥大學,學士班(進修),103,0,0,0,20,0,20
,102,2,私立,一般大學,1035,中國醫藥大學,碩士班(日間),520,35,11,24,45,13,32
,102,2,私立,一般大學,1035,中國醫藥大學,碩士在職專班,71,1,0,1,1,0,1
,102,2,私立,一般大學,1035,中國醫藥大學,博士班,330,26,13,13,31,17,14
,102,2,私立,一般大學,1039,玄奘大學,學士班(日間),3839,79,38,41,260,133,127
,102,2,私立,一般大學,1039,玄奘大學,學士班(進修),1422,91,46,45,249,132,117
,102,2,私立,一般大學,1039,玄奘大學,碩士班(日間),405,37,20,17,130,70,60
,102,2,私立,一般大學,1039,玄奘大學,碩士在職專班,298,21,11,10,48,18,30
,102,2,私立,一般大學,1039,玄奘大學,博士班,23,1,1,0,1,1,0
,102,2,私立,一般大學,1048,亞洲大學,學士班(日間),9394,101,68,33,573,356,217
,102,2,私立,一般大學,1048,亞洲大學,學士班(進修),1418,56,32,24,259,155,104
,102,2,私立,一般大學,1048,亞洲大學,碩士班(日間),670,47,28,19,196,104,92
,102,2,私立,一般大學,1048,亞洲大學,碩士在職專班,468,16,9,7,69,29,40
,102,2,私立,一般大學,1048,亞洲大學,博士班,149,14,8,6,39,18,21
,102,2,私立,一般大學,1049,開南大學,學士班(日間),7978,173,119,54,472,316,156
,102,2,私立,一般大學,1049,開南大學,學士班(進修),1297,42,28,14,173,116,57
,102,2,私立,一般大學,1049,開南大學,碩士班(日間),319,26,18,8,76,48,28
,102,2,私立,一般大學,1049,開南大學,碩士在職專班,386,9,8,1,32,20,12
,102,2,私立,一般大學,1050,佛光大學,學士班(日間),2577,38,15,23,111,55,56
,102,2,私立,一般大學,1050,佛光大學,碩士班(日間),712,67,39,28,180,85,95
,102,2,私立,一般大學,1050,佛光大學,碩士在職專班,262,10,8,2,36,23,13
,102,2,私立,一般大學,1050,佛光大學,博士班,40,4,2,2,8,4,4
,102,2,私立,一般大學,1058,明道大學,學士班(日間),3468,27,12,15,116,74,42
,102,2,私立,一般大學,1058,明道大學,學士班(進修),2008,124,79,45,258,176,82
,102,2,私立,一般大學,1058,明道大學,碩士班(日間),218,15,10,5,53,30,23
,102,2,私立,一般大學,1058,明道大學,碩士在職專班,50,1,1,0,7,5,2
,102,2,私立,一般大學,1058,明道大學,博士班,3,0,0,0,0,0,0
,102,2,私立,一般大學,1059,康寧大學,學士班(日間),1123,34,17,17,194,138,56
,102,2,私立,一般大學,1059,康寧大學,學士班(進修),483,31,18,13,77,51,26
,102,2,私立,一般大學,1059,康寧大學,碩士班(日間),195,15,11,4,51,27,24
,102,2,私立,一般大學,1059,康寧大學,碩士在職專班,145,5,3,2,23,13,10
,102,2,私立,一般大學,1067,台灣首府大學,學士班(日間),3609,53,33,20,149,98,51
,102,2,私立,一般大學,1067,台灣首府大學,學士班(進修),1175,25,17,8,96,65,31
,102,2,私立,一般大學,1067,台灣首府大學,碩士班(日間),78,0,0,0,3,2,1
,102,2,私立,一般大學,1125,興國管理學院,學士班(日間),287,3,2,1,4,2,2
,102,2,私立,一般大學,1125,興國管理學院,學士班(進修),1282,5,3,2,5,3,2
,102,2,私立,一般大學,1176,稻江科技暨管理學院,學士班(日間),1729,22,14,8,111,71,40
,102,2,私立,一般大學,1176,稻江科技暨管理學院,學士班(進修),957,8,6,2,69,41,28
,102,2,私立,一般大學,1176,稻江科技暨管理學院,碩士班(日間),53,2,2,0,6,3,3
,102,2,私立,一般大學,1176,稻江科技暨管理學院,碩士在職專班,31,0,0,0,0,0,0
,102,2,私立,一般大學,1195,馬偕醫學院,學士班(日間),419,1,1,0,6,4,2
,102,2,私立,一般大學,1195,馬偕醫學院,碩士班(日間),9,0,0,0,2,0,2
,102,2,私立,一般大學,1R01,法鼓佛教學院,學士班(日間),49,3,3,0,0,0,0
,102,2,私立,一般大學,1R01,法鼓佛教學院,碩士班(日間),69,21,9,12,25,11,14
,102,2,私立,一般大學,1R01,法鼓佛教學院,博士班,6,0,0,0,0,0,0
,102,2,私立,一般大學,1R02,基督教台灣浸會神學院,碩士班(日間),53,0,0,0,0,0,0
,102,2,私立,一般大學,1R03,臺北基督學院,學士班(日間),71,3,3,0,3,3,0
,102,2,私立,技專校院,1018,朝陽科技大學,學士班(日間),11395,109,62,47,368,227,141
,102,2,私立,技專校院,1018,朝陽科技大學,學士班(進修),3674,111,59,52,381,197,184
,102,2,私立,技專校院,1018,朝陽科技大學,碩士班(日間),891,62,30,32,159,85,74
,102,2,私立,技專校院,1018,朝陽科技大學,碩士在職專班,537,17,5,12,71,29,42
,102,2,私立,技專校院,1018,朝陽科技大學,博士班,75,3,3,0,16,13,3
,102,2,私立,技專校院,1023,南臺科技大學,學士班(日間),13209,97,66,31,392,261,131
,102,2,私立,技專校院,1023,南臺科技大學,學士班(進修),4628,107,71,36,550,364,186
,102,2,私立,技專校院,1023,南臺科技大學,碩士班(日間),1085,60,43,17,220,154,66
,102,2,私立,技專校院,1023,南臺科技大學,碩士在職專班,501,25,18,7,85,51,34
,102,2,私立,技專校院,1023,南臺科技大學,博士班,50,3,3,0,8,8,0
,102,2,私立,技專校院,1024,崑山科技大學,學士班(日間),8522,151,106,45,475,318,157
,102,2,私立,技專校院,1024,崑山科技大學,學士班(進修),3513,159,113,46,726,482,244
,102,2,私立,技專校院,1024,崑山科技大學,碩士班(日間),539,29,24,5,99,76,23
,102,2,私立,技專校院,1024,崑山科技大學,碩士在職專班,197,1,0,1,25,20,5
,102,2,私立,技專校院,1024,崑山科技大學,博士班,26,1,1,0,6,6,0
,102,2,私立,技專校院,1025,嘉南藥理大學,學士班(日間),12937,107,51,56,544,276,268
,102,2,私立,技專校院,1025,嘉南藥理大學,學士班(進修),3522,93,45,48,614,345,269
,102,2,私立,技專校院,1025,嘉南藥理大學,碩士班(日間),327,9,4,5,102,67,35
,102,2,私立,技專校院,1025,嘉南藥理大學,碩士在職專班,201,3,1,2,42,22,20
,102,2,私立,技專校院,1026,樹德科技大學,學士班(日間),8235,239,153,86,241,153,88
,102,2,私立,技專校院,1026,樹德科技大學,學士班(進修),2224,145,103,42,145,103,42
,102,2,私立,技專校院,1026,樹德科技大學,碩士班(日間),439,48,27,21,48,27,21
,102,2,私立,技專校院,1026,樹德科技大學,碩士在職專班,540,28,14,14,28,14,14
,102,2,私立,技專校院,1026,樹德科技大學,博士班,15,5,2,3,5,2,3
,102,2,私立,技專校院,1030,龍華科技大學,二專(日間),58,0,0,0,0,0,0
,102,2,私立,技專校院,1030,龍華科技大學,學士班(日間),6567,88,69,19,334,255,79
,102,2,私立,技專校院,1030,龍華科技大學,學士班(進修),4010,118,79,39,278,191,87
,102,2,私立,技專校院,1030,龍華科技大學,碩士班(日間),290,10,10,0,43,38,5
,102,2,私立,技專校院,1030,龍華科技大學,碩士在職專班,102,5,2,3,6,2,4
,102,2,私立,技專校院,1031,輔英科技大學,二專(進修),12,0,0,0,0,0,0
,102,2,私立,技專校院,1031,輔英科技大學,五專,3175,20,1,19,74,11,63
,102,2,私立,技專校院,1031,輔英科技大學,學士班(日間),5432,84,29,55,391,206,185
,102,2,私立,技專校院,1031,輔英科技大學,學士班(進修),1216,28,16,12,193,110,83
,102,2,私立,技專校院,1031,輔英科技大學,碩士班(日間),112,15,1,14,40,10,30
,102,2,私立,技專校院,1031,輔英科技大學,碩士在職專班,40,2,0,2,9,1,8
,102,2,私立,技專校院,1032,明新科技大學,二專(日間),20,0,0,0,0,0,0
,102,2,私立,技專校院,1032,明新科技大學,二專(進修),153,0,0,0,0,0,0
,102,2,私立,技專校院,1032,明新科技大學,學士班(日間),8785,95,66,29,908,538,370
,102,2,私立,技專校院,1032,明新科技大學,學士班(進修),3850,78,53,25,308,205,103
,102,2,私立,技專校院,1032,明新科技大學,碩士班(日間),387,10,8,2,153,111,42
,102,2,私立,技專校院,1032,明新科技大學,碩士在職專班,231,12,9,3,31,25,6
,102,2,私立,技專校院,1034,弘光科技大學,五專,321,0,0,0,7,1,6
,102,2,私立,技專校院,1034,弘光科技大學,學士班(日間),7813,71,20,51,348,138,210
,102,2,私立,技專校院,1034,弘光科技大學,學士班(進修),4367,93,33,60,532,217,315
,102,2,私立,技專校院,1034,弘光科技大學,碩士班(日間),224,14,7,7,63,30,33
,102,2,私立,技專校院,1034,弘光科技大學,碩士在職專班,97,7,2,5,35,10,25
,102,2,私立,技專校院,1036,健行科技大學,二專(日間),155,1,1,0,7,7,0
,102,2,私立,技專校院,1036,健行科技大學,學士班(日間),8412,110,80,30,366,277,89
,102,2,私立,技專校院,1036,健行科技大學,學士班(進修),3743,132,88,44,175,112,63
,102,2,私立,技專校院,1036,健行科技大學,碩士班(日間),320,14,10,4,47,39,8
,102,2,私立,技專校院,1036,健行科技大學,碩士在職專班,132,6,4,2,18,15,3
,102,2,私立,技專校院,1037,正修科技大學,二專(日間),56,0,0,0,9,8,1
,102,2,私立,技專校院,1037,正修科技大學,二專(進修),7,1,0,1,8,6,2
,102,2,私立,技專校院,1037,正修科技大學,五專,2,0,0,0,0,0,0
,102,2,私立,技專校院,1037,正修科技大學,學士班(日間),9648,150,104,46,420,276,144
,102,2,私立,技專校院,1037,正修科技大學,學士班(進修),6861,262,174,88,872,593,279
,102,2,私立,技專校院,1037,正修科技大學,碩士班(日間),332,8,6,2,47,38,9
,102,2,私立,技專校院,1037,正修科技大學,碩士在職專班,96,2,2,0,10,6,4
,102,2,私立,技專校院,1037,正修科技大學,博士班,11,0,0,0,1,1,0
,102,2,私立,技專校院,1038,萬能科技大學,二專(日間),15,0,0,0,0,0,0
,102,2,私立,技專校院,1038,萬能科技大學,學士班(日間),5999,36,21,15,381,263,118
,102,2,私立,技專校院,1038,萬能科技大學,學士班(進修),4541,55,29,26,359,225,134
,102,2,私立,技專校院,1038,萬能科技大學,碩士班(日間),125,6,6,0,40,33,7
,102,2,私立,技專校院,1038,萬能科技大學,碩士在職專班,139,6,5,1,14,11,3
,102,2,私立,技專校院,1040,建國科技大學,二專(日間),76,0,0,0,0,0,0
,102,2,私立,技專校院,1040,建國科技大學,二專(進修),35,0,0,0,3,3,0
,102,2,私立,技專校院,1040,建國科技大學,學士班(日間),7382,84,55,29,273,185,88
,102,2,私立,技專校院,1040,建國科技大學,學士班(進修),1837,27,19,8,130,91,39
,102,2,私立,技專校院,1040,建國科技大學,碩士班(日間),218,6,5,1,16,11,5
,102,2,私立,技專校院,1041,明志科技大學,二專(進修),21,0,0,0,2,0,2
,102,2,私立,技專校院,1041,明志科技大學,五專,38,0,0,0,1,0,1
,102,2,私立,技專校院,1041,明志科技大學,學士班(日間),3356,13,11,2,54,46,8
,102,2,私立,技專校院,1041,明志科技大學,學士班(進修),432,5,4,1,30,20,10
,102,2,私立,技專校院,1041,明志科技大學,碩士班(日間),437,7,6,1,26,22,4
,102,2,私立,技專校院,1041,明志科技大學,碩士在職專班,52,3,3,0,16,16,0
,102,2,私立,技專校院,1042,高苑科技大學,二專(日間),42,0,0,0,0,0,0
,102,2,私立,技專校院,1042,高苑科技大學,五專,5,0,0,0,1,1,0
,102,2,私立,技專校院,1042,高苑科技大學,學士班(日間),5701,52,32,20,69,47,22
,102,2,私立,技專校院,1042,高苑科技大學,學士班(進修),1302,25,18,7,85,65,20
,102,2,私立,技專校院,1042,高苑科技大學,碩士班(日間),141,3,3,0,6,5,1
,102,2,私立,技專校院,1042,高苑科技大學,碩士在職專班,277,3,3,0,12,8,4
,102,2,私立,技專校院,1043,大仁科技大學,二專(進修),1,0,0,0,0,0,0
,102,2,私立,技專校院,1043,大仁科技大學,五專,141,2,1,1,24,10,14
,102,2,私立,技專校院,1043,大仁科技大學,學士班(日間),5918,106,65,41,563,338,225
,102,2,私立,技專校院,1043,大仁科技大學,學士班(進修),1888,61,38,23,356,199,157
,102,2,私立,技專校院,1043,大仁科技大學,碩士班(日間),84,2,2,0,27,21,6
,102,2,私立,技專校院,1043,大仁科技大學,碩士在職專班,136,4,3,1,32,17,15
,102,2,私立,技專校院,1044,聖約翰科技大學,學士班(日間),5592,131,97,34,408,298,110
,102,2,私立,技專校院,1044,聖約翰科技大學,學士班(進修),624,24,16,8,122,93,29
,102,2,私立,技專校院,1044,聖約翰科技大學,碩士班(日間),215,11,9,2,41,34,7
,102,2,私立,技專校院,1044,聖約翰科技大學,碩士在職專班,108,2,2,0,13,11,2
,102,2,私立,技專校院,1045,嶺東科技大學,二專(日間),23,0,0,0,0,0,0
,102,2,私立,技專校院,1045,嶺東科技大學,學士班(日間),7520,63,35,28,172,107,65
,102,2,私立,技專校院,1045,嶺東科技大學,學士班(進修),2694,73,45,28,288,177,111
,102,2,私立,技專校院,1045,嶺東科技大學,碩士班(日間),229,13,8,5,37,21,16
,102,2,私立,技專校院,1045,嶺東科技大學,碩士在職專班,117,2,2,0,13,9,4
,102,2,私立,技專校院,1046,中國科技大學,五專,1,0,0,0,2,1,1
,102,2,私立,技專校院,1046,中國科技大學,學士班(日間),8755,124,62,62,415,232,183
,102,2,私立,技專校院,1046,中國科技大學,學士班(進修),2965,129,87,42,323,217,106
,102,2,私立,技專校院,1046,中國科技大學,碩士班(日間),137,8,4,4,23,13,10
,102,2,私立,技專校院,1046,中國科技大學,碩士在職專班,17,1,0,1,1,0,1
,102,2,私立,技專校院,1047,中臺科技大學,五專,12,0,0,0,1,1,0
,102,2,私立,技專校院,1047,中臺科技大學,學士班(日間),6325,89,43,46,408,209,199
,102,2,私立,技專校院,1047,中臺科技大學,學士班(進修),3108,137,46,91,690,295,395
,102,2,私立,技專校院,1047,中臺科技大學,碩士班(日間),197,11,5,6,45,26,19
,102,2,私立,技專校院,1047,中臺科技大學,碩士在職專班,293,32,7,25,76,17,59
,102,2,私立,技專校院,1047,中臺科技大學,博士班,17,0,0,0,1,1,0
,102,2,私立,技專校院,1051,台南應用科技大學,二專(進修),8,0,0,0,0,0,0
,102,2,私立,技專校院,1051,台南應用科技大學,五專,1222,12,3,9,23,5,18
,102,2,私立,技專校院,1051,台南應用科技大學,學士班(日間),8615,97,32,65,324,121,203
,102,2,私立,技專校院,1051,台南應用科技大學,學士班(進修),2866,101,53,48,310,146,164
,102,2,私立,技專校院,1051,台南應用科技大學,碩士班(日間),155,7,0,7,42,8,34
,102,2,私立,技專校院,1051,台南應用科技大學,碩士在職專班,163,12,3,9,39,9,30
,102,2,私立,技專校院,1052,遠東科技大學,二專(進修),52,2,2,0,11,10,1
,102,2,私立,技專校院,1052,遠東科技大學,五專,0,0,0,0,3,2,1
,102,2,私立,技專校院,1052,遠東科技大學,學士班(日間),8267,106,79,27,526,377,149
,102,2,私立,技專校院,1052,遠東科技大學,學士班(進修),687,19,16,3,87,80,7
,102,2,私立,技專校院,1052,遠東科技大學,碩士班(日間),184,10,8,2,34,27,7
,102,2,私立,技專校院,1052,遠東科技大學,碩士在職專班,41,2,2,0,7,7,0
,102,2,私立,技專校院,1053,元培醫事科技大學,學士班(日間),5871,68,50,18,199,145,54
,102,2,私立,技專校院,1053,元培醫事科技大學,學士班(進修),1416,13,5,8,75,44,31
,102,2,私立,技專校院,1053,元培醫事科技大學,碩士班(日間),200,11,5,6,23,12,11
,102,2,私立,技專校院,1053,元培醫事科技大學,碩士在職專班,22,1,0,1,1,0,1
,102,2,私立,技專校院,1054,景文科技大學,二專(進修),6,0,0,0,2,2,0
,102,2,私立,技專校院,1054,景文科技大學,學士班(日間),5902,62,39,23,163,90,73
,102,2,私立,技專校院,1054,景文科技大學,學士班(進修),2457,72,34,38,236,131,105
,102,2,私立,技專校院,1054,景文科技大學,碩士班(日間),50,0,0,0,7,2,5
,102,2,私立,技專校院,1054,景文科技大學,碩士在職專班,106,2,0,2,14,8,6
,102,2,私立,技專校院,1055,中華醫事科技大學,二專(日間),79,2,2,0,5,3,2
,102,2,私立,技專校院,1055,中華醫事科技大學,五專,1961,13,3,10,50,14,36
,102,2,私立,技專校院,1055,中華醫事科技大學,學士班(日間),5080,81,40,41,287,151,136
,102,2,私立,技專校院,1055,中華醫事科技大學,學士班(進修),2013,69,36,33,359,166,193
,102,2,私立,技專校院,1055,中華醫事科技大學,碩士班(日間),64,1,1,0,12,8,4
,102,2,私立,技專校院,1056,東南科技大學,二專(日間),55,0,0,0,10,7,3
,102,2,私立,技專校院,1056,東南科技大學,二專(進修),1,0,0,0,0,0,0
,102,2,私立,技專校院,1056,東南科技大學,學士班(日間),6719,188,141,47,838,666,172
,102,2,私立,技專校院,1056,東南科技大學,學士班(進修),527,46,37,9,210,166,44
,102,2,私立,技專校院,1056,東南科技大學,碩士班(日間),120,6,5,1,26,24,2
,102,2,私立,技專校院,1056,東南科技大學,碩士在職專班,68,8,8,0,7,7,0
,102,2,私立,技專校院,1057,德明財經科技大學,二專(日間),1,0,0,0,3,2,1
,102,2,私立,技專校院,1057,德明財經科技大學,二專(進修),0,0,0,0,6,4,2
,102,2,私立,技專校院,1057,德明財經科技大學,學士班(日間),6818,68,33,35,250,133,117
,102,2,私立,技專校院,1057,德明財經科技大學,學士班(進修),2043,66,30,36,344,163,181
,102,2,私立,技專校院,1057,德明財經科技大學,碩士班(日間),71,8,6,2,23,20,3
,102,2,私立,技專校院,1057,德明財經科技大學,碩士在職專班,54,3,1,2,9,4,5
,102,2,私立,技專校院,1060,南開科技大學,二專(日間),11,0,0,0,0,0,0
,102,2,私立,技專校院,1060,南開科技大學,五專,1265,19,16,3,66,54,12
,102,2,私立,技專校院,1060,南開科技大學,學士班(日間),3706,67,48,19,161,124,37
,102,2,私立,技專校院,1060,南開科技大學,學士班(進修),1237,29,24,5,65,47,18
,102,2,私立,技專校院,1060,南開科技大學,碩士班(日間),113,4,1,3,6,3,3
,102,2,私立,技專校院,1060,南開科技大學,碩士在職專班,160,1,1,0,2,1,1
,102,2,私立,技專校院,1061,中華科技大學,二專(進修),55,0,0,0,17,6,11
,102,2,私立,技專校院,1061,中華科技大學,學士班(日間),6856,111,79,32,656,466,190
,102,2,私立,技專校院,1061,中華科技大學,學士班(進修),1476,57,43,14,419,301,118
,102,2,私立,技專校院,1061,中華科技大學,碩士班(日間),288,19,15,4,90,67,23
,102,2,私立,技專校院,1061,中華科技大學,碩士在職專班,120,8,8,0,41,39,2
,102,2,私立,技專校院,1062,僑光科技大學,二專(日間),167,0,0,0,5,5,0
,102,2,私立,技專校院,1062,僑光科技大學,二專(進修),60,1,0,1,1,0,1
,102,2,私立,技專校院,1062,僑光科技大學,五專,784,8,4,4,48,20,28
,102,2,私立,技專校院,1062,僑光科技大學,學士班(日間),5829,38,23,15,134,78,56
,102,2,私立,技專校院,1062,僑光科技大學,學士班(進修),3682,65,39,26,261,156,105
,102,2,私立,技專校院,1062,僑光科技大學,碩士班(日間),90,3,3,0,8,8,0
,102,2,私立,技專校院,1062,僑光科技大學,碩士在職專班,61,0,0,0,5,1,4
,102,2,私立,技專校院,1063,育達科技大學,學士班(日間),4491,101,59,42,491,298,193
,102,2,私立,技專校院,1063,育達科技大學,學士班(進修),2072,173,118,55,528,357,171
,102,2,私立,技專校院,1063,育達科技大學,碩士班(日間),109,9,5,4,17,11,6
,102,2,私立,技專校院,1063,育達科技大學,碩士在職專班,106,6,5,1,13,11,2
,102,2,私立,技專校院,1064,美和科技大學,五專,1899,12,3,9,76,21,55
,102,2,私立,技專校院,1064,美和科技大學,學士班(日間),3766,47,24,23,280,156,124
,102,2,私立,技專校院,1064,美和科技大學,學士班(進修),1984,51,22,29,296,138,158
,102,2,私立,技專校院,1064,美和科技大學,碩士班(日間),88,5,0,5,15,5,10
,102,2,私立,技專校院,1064,美和科技大學,碩士在職專班,74,3,1,2,14,8,6
,102,2,私立,技專校院,1065,吳鳳科技大學,二專(日間),45,0,0,0,6,5,1
,102,2,私立,技專校院,1065,吳鳳科技大學,二專(進修),81,5,5,0,34,25,9
,102,2,私立,技專校院,1065,吳鳳科技大學,五專,0,0,0,0,2,2,0
,102,2,私立,技專校院,1065,吳鳳科技大學,學士班(日間),4243,84,61,23,268,198,70
,102,2,私立,技專校院,1065,吳鳳科技大學,學士班(進修),1123,49,36,13,239,180,59
,102,2,私立,技專校院,1065,吳鳳科技大學,碩士班(日間),45,5,5,0,10,10,0
,102,2,私立,技專校院,1065,吳鳳科技大學,碩士在職專班,79,1,1,0,7,4,3
,102,2,私立,技專校院,1066,環球科技大學,二專(日間),104,3,1,2,35,19,16
,102,2,私立,技專校院,1066,環球科技大學,二專(進修),506,6,3,3,24,13,11
,102,2,私立,技專校院,1066,環球科技大學,學士班(日間),4077,72,43,29,386,224,162
,102,2,私立,技專校院,1066,環球科技大學,學士班(進修),1435,18,10,8,30,19,11
,102,2,私立,技專校院,1066,環球科技大學,碩士班(日間),112,4,3,1,18,10,8
,102,2,私立,技專校院,1066,環球科技大學,碩士在職專班,31,0,0,0,0,0,0
,102,2,私立,技專校院,1068,中州科技大學,二專(日間),22,0,0,0,1,1,0
,102,2,私立,技專校院,1068,中州科技大學,學士班(日間),3577,48,31,17,182,125,57
,102,2,私立,技專校院,1068,中州科技大學,學士班(進修),1831,18,16,2,96,70,26
,102,2,私立,技專校院,1068,中州科技大學,碩士班(日間),80,1,1,0,4,4,0
,102,2,私立,技專校院,1068,中州科技大學,碩士在職專班,34,1,1,0,3,2,1
,102,2,私立,技專校院,1069,修平科技大學,二專(日間),15,0,0,0,0,0,0
,102,2,私立,技專校院,1069,修平科技大學,二專(進修),53,10,10,0,23,21,2
,102,2,私立,技專校院,1069,修平科技大學,學士班(日間),5491,209,154,55,449,321,128
,102,2,私立,技專校院,1069,修平科技大學,學士班(進修),1035,81,70,11,216,181,35
,102,2,私立,技專校院,1069,修平科技大學,碩士班(日間),64,4,4,0,15,14,1
,102,2,私立,技專校院,1070,長庚科技大學,五專,1984,7,0,7,21,0,21
,102,2,私立,技專校院,1070,長庚科技大學,學士班(日間),3654,21,1,20,58,4,54
,102,2,私立,技專校院,1070,長庚科技大學,學士班(進修),2012,56,2,54,147,7,140
,102,2,私立,技專校院,1070,長庚科技大學,碩士班(日間),10,0,0,0,0,0,0
,102,2,私立,技專校院,1070,長庚科技大學,碩士在職專班,37,5,0,5,9,0,9
,102,2,私立,技專校院,1071,臺北城市科技大學,二專(日間),187,2,1,1,30,25,5
,102,2,私立,技專校院,1071,臺北城市科技大學,二專(進修),146,18,16,2,54,40,14
,102,2,私立,技專校院,1071,臺北城市科技大學,五專,1664,41,27,14,113,86,27
,102,2,私立,技專校院,1071,臺北城市科技大學,學士班(日間),6810,162,108,54,567,410,157
,102,2,私立,技專校院,1071,臺北城市科技大學,學士班(進修),1046,62,47,15,224,174,50
,102,2,私立,技專校院,1071,臺北城市科技大學,碩士班(日間),95,7,7,0,24,19,5
,102,2,私立,技專校院,1072,大華科技大學,二專(日間),1,0,0,0,0,0,0
,102,2,私立,技專校院,1072,大華科技大學,二專(進修),63,0,0,0,0,0,0
,102,2,私立,技專校院,1072,大華科技大學,五專,1468,30,16,14,104,61,43
,102,2,私立,技專校院,1072,大華科技大學,學士班(日間),1868,39,28,11,144,107,37
,102,2,私立,技專校院,1072,大華科技大學,學士班(進修),1283,20,18,2,20,18,2
,102,2,私立,技專校院,1072,大華科技大學,碩士班(日間),29,2,2,0,5,5,0
,102,2,私立,技專校院,1072,大華科技大學,碩士在職專班,14,0,0,0,0,0,0
,102,2,私立,技專校院,1073,醒吾科技大學,二專(日間),54,0,0,0,0,0,0
,102,2,私立,技專校院,1073,醒吾科技大學,二專(進修),2,0,0,0,0,0,0
,102,2,私立,技專校院,1073,醒吾科技大學,五專,1412,18,8,10,91,28,63
,102,2,私立,技專校院,1073,醒吾科技大學,學士班(日間),5545,70,32,38,253,116,137
,102,2,私立,技專校院,1073,醒吾科技大學,學士班(進修),1437,107,66,41,277,181,96
,102,2,私立,技專校院,1073,醒吾科技大學,碩士班(日間),70,1,1,0,14,8,6
,102,2,私立,技專校院,1073,醒吾科技大學,碩士在職專班,28,1,0,1,3,0,3
,102,2,私立,技專校院,1074,南榮科技大學,二專(進修),252,8,7,1,13,12,1
,102,2,私立,技專校院,1074,南榮科技大學,五專,329,9,4,5,11,5,6
,102,2,私立,技專校院,1074,南榮科技大學,學士班(日間),1456,17,14,3,52,40,12
,102,2,私立,技專校院,1074,南榮科技大學,學士班(進修),950,24,17,7,55,42,13
,102,2,私立,技專校院,1074,南榮科技大學,碩士班(日間),24,0,0,0,1,1,0
,102,2,私立,技專校院,1074,南榮科技大學,碩士在職專班,19,0,0,0,3,3,0
,102,2,私立,技專校院,1075,文藻外語大學,五專,1734,7,0,7,51,14,37
,102,2,私立,技專校院,1075,文藻外語大學,學士班(日間),5335,58,23,35,267,97,170
,102,2,私立,技專校院,1075,文藻外語大學,學士班(進修),1915,83,26,57,333,132,201
,102,2,私立,技專校院,1075,文藻外語大學,碩士班(日間),90,15,4,11,33,9,24
,102,2,私立,技專校院,1075,文藻外語大學,碩士在職專班,62,5,2,3,20,6,14
,102,2,私立,技專校院,1148,大漢技術學院,二專(進修),201,1,0,1,3,3,0
,102,2,私立,技專校院,1148,大漢技術學院,學士班(日間),1068,20,15,5,92,72,20
,102,2,私立,技專校院,1148,大漢技術學院,學士班(進修),909,13,5,8,67,52,15
,102,2,私立,技專校院,1148,大漢技術學院,碩士班(日間),55,0,0,0,2,1,1
,102,2,私立,技專校院,1150,慈濟技術學院,五專,1154,13,0,13,28,1,27
,102,2,私立,技專校院,1150,慈濟技術學院,學士班(日間),1286,11,2,9,53,22,31
,102,2,私立,技專校院,1150,慈濟技術學院,學士班(進修),94,4,0,4,21,0,21
,102,2,私立,技專校院,1150,慈濟技術學院,碩士班(日間),15,2,1,1,5,3,2
,102,2,私立,技專校院,1154,永達技術學院,二專(日間),12,0,0,0,0,0,0
,102,2,私立,技專校院,1154,永達技術學院,二專(進修),79,0,0,0,0,0,0
,102,2,私立,技專校院,1154,永達技術學院,五專,129,0,0,0,0,0,0
,102,2,私立,技專校院,1154,永達技術學院,學士班(日間),258,0,0,0,0,0,0
,102,2,私立,技專校院,1154,永達技術學院,學士班(進修),365,0,0,0,0,0,0
,102,2,私立,技專校院,1154,永達技術學院,碩士班(日間),20,0,0,0,0,0,0
,102,2,私立,技專校院,1159,和春技術學院,二專(進修),181,5,5,0,38,32,6
,102,2,私立,技專校院,1159,和春技術學院,五專,387,4,1,3,30,15,15
,102,2,私立,技專校院,1159,和春技術學院,學士班(日間),1603,43,34,9,161,118,43
,102,2,私立,技專校院,1159,和春技術學院,學士班(進修),790,31,26,5,157,132,25
,102,2,私立,技專校院,1159,和春技術學院,碩士班(日間),10,0,0,0,2,2,0
,102,2,私立,技專校院,1164,致理技術學院,二專(日間),321,2,1,1,30,25,5
,102,2,私立,技專校院,1164,致理技術學院,二專(進修),0,0,0,0,1,0,1
,102,2,私立,技專校院,1164,致理技術學院,五專,1498,12,3,9,47,15,32
,102,2,私立,技專校院,1164,致理技術學院,學士班(日間),6238,57,27,30,224,115,109
,102,2,私立,技專校院,1164,致理技術學院,學士班(進修),3269,62,13,49,279,97,182
,102,2,私立,技專校院,1164,致理技術學院,碩士班(日間),20,1,1,0,7,2,5
,102,2,私立,技專校院,1164,致理技術學院,碩士在職專班,29,4,2,2,6,3,3
,102,2,私立,技專校院,1166,亞東技術學院,二專(日間),23,0,0,0,0,0,0
,102,2,私立,技專校院,1166,亞東技術學院,學士班(日間),4886,71,63,8,257,206,51
,102,2,私立,技專校院,1166,亞東技術學院,學士班(進修),566,10,6,4,90,54,36
,102,2,私立,技專校院,1166,亞東技術學院,碩士班(日間),82,6,5,1,26,21,5
,102,2,私立,技專校院,1168,桃園創新技術學院,二專(日間),350,0,0,0,0,0,0
,102,2,私立,技專校院,1168,桃園創新技術學院,學士班(日間),4855,80,46,34,314,203,111
,102,2,私立,技專校院,1168,桃園創新技術學院,學士班(進修),1447,62,39,23,365,244,121
,102,2,私立,技專校院,1168,桃園創新技術學院,碩士班(日間),29,0,0,0,2,2,0
,102,2,私立,技專校院,1179,德霖技術學院,二專(日間),214,0,0,0,0,0,0
,102,2,私立,技專校院,1179,德霖技術學院,二專(進修),477,15,10,5,45,26,19
,102,2,私立,技專校院,1179,德霖技術學院,五專,1902,27,16,11,103,81,22
,102,2,私立,技專校院,1179,德霖技術學院,學士班(日間),3481,103,67,36,308,209,99
,102,2,私立,技專校院,1179,德霖技術學院,學士班(進修),2147,74,55,19,204,160,44
,102,2,私立,技專校院,1182,蘭陽技術學院,二專(日間),42,0,0,0,1,0,1
,102,2,私立,技專校院,1182,蘭陽技術學院,二專(進修),38,0,0,0,0,0,0
,102,2,私立,技專校院,1182,蘭陽技術學院,五專,1025,59,39,20,108,74,34
,102,2,私立,技專校院,1182,蘭陽技術學院,學士班(日間),1604,32,25,7,104,83,21
,102,2,私立,技專校院,1182,蘭陽技術學院,學士班(進修),53,0,0,0,0,0,0
,102,2,私立,技專校院,1183,黎明技術學院,二專(進修),133,0,0,0,7,7,0
,102,2,私立,技專校院,1183,黎明技術學院,五專,947,16,15,1,84,77,7
,102,2,私立,技專校院,1183,黎明技術學院,學士班(日間),2586,71,39,32,301,191,110
,102,2,私立,技專校院,1183,黎明技術學院,學士班(進修),1005,38,30,8,320,253,67
,102,2,私立,技專校院,1184,東方設計學院,二專(日間),22,0,0,0,14,8,6
,102,2,私立,技專校院,1184,東方設計學院,五專,1451,27,12,15,97,49,48
,102,2,私立,技專校院,1184,東方設計學院,學士班(日間),2201,68,29,39,222,128,94
,102,2,私立,技專校院,1184,東方設計學院,學士班(進修),171,5,3,2,74,59,15
,102,2,私立,技專校院,1184,東方設計學院,碩士班(日間),33,5,3,2,20,14,6
,102,2,私立,技專校院,1184,東方設計學院,碩士在職專班,43,2,1,1,37,14,23
,102,2,私立,技專校院,1185,經國管理暨健康學院,五專,1557,25,5,20,111,37,74
,102,2,私立,技專校院,1185,經國管理暨健康學院,學士班(日間),1844,51,27,24,166,88,78
,102,2,私立,技專校院,1185,經國管理暨健康學院,學士班(進修),619,29,15,14,83,39,44
,102,2,私立,技專校院,1185,經國管理暨健康學院,碩士班(日間),23,1,0,1,6,2,4
,102,2,私立,技專校院,1185,經國管理暨健康學院,碩士在職專班,41,0,0,0,1,0,1
,102,2,私立,技專校院,1187,崇右技術學院,五專,1089,38,25,13,72,42,30
,102,2,私立,技專校院,1187,崇右技術學院,學士班(日間),2435,76,34,42,171,87,84
,102,2,私立,技專校院,1187,崇右技術學院,學士班(進修),1,0,0,0,1,1,0
,102,2,私立,技專校院,1187,崇右技術學院,碩士班(日間),14,0,0,0,1,0,1
,102,2,私立,技專校院,1188,大同技術學院,二專(日間),1,0,0,0,0,0,0
,102,2,私立,技專校院,1188,大同技術學院,二專(進修),70,5,4,1,59,34,25
,102,2,私立,技專校院,1188,大同技術學院,五專,229,9,6,3,62,42,20
,102,2,私立,技專校院,1188,大同技術學院,學士班(日間),1977,37,31,6,361,234,127
,102,2,私立,技專校院,1188,大同技術學院,學士班(進修),939,42,21,21,332,163,169
,102,2,私立,技專校院,1189,亞太創意技術學院,二專(日間),0,0,0,0,7,5,2
,102,2,私立,技專校院,1189,亞太創意技術學院,二專(進修),186,1,0,1,4,0,4
,102,2,私立,技專校院,1189,亞太創意技術學院,學士班(日間),1757,33,21,12,164,100,64
,102,2,私立,技專校院,1189,亞太創意技術學院,學士班(進修),149,0,0,0,0,0,0
,102,2,私立,技專校院,1189,亞太創意技術學院,碩士班(日間),47,2,1,1,3,1,2
,102,2,私立,技專校院,1190,高鳳數位內容學院,五專,95,0,0,0,0,0,0
,102,2,私立,技專校院,1190,高鳳數位內容學院,學士班(日間),351,0,0,0,0,0,0
,102,2,私立,技專校院,1190,高鳳數位內容學院,學士班(進修),166,0,0,0,0,0,0
,102,2,私立,技專校院,1191,華夏技術學院,二專(日間),0,0,0,0,31,27,4
,102,2,私立,技專校院,1191,華夏技術學院,二專(進修),446,12,6,6,276,194,82
,102,2,私立,技專校院,1191,華夏技術學院,五專,477,10,10,0,232,205,27
,102,2,私立,技專校院,1191,華夏技術學院,學士班(日間),3171,57,39,18,508,308,200
,102,2,私立,技專校院,1191,華夏技術學院,學士班(進修),1256,40,34,6,560,401,159
,102,2,私立,技專校院,1191,華夏技術學院,碩士班(日間),8,0,0,0,0,0,0
,102,2,私立,技專校院,1191,華夏技術學院,碩士在職專班,56,1,1,0,6,6,0
,102,2,私立,技專校院,1192,臺灣觀光學院,二專(日間),18,1,1,0,28,22,6
,102,2,私立,技專校院,1192,臺灣觀光學院,二專(進修),139,2,1,1,2,1,1
,102,2,私立,技專校院,1192,臺灣觀光學院,五專,172,5,2,3,29,14,15
,102,2,私立,技專校院,1192,臺灣觀光學院,學士班(日間),1397,23,12,11,128,81,47
,102,2,私立,技專校院,1192,臺灣觀光學院,學士班(進修),236,10,2,8,10,2,8
,102,2,私立,技專校院,1192,臺灣觀光學院,碩士班(日間),9,0,0,0,4,2,2
,102,2,私立,技專校院,1197,台北海洋技術學院,二專(日間),387,28,23,5,88,71,17
,102,2,私立,技專校院,1197,台北海洋技術學院,二專(進修),167,4,3,1,27,22,5
,102,2,私立,技專校院,1197,台北海洋技術學院,五專,1377,48,33,15,66,47,19
,102,2,私立,技專校院,1197,台北海洋技術學院,學士班(日間),4053,123,80,43,288,216,72
,102,2,私立,技專校院,1197,台北海洋技術學院,學士班(進修),389,7,6,1,65,50,15
,102,2,私立,技專校院,1281,康寧醫護暨管理專科學校,二專(日間),128,3,1,2,9,4,5
,102,2,私立,技專校院,1281,康寧醫護暨管理專科學校,二專(進修),276,10,6,4,27,11,16
,102,2,私立,技專校院,1281,康寧醫護暨管理專科學校,五專,2820,36,12,24,110,40,70
,102,2,私立,技專校院,1282,馬偕醫護管理專科學校,二專(日間),132,27,11,16,37,12,25
,102,2,私立,技專校院,1282,馬偕醫護管理專科學校,二專(進修),216,8,0,8,38,6,32
,102,2,私立,技專校院,1282,馬偕醫護管理專科學校,五專,3455,46,10,36,90,16,74
,102,2,私立,技專校院,1283,仁德醫護管理專科學校,二專(日間),1,0,0,0,0,0,0
,102,2,私立,技專校院,1283,仁德醫護管理專科學校,二專(進修),634,1,1,0,4,3,1
,102,2,私立,技專校院,1283,仁德醫護管理專科學校,五專,5879,44,19,25,111,39,72
,102,2,私立,技專校院,1284,樹人醫護管理專科學校,二專(進修),399,8,7,1,41,32,9
,102,2,私立,技專校院,1284,樹人醫護管理專科學校,五專,6285,84,34,50,191,75,116
,102,2,私立,技專校院,1285,慈惠醫護管理專科學校,二專(日間),197,3,2,1,17,12,5
,102,2,私立,技專校院,1285,慈惠醫護管理專科學校,二專(進修),310,9,3,6,44,20,24
,102,2,私立,技專校院,1285,慈惠醫護管理專科學校,五專,5972,76,29,47,176,58,118
,102,2,私立,技專校院,1286,耕莘健康管理專科學校,二專(日間),0,0,0,0,1,0,1
,102,2,私立,技專校院,1286,耕莘健康管理專科學校,二專(進修),97,2,1,1,7,2,5
,102,2,私立,技專校院,1286,耕莘健康管理專科學校,五專,4705,33,6,27,132,30,102
,102,2,私立,技專校院,1287,敏惠醫護管理專科學校,五專,3852,37,8,29,34,7,27
,102,2,私立,技專校院,1288,高美醫護管理專科學校,二專(進修),166,0,0,0,0,0,0
,102,2,私立,技專校院,1288,高美醫護管理專科學校,五專,768,14,6,8,13,6,7
,102,2,私立,技專校院,1289,育英醫護管理專科學校,五專,2045,34,6,28,86,11,75
,102,2,私立,技專校院,1290,崇仁醫護管理專科學校,二專(日間),13,0,0,0,1,0,1
,102,2,私立,技專校院,1290,崇仁醫護管理專科學校,二專(進修),41,0,0,0,1,0,1
,102,2,私立,技專校院,1290,崇仁醫護管理專科學校,五專,3143,26,1,25,47,5,42
,102,2,私立,技專校院,1291,聖母醫護管理專科學校,五專,3797,61,19,42,162,66,96
,102,2,私立,技專校院,1292,新生醫護管理專科學校,二專(進修),57,2,0,2,3,0,3
,102,2,私立,技專校院,1292,新生醫護管理專科學校,五專,5732,55,14,41,113,20,93
,103,1,公立,一般大學,1,國立政治大學,學士班(日間),9639,143,81,62,262,143,119
,103,1,公立,一般大學,1,國立政治大學,碩士班(日間),3816,299,128,171,834,382,452
,103,1,公立,一般大學,1,國立政治大學,碩士在職專班,1625,170,75,95,446,221,225
,103,1,公立,一般大學,1,國立政治大學,博士班,973,127,78,49,352,210,142
,103,1,公立,一般大學,2,國立清華大學,學士班(日間),6280,192,144,48,231,176,55
,103,1,公立,一般大學,2,國立清華大學,碩士班(日間),3920,164,78,86,253,127,126
,103,1,公立,一般大學,2,國立清華大學,碩士在職專班,305,24,10,14,46,25,21
,103,1,公立,一般大學,2,國立清華大學,博士班,1786,208,150,58,348,257,91
,103,1,公立,一般大學,3,國立臺灣大學,學士班(日間),16505,626,384,242,663,411,252
,103,1,公立,一般大學,3,國立臺灣大學,學士班(進修),9,2,2,0,2,2,0
,103,1,公立,一般大學,3,國立臺灣大學,碩士班(日間),9852,785,427,358,1163,634,529
,103,1,公立,一般大學,3,國立臺灣大學,碩士在職專班,1160,250,152,98,314,190,124
,103,1,公立,一般大學,3,國立臺灣大學,博士班,4265,661,446,215,1062,737,325
,103,1,公立,一般大學,4,國立臺灣師範大學,學士班(日間),7865,183,89,94,234,123,111
,103,1,公立,一般大學,4,國立臺灣師範大學,碩士班(日間),3939,679,237,442,837,302,535
,103,1,公立,一般大學,4,國立臺灣師範大學,碩士在職專班,1884,183,65,118,411,122,289
,103,1,公立,一般大學,4,國立臺灣師範大學,博士班,1352,324,142,182,420,192,228
,103,1,公立,一般大學,5,國立成功大學,學士班(日間),11436,270,171,99,371,242,129
,103,1,公立,一般大學,5,國立成功大學,碩士班(日間),6500,233,120,113,518,283,235
,103,1,公立,一般大學,5,國立成功大學,碩士在職專班,1267,85,47,38,201,117,84
,103,1,公立,一般大學,5,國立成功大學,博士班,2495,188,126,62,601,428,173
,103,1,公立,一般大學,6,國立中興大學,學士班(日間),8083,183,116,67,255,164,91
,103,1,公立,一般大學,6,國立中興大學,學士班(進修),1046,39,16,23,62,26,36
,103,1,公立,一般大學,6,國立中興大學,碩士班(日間),3362,209,135,74,416,258,158
,103,1,公立,一般大學,6,國立中興大學,碩士在職專班,1644,144,98,46,385,258,127
,103,1,公立,一般大學,6,國立中興大學,博士班,1215,100,61,39,300,210,90
,103,1,公立,一般大學,7,國立交通大學,學士班(日間),5432,148,103,45,183,132,51
,103,1,公立,一般大學,7,國立交通大學,碩士班(日間),5242,207,114,93,311,183,128
,103,1,公立,一般大學,7,國立交通大學,碩士在職專班,1502,299,226,73,447,340,107
,103,1,公立,一般大學,7,國立交通大學,博士班,1965,245,195,50,396,311,85
,103,1,公立,一般大學,8,國立中央大學,學士班(日間),6098,135,106,29,171,135,36
,103,1,公立,一般大學,8,國立中央大學,碩士班(日間),3264,170,99,71,287,175,112
,103,1,公立,一般大學,8,國立中央大學,碩士在職專班,1327,124,75,49,286,191,95
,103,1,公立,一般大學,8,國立中央大學,博士班,1175,115,83,32,281,217,64
,103,1,公立,一般大學,9,國立中山大學,學士班(日間),4655,73,53,20,108,78,30
,103,1,公立,一般大學,9,國立中山大學,碩士班(日間),2923,193,104,89,359,216,143
,103,1,公立,一般大學,9,國立中山大學,碩士在職專班,858,85,43,42,202,106,96
,103,1,公立,一般大學,9,國立中山大學,博士班,908,82,58,24,185,131,54
,103,1,公立,一般大學,12,國立臺灣海洋大學,學士班(日間),5409,73,57,16,104,81,23
,103,1,公立,一般大學,12,國立臺灣海洋大學,學士班(進修),636,39,25,14,58,36,22
,103,1,公立,一般大學,12,國立臺灣海洋大學,碩士班(日間),1430,87,59,28,155,111,44
,103,1,公立,一般大學,12,國立臺灣海洋大學,碩士在職專班,562,40,29,11,76,55,21
,103,1,公立,一般大學,12,國立臺灣海洋大學,博士班,334,31,24,7,68,52,16
,103,1,公立,一般大學,13,國立中正大學,學士班(日間),6631,112,66,46,158,99,59
,103,1,公立,一般大學,13,國立中正大學,碩士班(日間),2873,216,115,101,357,188,169
,103,1,公立,一般大學,13,國立中正大學,碩士在職專班,1709,264,148,116,378,208,170
,103,1,公立,一般大學,13,國立中正大學,博士班,625,85,55,30,154,102,52
,103,1,公立,一般大學,14,國立高雄師範大學,學士班(日間),3433,59,29,30,81,40,41
,103,1,公立,一般大學,14,國立高雄師範大學,碩士班(日間),1428,258,97,161,365,131,234
,103,1,公立,一般大學,14,國立高雄師範大學,碩士在職專班,1286,182,65,117,276,103,173
,103,1,公立,一般大學,14,國立高雄師範大學,博士班,465,66,26,40,97,39,58
,103,1,公立,一般大學,15,國立彰化師範大學,學士班(日間),4858,40,28,12,64,50,14
,103,1,公立,一般大學,15,國立彰化師範大學,碩士班(日間),1527,180,79,101,321,145,176
,103,1,公立,一般大學,15,國立彰化師範大學,碩士在職專班,1235,57,21,36,179,81,98
,103,1,公立,一般大學,15,國立彰化師範大學,博士班,465,55,31,24,101,49,52
,103,1,公立,一般大學,16,國立陽明大學,學士班(日間),2077,55,29,26,77,42,35
,103,1,公立,一般大學,16,國立陽明大學,碩士班(日間),1235,86,30,56,184,64,120
,103,1,公立,一般大學,16,國立陽明大學,碩士在職專班,112,8,1,7,27,5,22
,103,1,公立,一般大學,16,國立陽明大學,博士班,1007,83,50,33,233,131,102
,103,1,公立,一般大學,17,國立臺北大學,學士班(日間),5735,106,56,50,148,86,62
,103,1,公立,一般大學,17,國立臺北大學,學士班(進修),1911,82,45,37,183,107,76
,103,1,公立,一般大學,17,國立臺北大學,碩士班(日間),1312,135,66,69,253,129,124
,103,1,公立,一般大學,17,國立臺北大學,碩士在職專班,470,31,11,20,73,28,45
,103,1,公立,一般大學,17,國立臺北大學,博士班,185,28,19,9,45,31,14
,103,1,公立,一般大學,18,國立嘉義大學,學士班(日間),7864,112,58,54,233,153,80
,103,1,公立,一般大學,18,國立嘉義大學,學士班(進修),2111,97,55,42,260,171,89
,103,1,公立,一般大學,18,國立嘉義大學,碩士班(日間),1576,139,62,77,314,169,145
,103,1,公立,一般大學,18,國立嘉義大學,碩士在職專班,1013,83,41,42,232,98,134
,103,1,公立,一般大學,18,國立嘉義大學,博士班,194,19,10,9,59,35,24
,103,1,公立,一般大學,19,國立高雄大學,學士班(日間),4140,71,47,24,105,72,33
,103,1,公立,一般大學,19,國立高雄大學,學士班(進修),177,18,10,8,37,20,17
,103,1,公立,一般大學,19,國立高雄大學,碩士班(日間),644,47,30,17,101,70,31
,103,1,公立,一般大學,19,國立高雄大學,碩士在職專班,478,49,27,22,135,78,57
,103,1,公立,一般大學,19,國立高雄大學,博士班,15,2,2,0,2,2,0
,103,1,公立,一般大學,20,國立東華大學,學士班(日間),7302,148,91,57,248,165,83
,103,1,公立,一般大學,20,國立東華大學,學士班(進修),0,0,0,0,2,2,0
,103,1,公立,一般大學,20,國立東華大學,碩士班(日間),1851,264,116,148,565,244,321
,103,1,公立,一般大學,20,國立東華大學,碩士在職專班,557,65,25,40,172,74,98
,103,1,公立,一般大學,20,國立東華大學,博士班,383,47,27,20,117,69,48
,103,1,公立,一般大學,21,國立暨南國際大學,學士班(日間),4179,53,31,22,76,46,30
,103,1,公立,一般大學,21,國立暨南國際大學,學士班(進修),1,0,0,0,0,0,0
,103,1,公立,一般大學,21,國立暨南國際大學,碩士班(日間),1108,105,54,51,184,95,89
,103,1,公立,一般大學,21,國立暨南國際大學,碩士在職專班,370,29,16,13,52,30,22
,103,1,公立,一般大學,21,國立暨南國際大學,博士班,324,43,27,16,76,46,30
,103,1,公立,一般大學,28,國立臺北藝術大學,五專,86,2,1,1,3,2,1
,103,1,公立,一般大學,28,國立臺北藝術大學,學士班(日間),1700,57,23,34,95,43,52
,103,1,公立,一般大學,28,國立臺北藝術大學,碩士班(日間),935,178,58,120,327,114,213
,103,1,公立,一般大學,28,國立臺北藝術大學,碩士在職專班,140,15,4,11,39,14,25
,103,1,公立,一般大學,28,國立臺北藝術大學,博士班,61,12,4,8,25,6,19
,103,1,公立,一般大學,29,國立臺灣藝術大學,學士班(日間),2280,45,17,28,83,32,51
,103,1,公立,一般大學,29,國立臺灣藝術大學,學士班(進修),1918,80,28,52,154,48,106
,103,1,公立,一般大學,29,國立臺灣藝術大學,碩士班(日間),727,96,31,65,179,69,110
,103,1,公立,一般大學,29,國立臺灣藝術大學,碩士在職專班,397,44,16,28,92,28,64
,103,1,公立,一般大學,29,國立臺灣藝術大學,博士班,81,7,3,4,15,6,9
,103,1,公立,一般大學,30,國立臺東大學,學士班(日間),3480,71,46,25,146,96,50
,103,1,公立,一般大學,30,國立臺東大學,學士班(進修),196,19,11,8,45,27,18
,103,1,公立,一般大學,30,國立臺東大學,碩士班(日間),303,57,18,39,132,50,82
,103,1,公立,一般大學,30,國立臺東大學,碩士在職專班,631,56,24,32,112,52,60
,103,1,公立,一般大學,30,國立臺東大學,博士班,44,5,3,2,9,5,4
,103,1,公立,一般大學,31,國立宜蘭大學,學士班(日間),4275,49,35,14,95,73,22
,103,1,公立,一般大學,31,國立宜蘭大學,學士班(進修),533,31,24,7,91,79,12
,103,1,公立,一般大學,31,國立宜蘭大學,碩士班(日間),534,24,13,11,43,28,15
,103,1,公立,一般大學,31,國立宜蘭大學,碩士在職專班,178,19,15,4,43,35,8
,103,1,公立,一般大學,31,國立宜蘭大學,博士班,13,0,0,0,1,1,0
,103,1,公立,一般大學,32,國立聯合大學,學士班(日間),6069,109,93,16,194,169,25
,103,1,公立,一般大學,32,國立聯合大學,學士班(進修),1452,60,47,13,130,102,28
,103,1,公立,一般大學,32,國立聯合大學,碩士班(日間),466,24,18,6,42,31,11
,103,1,公立,一般大學,32,國立聯合大學,博士班,6,1,1,0,3,3,0
,103,1,公立,一般大學,35,國立臺南藝術大學,五專,163,2,1,1,3,1,2
,103,1,公立,一般大學,35,國立臺南藝術大學,學士班(日間),731,23,7,16,38,14,24
,103,1,公立,一般大學,35,國立臺南藝術大學,學士班(進修),2,1,0,1,1,0,1
,103,1,公立,一般大學,35,國立臺南藝術大學,碩士班(日間),565,57,15,42,168,63,105
,103,1,公立,一般大學,35,國立臺南藝術大學,碩士在職專班,45,7,1,6,25,5,20
,103,1,公立,一般大學,35,國立臺南藝術大學,博士班,48,4,2,2,10,7,3
,103,1,公立,一般大學,36,國立臺南大學,學士班(日間),3858,46,27,19,76,44,32
,103,1,公立,一般大學,36,國立臺南大學,學士班(進修),276,5,2,3,19,10,9
,103,1,公立,一般大學,36,國立臺南大學,碩士班(日間),1069,106,45,61,262,98,164
,103,1,公立,一般大學,36,國立臺南大學,碩士在職專班,708,75,25,50,134,43,91
,103,1,公立,一般大學,36,國立臺南大學,博士班,184,18,7,11,29,15,14
,103,1,公立,一般大學,37,國立臺北教育大學,學士班(日間),3270,69,39,30,100,46,54
,103,1,公立,一般大學,37,國立臺北教育大學,碩士班(日間),1140,209,58,151,304,100,204
,103,1,公立,一般大學,37,國立臺北教育大學,碩士在職專班,1068,79,18,61,210,53,157
,103,1,公立,一般大學,37,國立臺北教育大學,博士班,144,28,11,17,39,16,23
,103,1,公立,一般大學,38,國立新竹教育大學,學士班(日間),2535,40,17,23,63,26,37
,103,1,公立,一般大學,38,國立新竹教育大學,碩士班(日間),788,65,15,50,174,46,128
,103,1,公立,一般大學,38,國立新竹教育大學,碩士在職專班,582,30,2,28,63,9,54
,103,1,公立,一般大學,38,國立新竹教育大學,博士班,80,6,2,4,13,3,10
,103,1,公立,一般大學,39,國立臺中教育大學,學士班(日間),3407,44,21,23,67,37,30
,103,1,公立,一般大學,39,國立臺中教育大學,碩士班(日間),843,97,37,60,180,70,110
,103,1,公立,一般大學,39,國立臺中教育大學,碩士在職專班,705,45,9,36,74,16,58
,103,1,公立,一般大學,39,國立臺中教育大學,博士班,128,12,6,6,17,8,9
,103,1,公立,一般大學,44,國立體育大學,學士班(日間),1497,28,22,6,68,58,10
,103,1,公立,一般大學,44,國立體育大學,學士班(進修),95,5,5,0,20,16,4
,103,1,公立,一般大學,44,國立體育大學,碩士班(日間),319,63,46,17,121,81,40
,103,1,公立,一般大學,44,國立體育大學,碩士在職專班,198,28,14,14,55,30,25
,103,1,公立,一般大學,44,國立體育大學,博士班,131,16,10,6,20,14,6
,103,1,公立,一般大學,48,國立金門大學,學士班(日間),3068,63,37,26,101,67,34
,103,1,公立,一般大學,48,國立金門大學,學士班(進修),796,40,27,13,29,21,8
,103,1,公立,一般大學,48,國立金門大學,碩士班(日間),208,27,16,11,43,28,15
,103,1,公立,一般大學,48,國立金門大學,碩士在職專班,41,1,1,0,1,1,0
,103,1,公立,一般大學,49,國立臺灣體育運動大學,學士班(日間),2416,108,88,20,190,147,43
,103,1,公立,一般大學,49,國立臺灣體育運動大學,學士班(進修),402,28,22,6,45,34,11
,103,1,公立,一般大學,49,國立臺灣體育運動大學,碩士班(日間),275,49,26,23,103,52,51
,103,1,公立,一般大學,49,國立臺灣體育運動大學,碩士在職專班,103,6,5,1,7,6,1
,103,1,公立,一般大學,52,國立屏東大學,學士班(日間),6582,83,44,39,144,70,74
,103,1,公立,一般大學,52,國立屏東大學,學士班(進修),701,25,11,14,74,31,43
,103,1,公立,一般大學,52,國立屏東大學,碩士班(日間),993,157,65,92,236,99,137
,103,1,公立,一般大學,52,國立屏東大學,碩士在職專班,522,37,13,24,72,23,49
,103,1,公立,一般大學,52,國立屏東大學,博士班,53,5,1,4,5,1,4
,103,1,公立,一般大學,3002,臺北市立大學,學士班(日間),4971,136,87,49,235,151,84
,103,1,公立,一般大學,3002,臺北市立大學,碩士班(日間),1233,150,51,99,280,89,191
,103,1,公立,一般大學,3002,臺北市立大學,碩士在職專班,986,56,19,37,116,39,77
,103,1,公立,一般大學,3002,臺北市立大學,博士班,236,35,12,23,60,22,38
,103,1,公立,技專校院,22,國立臺灣科技大學,學士班(日間),5408,100,75,25,150,107,43
,103,1,公立,技專校院,22,國立臺灣科技大學,學士班(進修),40,6,2,4,12,3,9
,103,1,公立,技專校院,22,國立臺灣科技大學,碩士班(日間),3130,138,80,58,205,121,84
,103,1,公立,技專校院,22,國立臺灣科技大學,碩士在職專班,788,88,75,13,159,124,35
,103,1,公立,技專校院,22,國立臺灣科技大學,博士班,1005,154,115,39,261,206,55
,103,1,公立,技專校院,23,國立雲林科技大學,學士班(日間),6339,67,46,21,156,107,49
,103,1,公立,技專校院,23,國立雲林科技大學,碩士班(日間),2041,119,75,44,272,161,111
,103,1,公立,技專校院,23,國立雲林科技大學,碩士在職專班,740,61,38,23,163,104,59
,103,1,公立,技專校院,23,國立雲林科技大學,博士班,471,51,37,14,135,96,39
,103,1,公立,技專校院,24,國立屏東科技大學,學士班(日間),7719,104,59,45,177,109,68
,103,1,公立,技專校院,24,國立屏東科技大學,學士班(進修),1455,42,30,12,111,68,43
,103,1,公立,技專校院,24,國立屏東科技大學,碩士班(日間),1408,122,70,52,227,124,103
,103,1,公立,技專校院,24,國立屏東科技大學,碩士在職專班,566,63,47,16,122,92,30
,103,1,公立,技專校院,24,國立屏東科技大學,博士班,234,21,11,10,49,26,23
,103,1,公立,技專校院,25,國立臺北科技大學,學士班(日間),5956,158,124,34,202,159,43
,103,1,公立,技專校院,25,國立臺北科技大學,學士班(進修),1145,65,52,13,81,67,14
,103,1,公立,技專校院,25,國立臺北科技大學,碩士班(日間),2626,94,74,20,136,109,27
,103,1,公立,技專校院,25,國立臺北科技大學,碩士在職專班,1220,197,144,53,251,190,61
,103,1,公立,技專校院,25,國立臺北科技大學,博士班,713,52,44,8,100,85,15
,103,1,公立,技專校院,26,國立高雄第一科技大學,學士班(日間),5660,57,31,26,120,76,44
,103,1,公立,技專校院,26,國立高雄第一科技大學,碩士班(日間),1128,82,45,37,141,86,55
,103,1,公立,技專校院,26,國立高雄第一科技大學,碩士在職專班,722,82,61,21,146,114,32
,103,1,公立,技專校院,26,國立高雄第一科技大學,博士班,224,32,27,5,47,39,8
,103,1,公立,技專校院,27,國立高雄應用科技大學,學士班(日間),7601,92,72,20,159,119,40
,103,1,公立,技專校院,27,國立高雄應用科技大學,學士班(進修),1687,86,64,22,179,123,56
,103,1,公立,技專校院,27,國立高雄應用科技大學,碩士班(日間),1333,75,51,24,132,97,35
,103,1,公立,技專校院,27,國立高雄應用科技大學,碩士在職專班,1281,100,70,30,241,171,70
,103,1,公立,技專校院,27,國立高雄應用科技大學,博士班,286,31,28,3,46,41,5
,103,1,公立,技專校院,33,國立虎尾科技大學,學士班(日間),7760,82,65,17,253,204,49
,103,1,公立,技專校院,33,國立虎尾科技大學,學士班(進修),1280,33,25,8,83,68,15
,103,1,公立,技專校院,33,國立虎尾科技大學,碩士班(日間),865,29,24,5,126,103,23
,103,1,公立,技專校院,33,國立虎尾科技大學,碩士在職專班,285,18,12,6,22,17,5
,103,1,公立,技專校院,33,國立虎尾科技大學,博士班,27,2,2,0,6,6,0
,103,1,公立,技專校院,34,國立高雄海洋科技大學,五專,499,5,4,1,10,8,2
,103,1,公立,技專校院,34,國立高雄海洋科技大學,學士班(日間),4956,81,54,27,173,129,44
,103,1,公立,技專校院,34,國立高雄海洋科技大學,學士班(進修),1852,37,24,13,107,70,37
,103,1,公立,技專校院,34,國立高雄海洋科技大學,碩士班(日間),334,37,26,11,69,51,18
,103,1,公立,技專校院,34,國立高雄海洋科技大學,碩士在職專班,175,17,17,0,30,22,8
,103,1,公立,技專校院,34,國立高雄海洋科技大學,博士班,3,0,0,0,0,0,0
,103,1,公立,技專校院,42,國立澎湖科技大學,二專(進修),17,0,0,0,0,0,0
,103,1,公立,技專校院,42,國立澎湖科技大學,學士班(日間),2544,11,9,2,57,38,19
,103,1,公立,技專校院,42,國立澎湖科技大學,學士班(進修),321,4,3,1,25,12,13
,103,1,公立,技專校院,42,國立澎湖科技大學,碩士班(日間),89,7,5,2,23,14,9
,103,1,公立,技專校院,42,國立澎湖科技大學,碩士在職專班,43,3,1,2,11,6,5
,103,1,公立,技專校院,43,國立勤益科技大學,二專(日間),101,7,4,3,13,9,4
,103,1,公立,技專校院,43,國立勤益科技大學,二專(進修),7,0,0,0,0,0,0
,103,1,公立,技專校院,43,國立勤益科技大學,學士班(日間),6780,124,88,36,327,233,94
,103,1,公立,技專校院,43,國立勤益科技大學,學士班(進修),3514,128,107,21,183,150,33
,103,1,公立,技專校院,43,國立勤益科技大學,碩士班(日間),613,55,47,8,85,75,10
,103,1,公立,技專校院,43,國立勤益科技大學,碩士在職專班,228,32,27,5,28,24,4
,103,1,公立,技專校院,43,國立勤益科技大學,博士班,9,0,0,0,0,0,0
,103,1,公立,技專校院,46,國立臺北護理健康大學,學士班(日間),2908,42,11,31,87,23,64
,103,1,公立,技專校院,46,國立臺北護理健康大學,學士班(進修),693,26,0,26,80,0,80
,103,1,公立,技專校院,46,國立臺北護理健康大學,碩士班(日間),575,86,6,80,198,22,176
,103,1,公立,技專校院,46,國立臺北護理健康大學,碩士在職專班,180,25,3,22,51,6,45
,103,1,公立,技專校院,46,國立臺北護理健康大學,博士班,53,10,0,10,23,0,23
,103,1,公立,技專校院,47,國立高雄餐旅大學,二專(進修),243,34,16,18,34,16,18
,103,1,公立,技專校院,47,國立高雄餐旅大學,五專,220,5,2,3,7,4,3
,103,1,公立,技專校院,47,國立高雄餐旅大學,學士班(日間),3269,57,20,37,107,38,69
,103,1,公立,技專校院,47,國立高雄餐旅大學,學士班(進修),1165,19,3,16,44,15,29
,103,1,公立,技專校院,47,國立高雄餐旅大學,碩士班(日間),190,17,5,12,34,14,20
,103,1,公立,技專校院,47,國立高雄餐旅大學,碩士在職專班,88,6,4,2,12,8,4
,103,1,公立,技專校院,47,國立高雄餐旅大學,博士班,17,0,0,0,2,0,2
,103,1,公立,技專校院,50,國立臺中科技大學,二專(日間),162,13,1,12,17,2,15
,103,1,公立,技專校院,50,國立臺中科技大學,二專(進修),198,17,0,17,25,0,25
,103,1,公立,技專校院,50,國立臺中科技大學,五專,3903,33,11,22,69,25,44
,103,1,公立,技專校院,50,國立臺中科技大學,學士班(日間),6296,80,27,53,138,42,96
,103,1,公立,技專校院,50,國立臺中科技大學,學士班(進修),2657,129,35,94,198,59,139
,103,1,公立,技專校院,50,國立臺中科技大學,碩士班(日間),371,15,9,6,40,24,16
,103,1,公立,技專校院,50,國立臺中科技大學,碩士在職專班,132,11,5,6,18,8,10
,103,1,公立,技專校院,51,國立臺北商業大學,二專(進修),560,17,4,13,27,7,20
,103,1,公立,技專校院,51,國立臺北商業大學,五專,1896,73,24,49,107,34,73
,103,1,公立,技專校院,51,國立臺北商業大學,學士班(日間),2650,62,23,39,98,36,62
,103,1,公立,技專校院,51,國立臺北商業大學,學士班(進修),1649,51,23,28,117,52,65
,103,1,公立,技專校院,51,國立臺北商業大學,碩士班(日間),165,8,6,2,8,7,1
,103,1,公立,技專校院,51,國立臺北商業大學,碩士在職專班,21,1,0,1,7,4,3
,103,1,公立,技專校院,144,國立臺灣戲曲學院,學士班(日間),484,19,8,11,42,22,20
,103,1,公立,技專校院,144,國立臺灣戲曲學院,學士班(進修),44,5,3,2,6,3,3
,103,1,公立,技專校院,221,國立臺南護理專科學校,二專(日間),90,4,0,4,7,1,6
,103,1,公立,技專校院,221,國立臺南護理專科學校,二專(進修),83,5,0,5,22,2,20
,103,1,公立,技專校院,221,國立臺南護理專科學校,五專,1758,15,0,15,31,0,31
,103,1,公立,技專校院,222,國立臺東專科學校,二專(日間),444,1,1,0,28,16,12
,103,1,公立,技專校院,222,國立臺東專科學校,二專(進修),171,15,9,6,15,9,6
,103,1,公立,技專校院,222,國立臺東專科學校,五專,613,1,1,0,26,16,10
,103,1,私立,一般大學,1001,東海大學,學士班(日間),13687,280,160,120,551,332,219
,103,1,私立,一般大學,1001,東海大學,學士班(進修),668,50,33,17,172,111,61
,103,1,私立,一般大學,1001,東海大學,碩士班(日間),1613,103,46,57,357,174,183
,103,1,私立,一般大學,1001,東海大學,碩士在職專班,778,65,34,31,192,96,96
,103,1,私立,一般大學,1001,東海大學,博士班,218,26,17,9,69,40,29
,103,1,私立,一般大學,1002,輔仁大學,學士班(日間),18002,573,250,323,961,438,523
,103,1,私立,一般大學,1002,輔仁大學,學士班(進修),4759,57,19,38,111,46,65
,103,1,私立,一般大學,1002,輔仁大學,碩士班(日間),2165,295,109,186,647,264,383
,103,1,私立,一般大學,1002,輔仁大學,碩士在職專班,1617,106,53,53,381,179,202
,103,1,私立,一般大學,1002,輔仁大學,博士班,441,72,33,39,191,93,98
,103,1,私立,一般大學,1003,東吳大學,學士班(日間),11911,266,134,132,352,181,171
,103,1,私立,一般大學,1003,東吳大學,學士班(進修),1239,71,27,44,130,52,78
,103,1,私立,一般大學,1003,東吳大學,碩士班(日間),1193,197,94,103,285,137,148
,103,1,私立,一般大學,1003,東吳大學,碩士在職專班,1158,123,61,62,219,93,126
,103,1,私立,一般大學,1003,東吳大學,博士班,96,14,7,7,21,10,11
,103,1,私立,一般大學,1004,中原大學,學士班(日間),13020,217,142,75,460,323,137
,103,1,私立,一般大學,1004,中原大學,學士班(進修),0,0,0,0,1,1,0
,103,1,私立,一般大學,1004,中原大學,碩士班(日間),1815,103,62,41,321,194,127
,103,1,私立,一般大學,1004,中原大學,碩士在職專班,1039,85,56,29,278,192,86
,103,1,私立,一般大學,1004,中原大學,博士班,366,44,33,11,117,88,29
,103,1,私立,一般大學,1005,淡江大學,學士班(日間),20840,472,264,208,897,554,343
,103,1,私立,一般大學,1005,淡江大學,學士班(進修),2432,103,50,53,300,160,140
,103,1,私立,一般大學,1005,淡江大學,碩士班(日間),2057,151,88,63,420,255,165
,103,1,私立,一般大學,1005,淡江大學,碩士在職專班,1250,101,54,47,270,139,131
,103,1,私立,一般大學,1005,淡江大學,博士班,481,55,33,22,150,96,54
,103,1,私立,一般大學,1006,中國文化大學,學士班(日間),20928,489,266,223,791,443,348
,103,1,私立,一般大學,1006,中國文化大學,學士班(進修),2782,243,131,112,561,286,275
,103,1,私立,一般大學,1006,中國文化大學,碩士班(日間),1665,190,109,81,408,238,170
,103,1,私立,一般大學,1006,中國文化大學,碩士在職專班,629,31,14,17,117,50,67
,103,1,私立,一般大學,1006,中國文化大學,博士班,519,59,35,24,99,52,47
,103,1,私立,一般大學,1007,逢甲大學,學士班(日間),16860,377,290,87,456,350,106
,103,1,私立,一般大學,1007,逢甲大學,學士班(進修),945,84,46,38,106,62,44
,103,1,私立,一般大學,1007,逢甲大學,碩士班(日間),1648,157,110,47,201,145,56
,103,1,私立,一般大學,1007,逢甲大學,碩士在職專班,1150,123,75,48,162,94,68
,103,1,私立,一般大學,1007,逢甲大學,博士班,411,58,39,19,79,55,24
,103,1,私立,一般大學,1008,靜宜大學,學士班(日間),11177,210,99,111,374,206,168
,103,1,私立,一般大學,1008,靜宜大學,學士班(進修),81,3,1,2,9,3,6
,103,1,私立,一般大學,1008,靜宜大學,碩士班(日間),629,64,21,43,127,54,73
,103,1,私立,一般大學,1008,靜宜大學,碩士在職專班,325,22,11,11,37,16,21
,103,1,私立,一般大學,1008,靜宜大學,博士班,37,7,5,2,8,6,2
,103,1,私立,一般大學,1009,長庚大學,學士班(日間),5167,88,38,50,120,60,60
,103,1,私立,一般大學,1009,長庚大學,碩士班(日間),1360,88,37,51,196,87,109
,103,1,私立,一般大學,1009,長庚大學,碩士在職專班,329,38,24,14,110,70,40
,103,1,私立,一般大學,1009,長庚大學,博士班,537,39,28,11,101,63,38
,103,1,私立,一般大學,1010,元智大學,學士班(日間),7188,65,42,23,120,86,34
,103,1,私立,一般大學,1010,元智大學,學士班(進修),1,0,0,0,0,0,0
,103,1,私立,一般大學,1010,元智大學,碩士班(日間),1139,41,30,11,94,62,32
,103,1,私立,一般大學,1010,元智大學,碩士在職專班,995,58,37,21,129,85,44
,103,1,私立,一般大學,1010,元智大學,博士班,326,20,16,4,64,48,16
,103,1,私立,一般大學,1011,中華大學,學士班(日間),7222,155,106,49,301,215,86
,103,1,私立,一般大學,1011,中華大學,學士班(進修),397,12,8,4,29,20,9
,103,1,私立,一般大學,1011,中華大學,碩士班(日間),664,24,17,7,91,71,20
,103,1,私立,一般大學,1011,中華大學,碩士在職專班,283,24,15,9,55,37,18
,103,1,私立,一般大學,1011,中華大學,博士班,132,11,10,1,38,28,10
,103,1,私立,一般大學,1012,大葉大學,學士班(日間),8508,160,110,50,339,256,83
,103,1,私立,一般大學,1012,大葉大學,學士班(進修),1262,45,30,15,105,73,32
,103,1,私立,一般大學,1012,大葉大學,碩士班(日間),846,46,27,19,117,70,47
,103,1,私立,一般大學,1012,大葉大學,碩士在職專班,879,27,14,13,61,34,27
,103,1,私立,一般大學,1012,大葉大學,博士班,154,17,11,6,51,33,18
,103,1,私立,一般大學,1013,華梵大學,學士班(日間),2740,104,52,52,175,105,70
,103,1,私立,一般大學,1013,華梵大學,碩士班(日間),328,25,14,11,88,53,35
,103,1,私立,一般大學,1013,華梵大學,碩士在職專班,351,29,18,11,79,51,28
,103,1,私立,一般大學,1013,華梵大學,博士班,56,3,1,2,14,11,3
,103,1,私立,一般大學,1014,義守大學,學士班(日間),12814,101,87,14,153,123,30
,103,1,私立,一般大學,1014,義守大學,學士班(進修),2506,116,86,30,309,216,93
,103,1,私立,一般大學,1014,義守大學,碩士班(日間),597,13,11,2,29,23,6
,103,1,私立,一般大學,1014,義守大學,碩士在職專班,496,15,7,8,56,34,22
,103,1,私立,一般大學,1014,義守大學,博士班,143,7,5,2,13,9,4
,103,1,私立,一般大學,1015,世新大學,學士班(日間),9865,157,65,92,279,124,155
,103,1,私立,一般大學,1015,世新大學,學士班(進修),180,2,1,1,6,2,4
,103,1,私立,一般大學,1015,世新大學,碩士班(日間),774,99,59,40,180,93,87
,103,1,私立,一般大學,1015,世新大學,碩士在職專班,997,81,40,41,250,127,123
,103,1,私立,一般大學,1015,世新大學,博士班,73,11,4,7,21,10,11
,103,1,私立,一般大學,1016,銘傳大學,學士班(日間),17524,417,219,198,650,365,285
,103,1,私立,一般大學,1016,銘傳大學,碩士班(日間),809,68,42,26,118,68,50
,103,1,私立,一般大學,1016,銘傳大學,碩士在職專班,882,50,20,30,94,36,58
,103,1,私立,一般大學,1016,銘傳大學,博士班,65,7,4,3,14,9,5
,103,1,私立,一般大學,1017,實踐大學,學士班(日間),12407,243,97,146,407,185,222
,103,1,私立,一般大學,1017,實踐大學,學士班(進修),2592,128,31,97,234,72,162
,103,1,私立,一般大學,1017,實踐大學,碩士班(日間),378,65,36,29,103,60,43
,103,1,私立,一般大學,1017,實踐大學,碩士在職專班,193,23,10,13,49,26,23
,103,1,私立,一般大學,1017,實踐大學,博士班,8,0,0,0,1,0,1
,103,1,私立,一般大學,1019,高雄醫學大學,學士班(日間),5659,149,68,81,193,93,100
,103,1,私立,一般大學,1019,高雄醫學大學,學士班(進修),150,1,0,1,5,0,5
,103,1,私立,一般大學,1019,高雄醫學大學,碩士班(日間),610,70,30,40,126,55,71
,103,1,私立,一般大學,1019,高雄醫學大學,碩士在職專班,220,23,14,9,54,24,30
,103,1,私立,一般大學,1019,高雄醫學大學,博士班,342,35,18,17,85,51,34
,103,1,私立,一般大學,1020,南華大學,學士班(日間),3926,80,49,31,207,126,81
,103,1,私立,一般大學,1020,南華大學,學士班(進修),173,9,6,3,20,16,4
,103,1,私立,一般大學,1020,南華大學,碩士班(日間),691,48,28,20,180,90,90
,103,1,私立,一般大學,1020,南華大學,碩士在職專班,488,19,9,10,85,44,41
,103,1,私立,一般大學,1020,南華大學,博士班,24,2,2,0,7,5,2
,103,1,私立,一般大學,1021,真理大學,學士班(日間),8033,222,146,76,315,222,93
,103,1,私立,一般大學,1021,真理大學,學士班(進修),678,52,32,20,92,62,30
,103,1,私立,一般大學,1021,真理大學,碩士班(日間),147,6,3,3,14,8,6
,103,1,私立,一般大學,1021,真理大學,碩士在職專班,9,0,0,0,0,0,0
,103,1,私立,一般大學,1022,大同大學,學士班(日間),3683,61,40,21,130,95,35
,103,1,私立,一般大學,1022,大同大學,碩士班(日間),440,13,11,2,79,65,14
,103,1,私立,一般大學,1022,大同大學,碩士在職專班,437,37,32,5,263,227,36
,103,1,私立,一般大學,1022,大同大學,博士班,150,10,9,1,50,43,7
,103,1,私立,一般大學,1027,慈濟大學,學士班(日間),2858,76,33,43,94,42,52
,103,1,私立,一般大學,1027,慈濟大學,碩士班(日間),330,37,17,20,74,31,43
,103,1,私立,一般大學,1027,慈濟大學,碩士在職專班,40,1,0,1,10,4,6
,103,1,私立,一般大學,1027,慈濟大學,博士班,102,18,4,14,39,12,27
,103,1,私立,一般大學,1028,臺北醫學大學,學士班(日間),4544,126,64,62,169,83,86
,103,1,私立,一般大學,1028,臺北醫學大學,學士班(進修),121,0,0,0,2,0,2
,103,1,私立,一般大學,1028,臺北醫學大學,碩士班(日間),638,33,12,21,78,34,44
,103,1,私立,一般大學,1028,臺北醫學大學,碩士在職專班,224,17,1,16,39,5,34
,103,1,私立,一般大學,1028,臺北醫學大學,博士班,402,29,18,11,62,35,27
,103,1,私立,一般大學,1029,中山醫學大學,學士班(日間),6423,150,79,71,200,106,94
,103,1,私立,一般大學,1029,中山醫學大學,學士班(進修),289,22,10,12,29,15,14
,103,1,私立,一般大學,1029,中山醫學大學,碩士班(日間),510,30,8,22,44,13,31
,103,1,私立,一般大學,1029,中山醫學大學,碩士在職專班,117,6,4,2,8,4,4
,103,1,私立,一般大學,1029,中山醫學大學,博士班,227,22,10,12,35,18,17
,103,1,私立,一般大學,1033,長榮大學,學士班(日間),9100,218,130,88,356,231,125
,103,1,私立,一般大學,1033,長榮大學,學士班(進修),646,23,16,7,33,24,9
,103,1,私立,一般大學,1033,長榮大學,碩士班(日間),500,68,30,38,114,57,57
,103,1,私立,一般大學,1033,長榮大學,碩士在職專班,190,20,8,12,41,18,23
,103,1,私立,一般大學,1033,長榮大學,博士班,38,9,6,3,14,11,3
,103,1,私立,一般大學,1035,中國醫藥大學,學士班(日間),6355,183,92,91,364,186,178
,103,1,私立,一般大學,1035,中國醫藥大學,學士班(進修),84,6,3,3,22,3,19
,103,1,私立,一般大學,1035,中國醫藥大學,碩士班(日間),517,29,13,16,82,35,47
,103,1,私立,一般大學,1035,中國醫藥大學,碩士在職專班,77,3,1,2,5,2,3
,103,1,私立,一般大學,1035,中國醫藥大學,博士班,337,42,19,23,96,51,45
,103,1,私立,一般大學,1039,玄奘大學,學士班(日間),4183,117,62,55,270,144,126
,103,1,私立,一般大學,1039,玄奘大學,學士班(進修),1331,102,47,55,213,108,105
,103,1,私立,一般大學,1039,玄奘大學,碩士班(日間),376,49,19,30,121,56,65
,103,1,私立,一般大學,1039,玄奘大學,碩士在職專班,232,16,5,11,45,16,29
,103,1,私立,一般大學,1039,玄奘大學,博士班,16,0,0,0,1,1,0
,103,1,私立,一般大學,1048,亞洲大學,學士班(日間),9602,242,148,94,682,409,273
,103,1,私立,一般大學,1048,亞洲大學,學士班(進修),1354,106,71,35,294,177,117
,103,1,私立,一般大學,1048,亞洲大學,碩士班(日間),625,67,34,33,206,110,96
,103,1,私立,一般大學,1048,亞洲大學,碩士在職專班,526,19,12,7,67,33,34
,103,1,私立,一般大學,1048,亞洲大學,博士班,164,16,5,11,44,17,27
,103,1,私立,一般大學,1049,開南大學,學士班(日間),7758,186,145,41,458,339,119
,103,1,私立,一般大學,1049,開南大學,學士班(進修),1319,47,31,16,152,105,47
,103,1,私立,一般大學,1049,開南大學,碩士班(日間),298,22,15,7,82,56,26
,103,1,私立,一般大學,1049,開南大學,碩士在職專班,367,6,5,1,29,20,9
,103,1,私立,一般大學,1050,佛光大學,學士班(日間),2803,57,28,29,103,53,50
,103,1,私立,一般大學,1050,佛光大學,碩士班(日間),659,82,39,43,196,96,100
,103,1,私立,一般大學,1050,佛光大學,碩士在職專班,243,24,13,11,39,23,16
,103,1,私立,一般大學,1050,佛光大學,博士班,47,2,1,1,7,3,4
,103,1,私立,一般大學,1058,明道大學,學士班(日間),3672,60,41,19,110,72,38
,103,1,私立,一般大學,1058,明道大學,學士班(進修),1732,91,62,29,83,53,30
,103,1,私立,一般大學,1058,明道大學,碩士班(日間),192,17,12,5,49,30,19
,103,1,私立,一般大學,1058,明道大學,碩士在職專班,71,1,0,1,3,2,1
,103,1,私立,一般大學,1058,明道大學,博士班,8,1,0,1,1,0,1
,103,1,私立,一般大學,1059,康寧大學,學士班(日間),1166,52,32,20,223,154,69
,103,1,私立,一般大學,1059,康寧大學,學士班(進修),456,39,28,11,118,82,36
,103,1,私立,一般大學,1059,康寧大學,碩士班(日間),201,15,6,9,60,30,30
,103,1,私立,一般大學,1059,康寧大學,碩士在職專班,182,7,6,1,22,15,7
,103,1,私立,一般大學,1067,台灣首府大學,學士班(日間),3592,74,43,31,144,92,52
,103,1,私立,一般大學,1067,台灣首府大學,學士班(進修),942,41,29,12,54,41,13
,103,1,私立,一般大學,1067,台灣首府大學,碩士班(日間),69,7,5,2,8,6,2
,103,1,私立,一般大學,1067,台灣首府大學,碩士在職專班,7,0,0,0,0,0,0
,103,1,私立,一般大學,1125,中信金融管理學院,學士班(日間),197,6,2,4,6,2,4
,103,1,私立,一般大學,1125,中信金融管理學院,學士班(進修),277,9,6,3,9,6,3
,103,1,私立,一般大學,1176,稻江科技暨管理學院,學士班(日間),1755,36,17,19,106,59,47
,103,1,私立,一般大學,1176,稻江科技暨管理學院,學士班(進修),845,16,7,9,62,34,28
,103,1,私立,一般大學,1176,稻江科技暨管理學院,碩士班(日間),67,2,1,1,6,3,3
,103,1,私立,一般大學,1176,稻江科技暨管理學院,碩士在職專班,52,0,0,0,0,0,0
,103,1,私立,一般大學,1195,馬偕醫學院,學士班(日間),509,10,5,5,10,5,5
,103,1,私立,一般大學,1195,馬偕醫學院,學士班(進修),11,0,0,0,0,0,0
,103,1,私立,一般大學,1195,馬偕醫學院,碩士班(日間),10,3,1,2,4,1,3
,103,1,私立,一般大學,1196,法鼓文理學院,學士班(日間),48,2,2,0,2,2,0
,103,1,私立,一般大學,1196,法鼓文理學院,碩士班(日間),70,7,7,0,7,7,0
,103,1,私立,一般大學,1196,法鼓文理學院,博士班,8,1,1,0,1,1,0
,103,1,私立,一般大學,1R02,基督教台灣浸會神學院,碩士班(日間),47,0,0,0,0,0,0
,103,1,私立,一般大學,1R03,臺北基督學院,學士班(日間),116,4,2,2,10,5,5
,103,1,私立,技專校院,1018,朝陽科技大學,學士班(日間),11675,152,85,67,344,215,129
,103,1,私立,技專校院,1018,朝陽科技大學,學士班(進修),3543,193,91,102,357,177,180
,103,1,私立,技專校院,1018,朝陽科技大學,碩士班(日間),767,88,47,41,192,101,91
,103,1,私立,技專校院,1018,朝陽科技大學,碩士在職專班,497,26,15,11,72,33,39
,103,1,私立,技專校院,1018,朝陽科技大學,博士班,88,1,1,0,11,9,2
,103,1,私立,技專校院,1023,南臺科技大學,學士班(日間),13281,181,113,68,419,277,142
,103,1,私立,技專校院,1023,南臺科技大學,學士班(進修),4613,231,153,78,593,394,199
,103,1,私立,技專校院,1023,南臺科技大學,碩士班(日間),1013,63,47,16,200,142,58
,103,1,私立,技專校院,1023,南臺科技大學,碩士在職專班,474,39,19,20,96,58,38
,103,1,私立,技專校院,1023,南臺科技大學,博士班,61,3,3,0,10,10,0
,103,1,私立,技專校院,1024,崑山科技大學,學士班(日間),8669,244,156,88,586,392,194
,103,1,私立,技專校院,1024,崑山科技大學,學士班(進修),3384,226,162,64,681,470,211
,103,1,私立,技專校院,1024,崑山科技大學,碩士班(日間),463,34,24,10,102,79,23
,103,1,私立,技專校院,1024,崑山科技大學,碩士在職專班,190,8,7,1,28,21,7
,103,1,私立,技專校院,1024,崑山科技大學,博士班,33,2,2,0,6,6,0
,103,1,私立,技專校院,1025,嘉南藥理大學,學士班(日間),13119,225,97,128,600,307,293
,103,1,私立,技專校院,1025,嘉南藥理大學,學士班(進修),3375,215,132,83,623,372,251
,103,1,私立,技專校院,1025,嘉南藥理大學,碩士班(日間),329,31,17,14,101,67,34
,103,1,私立,技專校院,1025,嘉南藥理大學,碩士在職專班,197,23,9,14,47,22,25
,103,1,私立,技專校院,1026,樹德科技大學,學士班(日間),8242,272,162,110,272,162,110
,103,1,私立,技專校院,1026,樹德科技大學,學士班(進修),2261,163,108,55,163,108,55
,103,1,私立,技專校院,1026,樹德科技大學,碩士班(日間),377,57,32,25,57,32,25
,103,1,私立,技專校院,1026,樹德科技大學,碩士在職專班,497,36,21,15,36,21,15
,103,1,私立,技專校院,1026,樹德科技大學,博士班,23,4,1,3,5,2,3
,103,1,私立,技專校院,1030,龍華科技大學,二專(日間),49,0,0,0,0,0,0
,103,1,私立,技專校院,1030,龍華科技大學,學士班(日間),6712,111,81,30,337,260,77
,103,1,私立,技專校院,1030,龍華科技大學,學士班(進修),4053,209,150,59,304,221,83
,103,1,私立,技專校院,1030,龍華科技大學,碩士班(日間),355,12,9,3,41,36,5
,103,1,私立,技專校院,1030,龍華科技大學,碩士在職專班,85,5,1,4,7,2,5
,103,1,私立,技專校院,1031,輔英科技大學,五專,3058,44,10,34,75,15,60
,103,1,私立,技專校院,1031,輔英科技大學,學士班(日間),5342,135,70,65,356,185,171
,103,1,私立,技專校院,1031,輔英科技大學,學士班(進修),1192,53,32,21,154,86,68
,103,1,私立,技專校院,1031,輔英科技大學,碩士班(日間),128,11,1,10,32,6,26
,103,1,私立,技專校院,1031,輔英科技大學,碩士在職專班,46,7,0,7,10,0,10
,103,1,私立,技專校院,1032,明新科技大學,二專(日間),22,0,0,0,0,0,0
,103,1,私立,技專校院,1032,明新科技大學,二專(進修),122,1,1,0,1,1,0
,103,1,私立,技專校院,1032,明新科技大學,學士班(日間),8788,198,136,62,1036,634,402
,103,1,私立,技專校院,1032,明新科技大學,學士班(進修),3935,250,171,79,344,238,106
,103,1,私立,技專校院,1032,明新科技大學,碩士班(日間),364,33,24,9,176,126,50
,103,1,私立,技專校院,1032,明新科技大學,碩士在職專班,236,15,13,2,28,23,5
,103,1,私立,技專校院,1034,弘光科技大學,二專(進修),22,2,1,1,2,1,1
,103,1,私立,技專校院,1034,弘光科技大學,五專,273,3,0,3,6,0,6
,103,1,私立,技專校院,1034,弘光科技大學,學士班(日間),7941,128,60,68,340,148,192
,103,1,私立,技專校院,1034,弘光科技大學,學士班(進修),4296,186,72,114,540,230,310
,103,1,私立,技專校院,1034,弘光科技大學,碩士班(日間),205,22,5,17,60,24,36
,103,1,私立,技專校院,1034,弘光科技大學,碩士在職專班,99,13,5,8,30,10,20
,103,1,私立,技專校院,1036,健行科技大學,二專(日間),140,0,0,0,3,3,0
,103,1,私立,技專校院,1036,健行科技大學,學士班(日間),8420,179,135,44,377,288,89
,103,1,私立,技專校院,1036,健行科技大學,學士班(進修),3572,185,134,51,257,183,74
,103,1,私立,技專校院,1036,健行科技大學,碩士班(日間),348,9,7,2,36,28,8
,103,1,私立,技專校院,1036,健行科技大學,碩士在職專班,149,2,1,1,10,7,3
,103,1,私立,技專校院,1037,正修科技大學,二專(日間),16,1,1,0,7,6,1
,103,1,私立,技專校院,1037,正修科技大學,二專(進修),9,0,0,0,7,5,2
,103,1,私立,技專校院,1037,正修科技大學,五專,15,0,0,0,0,0,0
,103,1,私立,技專校院,1037,正修科技大學,學士班(日間),10031,254,150,104,494,307,187
,103,1,私立,技專校院,1037,正修科技大學,學士班(進修),6995,469,302,167,957,641,316
,103,1,私立,技專校院,1037,正修科技大學,碩士班(日間),340,27,17,10,60,46,14
,103,1,私立,技專校院,1037,正修科技大學,碩士在職專班,101,5,4,1,11,9,2
,103,1,私立,技專校院,1037,正修科技大學,博士班,11,1,1,0,2,2,0
,103,1,私立,技專校院,1038,萬能科技大學,學士班(日間),6474,88,47,41,420,278,142
,103,1,私立,技專校院,1038,萬能科技大學,學士班(進修),4161,69,51,18,423,274,149
,103,1,私立,技專校院,1038,萬能科技大學,碩士班(日間),147,8,4,4,45,35,10
,103,1,私立,技專校院,1038,萬能科技大學,碩士在職專班,136,2,2,0,16,13,3
,103,1,私立,技專校院,1040,建國科技大學,二專(日間),36,0,0,0,0,0,0
,103,1,私立,技專校院,1040,建國科技大學,二專(進修),5,1,1,0,2,2,0
,103,1,私立,技專校院,1040,建國科技大學,學士班(日間),7407,188,131,57,337,239,98
,103,1,私立,技專校院,1040,建國科技大學,學士班(進修),1816,63,45,18,108,79,29
,103,1,私立,技專校院,1040,建國科技大學,碩士班(日間),210,9,8,1,17,15,2
,103,1,私立,技專校院,1041,明志科技大學,二專(進修),2,0,0,0,0,0,0
,103,1,私立,技專校院,1041,明志科技大學,五專,39,0,0,0,1,0,1
,103,1,私立,技專校院,1041,明志科技大學,學士班(日間),3465,20,12,8,28,20,8
,103,1,私立,技專校院,1041,明志科技大學,學士班(進修),498,21,12,9,28,17,11
,103,1,私立,技專校院,1041,明志科技大學,碩士班(日間),415,23,20,3,31,26,5
,103,1,私立,技專校院,1041,明志科技大學,碩士在職專班,46,7,7,0,13,13,0
,103,1,私立,技專校院,1042,高苑科技大學,二專(日間),12,1,1,0,1,1,0
,103,1,私立,技專校院,1042,高苑科技大學,學士班(日間),5826,143,96,47,185,131,54
,103,1,私立,技專校院,1042,高苑科技大學,學士班(進修),1465,38,30,8,77,62,15
,103,1,私立,技專校院,1042,高苑科技大學,碩士班(日間),131,5,4,1,8,6,2
,103,1,私立,技專校院,1042,高苑科技大學,碩士在職專班,289,4,2,2,8,4,4
,103,1,私立,技專校院,1043,大仁科技大學,五專,3,4,2,2,22,11,11
,103,1,私立,技專校院,1043,大仁科技大學,學士班(日間),5643,207,137,70,685,443,242
,103,1,私立,技專校院,1043,大仁科技大學,學士班(進修),1901,78,55,23,417,244,173
,103,1,私立,技專校院,1043,大仁科技大學,碩士班(日間),65,8,4,4,32,24,8
,103,1,私立,技專校院,1043,大仁科技大學,碩士在職專班,145,10,7,3,24,11,13
,103,1,私立,技專校院,1044,聖約翰科技大學,學士班(日間),5173,166,125,41,431,330,101
,103,1,私立,技專校院,1044,聖約翰科技大學,學士班(進修),481,27,20,7,103,79,24
,103,1,私立,技專校院,1044,聖約翰科技大學,碩士班(日間),181,12,12,0,40,34,6
,103,1,私立,技專校院,1044,聖約翰科技大學,碩士在職專班,90,1,1,0,10,9,1
,103,1,私立,技專校院,1045,嶺東科技大學,二專(日間),46,0,0,0,0,0,0
,103,1,私立,技專校院,1045,嶺東科技大學,學士班(日間),7640,91,41,50,179,96,83
,103,1,私立,技專校院,1045,嶺東科技大學,學士班(進修),2561,139,79,60,268,161,107
,103,1,私立,技專校院,1045,嶺東科技大學,碩士班(日間),231,13,9,4,33,19,14
,103,1,私立,技專校院,1045,嶺東科技大學,碩士在職專班,106,6,6,0,11,10,1
,103,1,私立,技專校院,1046,中國科技大學,學士班(日間),9248,229,108,121,437,240,197
,103,1,私立,技專校院,1046,中國科技大學,學士班(進修),2635,174,107,67,321,209,112
,103,1,私立,技專校院,1046,中國科技大學,碩士班(日間),144,19,13,6,32,19,13
,103,1,私立,技專校院,1046,中國科技大學,碩士在職專班,35,0,0,0,0,0,0
,103,1,私立,技專校院,1047,中臺科技大學,五專,0,1,1,0,2,2,0
,103,1,私立,技專校院,1047,中臺科技大學,學士班(日間),6345,154,83,71,414,223,191
,103,1,私立,技專校院,1047,中臺科技大學,學士班(進修),3007,170,63,107,626,255,371
,103,1,私立,技專校院,1047,中臺科技大學,碩士班(日間),177,31,14,17,50,27,23
,103,1,私立,技專校院,1047,中臺科技大學,碩士在職專班,249,15,0,15,70,13,57
,103,1,私立,技專校院,1047,中臺科技大學,博士班,20,0,0,0,1,1,0
,103,1,私立,技專校院,1051,台南應用科技大學,五專,1211,21,7,14,43,11,32
,103,1,私立,技專校院,1051,台南應用科技大學,學士班(日間),8587,132,51,81,431,164,267
,103,1,私立,技專校院,1051,台南應用科技大學,學士班(進修),2724,163,64,99,287,122,165
,103,1,私立,技專校院,1051,台南應用科技大學,碩士班(日間),154,21,4,17,59,12,47
,103,1,私立,技專校院,1051,台南應用科技大學,碩士在職專班,159,24,5,19,53,9,44
,103,1,私立,技專校院,1052,遠東科技大學,二專(進修),45,0,0,0,0,0,0
,103,1,私立,技專校院,1052,遠東科技大學,五專,0,0,0,0,1,1,0
,103,1,私立,技專校院,1052,遠東科技大學,學士班(日間),7870,203,140,63,574,416,158
,103,1,私立,技專校院,1052,遠東科技大學,學士班(進修),671,22,17,5,76,66,10
,103,1,私立,技專校院,1052,遠東科技大學,碩士班(日間),179,8,6,2,33,25,8
,103,1,私立,技專校院,1052,遠東科技大學,碩士在職專班,45,1,1,0,6,6,0
,103,1,私立,技專校院,1053,元培醫事科技大學,學士班(日間),5733,123,73,50,198,139,59
,103,1,私立,技專校院,1053,元培醫事科技大學,學士班(進修),1400,42,28,14,70,40,30
,103,1,私立,技專校院,1053,元培醫事科技大學,碩士班(日間),222,20,15,5,35,24,11
,103,1,私立,技專校院,1053,元培醫事科技大學,碩士在職專班,26,4,0,4,4,0,4
,103,1,私立,技專校院,1054,景文科技大學,二專(進修),2,0,0,0,0,0,0
,103,1,私立,技專校院,1054,景文科技大學,學士班(日間),5923,43,19,24,135,74,61
,103,1,私立,技專校院,1054,景文科技大學,學士班(進修),2293,140,92,48,214,130,84
,103,1,私立,技專校院,1054,景文科技大學,碩士班(日間),50,2,2,0,7,4,3
,103,1,私立,技專校院,1054,景文科技大學,碩士在職專班,95,14,10,4,15,10,5
,103,1,私立,技專校院,1055,中華醫事科技大學,二專(日間),79,1,0,1,4,2,2
,103,1,私立,技專校院,1055,中華醫事科技大學,五專,2002,22,5,17,45,13,32
,103,1,私立,技專校院,1055,中華醫事科技大學,學士班(日間),5153,124,63,61,323,159,164
,103,1,私立,技專校院,1055,中華醫事科技大學,學士班(進修),1868,115,57,58,371,178,193
,103,1,私立,技專校院,1055,中華醫事科技大學,碩士班(日間),46,4,3,1,13,9,4
,103,1,私立,技專校院,1056,東南科技大學,二專(日間),48,2,2,0,6,4,2
,103,1,私立,技專校院,1056,東南科技大學,學士班(日間),6702,322,227,95,938,729,209
,103,1,私立,技專校院,1056,東南科技大學,學士班(進修),607,31,28,3,178,146,32
,103,1,私立,技專校院,1056,東南科技大學,碩士班(日間),127,2,2,0,17,15,2
,103,1,私立,技專校院,1056,東南科技大學,碩士在職專班,68,5,4,1,6,5,1
,103,1,私立,技專校院,1057,德明財經科技大學,二專(日間),1,0,0,0,0,0,0
,103,1,私立,技專校院,1057,德明財經科技大學,學士班(日間),7244,120,52,68,273,134,139
,103,1,私立,技專校院,1057,德明財經科技大學,學士班(進修),1826,106,57,49,348,176,172
,103,1,私立,技專校院,1057,德明財經科技大學,碩士班(日間),58,8,5,3,25,20,5
,103,1,私立,技專校院,1057,德明財經科技大學,碩士在職專班,52,6,1,5,10,2,8
,103,1,私立,技專校院,1060,南開科技大學,二專(日間),18,0,0,0,0,0,0
,103,1,私立,技專校院,1060,南開科技大學,五專,1129,51,38,13,87,65,22
,103,1,私立,技專校院,1060,南開科技大學,學士班(日間),3723,100,79,21,178,132,46
,103,1,私立,技專校院,1060,南開科技大學,學士班(進修),1221,49,36,13,91,61,30
,103,1,私立,技專校院,1060,南開科技大學,碩士班(日間),112,5,4,1,8,4,4
,103,1,私立,技專校院,1060,南開科技大學,碩士在職專班,143,0,0,0,6,4,2
,103,1,私立,技專校院,1061,中華科技大學,二專(進修),4,3,0,3,21,7,14
,103,1,私立,技專校院,1061,中華科技大學,學士班(日間),6697,231,171,60,674,479,195
,103,1,私立,技專校院,1061,中華科技大學,學士班(進修),1388,114,85,29,566,413,153
,103,1,私立,技專校院,1061,中華科技大學,碩士班(日間),295,20,19,1,68,57,11
,103,1,私立,技專校院,1061,中華科技大學,碩士在職專班,128,14,12,2,49,45,4
,103,1,私立,技專校院,1062,僑光科技大學,二專(日間),137,3,3,0,6,6,0
,103,1,私立,技專校院,1062,僑光科技大學,二專(進修),86,0,0,0,1,0,1
,103,1,私立,技專校院,1062,僑光科技大學,五專,463,9,7,2,21,14,7
,103,1,私立,技專校院,1062,僑光科技大學,學士班(日間),6280,84,43,41,160,93,67
,103,1,私立,技專校院,1062,僑光科技大學,學士班(進修),3732,127,74,53,243,151,92
,103,1,私立,技專校院,1062,僑光科技大學,碩士班(日間),83,4,2,2,7,5,2
,103,1,私立,技專校院,1062,僑光科技大學,碩士在職專班,65,0,0,0,4,0,4
,103,1,私立,技專校院,1063,育達科技大學,學士班(日間),4145,172,111,61,441,280,161
,103,1,私立,技專校院,1063,育達科技大學,學士班(進修),1760,205,126,79,453,293,160
,103,1,私立,技專校院,1063,育達科技大學,碩士班(日間),116,5,4,1,13,8,5
,103,1,私立,技專校院,1063,育達科技大學,碩士在職專班,90,2,2,0,9,8,1
,103,1,私立,技專校院,1064,美和科技大學,二專(進修),21,0,0,0,0,0,0
,103,1,私立,技專校院,1064,美和科技大學,五專,1906,20,6,14,66,20,46
,103,1,私立,技專校院,1064,美和科技大學,學士班(日間),3920,116,56,60,298,163,135
,103,1,私立,技專校院,1064,美和科技大學,學士班(進修),1965,86,28,58,287,126,161
,103,1,私立,技專校院,1064,美和科技大學,碩士班(日間),207,16,7,9,27,10,17
,103,1,私立,技專校院,1064,美和科技大學,碩士在職專班,78,3,2,1,10,5,5
,103,1,私立,技專校院,1065,吳鳳科技大學,二專(日間),14,0,0,0,1,1,0
,103,1,私立,技專校院,1065,吳鳳科技大學,二專(進修),28,6,5,1,23,19,4
,103,1,私立,技專校院,1065,吳鳳科技大學,五專,0,0,0,0,1,1,0
,103,1,私立,技專校院,1065,吳鳳科技大學,學士班(日間),4328,121,74,47,284,203,81
,103,1,私立,技專校院,1065,吳鳳科技大學,學士班(進修),1141,91,70,21,256,195,61
,103,1,私立,技專校院,1065,吳鳳科技大學,碩士班(日間),30,6,6,0,13,13,0
,103,1,私立,技專校院,1065,吳鳳科技大學,碩士在職專班,81,1,1,0,7,4,3
,103,1,私立,技專校院,1066,環球科技大學,二專(日間),34,0,0,0,27,11,16
,103,1,私立,技專校院,1066,環球科技大學,二專(進修),358,5,4,1,12,7,5
,103,1,私立,技專校院,1066,環球科技大學,學士班(日間),4412,155,88,67,396,230,166
,103,1,私立,技專校院,1066,環球科技大學,學士班(進修),1405,21,12,9,33,18,15
,103,1,私立,技專校院,1066,環球科技大學,碩士班(日間),115,9,5,4,17,8,9
,103,1,私立,技專校院,1066,環球科技大學,碩士在職專班,34,2,0,2,2,0,2
,103,1,私立,技專校院,1068,中州科技大學,二專(日間),31,0,0,0,0,0,0
,103,1,私立,技專校院,1068,中州科技大學,學士班(日間),3173,99,73,26,180,133,47
,103,1,私立,技專校院,1068,中州科技大學,學士班(進修),1754,44,31,13,77,60,17
,103,1,私立,技專校院,1068,中州科技大學,碩士班(日間),71,0,0,0,2,2,0
,103,1,私立,技專校院,1068,中州科技大學,碩士在職專班,45,0,0,0,2,1,1
,103,1,私立,技專校院,1069,修平科技大學,二專(日間),14,0,0,0,0,0,0
,103,1,私立,技專校院,1069,修平科技大學,二專(進修),38,5,3,2,15,13,2
,103,1,私立,技專校院,1069,修平科技大學,學士班(日間),5636,172,132,40,357,271,86
,103,1,私立,技專校院,1069,修平科技大學,學士班(進修),872,77,70,7,141,126,15
,103,1,私立,技專校院,1069,修平科技大學,碩士班(日間),72,11,10,1,13,12,1
,103,1,私立,技專校院,1070,長庚科技大學,五專,1686,15,0,15,20,0,20
,103,1,私立,技專校院,1070,長庚科技大學,學士班(日間),3852,54,2,52,72,2,70
,103,1,私立,技專校院,1070,長庚科技大學,學士班(進修),1985,97,4,93,146,6,140
,103,1,私立,技專校院,1070,長庚科技大學,碩士班(日間),38,3,0,3,3,0,3
,103,1,私立,技專校院,1070,長庚科技大學,碩士在職專班,34,7,0,7,12,0,12
,103,1,私立,技專校院,1071,臺北城市科技大學,二專(日間),175,11,9,2,26,22,4
,103,1,私立,技專校院,1071,臺北城市科技大學,二專(進修),80,14,8,6,48,34,14
,103,1,私立,技專校院,1071,臺北城市科技大學,五專,1578,52,41,11,120,95,25
,103,1,私立,技專校院,1071,臺北城市科技大學,學士班(日間),6964,216,147,69,564,402,162
,103,1,私立,技專校院,1071,臺北城市科技大學,學士班(進修),934,55,39,16,166,130,36
,103,1,私立,技專校院,1071,臺北城市科技大學,碩士班(日間),101,1,1,0,17,15,2
,103,1,私立,技專校院,1072,大華科技大學,二專(進修),74,0,0,0,0,0,0
,103,1,私立,技專校院,1072,大華科技大學,五專,1273,5,4,1,36,18,18
,103,1,私立,技專校院,1072,大華科技大學,學士班(日間),1608,13,11,2,61,48,13
,103,1,私立,技專校院,1072,大華科技大學,學士班(進修),1275,31,23,8,52,42,10
,103,1,私立,技專校院,1072,大華科技大學,碩士班(日間),28,3,3,0,5,5,0
,103,1,私立,技專校院,1072,大華科技大學,碩士在職專班,6,0,0,0,0,0,0
,103,1,私立,技專校院,1073,醒吾科技大學,二專(日間),27,0,0,0,0,0,0
,103,1,私立,技專校院,1073,醒吾科技大學,五專,1323,37,12,25,109,31,78
,103,1,私立,技專校院,1073,醒吾科技大學,學士班(日間),5911,130,79,51,305,160,145
,103,1,私立,技專校院,1073,醒吾科技大學,學士班(進修),1410,79,55,24,313,210,103
,103,1,私立,技專校院,1073,醒吾科技大學,碩士班(日間),84,3,2,1,15,9,6
,103,1,私立,技專校院,1073,醒吾科技大學,碩士在職專班,48,0,0,0,3,0,3
,103,1,私立,技專校院,1074,南榮科技大學,二專(進修),351,7,1,6,12,5,7
,103,1,私立,技專校院,1074,南榮科技大學,五專,317,14,12,2,20,15,5
,103,1,私立,技專校院,1074,南榮科技大學,學士班(日間),1638,26,20,6,45,35,10
,103,1,私立,技專校院,1074,南榮科技大學,學士班(進修),1233,22,17,5,49,38,11
,103,1,私立,技專校院,1074,南榮科技大學,碩士班(日間),25,0,0,0,1,1,0
,103,1,私立,技專校院,1074,南榮科技大學,碩士在職專班,34,0,0,0,2,2,0
,103,1,私立,技專校院,1075,文藻外語大學,五專,1768,36,7,29,67,16,51
,103,1,私立,技專校院,1075,文藻外語大學,學士班(日間),5435,131,42,89,278,101,177
,103,1,私立,技專校院,1075,文藻外語大學,學士班(進修),1902,161,52,109,317,113,204
,103,1,私立,技專校院,1075,文藻外語大學,碩士班(日間),86,7,3,4,32,9,23
,103,1,私立,技專校院,1075,文藻外語大學,碩士在職專班,72,13,5,8,25,7,18
,103,1,私立,技專校院,1076,華夏科技大學,二專(日間),0,0,0,0,31,27,4
,103,1,私立,技專校院,1076,華夏科技大學,二專(進修),345,40,16,24,266,177,89
,103,1,私立,技專校院,1076,華夏科技大學,五專,473,6,6,0,202,178,24
,103,1,私立,技專校院,1076,華夏科技大學,學士班(日間),3258,101,64,37,498,309,189
,103,1,私立,技專校院,1076,華夏科技大學,學士班(進修),1156,70,51,19,491,345,146
,103,1,私立,技專校院,1076,華夏科技大學,碩士班(日間),21,1,1,0,1,1,0
,103,1,私立,技專校院,1076,華夏科技大學,碩士在職專班,65,2,2,0,7,7,0
,103,1,私立,技專校院,1148,大漢技術學院,二專(進修),215,15,11,4,20,16,4
,103,1,私立,技專校院,1148,大漢技術學院,學士班(日間),943,29,15,14,124,91,33
,103,1,私立,技專校院,1148,大漢技術學院,學士班(進修),791,16,11,5,68,53,15
,103,1,私立,技專校院,1148,大漢技術學院,碩士班(日間),73,0,0,0,2,1,1
,103,1,私立,技專校院,1150,慈濟技術學院,五專,1208,12,2,10,23,3,20
,103,1,私立,技專校院,1150,慈濟技術學院,學士班(日間),1377,42,22,20,61,33,28
,103,1,私立,技專校院,1150,慈濟技術學院,學士班(進修),106,7,1,6,18,1,17
,103,1,私立,技專校院,1150,慈濟技術學院,碩士班(日間),20,1,1,0,4,3,1
,103,1,私立,技專校院,1159,和春技術學院,二專(進修),193,6,6,0,36,32,4
,103,1,私立,技專校院,1159,和春技術學院,五專,400,13,6,7,20,9,11
,103,1,私立,技專校院,1159,和春技術學院,學士班(日間),1459,54,36,18,129,96,33
,103,1,私立,技專校院,1159,和春技術學院,學士班(進修),856,47,28,19,203,159,44
,103,1,私立,技專校院,1159,和春技術學院,碩士班(日間),10,3,3,0,3,3,0
,103,1,私立,技專校院,1164,致理技術學院,二專(日間),238,14,6,8,35,24,11
,103,1,私立,技專校院,1164,致理技術學院,五專,1590,21,11,10,54,24,30
,103,1,私立,技專校院,1164,致理技術學院,學士班(日間),6737,104,51,53,241,124,117
,103,1,私立,技專校院,1164,致理技術學院,學士班(進修),3138,148,56,92,304,121,183
,103,1,私立,技專校院,1164,致理技術學院,碩士班(日間),21,2,1,1,6,2,4
,103,1,私立,技專校院,1164,致理技術學院,碩士在職專班,27,2,1,1,8,4,4
,103,1,私立,技專校院,1166,亞東技術學院,二專(日間),33,0,0,0,0,0,0
,103,1,私立,技專校院,1166,亞東技術學院,學士班(日間),4877,97,59,38,266,192,74
,103,1,私立,技專校院,1166,亞東技術學院,學士班(進修),292,17,15,2,72,53,19
,103,1,私立,技專校院,1166,亞東技術學院,碩士班(日間),61,3,2,1,17,15,2
,103,1,私立,技專校院,1168,桃園創新技術學院,二專(日間),245,0,0,0,0,0,0
,103,1,私立,技專校院,1168,桃園創新技術學院,學士班(日間),4532,149,86,63,287,182,105
,103,1,私立,技專校院,1168,桃園創新技術學院,學士班(進修),1258,91,61,30,311,211,100
,103,1,私立,技專校院,1168,桃園創新技術學院,碩士班(日間),45,1,1,0,1,1,0
,103,1,私立,技專校院,1179,德霖技術學院,二專(日間),183,0,0,0,0,0,0
,103,1,私立,技專校院,1179,德霖技術學院,二專(進修),436,20,13,7,38,25,13
,103,1,私立,技專校院,1179,德霖技術學院,五專,1809,100,75,25,141,113,28
,103,1,私立,技專校院,1179,德霖技術學院,學士班(日間),3306,147,95,52,302,219,83
,103,1,私立,技專校院,1179,德霖技術學院,學士班(進修),1848,66,47,19,179,139,40
,103,1,私立,技專校院,1182,蘭陽技術學院,二專(日間),17,0,0,0,0,0,0
,103,1,私立,技專校院,1182,蘭陽技術學院,二專(進修),3,1,1,0,1,1,0
,103,1,私立,技專校院,1182,蘭陽技術學院,五專,840,35,25,10,96,65,31
,103,1,私立,技專校院,1182,蘭陽技術學院,學士班(日間),1235,39,33,6,77,65,12
,103,1,私立,技專校院,1182,蘭陽技術學院,學士班(進修),13,0,0,0,0,0,0
,103,1,私立,技專校院,1183,黎明技術學院,二專(進修),136,3,1,2,10,8,2
,103,1,私立,技專校院,1183,黎明技術學院,五專,943,17,14,3,94,86,8
,103,1,私立,技專校院,1183,黎明技術學院,學士班(日間),2666,84,50,34,378,237,141
,103,1,私立,技專校院,1183,黎明技術學院,學士班(進修),857,58,45,13,363,285,78
,103,1,私立,技專校院,1184,東方設計學院,二專(日間),11,0,0,0,14,8,6
,103,1,私立,技專校院,1184,東方設計學院,五專,1591,81,40,41,133,63,70
,103,1,私立,技專校院,1184,東方設計學院,學士班(日間),2106,100,57,43,259,151,108
,103,1,私立,技專校院,1184,東方設計學院,學士班(進修),152,6,0,6,79,57,22
,103,1,私立,技專校院,1184,東方設計學院,碩士班(日間),47,4,4,0,24,18,6
,103,1,私立,技專校院,1184,東方設計學院,碩士在職專班,63,5,3,2,35,15,20
,103,1,私立,技專校院,1184,東方設計學院,博士班,3,0,0,0,0,0,0
,103,1,私立,技專校院,1185,經國管理暨健康學院,五專,1636,44,18,26,97,38,59
,103,1,私立,技專校院,1185,經國管理暨健康學院,學士班(日間),1867,80,41,39,179,97,82
,103,1,私立,技專校院,1185,經國管理暨健康學院,學士班(進修),534,27,7,20,69,29,40
,103,1,私立,技專校院,1185,經國管理暨健康學院,碩士班(日間),23,3,1,2,6,2,4
,103,1,私立,技專校院,1185,經國管理暨健康學院,碩士在職專班,44,1,1,0,2,1,1
,103,1,私立,技專校院,1187,崇右技術學院,五專,913,61,30,31,92,51,41
,103,1,私立,技專校院,1187,崇右技術學院,學士班(日間),2265,132,67,65,204,99,105
,103,1,私立,技專校院,1187,崇右技術學院,碩士班(日間),40,3,1,2,3,1,2
,103,1,私立,技專校院,1188,大同技術學院,二專(日間),0,5,4,1,58,44,14
,103,1,私立,技專校院,1188,大同技術學院,二專(進修),54,8,5,3,22,15,7
,103,1,私立,技專校院,1188,大同技術學院,五專,231,9,7,2,71,48,23
,103,1,私立,技專校院,1188,大同技術學院,學士班(日間),1776,89,44,45,466,289,177
,103,1,私立,技專校院,1188,大同技術學院,學士班(進修),852,49,25,24,187,117,70
,103,1,私立,技專校院,1189,亞太創意技術學院,二專(進修),201,3,0,3,7,0,7
,103,1,私立,技專校院,1189,亞太創意技術學院,學士班(日間),1323,52,30,22,146,87,59
,103,1,私立,技專校院,1189,亞太創意技術學院,學士班(進修),217,1,0,1,1,0,1
,103,1,私立,技專校院,1189,亞太創意技術學院,碩士班(日間),61,4,1,3,7,2,5
,103,1,私立,技專校院,1192,臺灣觀光學院,二專(日間),29,1,1,0,13,9,4
,103,1,私立,技專校院,1192,臺灣觀光學院,二專(進修),104,4,2,2,4,2,2
,103,1,私立,技專校院,1192,臺灣觀光學院,五專,191,13,7,6,23,9,14
,103,1,私立,技專校院,1192,臺灣觀光學院,學士班(日間),1200,34,22,12,97,62,35
,103,1,私立,技專校院,1192,臺灣觀光學院,學士班(進修),215,9,5,4,9,5,4
,103,1,私立,技專校院,1192,臺灣觀光學院,碩士班(日間),20,1,0,1,2,0,2
,103,1,私立,技專校院,1197,台北海洋技術學院,二專(日間),337,16,11,5,100,80,20
,103,1,私立,技專校院,1197,台北海洋技術學院,二專(進修),142,4,4,0,33,27,6
,103,1,私立,技專校院,1197,台北海洋技術學院,五專,1404,27,18,9,103,72,31
,103,1,私立,技專校院,1197,台北海洋技術學院,學士班(日間),4229,88,42,46,340,239,101
,103,1,私立,技專校院,1197,台北海洋技術學院,學士班(進修),304,6,5,1,76,60,16
,103,1,私立,技專校院,1281,康寧醫護暨管理專科學校,二專(日間),115,1,0,1,4,2,2
,103,1,私立,技專校院,1281,康寧醫護暨管理專科學校,二專(進修),301,15,3,12,23,9,14
,103,1,私立,技專校院,1281,康寧醫護暨管理專科學校,五專,2811,34,12,22,79,30,49
,103,1,私立,技專校院,1282,馬偕醫護管理專科學校,二專(日間),82,9,3,6,15,6,9
,103,1,私立,技專校院,1282,馬偕醫護管理專科學校,二專(進修),377,9,2,7,31,4,27
,103,1,私立,技專校院,1282,馬偕醫護管理專科學校,五專,3701,44,9,35,82,18,64
,103,1,私立,技專校院,1283,仁德醫護管理專科學校,二專(進修),466,1,1,0,2,2,0
,103,1,私立,技專校院,1283,仁德醫護管理專科學校,五專,5989,100,33,67,114,42,72
,103,1,私立,技專校院,1284,樹人醫護管理專科學校,二專(進修),451,22,16,6,43,34,9
,103,1,私立,技專校院,1284,樹人醫護管理專科學校,五專,6397,199,83,116,348,138,210
,103,1,私立,技專校院,1285,慈惠醫護管理專科學校,二專(日間),160,2,1,1,8,5,3
,103,1,私立,技專校院,1285,慈惠醫護管理專科學校,二專(進修),307,6,4,2,32,14,18
,103,1,私立,技專校院,1285,慈惠醫護管理專科學校,五專,6023,119,36,83,202,64,138
,103,1,私立,技專校院,1286,耕莘健康管理專科學校,二專(日間),0,1,1,0,1,1,0
,103,1,私立,技專校院,1286,耕莘健康管理專科學校,二專(進修),80,4,0,4,7,1,6
,103,1,私立,技專校院,1286,耕莘健康管理專科學校,五專,4906,90,22,68,148,37,111
,103,1,私立,技專校院,1287,敏惠醫護管理專科學校,五專,3875,32,7,25,42,11,31
,103,1,私立,技專校院,1288,高美醫護管理專科學校,二專(進修),198,1,0,1,1,0,1
,103,1,私立,技專校院,1288,高美醫護管理專科學校,五專,652,13,5,8,13,4,9
,103,1,私立,技專校院,1289,育英醫護管理專科學校,五專,2010,25,1,24,77,6,71
,103,1,私立,技專校院,1290,崇仁醫護管理專科學校,二專(進修),19,1,0,1,1,0,1
,103,1,私立,技專校院,1290,崇仁醫護管理專科學校,五專,3238,31,8,23,55,9,46
,103,1,私立,技專校院,1291,聖母醫護管理專科學校,五專,3702,115,38,77,166,58,108
,103,1,私立,技專校院,1292,新生醫護管理專科學校,二專(進修),86,3,1,2,6,1,5
,103,1,私立,技專校院,1292,新生醫護管理專科學校,五專,5769,92,15,77,179,31,148
,103,2,公立,一般大學,1,國立政治大學,學士班(日間),9639,64,37,27,249,138,111
,103,2,公立,一般大學,1,國立政治大學,碩士班(日間),3816,246,114,132,847,396,451
,103,2,公立,一般大學,1,國立政治大學,碩士在職專班,1625,125,64,61,454,220,234
,103,2,公立,一般大學,1,國立政治大學,博士班,973,94,53,41,337,191,146
,103,2,公立,一般大學,2,國立清華大學,學士班(日間),6280,81,63,18,253,188,65
,103,2,公立,一般大學,2,國立清華大學,碩士班(日間),3920,105,60,45,246,135,111
,103,2,公立,一般大學,2,國立清華大學,碩士在職專班,305,24,17,7,45,25,20
,103,2,公立,一般大學,2,國立清華大學,博士班,1786,167,128,39,330,251,79
,103,2,公立,一般大學,3,國立臺灣大學,學士班(日間),16505,218,157,61,677,431,246
,103,2,公立,一般大學,3,國立臺灣大學,學士班(進修),9,1,1,0,2,2,0
,103,2,公立,一般大學,3,國立臺灣大學,碩士班(日間),9852,532,292,240,1120,611,509
,103,2,公立,一般大學,3,國立臺灣大學,碩士在職專班,1160,134,88,46,216,131,85
,103,2,公立,一般大學,3,國立臺灣大學,博士班,4265,574,394,180,1050,743,307
,103,2,公立,一般大學,4,國立臺灣師範大學,學士班(日間),7865,98,56,42,246,135,111
,103,2,公立,一般大學,4,國立臺灣師範大學,碩士班(日間),3939,385,126,259,819,286,533
,103,2,公立,一般大學,4,國立臺灣師範大學,碩士在職專班,1884,278,73,205,448,136,312
,103,2,公立,一般大學,4,國立臺灣師範大學,博士班,1352,238,95,143,417,188,229
,103,2,公立,一般大學,5,國立成功大學,學士班(日間),11436,113,92,21,414,282,132
,103,2,公立,一般大學,5,國立成功大學,碩士班(日間),6500,138,74,64,531,291,240
,103,2,公立,一般大學,5,國立成功大學,碩士在職專班,1267,60,41,19,199,116,83
,103,2,公立,一般大學,5,國立成功大學,博士班,2495,188,144,44,598,435,163
,103,2,公立,一般大學,6,國立中興大學,學士班(日間),8083,65,38,27,279,177,102
,103,2,公立,一般大學,6,國立中興大學,學士班(進修),1046,13,8,5,60,27,33
,103,2,公立,一般大學,6,國立中興大學,碩士班(日間),3362,81,39,42,417,253,164
,103,2,公立,一般大學,6,國立中興大學,碩士在職專班,1644,88,60,28,380,249,131
,103,2,公立,一般大學,6,國立中興大學,博士班,1215,73,56,17,301,212,89
,103,2,公立,一般大學,7,國立交通大學,學士班(日間),5432,60,49,11,196,145,51
,103,2,公立,一般大學,7,國立交通大學,碩士班(日間),5242,131,73,58,329,185,144
,103,2,公立,一般大學,7,國立交通大學,碩士在職專班,1502,227,175,52,438,335,103
,103,2,公立,一般大學,7,國立交通大學,博士班,1965,197,147,50,414,324,90
,103,2,公立,一般大學,8,國立中央大學,學士班(日間),6098,40,33,7,161,121,40
,103,2,公立,一般大學,8,國立中央大學,碩士班(日間),3264,71,43,28,257,161,96
,103,2,公立,一般大學,8,國立中央大學,碩士在職專班,1327,84,64,20,278,193,85
,103,2,公立,一般大學,8,國立中央大學,博士班,1175,117,91,26,292,224,68
,103,2,公立,一般大學,9,國立中山大學,學士班(日間),4655,64,43,21,133,96,37
,103,2,公立,一般大學,9,國立中山大學,碩士班(日間),2923,116,77,39,351,214,137
,103,2,公立,一般大學,9,國立中山大學,碩士在職專班,858,39,20,19,147,76,71
,103,2,公立,一般大學,9,國立中山大學,博士班,908,93,62,31,219,150,69
,103,2,公立,一般大學,12,國立臺灣海洋大學,學士班(日間),5409,32,23,9,63,52,11
,103,2,公立,一般大學,12,國立臺灣海洋大學,學士班(進修),636,16,11,5,60,39,21
,103,2,公立,一般大學,12,國立臺灣海洋大學,碩士班(日間),1430,35,24,11,116,79,37
,103,2,公立,一般大學,12,國立臺灣海洋大學,碩士在職專班,562,30,18,12,83,58,25
,103,2,公立,一般大學,12,國立臺灣海洋大學,博士班,334,34,28,6,66,53,13
,103,2,公立,一般大學,13,國立中正大學,學士班(日間),6631,68,49,19,168,110,58
,103,2,公立,一般大學,13,國立中正大學,碩士班(日間),2873,138,69,69,359,197,162
,103,2,公立,一般大學,13,國立中正大學,碩士在職專班,1709,156,84,72,344,178,166
,103,2,公立,一般大學,13,國立中正大學,博士班,625,72,48,24,149,99,50
,103,2,公立,一般大學,14,國立高雄師範大學,學士班(日間),3433,22,13,9,87,50,37
,103,2,公立,一般大學,14,國立高雄師範大學,碩士班(日間),1428,95,33,62,354,127,227
,103,2,公立,一般大學,14,國立高雄師範大學,碩士在職專班,1286,131,46,85,260,96,164
,103,2,公立,一般大學,14,國立高雄師範大學,博士班,465,20,13,7,94,42,52
,103,2,公立,一般大學,15,國立彰化師範大學,學士班(日間),4858,30,25,5,73,59,14
,103,2,公立,一般大學,15,國立彰化師範大學,碩士班(日間),1527,72,31,41,301,142,159
,103,2,公立,一般大學,15,國立彰化師範大學,碩士在職專班,1235,105,43,62,186,80,106
,103,2,公立,一般大學,15,國立彰化師範大學,博士班,465,39,21,18,109,56,53
,103,2,公立,一般大學,16,國立陽明大學,學士班(日間),2077,12,9,3,86,50,36
,103,2,公立,一般大學,16,國立陽明大學,碩士班(日間),1235,43,17,26,177,63,114
,103,2,公立,一般大學,16,國立陽明大學,碩士在職專班,112,5,0,5,22,4,18
,103,2,公立,一般大學,16,國立陽明大學,博士班,1007,97,53,44,261,150,111
,103,2,公立,一般大學,17,國立臺北大學,學士班(日間),5735,45,27,18,151,90,61
,103,2,公立,一般大學,17,國立臺北大學,學士班(進修),1911,47,24,23,174,102,72
,103,2,公立,一般大學,17,國立臺北大學,碩士班(日間),1312,74,46,28,244,139,105
,103,2,公立,一般大學,17,國立臺北大學,碩士在職專班,470,28,13,15,83,35,48
,103,2,公立,一般大學,17,國立臺北大學,博士班,185,20,15,5,48,34,14
,103,2,公立,一般大學,18,國立嘉義大學,學士班(日間),7864,66,38,28,266,166,100
,103,2,公立,一般大學,18,國立嘉義大學,學士班(進修),2111,53,34,19,248,163,85
,103,2,公立,一般大學,18,國立嘉義大學,碩士班(日間),1576,76,32,44,321,166,155
,103,2,公立,一般大學,18,國立嘉義大學,碩士在職專班,1013,62,22,40,228,96,132
,103,2,公立,一般大學,18,國立嘉義大學,博士班,194,12,7,5,64,37,27
,103,2,公立,一般大學,19,國立高雄大學,學士班(日間),4140,28,22,6,103,70,33
,103,2,公立,一般大學,19,國立高雄大學,學士班(進修),177,8,5,3,36,23,13
,103,2,公立,一般大學,19,國立高雄大學,碩士班(日間),644,30,18,12,106,72,34
,103,2,公立,一般大學,19,國立高雄大學,碩士在職專班,478,43,28,15,149,88,61
,103,2,公立,一般大學,19,國立高雄大學,博士班,15,1,1,0,2,2,0
,103,2,公立,一般大學,20,國立東華大學,學士班(日間),7302,87,57,30,248,163,85
,103,2,公立,一般大學,20,國立東華大學,碩士班(日間),1851,158,75,83,549,247,302
,103,2,公立,一般大學,20,國立東華大學,碩士在職專班,557,39,23,16,168,74,94
,103,2,公立,一般大學,20,國立東華大學,博士班,383,36,26,10,118,73,45
,103,2,公立,一般大學,21,國立暨南國際大學,學士班(日間),4179,26,19,7,82,49,33
,103,2,公立,一般大學,21,國立暨南國際大學,學士班(進修),1,1,0,1,1,0,1
,103,2,公立,一般大學,21,國立暨南國際大學,碩士班(日間),1108,74,33,41,187,100,87
,103,2,公立,一般大學,21,國立暨南國際大學,碩士在職專班,370,14,7,7,55,30,25
,103,2,公立,一般大學,21,國立暨南國際大學,博士班,324,27,13,14,72,40,32
,103,2,公立,一般大學,28,國立臺北藝術大學,五專,86,0,0,0,3,2,1
,103,2,公立,一般大學,28,國立臺北藝術大學,學士班(日間),1700,31,17,14,92,44,48
,103,2,公立,一般大學,28,國立臺北藝術大學,碩士班(日間),935,114,47,67,305,115,190
,103,2,公立,一般大學,28,國立臺北藝術大學,碩士在職專班,140,10,4,6,34,13,21
,103,2,公立,一般大學,28,國立臺北藝術大學,博士班,61,11,2,9,25,6,19
,103,2,公立,一般大學,29,國立臺灣藝術大學,學士班(日間),2280,14,5,9,71,27,44
,103,2,公立,一般大學,29,國立臺灣藝術大學,學士班(進修),1918,41,10,31,157,48,109
,103,2,公立,一般大學,29,國立臺灣藝術大學,碩士班(日間),727,52,25,27,182,77,105
,103,2,公立,一般大學,29,國立臺灣藝術大學,碩士在職專班,397,22,8,14,93,27,66
,103,2,公立,一般大學,29,國立臺灣藝術大學,博士班,81,8,2,6,18,6,12
,103,2,公立,一般大學,30,國立臺東大學,學士班(日間),3480,36,21,15,142,87,55
,103,2,公立,一般大學,30,國立臺東大學,學士班(進修),196,9,2,7,39,21,18
,103,2,公立,一般大學,30,國立臺東大學,碩士班(日間),303,21,6,15,122,46,76
,103,2,公立,一般大學,30,國立臺東大學,碩士在職專班,631,16,5,11,117,51,66
,103,2,公立,一般大學,30,國立臺東大學,博士班,44,3,1,2,9,5,4
,103,2,公立,一般大學,31,國立宜蘭大學,學士班(日間),4275,37,29,8,93,72,21
,103,2,公立,一般大學,31,國立宜蘭大學,學士班(進修),533,14,14,0,89,79,10
,103,2,公立,一般大學,31,國立宜蘭大學,碩士班(日間),534,17,12,5,48,32,16
,103,2,公立,一般大學,31,國立宜蘭大學,碩士在職專班,178,8,7,1,38,30,8
,103,2,公立,一般大學,31,國立宜蘭大學,博士班,13,0,0,0,1,1,0
,103,2,公立,一般大學,32,國立聯合大學,學士班(日間),6069,79,68,11,202,177,25
,103,2,公立,一般大學,32,國立聯合大學,學士班(進修),1452,51,29,22,133,95,38
,103,2,公立,一般大學,32,國立聯合大學,碩士班(日間),466,17,15,2,48,39,9
,103,2,公立,一般大學,32,國立聯合大學,博士班,6,0,0,0,3,3,0
,103,2,公立,一般大學,35,國立臺南藝術大學,五專,163,1,0,1,8,1,7
,103,2,公立,一般大學,35,國立臺南藝術大學,學士班(日間),731,16,7,9,43,20,23
,103,2,公立,一般大學,35,國立臺南藝術大學,學士班(進修),2,0,0,0,0,0,0
,103,2,公立,一般大學,35,國立臺南藝術大學,碩士班(日間),565,59,23,36,165,62,103
,103,2,公立,一般大學,35,國立臺南藝術大學,碩士在職專班,45,0,0,0,17,4,13
,103,2,公立,一般大學,35,國立臺南藝術大學,博士班,48,4,2,2,11,8,3
,103,2,公立,一般大學,36,國立臺南大學,學士班(日間),3858,24,13,11,79,46,33
,103,2,公立,一般大學,36,國立臺南大學,學士班(進修),276,6,4,2,20,10,10
,103,2,公立,一般大學,36,國立臺南大學,碩士班(日間),1069,59,24,35,239,90,149
,103,2,公立,一般大學,36,國立臺南大學,碩士在職專班,708,28,9,19,114,36,78
,103,2,公立,一般大學,36,國立臺南大學,博士班,184,16,11,5,36,22,14
,103,2,公立,一般大學,37,國立臺北教育大學,學士班(日間),3270,36,16,20,101,50,51
,103,2,公立,一般大學,37,國立臺北教育大學,碩士班(日間),1140,130,46,84,304,105,199
,103,2,公立,一般大學,37,國立臺北教育大學,碩士在職專班,1068,55,21,34,191,51,140
,103,2,公立,一般大學,37,國立臺北教育大學,博士班,144,23,11,12,39,16,23
,103,2,公立,一般大學,38,國立新竹教育大學,學士班(日間),2535,15,3,12,59,23,36
,103,2,公立,一般大學,38,國立新竹教育大學,碩士班(日間),788,63,16,47,192,47,145
,103,2,公立,一般大學,38,國立新竹教育大學,碩士在職專班,582,19,2,17,46,7,39
,103,2,公立,一般大學,38,國立新竹教育大學,博士班,80,3,1,2,11,4,7
,103,2,公立,一般大學,39,國立臺中教育大學,學士班(日間),3407,24,14,10,72,40,32
,103,2,公立,一般大學,39,國立臺中教育大學,碩士班(日間),843,47,20,27,182,73,109
,103,2,公立,一般大學,39,國立臺中教育大學,碩士在職專班,705,20,3,17,85,17,68
,103,2,公立,一般大學,39,國立臺中教育大學,博士班,128,5,1,4,15,6,9
,103,2,公立,一般大學,44,國立體育大學,學士班(日間),1497,22,18,4,75,60,15
,103,2,公立,一般大學,44,國立體育大學,學士班(進修),95,2,2,0,12,10,2
,103,2,公立,一般大學,44,國立體育大學,碩士班(日間),319,17,8,9,109,75,34
,103,2,公立,一般大學,44,國立體育大學,碩士在職專班,198,16,6,10,61,30,31
,103,2,公立,一般大學,44,國立體育大學,博士班,131,9,6,3,23,15,8
,103,2,公立,一般大學,48,國立金門大學,學士班(日間),3068,28,20,8,92,65,27
,103,2,公立,一般大學,48,國立金門大學,學士班(進修),796,25,18,7,34,26,8
,103,2,公立,一般大學,48,國立金門大學,碩士班(日間),208,16,11,5,43,29,14
,103,2,公立,一般大學,48,國立金門大學,碩士在職專班,41,1,1,0,2,2,0
,103,2,公立,一般大學,49,國立臺灣體育運動大學,學士班(日間),2416,64,44,20,134,97,37
,103,2,公立,一般大學,49,國立臺灣體育運動大學,學士班(進修),402,19,17,2,55,44,11
,103,2,公立,一般大學,49,國立臺灣體育運動大學,碩士班(日間),275,9,8,1,79,52,27
,103,2,公立,一般大學,49,國立臺灣體育運動大學,碩士在職專班,103,4,4,0,7,7,0
,103,2,公立,一般大學,52,國立屏東大學,學士班(日間),6582,52,31,21,151,86,65
,103,2,公立,一般大學,52,國立屏東大學,學士班(進修),701,15,5,10,66,27,39
,103,2,公立,一般大學,52,國立屏東大學,碩士班(日間),993,98,37,61,242,97,145
,103,2,公立,一般大學,52,國立屏東大學,碩士在職專班,522,36,13,23,88,27,61
,103,2,公立,一般大學,52,國立屏東大學,博士班,53,2,2,0,6,3,3
,103,2,公立,一般大學,3002,臺北市立大學,學士班(日間),4971,82,59,23,229,149,80
,103,2,公立,一般大學,3002,臺北市立大學,碩士班(日間),1233,70,31,39,261,97,164
,103,2,公立,一般大學,3002,臺北市立大學,碩士在職專班,986,41,14,27,133,46,87
,103,2,公立,一般大學,3002,臺北市立大學,博士班,236,16,9,7,55,24,31
,103,2,公立,技專校院,22,國立臺灣科技大學,學士班(日間),5408,77,51,26,177,120,57
,103,2,公立,技專校院,22,國立臺灣科技大學,學士班(進修),40,2,1,1,11,4,7
,103,2,公立,技專校院,22,國立臺灣科技大學,碩士班(日間),3130,72,45,27,212,130,82
,103,2,公立,技專校院,22,國立臺灣科技大學,碩士在職專班,788,84,68,16,155,124,31
,103,2,公立,技專校院,22,國立臺灣科技大學,博士班,1005,118,95,23,250,199,51
,103,2,公立,技專校院,23,國立雲林科技大學,學士班(日間),6339,34,21,13,159,108,51
,103,2,公立,技專校院,23,國立雲林科技大學,碩士班(日間),2041,54,33,21,273,168,105
,103,2,公立,技專校院,23,國立雲林科技大學,碩士在職專班,740,27,15,12,150,95,55
,103,2,公立,技專校院,23,國立雲林科技大學,博士班,471,35,26,9,129,94,35
,103,2,公立,技專校院,24,國立屏東科技大學,學士班(日間),7719,53,26,27,177,105,72
,103,2,公立,技專校院,24,國立屏東科技大學,學士班(進修),1455,36,19,17,68,41,27
,103,2,公立,技專校院,24,國立屏東科技大學,碩士班(日間),1408,49,25,24,211,115,96
,103,2,公立,技專校院,24,國立屏東科技大學,碩士在職專班,566,25,16,9,68,47,21
,103,2,公立,技專校院,24,國立屏東科技大學,博士班,234,14,10,4,51,27,24
,103,2,公立,技專校院,25,國立臺北科技大學,學士班(日間),5956,78,52,26,210,160,50
,103,2,公立,技專校院,25,國立臺北科技大學,學士班(進修),1145,39,35,4,80,66,14
,103,2,公立,技專校院,25,國立臺北科技大學,碩士班(日間),2626,47,37,10,124,103,21
,103,2,公立,技專校院,25,國立臺北科技大學,碩士在職專班,1220,136,116,20,225,179,46
,103,2,公立,技專校院,25,國立臺北科技大學,博士班,713,68,48,20,121,96,25
,103,2,公立,技專校院,26,國立高雄第一科技大學,學士班(日間),5660,39,23,16,117,73,44
,103,2,公立,技專校院,26,國立高雄第一科技大學,碩士班(日間),1128,25,13,12,140,85,55
,103,2,公立,技專校院,26,國立高雄第一科技大學,碩士在職專班,722,47,35,12,146,111,35
,103,2,公立,技專校院,26,國立高雄第一科技大學,博士班,224,19,12,7,49,37,12
,103,2,公立,技專校院,27,國立高雄應用科技大學,學士班(日間),7601,52,38,14,150,109,41
,103,2,公立,技專校院,27,國立高雄應用科技大學,學士班(進修),1687,50,36,14,188,131,57
,103,2,公立,技專校院,27,國立高雄應用科技大學,碩士班(日間),1333,47,35,12,138,104,34
,103,2,公立,技專校院,27,國立高雄應用科技大學,碩士在職專班,1281,52,43,9,240,175,65
,103,2,公立,技專校院,27,國立高雄應用科技大學,博士班,286,29,26,3,47,42,5
,103,2,公立,技專校院,33,國立虎尾科技大學,學士班(日間),7760,53,42,11,171,141,30
,103,2,公立,技專校院,33,國立虎尾科技大學,學士班(進修),1280,18,15,3,71,57,14
,103,2,公立,技專校院,33,國立虎尾科技大學,碩士班(日間),865,12,8,4,82,64,18
,103,2,公立,技專校院,33,國立虎尾科技大學,碩士在職專班,285,16,11,5,14,11,3
,103,2,公立,技專校院,33,國立虎尾科技大學,博士班,27,2,2,0,9,9,0
,103,2,公立,技專校院,34,國立高雄海洋科技大學,五專,499,4,4,0,9,8,1
,103,2,公立,技專校院,34,國立高雄海洋科技大學,學士班(日間),4956,42,33,9,156,115,41
,103,2,公立,技專校院,34,國立高雄海洋科技大學,學士班(進修),1852,16,10,6,55,39,16
,103,2,公立,技專校院,34,國立高雄海洋科技大學,碩士班(日間),334,8,4,4,68,47,21
,103,2,公立,技專校院,34,國立高雄海洋科技大學,碩士在職專班,175,5,3,2,13,10,3
,103,2,公立,技專校院,34,國立高雄海洋科技大學,博士班,3,0,0,0,0,0,0
,103,2,公立,技專校院,42,國立澎湖科技大學,二專(進修),17,0,0,0,0,0,0
,103,2,公立,技專校院,42,國立澎湖科技大學,學士班(日間),2544,17,12,5,43,28,15
,103,2,公立,技專校院,42,國立澎湖科技大學,學士班(進修),321,6,5,1,20,11,9
,103,2,公立,技專校院,42,國立澎湖科技大學,碩士班(日間),89,8,5,3,17,9,8
,103,2,公立,技專校院,42,國立澎湖科技大學,碩士在職專班,43,3,1,2,7,3,4
,103,2,公立,技專校院,43,國立勤益科技大學,二專(日間),101,1,1,0,13,10,3
,103,2,公立,技專校院,43,國立勤益科技大學,二專(進修),7,0,0,0,0,0,0
,103,2,公立,技專校院,43,國立勤益科技大學,學士班(日間),6780,74,56,18,317,228,89
,103,2,公立,技專校院,43,國立勤益科技大學,學士班(進修),3514,95,79,16,181,154,27
,103,2,公立,技專校院,43,國立勤益科技大學,碩士班(日間),613,36,34,2,85,77,8
,103,2,公立,技專校院,43,國立勤益科技大學,碩士在職專班,228,18,16,2,15,13,2
,103,2,公立,技專校院,43,國立勤益科技大學,博士班,9,0,0,0,0,0,0
,103,2,公立,技專校院,46,國立臺北護理健康大學,學士班(日間),2908,22,4,18,90,20,70
,103,2,公立,技專校院,46,國立臺北護理健康大學,學士班(進修),693,11,0,11,76,0,76
,103,2,公立,技專校院,46,國立臺北護理健康大學,碩士班(日間),575,63,10,53,195,23,172
,103,2,公立,技專校院,46,國立臺北護理健康大學,碩士在職專班,180,16,0,16,55,6,49
,103,2,公立,技專校院,46,國立臺北護理健康大學,博士班,53,4,0,4,23,1,22
,103,2,公立,技專校院,47,國立高雄餐旅大學,二專(進修),243,9,6,3,31,17,14
,103,2,公立,技專校院,47,國立高雄餐旅大學,五專,220,1,0,1,7,4,3
,103,2,公立,技專校院,47,國立高雄餐旅大學,學士班(日間),3269,18,5,13,93,33,60
,103,2,公立,技專校院,47,國立高雄餐旅大學,學士班(進修),1165,3,2,1,41,15,26
,103,2,公立,技專校院,47,國立高雄餐旅大學,碩士班(日間),190,5,5,0,36,17,19
,103,2,公立,技專校院,47,國立高雄餐旅大學,碩士在職專班,88,1,0,1,11,7,4
,103,2,公立,技專校院,47,國立高雄餐旅大學,博士班,17,0,0,0,1,0,1
,103,2,公立,技專校院,50,國立臺中科技大學,二專(日間),162,2,0,2,5,1,4
,103,2,公立,技專校院,50,國立臺中科技大學,二專(進修),198,9,2,7,22,2,20
,103,2,公立,技專校院,50,國立臺中科技大學,五專,3903,27,7,20,69,26,43
,103,2,公立,技專校院,50,國立臺中科技大學,學士班(日間),6296,37,16,21,115,52,63
,103,2,公立,技專校院,50,國立臺中科技大學,學士班(進修),2657,55,20,35,138,44,94
,103,2,公立,技專校院,50,國立臺中科技大學,碩士班(日間),371,10,6,4,34,23,11
,103,2,公立,技專校院,50,國立臺中科技大學,碩士在職專班,132,10,5,5,23,10,13
,103,2,公立,技專校院,51,國立臺北商業大學,二專(進修),560,4,1,3,11,3,8
,103,2,公立,技專校院,51,國立臺北商業大學,五專,1896,26,14,12,102,41,61
,103,2,公立,技專校院,51,國立臺北商業大學,學士班(日間),2650,27,14,13,76,33,43
,103,2,公立,技專校院,51,國立臺北商業大學,學士班(進修),1649,22,13,9,103,43,60
,103,2,公立,技專校院,51,國立臺北商業大學,碩士班(日間),165,7,5,2,16,12,4
,103,2,公立,技專校院,51,國立臺北商業大學,碩士在職專班,21,2,1,1,11,6,5
,103,2,公立,技專校院,144,國立臺灣戲曲學院,學士班(日間),484,3,1,2,37,19,18
,103,2,公立,技專校院,144,國立臺灣戲曲學院,學士班(進修),44,2,1,1,8,4,4
,103,2,公立,技專校院,221,國立臺南護理專科學校,二專(日間),90,0,0,0,6,1,5
,103,2,公立,技專校院,221,國立臺南護理專科學校,二專(進修),83,3,2,1,20,3,17
,103,2,公立,技專校院,221,國立臺南護理專科學校,五專,1758,11,0,11,27,0,27
,103,2,公立,技專校院,222,國立臺東專科學校,二專(日間),444,9,6,3,19,14,5
,103,2,公立,技專校院,222,國立臺東專科學校,二專(進修),171,18,8,10,18,8,10
,103,2,公立,技專校院,222,國立臺東專科學校,五專,613,20,12,8,18,12,6
,103,2,私立,一般大學,1001,東海大學,學士班(日間),13687,137,87,50,511,322,189
,103,2,私立,一般大學,1001,東海大學,學士班(進修),668,37,23,14,156,93,63
,103,2,私立,一般大學,1001,東海大學,碩士班(日間),1613,92,44,48,336,157,179
,103,2,私立,一般大學,1001,東海大學,碩士在職專班,778,48,25,23,193,91,102
,103,2,私立,一般大學,1001,東海大學,博士班,218,34,20,14,85,48,37
,103,2,私立,一般大學,1002,輔仁大學,學士班(日間),18002,220,133,87,684,354,330
,103,2,私立,一般大學,1002,輔仁大學,學士班(進修),4759,133,57,76,397,162,235
,103,2,私立,一般大學,1002,輔仁大學,碩士班(日間),2165,246,98,148,650,258,392
,103,2,私立,一般大學,1002,輔仁大學,碩士在職專班,1617,83,38,45,363,175,188
,103,2,私立,一般大學,1002,輔仁大學,博士班,441,54,27,27,177,93,84
,103,2,私立,一般大學,1003,東吳大學,學士班(日間),11911,126,69,57,334,170,164
,103,2,私立,一般大學,1003,東吳大學,學士班(進修),1239,45,18,27,130,53,77
,103,2,私立,一般大學,1003,東吳大學,碩士班(日間),1193,155,77,78,271,135,136
,103,2,私立,一般大學,1003,東吳大學,碩士在職專班,1158,88,40,48,214,91,123
,103,2,私立,一般大學,1003,東吳大學,博士班,96,8,4,4,17,9,8
,103,2,私立,一般大學,1004,中原大學,學士班(日間),13020,146,108,38,442,309,133
,103,2,私立,一般大學,1004,中原大學,學士班(進修),0,0,0,0,1,1,0
,103,2,私立,一般大學,1004,中原大學,碩士班(日間),1815,73,35,38,302,177,125
,103,2,私立,一般大學,1004,中原大學,碩士在職專班,1039,73,54,19,271,186,85
,103,2,私立,一般大學,1004,中原大學,博士班,366,33,21,12,123,86,37
,103,2,私立,一般大學,1005,淡江大學,學士班(日間),20840,288,200,88,909,589,320
,103,2,私立,一般大學,1005,淡江大學,學士班(進修),2432,92,59,33,287,160,127
,103,2,私立,一般大學,1005,淡江大學,碩士班(日間),2057,109,46,63,429,240,189
,103,2,私立,一般大學,1005,淡江大學,碩士在職專班,1250,70,34,36,252,122,130
,103,2,私立,一般大學,1005,淡江大學,博士班,481,39,26,13,152,100,52
,103,2,私立,一般大學,1006,中國文化大學,學士班(日間),20928,259,161,98,770,450,320
,103,2,私立,一般大學,1006,中國文化大學,學士班(進修),2782,208,97,111,615,305,310
,103,2,私立,一般大學,1006,中國文化大學,碩士班(日間),1665,108,56,52,385,219,166
,103,2,私立,一般大學,1006,中國文化大學,碩士在職專班,629,33,13,20,122,55,67
,103,2,私立,一般大學,1006,中國文化大學,博士班,519,24,16,8,89,53,36
,103,2,私立,一般大學,1007,逢甲大學,學士班(日間),16860,162,141,21,414,336,78
,103,2,私立,一般大學,1007,逢甲大學,學士班(進修),945,49,30,19,114,67,47
,103,2,私立,一般大學,1007,逢甲大學,碩士班(日間),1648,71,46,25,195,139,56
,103,2,私立,一般大學,1007,逢甲大學,碩士在職專班,1150,76,44,32,153,93,60
,103,2,私立,一般大學,1007,逢甲大學,博士班,411,48,33,15,86,58,28
,103,2,私立,一般大學,1008,靜宜大學,學士班(日間),11177,120,63,57,341,189,152
,103,2,私立,一般大學,1008,靜宜大學,學士班(進修),81,4,3,1,9,6,3
,103,2,私立,一般大學,1008,靜宜大學,碩士班(日間),629,45,18,27,121,55,66
,103,2,私立,一般大學,1008,靜宜大學,碩士在職專班,325,16,9,7,44,20,24
,103,2,私立,一般大學,1008,靜宜大學,博士班,37,5,2,3,10,5,5
,103,2,私立,一般大學,1009,長庚大學,學士班(日間),5167,44,26,18,119,61,58
,103,2,私立,一般大學,1009,長庚大學,碩士班(日間),1360,53,24,29,198,88,110
,103,2,私立,一般大學,1009,長庚大學,碩士在職專班,329,27,13,14,100,56,44
,103,2,私立,一般大學,1009,長庚大學,博士班,537,29,19,10,104,63,41
,103,2,私立,一般大學,1010,元智大學,學士班(日間),7188,56,37,19,136,94,42
,103,2,私立,一般大學,1010,元智大學,學士班(進修),1,0,0,0,0,0,0
,103,2,私立,一般大學,1010,元智大學,碩士班(日間),1139,34,21,13,89,61,28
,103,2,私立,一般大學,1010,元智大學,碩士在職專班,995,40,28,12,129,83,46
,103,2,私立,一般大學,1010,元智大學,博士班,326,13,10,3,51,39,12
,103,2,私立,一般大學,1011,中華大學,學士班(日間),7222,92,69,23,302,224,78
,103,2,私立,一般大學,1011,中華大學,學士班(進修),397,5,4,1,25,18,7
,103,2,私立,一般大學,1011,中華大學,碩士班(日間),664,23,16,7,87,68,19
,103,2,私立,一般大學,1011,中華大學,碩士在職專班,283,8,6,2,44,31,13
,103,2,私立,一般大學,1011,中華大學,博士班,132,12,6,6,38,29,9
,103,2,私立,一般大學,1012,大葉大學,學士班(日間),8508,70,44,26,346,256,90
,103,2,私立,一般大學,1012,大葉大學,學士班(進修),1262,37,31,6,108,83,25
,103,2,私立,一般大學,1012,大葉大學,碩士班(日間),846,32,19,13,120,65,55
,103,2,私立,一般大學,1012,大葉大學,碩士在職專班,879,23,16,7,71,46,25
,103,2,私立,一般大學,1012,大葉大學,博士班,154,17,12,5,60,41,19
,103,2,私立,一般大學,1013,華梵大學,學士班(日間),2740,48,32,16,166,106,60
,103,2,私立,一般大學,1013,華梵大學,碩士班(日間),328,27,17,10,88,52,36
,103,2,私立,一般大學,1013,華梵大學,碩士在職專班,351,8,6,2,66,44,22
,103,2,私立,一般大學,1013,華梵大學,博士班,56,4,3,1,11,8,3
,103,2,私立,一般大學,1014,義守大學,學士班(日間),12814,59,44,15,156,126,30
,103,2,私立,一般大學,1014,義守大學,學士班(進修),2506,51,31,20,325,220,105
,103,2,私立,一般大學,1014,義守大學,碩士班(日間),597,15,10,5,31,22,9
,103,2,私立,一般大學,1014,義守大學,碩士在職專班,496,26,17,9,76,46,30
,103,2,私立,一般大學,1014,義守大學,博士班,143,3,1,2,10,6,4
,103,2,私立,一般大學,1015,世新大學,學士班(日間),9865,124,73,51,300,154,146
,103,2,私立,一般大學,1015,世新大學,學士班(進修),180,9,3,6,11,4,7
,103,2,私立,一般大學,1015,世新大學,碩士班(日間),774,71,44,27,164,91,73
,103,2,私立,一般大學,1015,世新大學,碩士在職專班,997,77,37,40,254,124,130
,103,2,私立,一般大學,1015,世新大學,博士班,73,9,4,5,20,9,11
,103,2,私立,一般大學,1016,銘傳大學,學士班(日間),17524,283,196,87,652,412,240
,103,2,私立,一般大學,1016,銘傳大學,碩士班(日間),809,49,25,24,123,75,48
,103,2,私立,一般大學,1016,銘傳大學,碩士在職專班,882,31,14,17,92,35,57
,103,2,私立,一般大學,1016,銘傳大學,博士班,65,10,4,6,19,10,9
,103,2,私立,一般大學,1017,實踐大學,學士班(日間),12407,123,56,67,406,178,228
,103,2,私立,一般大學,1017,實踐大學,學士班(進修),2592,67,30,37,213,73,140
,103,2,私立,一般大學,1017,實踐大學,碩士班(日間),378,32,13,19,99,54,45
,103,2,私立,一般大學,1017,實踐大學,碩士在職專班,193,27,13,14,48,22,26
,103,2,私立,一般大學,1017,實踐大學,博士班,8,1,1,0,1,1,0
,103,2,私立,一般大學,1019,高雄醫學大學,學士班(日間),5659,49,35,14,222,115,107
,103,2,私立,一般大學,1019,高雄醫學大學,學士班(進修),150,1,0,1,4,0,4
,103,2,私立,一般大學,1019,高雄醫學大學,碩士班(日間),610,32,7,25,128,51,77
,103,2,私立,一般大學,1019,高雄醫學大學,碩士在職專班,220,19,8,11,64,27,37
,103,2,私立,一般大學,1019,高雄醫學大學,博士班,342,37,21,16,95,55,40
,103,2,私立,一般大學,1020,南華大學,學士班(日間),3926,54,30,24,214,127,87
,103,2,私立,一般大學,1020,南華大學,學士班(進修),173,5,3,2,20,15,5
,103,2,私立,一般大學,1020,南華大學,碩士班(日間),691,52,30,22,175,86,89
,103,2,私立,一般大學,1020,南華大學,碩士在職專班,488,22,12,10,81,43,38
,103,2,私立,一般大學,1020,南華大學,博士班,24,1,0,1,7,4,3
,103,2,私立,一般大學,1021,真理大學,學士班(日間),8033,83,47,36,284,188,96
,103,2,私立,一般大學,1021,真理大學,學士班(進修),678,23,11,12,80,50,30
,103,2,私立,一般大學,1021,真理大學,碩士班(日間),147,10,5,5,16,8,8
,103,2,私立,一般大學,1021,真理大學,碩士在職專班,9,0,0,0,0,0,0
,103,2,私立,一般大學,1022,大同大學,學士班(日間),3683,61,49,12,134,102,32
,103,2,私立,一般大學,1022,大同大學,碩士班(日間),440,13,11,2,39,32,7
,103,2,私立,一般大學,1022,大同大學,碩士在職專班,437,57,43,14,126,103,23
,103,2,私立,一般大學,1022,大同大學,博士班,150,21,17,4,38,31,7
,103,2,私立,一般大學,1027,慈濟大學,學士班(日間),2858,31,13,18,97,42,55
,103,2,私立,一般大學,1027,慈濟大學,碩士班(日間),330,25,11,14,69,33,36
,103,2,私立,一般大學,1027,慈濟大學,碩士在職專班,40,1,1,0,8,3,5
,103,2,私立,一般大學,1027,慈濟大學,博士班,102,11,6,5,39,17,22
,103,2,私立,一般大學,1028,臺北醫學大學,學士班(日間),4544,38,20,18,174,85,89
,103,2,私立,一般大學,1028,臺北醫學大學,學士班(進修),121,0,0,0,2,0,2
,103,2,私立,一般大學,1028,臺北醫學大學,碩士班(日間),638,27,11,16,90,41,49
,103,2,私立,一般大學,1028,臺北醫學大學,碩士在職專班,224,21,2,19,49,6,43
,103,2,私立,一般大學,1028,臺北醫學大學,博士班,402,31,21,10,65,39,26
,103,2,私立,一般大學,1029,中山醫學大學,學士班(日間),6423,48,25,23,208,111,97
,103,2,私立,一般大學,1029,中山醫學大學,學士班(進修),289,7,3,4,28,14,14
,103,2,私立,一般大學,1029,中山醫學大學,碩士班(日間),510,14,7,7,49,18,31
,103,2,私立,一般大學,1029,中山醫學大學,碩士在職專班,117,1,1,0,7,5,2
,103,2,私立,一般大學,1029,中山醫學大學,博士班,227,16,7,9,43,21,22
,103,2,私立,一般大學,1033,長榮大學,學士班(日間),9100,111,67,44,401,262,139
,103,2,私立,一般大學,1033,長榮大學,學士班(進修),646,19,15,4,46,36,10
,103,2,私立,一般大學,1033,長榮大學,碩士班(日間),500,36,18,18,119,57,62
,103,2,私立,一般大學,1033,長榮大學,碩士在職專班,190,16,9,7,43,22,21
,103,2,私立,一般大學,1033,長榮大學,博士班,38,3,1,2,15,10,5
,103,2,私立,一般大學,1035,中國醫藥大學,學士班(日間),6355,42,23,19,368,188,180
,103,2,私立,一般大學,1035,中國醫藥大學,學士班(進修),84,6,1,5,23,4,19
,103,2,私立,一般大學,1035,中國醫藥大學,碩士班(日間),517,27,10,17,86,36,50
,103,2,私立,一般大學,1035,中國醫藥大學,碩士在職專班,77,6,2,4,9,3,6
,103,2,私立,一般大學,1035,中國醫藥大學,博士班,337,22,13,9,99,53,46
,103,2,私立,一般大學,1039,玄奘大學,學士班(日間),4183,98,51,47,263,134,129
,103,2,私立,一般大學,1039,玄奘大學,學士班(進修),1331,100,68,32,219,127,92
,103,2,私立,一般大學,1039,玄奘大學,碩士班(日間),376,37,20,17,111,53,58
,103,2,私立,一般大學,1039,玄奘大學,碩士在職專班,232,19,9,10,41,20,21
,103,2,私立,一般大學,1039,玄奘大學,博士班,16,0,0,0,1,1,0
,103,2,私立,一般大學,1048,亞洲大學,學士班(日間),9602,104,65,39,686,409,277
,103,2,私立,一般大學,1048,亞洲大學,學士班(進修),1354,40,27,13,288,179,109
,103,2,私立,一般大學,1048,亞洲大學,碩士班(日間),625,34,15,19,211,106,105
,103,2,私立,一般大學,1048,亞洲大學,碩士在職專班,526,10,5,5,64,31,33
,103,2,私立,一般大學,1048,亞洲大學,博士班,164,15,12,3,51,26,25
,103,2,私立,一般大學,1049,開南大學,學士班(日間),7758,129,84,45,435,309,126
,103,2,私立,一般大學,1049,開南大學,學士班(進修),1319,43,26,17,142,96,46
,103,2,私立,一般大學,1049,開南大學,碩士班(日間),298,22,15,7,77,54,23
,103,2,私立,一般大學,1049,開南大學,碩士在職專班,367,4,4,0,20,15,5
,103,2,私立,一般大學,1050,佛光大學,學士班(日間),2803,48,29,19,115,61,54
,103,2,私立,一般大學,1050,佛光大學,碩士班(日間),659,58,43,15,191,114,77
,103,2,私立,一般大學,1050,佛光大學,碩士在職專班,243,11,7,4,30,16,14
,103,2,私立,一般大學,1050,佛光大學,博士班,47,3,2,1,8,4,4
,103,2,私立,一般大學,1058,明道大學,學士班(日間),3672,36,22,14,119,76,43
,103,2,私立,一般大學,1058,明道大學,學士班(進修),1732,34,25,9,118,84,34
,103,2,私立,一般大學,1058,明道大學,碩士班(日間),192,11,8,3,37,24,13
,103,2,私立,一般大學,1058,明道大學,碩士在職專班,71,2,1,1,2,1,1
,103,2,私立,一般大學,1058,明道大學,博士班,8,0,0,0,0,0,0
,103,2,私立,一般大學,1059,康寧大學,學士班(日間),1166,30,22,8,245,170,75
,103,2,私立,一般大學,1059,康寧大學,學士班(進修),456,31,22,9,137,92,45
,103,2,私立,一般大學,1059,康寧大學,碩士班(日間),201,13,10,3,69,37,32
,103,2,私立,一般大學,1059,康寧大學,碩士在職專班,182,6,5,1,27,19,8
,103,2,私立,一般大學,1067,台灣首府大學,學士班(日間),3592,50,35,15,136,90,46
,103,2,私立,一般大學,1067,台灣首府大學,學士班(進修),942,21,15,6,73,56,17
,103,2,私立,一般大學,1067,台灣首府大學,碩士班(日間),69,2,2,0,6,5,1
,103,2,私立,一般大學,1067,台灣首府大學,碩士在職專班,7,0,0,0,0,0,0
,103,2,私立,一般大學,1125,中信金融管理學院,學士班(日間),197,14,9,5,14,9,5
,103,2,私立,一般大學,1125,中信金融管理學院,學士班(進修),277,26,11,15,26,11,15
,103,2,私立,一般大學,1176,稻江科技暨管理學院,學士班(日間),1755,28,14,14,121,64,57
,103,2,私立,一般大學,1176,稻江科技暨管理學院,學士班(進修),845,7,4,3,63,34,29
,103,2,私立,一般大學,1176,稻江科技暨管理學院,碩士班(日間),67,4,4,0,8,5,3
,103,2,私立,一般大學,1176,稻江科技暨管理學院,碩士在職專班,52,2,2,0,2,2,0
,103,2,私立,一般大學,1195,馬偕醫學院,學士班(日間),509,1,1,0,9,5,4
,103,2,私立,一般大學,1195,馬偕醫學院,學士班(進修),11,0,0,0,0,0,0
,103,2,私立,一般大學,1195,馬偕醫學院,碩士班(日間),10,0,0,0,4,1,3
,103,2,私立,一般大學,1196,法鼓文理學院,學士班(日間),48,3,1,2,3,1,2
,103,2,私立,一般大學,1196,法鼓文理學院,碩士班(日間),70,16,6,10,16,6,10
,103,2,私立,一般大學,1196,法鼓文理學院,博士班,8,1,0,1,1,0,1
,103,2,私立,一般大學,1R02,基督教台灣浸會神學院,碩士班(日間),47,0,0,0,0,0,0
,103,2,私立,一般大學,1R03,臺北基督學院,學士班(日間),116,7,3,4,17,8,9
,103,2,私立,技專校院,1018,朝陽科技大學,學士班(日間),11675,108,58,50,346,197,149
,103,2,私立,技專校院,1018,朝陽科技大學,學士班(進修),3543,103,62,41,338,179,159
,103,2,私立,技專校院,1018,朝陽科技大學,碩士班(日間),767,47,27,20,188,106,82
,103,2,私立,技專校院,1018,朝陽科技大學,碩士在職專班,497,27,14,13,88,39,49
,103,2,私立,技專校院,1018,朝陽科技大學,博士班,88,5,4,1,11,8,3
,103,2,私立,技專校院,1023,南臺科技大學,學士班(日間),13281,77,50,27,390,261,129
,103,2,私立,技專校院,1023,南臺科技大學,學士班(進修),4613,99,72,27,554,369,185
,103,2,私立,技專校院,1023,南臺科技大學,碩士班(日間),1013,37,24,13,178,131,47
,103,2,私立,技專校院,1023,南臺科技大學,碩士在職專班,474,17,8,9,79,42,37
,103,2,私立,技專校院,1023,南臺科技大學,博士班,61,4,4,0,12,12,0
,103,2,私立,技專校院,1024,崑山科技大學,學士班(日間),8669,154,104,50,577,415,162
,103,2,私立,技專校院,1024,崑山科技大學,學士班(進修),3384,153,96,57,666,455,211
,103,2,私立,技專校院,1024,崑山科技大學,碩士班(日間),463,32,22,10,100,78,22
,103,2,私立,技專校院,1024,崑山科技大學,碩士在職專班,190,10,9,1,25,21,4
,103,2,私立,技專校院,1024,崑山科技大學,博士班,33,0,0,0,4,4,0
,103,2,私立,技專校院,1025,嘉南藥理大學,學士班(日間),13119,120,65,55,631,338,293
,103,2,私立,技專校院,1025,嘉南藥理大學,學士班(進修),3375,151,89,62,658,405,253
,103,2,私立,技專校院,1025,嘉南藥理大學,碩士班(日間),329,13,6,7,106,71,35
,103,2,私立,技專校院,1025,嘉南藥理大學,碩士在職專班,197,7,2,5,45,21,24
,103,2,私立,技專校院,1026,樹德科技大學,學士班(日間),8242,251,146,105,251,146,105
,103,2,私立,技專校院,1026,樹德科技大學,學士班(進修),2261,150,105,45,150,105,45
,103,2,私立,技專校院,1026,樹德科技大學,碩士班(日間),377,56,29,27,56,29,27
,103,2,私立,技專校院,1026,樹德科技大學,碩士在職專班,497,48,25,23,48,25,23
,103,2,私立,技專校院,1026,樹德科技大學,博士班,23,4,1,3,4,1,3
,103,2,私立,技專校院,1030,龍華科技大學,二專(日間),49,0,0,0,0,0,0
,103,2,私立,技專校院,1030,龍華科技大學,學士班(日間),6712,77,50,27,342,255,87
,103,2,私立,技專校院,1030,龍華科技大學,學士班(進修),4053,93,70,23,306,220,86
,103,2,私立,技專校院,1030,龍華科技大學,碩士班(日間),355,6,5,1,34,29,5
,103,2,私立,技專校院,1030,龍華科技大學,碩士在職專班,85,2,0,2,6,1,5
,103,2,私立,技專校院,1031,輔英科技大學,五專,3058,15,3,12,73,15,58
,103,2,私立,技專校院,1031,輔英科技大學,學士班(日間),5342,86,37,49,341,169,172
,103,2,私立,技專校院,1031,輔英科技大學,學士班(進修),1192,39,25,14,155,88,67
,103,2,私立,技專校院,1031,輔英科技大學,碩士班(日間),128,15,2,13,38,5,33
,103,2,私立,技專校院,1031,輔英科技大學,碩士在職專班,46,3,0,3,11,0,11
,103,2,私立,技專校院,1032,明新科技大學,二專(日間),22,0,0,0,0,0,0
,103,2,私立,技專校院,1032,明新科技大學,二專(進修),122,0,0,0,0,0,0
,103,2,私立,技專校院,1032,明新科技大學,學士班(日間),8788,94,63,31,1066,661,405
,103,2,私立,技專校院,1032,明新科技大學,學士班(進修),3935,95,68,27,400,280,120
,103,2,私立,技專校院,1032,明新科技大學,碩士班(日間),364,13,12,1,187,136,51
,103,2,私立,技專校院,1032,明新科技大學,碩士在職專班,236,2,1,1,26,20,6
,103,2,私立,技專校院,1034,弘光科技大學,二專(進修),22,0,0,0,2,1,1
,103,2,私立,技專校院,1034,弘光科技大學,五專,273,0,0,0,4,0,4
,103,2,私立,技專校院,1034,弘光科技大學,學士班(日間),7941,81,27,54,342,145,197
,103,2,私立,技專校院,1034,弘光科技大學,學士班(進修),4296,84,43,41,540,242,298
,103,2,私立,技專校院,1034,弘光科技大學,碩士班(日間),205,5,2,3,55,25,30
,103,2,私立,技專校院,1034,弘光科技大學,碩士在職專班,99,8,0,8,31,9,22
,103,2,私立,技專校院,1036,健行科技大學,二專(日間),140,1,1,0,1,1,0
,103,2,私立,技專校院,1036,健行科技大學,學士班(日間),8420,111,81,30,349,271,78
,103,2,私立,技專校院,1036,健行科技大學,學士班(進修),3572,108,74,34,278,194,84
,103,2,私立,技專校院,1036,健行科技大學,碩士班(日間),348,13,12,1,35,30,5
,103,2,私立,技專校院,1036,健行科技大學,碩士在職專班,149,3,3,0,11,8,3
,103,2,私立,技專校院,1037,正修科技大學,二專(日間),16,0,0,0,7,6,1
,103,2,私立,技專校院,1037,正修科技大學,二專(進修),9,0,0,0,3,2,1
,103,2,私立,技專校院,1037,正修科技大學,五專,15,0,0,0,0,0,0
,103,2,私立,技專校院,1037,正修科技大學,學士班(日間),10031,190,127,63,522,344,178
,103,2,私立,技專校院,1037,正修科技大學,學士班(進修),6995,316,198,118,973,637,336
,103,2,私立,技專校院,1037,正修科技大學,碩士班(日間),340,16,11,5,60,46,14
,103,2,私立,技專校院,1037,正修科技大學,碩士在職專班,101,2,1,1,9,7,2
,103,2,私立,技專校院,1037,正修科技大學,博士班,11,0,0,0,2,2,0
,103,2,私立,技專校院,1038,萬能科技大學,學士班(日間),6474,47,30,17,416,272,144
,103,2,私立,技專校院,1038,萬能科技大學,學士班(進修),4161,0,0,0,455,289,166
,103,2,私立,技專校院,1038,萬能科技大學,碩士班(日間),147,7,6,1,45,36,9
,103,2,私立,技專校院,1038,萬能科技大學,碩士在職專班,136,0,0,0,16,12,4
,103,2,私立,技專校院,1040,建國科技大學,二專(日間),36,0,0,0,0,0,0
,103,2,私立,技專校院,1040,建國科技大學,二專(進修),5,0,0,0,1,1,0
,103,2,私立,技專校院,1040,建國科技大學,學士班(日間),7407,110,74,36,349,253,96
,103,2,私立,技專校院,1040,建國科技大學,學士班(進修),1816,28,19,9,104,74,30
,103,2,私立,技專校院,1040,建國科技大學,碩士班(日間),210,5,3,2,16,13,3
,103,2,私立,技專校院,1041,明志科技大學,二專(進修),2,0,0,0,0,0,0
,103,2,私立,技專校院,1041,明志科技大學,五專,39,2,1,1,2,1,1
,103,2,私立,技專校院,1041,明志科技大學,學士班(日間),3465,19,12,7,24,12,12
,103,2,私立,技專校院,1041,明志科技大學,學士班(進修),498,11,9,2,36,24,12
,103,2,私立,技專校院,1041,明志科技大學,碩士班(日間),415,16,15,1,34,31,3
,103,2,私立,技專校院,1041,明志科技大學,碩士在職專班,46,4,3,1,13,12,1
,103,2,私立,技專校院,1042,高苑科技大學,二專(日間),12,0,0,0,0,0,0
,103,2,私立,技專校院,1042,高苑科技大學,學士班(日間),5826,82,55,27,107,77,30
,103,2,私立,技專校院,1042,高苑科技大學,學士班(進修),1465,39,27,12,48,32,16
,103,2,私立,技專校院,1042,高苑科技大學,碩士班(日間),131,3,3,0,3,3,0
,103,2,私立,技專校院,1042,高苑科技大學,碩士在職專班,289,11,9,2,14,11,3
,103,2,私立,技專校院,1043,大仁科技大學,五專,3,0,0,0,18,10,8
,103,2,私立,技專校院,1043,大仁科技大學,學士班(日間),5643,103,68,35,734,478,256
,103,2,私立,技專校院,1043,大仁科技大學,學士班(進修),1901,45,24,21,396,236,160
,103,2,私立,技專校院,1043,大仁科技大學,碩士班(日間),65,1,1,0,29,21,8
,103,2,私立,技專校院,1043,大仁科技大學,碩士在職專班,145,4,2,2,26,12,14
,103,2,私立,技專校院,1044,聖約翰科技大學,學士班(日間),5173,120,86,34,414,314,100
,103,2,私立,技專校院,1044,聖約翰科技大學,學士班(進修),481,25,16,9,107,82,25
,103,2,私立,技專校院,1044,聖約翰科技大學,碩士班(日間),181,14,12,2,37,34,3
,103,2,私立,技專校院,1044,聖約翰科技大學,碩士在職專班,90,3,3,0,10,9,1
,103,2,私立,技專校院,1045,嶺東科技大學,二專(日間),46,0,0,0,0,0,0
,103,2,私立,技專校院,1045,嶺東科技大學,學士班(日間),7640,41,23,18,156,88,68
,103,2,私立,技專校院,1045,嶺東科技大學,學士班(進修),2561,104,51,53,286,157,129
,103,2,私立,技專校院,1045,嶺東科技大學,碩士班(日間),231,9,2,7,30,15,15
,103,2,私立,技專校院,1045,嶺東科技大學,碩士在職專班,106,3,3,0,11,11,0
,103,2,私立,技專校院,1046,中國科技大學,學士班(日間),9248,169,76,93,431,216,215
,103,2,私立,技專校院,1046,中國科技大學,學士班(進修),2635,64,37,27,341,220,121
,103,2,私立,技專校院,1046,中國科技大學,碩士班(日間),144,12,5,7,31,17,14
,103,2,私立,技專校院,1046,中國科技大學,碩士在職專班,35,0,0,0,0,0,0
,103,2,私立,技專校院,1047,中臺科技大學,五專,0,0,0,0,1,1,0
,103,2,私立,技專校院,1047,中臺科技大學,學士班(日間),6345,105,42,63,410,205,205
,103,2,私立,技專校院,1047,中臺科技大學,學士班(進修),3007,103,46,57,581,257,324
,103,2,私立,技專校院,1047,中臺科技大學,碩士班(日間),177,9,4,5,55,28,27
,103,2,私立,技專校院,1047,中臺科技大學,碩士在職專班,249,22,4,18,51,9,42
,103,2,私立,技專校院,1047,中臺科技大學,博士班,20,3,1,2,4,2,2
,103,2,私立,技專校院,1051,台南應用科技大學,五專,1211,9,3,6,42,12,30
,103,2,私立,技專校院,1051,台南應用科技大學,學士班(日間),8587,88,36,52,472,180,292
,103,2,私立,技專校院,1051,台南應用科技大學,學士班(進修),2724,90,39,51,270,105,165
,103,2,私立,技專校院,1051,台南應用科技大學,碩士班(日間),154,10,2,8,52,9,43
,103,2,私立,技專校院,1051,台南應用科技大學,碩士在職專班,159,12,2,10,54,5,49
,103,2,私立,技專校院,1052,遠東科技大學,二專(進修),45,2,2,0,5,5,0
,103,2,私立,技專校院,1052,遠東科技大學,五專,0,0,0,0,1,1,0
,103,2,私立,技專校院,1052,遠東科技大學,學士班(日間),7870,117,84,33,556,402,154
,103,2,私立,技專校院,1052,遠東科技大學,學士班(進修),671,25,19,6,75,59,16
,103,2,私立,技專校院,1052,遠東科技大學,碩士班(日間),179,12,12,0,36,30,6
,103,2,私立,技專校院,1052,遠東科技大學,碩士在職專班,45,2,2,0,5,5,0
,103,2,私立,技專校院,1053,元培醫事科技大學,學士班(日間),5733,79,51,28,240,159,81
,103,2,私立,技專校院,1053,元培醫事科技大學,學士班(進修),1400,34,18,16,79,48,31
,103,2,私立,技專校院,1053,元培醫事科技大學,碩士班(日間),222,4,3,1,22,18,4
,103,2,私立,技專校院,1053,元培醫事科技大學,碩士在職專班,26,2,1,1,5,1,4
,103,2,私立,技專校院,1054,景文科技大學,二專(進修),2,0,0,0,0,0,0
,103,2,私立,技專校院,1054,景文科技大學,學士班(日間),5923,57,24,33,123,51,72
,103,2,私立,技專校院,1054,景文科技大學,學士班(進修),2293,72,42,30,191,120,71
,103,2,私立,技專校院,1054,景文科技大學,碩士班(日間),50,1,1,0,6,3,3
,103,2,私立,技專校院,1054,景文科技大學,碩士在職專班,95,5,5,0,14,11,3
,103,2,私立,技專校院,1055,中華醫事科技大學,二專(日間),79,1,0,1,4,1,3
,103,2,私立,技專校院,1055,中華醫事科技大學,五專,2002,15,7,8,48,15,33
,103,2,私立,技專校院,1055,中華醫事科技大學,學士班(日間),5153,59,25,34,308,148,160
,103,2,私立,技專校院,1055,中華醫事科技大學,學士班(進修),1868,74,32,42,338,160,178
,103,2,私立,技專校院,1055,中華醫事科技大學,碩士班(日間),46,5,3,2,12,8,4
,103,2,私立,技專校院,1056,東南科技大學,二專(日間),48,2,1,1,6,3,3
,103,2,私立,技專校院,1056,東南科技大學,學士班(日間),6702,173,102,71,913,678,235
,103,2,私立,技專校院,1056,東南科技大學,學士班(進修),607,47,41,6,187,158,29
,103,2,私立,技專校院,1056,東南科技大學,碩士班(日間),127,10,9,1,25,22,3
,103,2,私立,技專校院,1056,東南科技大學,碩士在職專班,68,2,2,0,5,4,1
,103,2,私立,技專校院,1057,德明財經科技大學,二專(日間),1,0,0,0,4,1,3
,103,2,私立,技專校院,1057,德明財經科技大學,學士班(日間),7244,85,43,42,297,143,154
,103,2,私立,技專校院,1057,德明財經科技大學,學士班(進修),1826,52,30,22,293,150,143
,103,2,私立,技專校院,1057,德明財經科技大學,碩士班(日間),58,2,2,0,24,20,4
,103,2,私立,技專校院,1057,德明財經科技大學,碩士在職專班,52,10,3,7,19,5,14
,103,2,私立,技專校院,1060,南開科技大學,二專(日間),18,0,0,0,0,0,0
,103,2,私立,技專校院,1060,南開科技大學,五專,1129,24,23,1,94,72,22
,103,2,私立,技專校院,1060,南開科技大學,學士班(日間),3723,55,42,13,192,142,50
,103,2,私立,技專校院,1060,南開科技大學,學士班(進修),1221,20,16,4,90,59,31
,103,2,私立,技專校院,1060,南開科技大學,碩士班(日間),112,5,3,2,11,6,5
,103,2,私立,技專校院,1060,南開科技大學,碩士在職專班,143,10,6,4,15,9,6
,103,2,私立,技專校院,1061,中華科技大學,二專(進修),4,1,0,1,9,1,8
,103,2,私立,技專校院,1061,中華科技大學,學士班(日間),6697,134,92,42,691,526,165
,103,2,私立,技專校院,1061,中華科技大學,學士班(進修),1388,61,47,14,420,312,108
,103,2,私立,技專校院,1061,中華科技大學,碩士班(日間),295,13,9,4,66,59,7
,103,2,私立,技專校院,1061,中華科技大學,碩士在職專班,128,6,5,1,48,45,3
,103,2,私立,技專校院,1062,僑光科技大學,二專(日間),137,0,0,0,5,5,0
,103,2,私立,技專校院,1062,僑光科技大學,二專(進修),86,0,0,0,0,0,0
,103,2,私立,技專校院,1062,僑光科技大學,五專,463,6,4,2,17,13,4
,103,2,私立,技專校院,1062,僑光科技大學,學士班(日間),6280,47,24,23,152,86,66
,103,2,私立,技專校院,1062,僑光科技大學,學士班(進修),3732,51,35,16,210,137,73
,103,2,私立,技專校院,1062,僑光科技大學,碩士班(日間),83,1,1,0,8,6,2
,103,2,私立,技專校院,1062,僑光科技大學,碩士在職專班,65,0,0,0,0,0,0
,103,2,私立,技專校院,1063,育達科技大學,學士班(日間),4145,94,56,38,387,244,143
,103,2,私立,技專校院,1063,育達科技大學,學士班(進修),1760,145,93,52,398,251,147
,103,2,私立,技專校院,1063,育達科技大學,碩士班(日間),116,6,6,0,13,12,1
,103,2,私立,技專校院,1063,育達科技大學,碩士在職專班,90,7,6,1,10,9,1
,103,2,私立,技專校院,1064,美和科技大學,二專(進修),21,1,1,0,1,1,0
,103,2,私立,技專校院,1064,美和科技大學,五專,1906,11,1,10,51,16,35
,103,2,私立,技專校院,1064,美和科技大學,學士班(日間),3920,49,24,25,280,159,121
,103,2,私立,技專校院,1064,美和科技大學,學士班(進修),1965,48,23,25,263,122,141
,103,2,私立,技專校院,1064,美和科技大學,碩士班(日間),207,6,2,4,32,12,20
,103,2,私立,技專校院,1064,美和科技大學,碩士在職專班,78,6,4,2,15,8,7
,103,2,私立,技專校院,1065,吳鳳科技大學,二專(日間),14,0,0,0,1,1,0
,103,2,私立,技專校院,1065,吳鳳科技大學,二專(進修),28,0,0,0,18,15,3
,103,2,私立,技專校院,1065,吳鳳科技大學,學士班(日間),4328,82,48,34,288,197,91
,103,2,私立,技專校院,1065,吳鳳科技大學,學士班(進修),1141,47,38,9,241,186,55
,103,2,私立,技專校院,1065,吳鳳科技大學,碩士班(日間),30,5,4,1,18,17,1
,103,2,私立,技專校院,1065,吳鳳科技大學,碩士在職專班,81,3,2,1,6,4,2
,103,2,私立,技專校院,1066,環球科技大學,二專(日間),34,0,0,0,11,5,6
,103,2,私立,技專校院,1066,環球科技大學,二專(進修),358,3,3,0,8,6,2
,103,2,私立,技專校院,1066,環球科技大學,學士班(日間),4412,47,32,15,362,201,161
,103,2,私立,技專校院,1066,環球科技大學,學士班(進修),1405,17,12,5,40,25,15
,103,2,私立,技專校院,1066,環球科技大學,碩士班(日間),115,0,0,0,18,9,9
,103,2,私立,技專校院,1066,環球科技大學,碩士在職專班,34,0,0,0,5,3,2
,103,2,私立,技專校院,1068,中州科技大學,二專(日間),31,0,0,0,0,0,0
,103,2,私立,技專校院,1068,中州科技大學,學士班(日間),3173,34,21,13,158,113,45
,103,2,私立,技專校院,1068,中州科技大學,學士班(進修),1754,22,17,5,81,60,21
,103,2,私立,技專校院,1068,中州科技大學,碩士班(日間),71,0,0,0,1,1,0
,103,2,私立,技專校院,1068,中州科技大學,碩士在職專班,45,0,0,0,1,1,0
,103,2,私立,技專校院,1069,修平科技大學,二專(日間),14,0,0,0,0,0,0
,103,2,私立,技專校院,1069,修平科技大學,二專(進修),38,3,3,0,9,7,2
,103,2,私立,技專校院,1069,修平科技大學,學士班(日間),5636,94,63,31,253,191,62
,103,2,私立,技專校院,1069,修平科技大學,學士班(進修),872,13,13,0,71,67,4
,103,2,私立,技專校院,1069,修平科技大學,碩士班(日間),72,4,3,1,11,10,1
,103,2,私立,技專校院,1070,長庚科技大學,五專,1686,3,0,3,9,0,9
,103,2,私立,技專校院,1070,長庚科技大學,學士班(日間),3852,19,0,19,61,2,59
,103,2,私立,技專校院,1070,長庚科技大學,學士班(進修),1985,44,3,41,129,7,122
,103,2,私立,技專校院,1070,長庚科技大學,碩士班(日間),38,2,0,2,5,0,5
,103,2,私立,技專校院,1070,長庚科技大學,碩士在職專班,34,5,1,4,11,1,10
,103,2,私立,技專校院,1071,臺北城市科技大學,二專(日間),175,1,1,0,19,16,3
,103,2,私立,技專校院,1071,臺北城市科技大學,二專(進修),80,7,6,1,36,25,11
,103,2,私立,技專校院,1071,臺北城市科技大學,五專,1578,24,16,8,96,75,21
,103,2,私立,技專校院,1071,臺北城市科技大學,學士班(日間),6964,148,100,48,521,387,134
,103,2,私立,技專校院,1071,臺北城市科技大學,學士班(進修),934,52,34,18,133,91,42
,103,2,私立,技專校院,1071,臺北城市科技大學,碩士班(日間),101,9,8,1,16,14,2
,103,2,私立,技專校院,1072,大華科技大學,二專(進修),74,1,1,0,1,1,0
,103,2,私立,技專校院,1072,大華科技大學,五專,1273,27,19,8,62,41,21
,103,2,私立,技專校院,1072,大華科技大學,學士班(日間),1608,43,31,12,113,84,29
,103,2,私立,技專校院,1072,大華科技大學,學士班(進修),1275,23,17,6,55,41,14
,103,2,私立,技專校院,1072,大華科技大學,碩士班(日間),28,1,1,0,3,3,0
,103,2,私立,技專校院,1072,大華科技大學,碩士在職專班,6,0,0,0,3,3,0
,103,2,私立,技專校院,1073,醒吾科技大學,二專(日間),27,0,0,0,0,0,0
,103,2,私立,技專校院,1073,醒吾科技大學,五專,1323,27,9,18,130,38,92
,103,2,私立,技專校院,1073,醒吾科技大學,學士班(日間),5911,71,39,32,329,171,158
,103,2,私立,技專校院,1073,醒吾科技大學,學士班(進修),1410,99,57,42,345,229,116
,103,2,私立,技專校院,1073,醒吾科技大學,碩士班(日間),84,6,5,1,20,13,7
,103,2,私立,技專校院,1073,醒吾科技大學,碩士在職專班,48,0,0,0,3,0,3
,103,2,私立,技專校院,1074,南榮科技大學,二專(進修),351,3,2,1,7,2,5
,103,2,私立,技專校院,1074,南榮科技大學,五專,317,9,7,2,24,20,4
,103,2,私立,技專校院,1074,南榮科技大學,學士班(日間),1638,22,12,10,48,33,15
,103,2,私立,技專校院,1074,南榮科技大學,學士班(進修),1233,26,18,8,48,35,13
,103,2,私立,技專校院,1074,南榮科技大學,碩士班(日間),25,0,0,0,0,0,0
,103,2,私立,技專校院,1074,南榮科技大學,碩士在職專班,34,0,0,0,2,2,0
,103,2,私立,技專校院,1075,文藻外語大學,五專,1768,7,2,5,60,12,48
,103,2,私立,技專校院,1075,文藻外語大學,學士班(日間),5435,87,22,65,289,98,191
,103,2,私立,技專校院,1075,文藻外語大學,學士班(進修),1902,96,33,63,323,112,211
,103,2,私立,技專校院,1075,文藻外語大學,碩士班(日間),86,4,1,3,27,9,18
,103,2,私立,技專校院,1075,文藻外語大學,碩士在職專班,72,3,0,3,21,6,15
,103,2,私立,技專校院,1076,華夏科技大學,二專(日間),0,0,0,0,31,27,4
,103,2,私立,技專校院,1076,華夏科技大學,二專(進修),345,12,9,3,275,186,89
,103,2,私立,技專校院,1076,華夏科技大學,五專,473,6,3,3,207,180,27
,103,2,私立,技專校院,1076,華夏科技大學,學士班(日間),3258,65,48,17,548,350,198
,103,2,私立,技專校院,1076,華夏科技大學,學士班(進修),1156,42,31,11,527,372,155
,103,2,私立,技專校院,1076,華夏科技大學,碩士班(日間),21,3,3,0,4,4,0
,103,2,私立,技專校院,1076,華夏科技大學,碩士在職專班,65,4,3,1,11,10,1
,103,2,私立,技專校院,1148,大漢技術學院,二專(進修),215,3,2,1,6,4,2
,103,2,私立,技專校院,1148,大漢技術學院,學士班(日間),943,8,6,2,87,62,25
,103,2,私立,技專校院,1148,大漢技術學院,學士班(進修),791,17,11,6,57,41,16
,103,2,私立,技專校院,1148,大漢技術學院,碩士班(日間),73,1,0,1,1,0,1
,103,2,私立,技專校院,1150,慈濟技術學院,五專,1208,28,3,25,42,5,37
,103,2,私立,技專校院,1150,慈濟技術學院,學士班(日間),1377,21,11,10,69,38,31
,103,2,私立,技專校院,1150,慈濟技術學院,學士班(進修),106,4,0,4,18,1,17
,103,2,私立,技專校院,1150,慈濟技術學院,碩士班(日間),20,0,0,0,1,1,0
,103,2,私立,技專校院,1159,和春技術學院,二專(進修),193,3,3,0,33,29,4
,103,2,私立,技專校院,1159,和春技術學院,五專,400,9,4,5,26,12,14
,103,2,私立,技專校院,1159,和春技術學院,學士班(日間),1459,37,27,10,124,92,32
,103,2,私立,技專校院,1159,和春技術學院,學士班(進修),856,19,19,0,202,161,41
,103,2,私立,技專校院,1159,和春技術學院,碩士班(日間),10,0,0,0,3,3,0
,103,2,私立,技專校院,1164,致理技術學院,二專(日間),238,2,2,0,29,19,10
,103,2,私立,技專校院,1164,致理技術學院,五專,1590,9,2,7,38,20,18
,103,2,私立,技專校院,1164,致理技術學院,學士班(日間),6737,80,36,44,257,132,125
,103,2,私立,技專校院,1164,致理技術學院,學士班(進修),3138,77,32,45,278,119,159
,103,2,私立,技專校院,1164,致理技術學院,碩士班(日間),21,1,1,0,6,3,3
,103,2,私立,技專校院,1164,致理技術學院,碩士在職專班,27,0,0,0,5,3,2
,103,2,私立,技專校院,1166,亞東技術學院,二專(日間),33,0,0,0,0,0,0
,103,2,私立,技專校院,1166,亞東技術學院,學士班(日間),4877,66,49,17,265,191,74
,103,2,私立,技專校院,1166,亞東技術學院,學士班(進修),292,5,4,1,64,46,18
,103,2,私立,技專校院,1166,亞東技術學院,碩士班(日間),61,6,6,0,19,17,2
,103,2,私立,技專校院,1168,桃園創新技術學院,二專(日間),245,0,0,0,0,0,0
,103,2,私立,技專校院,1168,桃園創新技術學院,學士班(日間),4532,89,58,31,286,193,93
,103,2,私立,技專校院,1168,桃園創新技術學院,學士班(進修),1258,51,35,16,145,101,44
,103,2,私立,技專校院,1168,桃園創新技術學院,碩士班(日間),45,0,0,0,1,1,0
,103,2,私立,技專校院,1179,德霖技術學院,二專(日間),183,0,0,0,0,0,0
,103,2,私立,技專校院,1179,德霖技術學院,二專(進修),436,16,10,6,34,23,11
,103,2,私立,技專校院,1179,德霖技術學院,五專,1809,33,24,9,63,50,13
,103,2,私立,技專校院,1179,德霖技術學院,學士班(日間),3306,126,79,47,241,178,63
,103,2,私立,技專校院,1179,德霖技術學院,學士班(進修),1848,56,35,21,145,102,43
,103,2,私立,技專校院,1182,蘭陽技術學院,二專(日間),17,0,0,0,0,0,0
,103,2,私立,技專校院,1182,蘭陽技術學院,二專(進修),3,0,0,0,0,0,0
,103,2,私立,技專校院,1182,蘭陽技術學院,五專,840,29,15,14,22,10,12
,103,2,私立,技專校院,1182,蘭陽技術學院,學士班(日間),1235,22,20,2,24,20,4
,103,2,私立,技專校院,1182,蘭陽技術學院,學士班(進修),13,0,0,0,0,0,0
,103,2,私立,技專校院,1183,黎明技術學院,二專(進修),136,5,0,5,14,8,6
,103,2,私立,技專校院,1183,黎明技術學院,五專,943,10,10,0,102,95,7
,103,2,私立,技專校院,1183,黎明技術學院,學士班(日間),2666,47,28,19,417,263,154
,103,2,私立,技專校院,1183,黎明技術學院,學士班(進修),857,25,21,4,376,298,78
,103,2,私立,技專校院,1184,東方設計學院,二專(日間),11,0,0,0,14,8,6
,103,2,私立,技專校院,1184,東方設計學院,五專,1591,41,16,25,132,58,74
,103,2,私立,技專校院,1184,東方設計學院,學士班(日間),2106,40,20,20,260,148,112
,103,2,私立,技專校院,1184,東方設計學院,學士班(進修),152,11,8,3,25,9,16
,103,2,私立,技專校院,1184,東方設計學院,碩士班(日間),47,6,3,3,25,18,7
,103,2,私立,技專校院,1184,東方設計學院,碩士在職專班,63,8,4,4,41,18,23
,103,2,私立,技專校院,1184,東方設計學院,博士班,3,0,0,0,0,0,0
,103,2,私立,技專校院,1185,經國管理暨健康學院,五專,1636,34,13,21,100,41,59
,103,2,私立,技專校院,1185,經國管理暨健康學院,學士班(日間),1867,50,28,22,162,88,74
,103,2,私立,技專校院,1185,經國管理暨健康學院,學士班(進修),534,16,6,10,49,19,30
,103,2,私立,技專校院,1185,經國管理暨健康學院,碩士班(日間),23,0,0,0,6,2,4
,103,2,私立,技專校院,1185,經國管理暨健康學院,碩士在職專班,44,0,0,0,2,1,1
,103,2,私立,技專校院,1187,崇右技術學院,五專,913,36,19,17,78,42,36
,103,2,私立,技專校院,1187,崇右技術學院,學士班(日間),2265,63,28,35,181,90,91
,103,2,私立,技專校院,1187,崇右技術學院,碩士班(日間),40,0,0,0,0,0,0
,103,2,私立,技專校院,1188,大同技術學院,二專(日間),0,0,0,0,58,44,14
,103,2,私立,技專校院,1188,大同技術學院,二專(進修),54,4,0,4,24,14,10
,103,2,私立,技專校院,1188,大同技術學院,五專,231,4,2,2,70,48,22
,103,2,私立,技專校院,1188,大同技術學院,學士班(日間),1776,30,17,13,483,305,178
,103,2,私立,技專校院,1188,大同技術學院,學士班(進修),852,24,11,13,121,59,62
,103,2,私立,技專校院,1189,亞太創意技術學院,二專(進修),201,0,0,0,3,0,3
,103,2,私立,技專校院,1189,亞太創意技術學院,學士班(日間),1323,35,19,16,139,84,55
,103,2,私立,技專校院,1189,亞太創意技術學院,學士班(進修),217,0,0,0,1,0,1
,103,2,私立,技專校院,1189,亞太創意技術學院,碩士班(日間),61,3,2,1,8,2,6
,103,2,私立,技專校院,1192,臺灣觀光學院,二專(日間),29,1,0,1,2,1,1
,103,2,私立,技專校院,1192,臺灣觀光學院,二專(進修),104,4,3,1,4,3,1
,103,2,私立,技專校院,1192,臺灣觀光學院,五專,191,8,3,5,13,7,6
,103,2,私立,技專校院,1192,臺灣觀光學院,學士班(日間),1200,38,25,13,53,31,22
,103,2,私立,技專校院,1192,臺灣觀光學院,學士班(進修),215,4,1,3,4,1,3
,103,2,私立,技專校院,1192,臺灣觀光學院,碩士班(日間),20,2,2,0,2,2,0
,103,2,私立,技專校院,1197,台北海洋技術學院,二專(日間),337,14,11,3,88,70,18
,103,2,私立,技專校院,1197,台北海洋技術學院,二專(進修),142,5,5,0,29,25,4
,103,2,私立,技專校院,1197,台北海洋技術學院,五專,1404,38,27,11,105,76,29
,103,2,私立,技專校院,1197,台北海洋技術學院,學士班(日間),4229,111,76,35,371,268,103
,103,2,私立,技專校院,1197,台北海洋技術學院,學士班(進修),304,10,7,3,81,65,16
,103,2,私立,技專校院,1281,康寧醫護暨管理專科學校,二專(日間),115,4,0,4,5,0,5
,103,2,私立,技專校院,1281,康寧醫護暨管理專科學校,二專(進修),301,4,1,3,18,3,15
,103,2,私立,技專校院,1281,康寧醫護暨管理專科學校,五專,2811,14,5,9,68,28,40
,103,2,私立,技專校院,1282,馬偕醫護管理專科學校,二專(日間),82,2,0,2,9,3,6
,103,2,私立,技專校院,1282,馬偕醫護管理專科學校,二專(進修),377,2,0,2,25,4,21
,103,2,私立,技專校院,1282,馬偕醫護管理專科學校,五專,3701,32,5,27,80,17,63
,103,2,私立,技專校院,1283,仁德醫護管理專科學校,二專(進修),466,0,0,0,1,1,0
,103,2,私立,技專校院,1283,仁德醫護管理專科學校,五專,5989,50,15,35,100,34,66
,103,2,私立,技專校院,1284,樹人醫護管理專科學校,二專(進修),451,16,12,4,46,37,9
,103,2,私立,技專校院,1284,樹人醫護管理專科學校,五專,6397,95,26,69,259,97,162
,103,2,私立,技專校院,1285,慈惠醫護管理專科學校,二專(日間),160,1,0,1,7,4,3
,103,2,私立,技專校院,1285,慈惠醫護管理專科學校,二專(進修),307,3,3,0,26,12,14
,103,2,私立,技專校院,1285,慈惠醫護管理專科學校,五專,6023,113,47,66,243,87,156
,103,2,私立,技專校院,1286,耕莘健康管理專科學校,二專(日間),0,0,0,0,1,1,0
,103,2,私立,技專校院,1286,耕莘健康管理專科學校,二專(進修),80,2,0,2,7,0,7
,103,2,私立,技專校院,1286,耕莘健康管理專科學校,五專,4906,60,19,41,160,44,116
,103,2,私立,技專校院,1287,敏惠醫護管理專科學校,五專,3875,38,9,29,37,10,27
,103,2,私立,技專校院,1288,高美醫護管理專科學校,二專(進修),198,1,1,0,0,0,0
,103,2,私立,技專校院,1288,高美醫護管理專科學校,五專,652,19,6,13,19,6,13
,103,2,私立,技專校院,1289,育英醫護管理專科學校,五專,2010,27,4,23,56,9,47
,103,2,私立,技專校院,1290,崇仁醫護管理專科學校,二專(進修),19,0,0,0,0,0,0
,103,2,私立,技專校院,1290,崇仁醫護管理專科學校,五專,3238,35,4,31,54,8,46
,103,2,私立,技專校院,1291,聖母醫護管理專科學校,五專,3702,59,18,41,103,34,69
,103,2,私立,技專校院,1292,新生醫護管理專科學校,二專(進修),86,1,0,1,6,1,5
,103,2,私立,技專校院,1292,新生醫護管理專科學校,五專,5769,70,8,62,160,28,132
,104,1,公立,一般大學,1,國立政治大學,學士班(日間),9736,178,87,91,313,164,149
,104,1,公立,一般大學,1,國立政治大學,碩士班(日間),3882,322,156,166,882,428,454
,104,1,公立,一般大學,1,國立政治大學,碩士在職專班,1666,212,102,110,517,236,281
,104,1,公立,一般大學,1,國立政治大學,博士班,963,134,76,58,370,208,162
,104,1,公立,一般大學,2,國立清華大學,學士班(日間),6315,177,120,57,237,165,72
,104,1,公立,一般大學,2,國立清華大學,碩士班(日間),3987,162,89,73,257,143,114
,104,1,公立,一般大學,2,國立清華大學,碩士在職專班,352,37,19,18,49,29,20
,104,1,公立,一般大學,2,國立清華大學,博士班,1681,209,154,55,347,257,90
,104,1,公立,一般大學,3,國立臺灣大學,學士班(日間),16532,615,375,240,699,426,273
,104,1,公立,一般大學,3,國立臺灣大學,學士班(進修),1,0,0,0,1,1,0
,104,1,公立,一般大學,3,國立臺灣大學,碩士班(日間),10069,792,421,371,1170,645,525
,104,1,公立,一般大學,3,國立臺灣大學,碩士在職專班,1191,247,154,93,317,191,126
,104,1,公立,一般大學,3,國立臺灣大學,博士班,3965,686,439,247,1083,740,343
,104,1,公立,一般大學,4,國立臺灣師範大學,學士班(日間),7919,197,104,93,268,152,116
,104,1,公立,一般大學,4,國立臺灣師範大學,碩士班(日間),3923,715,253,462,908,332,576
,104,1,公立,一般大學,4,國立臺灣師範大學,碩士在職專班,1851,200,62,138,430,122,308
,104,1,公立,一般大學,4,國立臺灣師範大學,博士班,1388,322,142,180,422,189,233
,104,1,公立,一般大學,5,國立成功大學,學士班(日間),11402,326,216,110,443,299,144
,104,1,公立,一般大學,5,國立成功大學,碩士班(日間),6422,225,125,100,524,294,230
,104,1,公立,一般大學,5,國立成功大學,碩士在職專班,1241,91,60,31,224,140,84
,104,1,公立,一般大學,5,國立成功大學,博士班,2171,218,153,65,609,431,178
,104,1,公立,一般大學,6,國立中興大學,學士班(日間),8114,179,125,54,278,191,87
,104,1,公立,一般大學,6,國立中興大學,學士班(進修),1024,28,13,15,58,27,31
,104,1,公立,一般大學,6,國立中興大學,碩士班(日間),3324,184,100,84,398,230,168
,104,1,公立,一般大學,6,國立中興大學,碩士在職專班,1563,114,91,23,358,254,104
,104,1,公立,一般大學,6,國立中興大學,博士班,1116,79,63,16,273,200,73
,104,1,公立,一般大學,7,國立交通大學,學士班(日間),5437,145,99,46,177,123,54
,104,1,公立,一般大學,7,國立交通大學,碩士班(日間),5334,207,113,94,320,189,131
,104,1,公立,一般大學,7,國立交通大學,碩士在職專班,1476,250,196,54,413,316,97
,104,1,公立,一般大學,7,國立交通大學,博士班,1836,242,186,56,394,301,93
,104,1,公立,一般大學,8,國立中央大學,學士班(日間),6117,127,101,26,179,140,39
,104,1,公立,一般大學,8,國立中央大學,碩士班(日間),3401,136,77,59,247,160,87
,104,1,公立,一般大學,8,國立中央大學,碩士在職專班,1348,98,63,35,276,188,88
,104,1,公立,一般大學,8,國立中央大學,博士班,1096,120,94,26,286,221,65
,104,1,公立,一般大學,9,國立中山大學,學士班(日間),4681,95,64,31,169,115,54
,104,1,公立,一般大學,9,國立中山大學,碩士班(日間),2917,218,126,92,411,248,163
,104,1,公立,一般大學,9,國立中山大學,碩士在職專班,862,99,43,56,197,92,105
,104,1,公立,一般大學,9,國立中山大學,博士班,852,99,64,35,231,155,76
,104,1,公立,一般大學,12,國立臺灣海洋大學,學士班(日間),5626,78,61,17,109,89,20
,104,1,公立,一般大學,12,國立臺灣海洋大學,學士班(進修),662,41,28,13,74,46,28
,104,1,公立,一般大學,12,國立臺灣海洋大學,碩士班(日間),1431,88,54,34,160,105,55
,104,1,公立,一般大學,12,國立臺灣海洋大學,碩士在職專班,569,48,35,13,90,63,27
,104,1,公立,一般大學,12,國立臺灣海洋大學,博士班,321,21,14,7,64,49,15
,104,1,公立,一般大學,13,國立中正大學,學士班(日間),6727,120,80,40,154,100,54
,104,1,公立,一般大學,13,國立中正大學,碩士班(日間),2766,245,122,123,410,216,194
,104,1,公立,一般大學,13,國立中正大學,碩士在職專班,1595,248,138,110,388,200,188
,104,1,公立,一般大學,13,國立中正大學,博士班,591,94,64,30,167,109,58
,104,1,公立,一般大學,14,國立高雄師範大學,學士班(日間),3471,56,32,24,80,47,33
,104,1,公立,一般大學,14,國立高雄師範大學,碩士班(日間),1429,179,65,114,350,123,227
,104,1,公立,一般大學,14,國立高雄師範大學,碩士在職專班,1253,128,40,88,275,84,191
,104,1,公立,一般大學,14,國立高雄師範大學,博士班,478,36,20,16,93,43,50
,104,1,公立,一般大學,15,國立彰化師範大學,學士班(日間),4850,64,48,16,97,72,25
,104,1,公立,一般大學,15,國立彰化師範大學,碩士班(日間),1524,177,77,100,339,167,172
,104,1,公立,一般大學,15,國立彰化師範大學,碩士在職專班,1286,69,30,39,173,73,100
,104,1,公立,一般大學,15,國立彰化師範大學,博士班,464,55,34,21,121,63,58
,104,1,公立,一般大學,16,國立陽明大學,學士班(日間),2100,86,44,42,116,60,56
,104,1,公立,一般大學,16,國立陽明大學,碩士班(日間),1168,89,32,57,198,69,129
,104,1,公立,一般大學,16,國立陽明大學,碩士在職專班,125,8,3,5,23,5,18
,104,1,公立,一般大學,16,國立陽明大學,博士班,934,97,47,50,279,157,122
,104,1,公立,一般大學,17,國立臺北大學,學士班(日間),5856,100,57,43,152,84,68
,104,1,公立,一般大學,17,國立臺北大學,學士班(進修),1930,94,47,47,173,90,83
,104,1,公立,一般大學,17,國立臺北大學,碩士班(日間),1328,149,65,84,265,132,133
,104,1,公立,一般大學,17,國立臺北大學,碩士在職專班,469,29,18,11,78,37,41
,104,1,公立,一般大學,17,國立臺北大學,博士班,182,25,17,8,56,41,15
,104,1,公立,一般大學,18,國立嘉義大學,學士班(日間),7918,143,90,53,276,178,98
,104,1,公立,一般大學,18,國立嘉義大學,學士班(進修),2104,113,68,45,292,185,107
,104,1,公立,一般大學,18,國立嘉義大學,碩士班(日間),1488,137,58,79,312,145,167
,104,1,公立,一般大學,18,國立嘉義大學,碩士在職專班,998,96,51,45,245,112,133
,104,1,公立,一般大學,18,國立嘉義大學,博士班,185,23,14,9,56,34,22
,104,1,公立,一般大學,19,國立高雄大學,學士班(日間),4185,85,57,28,109,74,35
,104,1,公立,一般大學,19,國立高雄大學,學士班(進修),168,24,15,9,34,24,10
,104,1,公立,一般大學,19,國立高雄大學,碩士班(日間),619,89,57,32,126,84,42
,104,1,公立,一般大學,19,國立高雄大學,碩士在職專班,427,104,57,47,154,88,66
,104,1,公立,一般大學,19,國立高雄大學,博士班,17,1,1,0,1,1,0
,104,1,公立,一般大學,20,國立東華大學,學士班(日間),7477,147,89,58,266,177,89
,104,1,公立,一般大學,20,國立東華大學,學士班(進修),0,0,0,0,1,1,0
,104,1,公立,一般大學,20,國立東華大學,碩士班(日間),1741,269,120,149,588,269,319
,104,1,公立,一般大學,20,國立東華大學,碩士在職專班,581,63,33,30,168,75,93
,104,1,公立,一般大學,20,國立東華大學,博士班,375,63,42,21,126,85,41
,104,1,公立,一般大學,21,國立暨南國際大學,學士班(日間),4392,72,43,29,104,64,40
,104,1,公立,一般大學,21,國立暨南國際大學,學士班(進修),1,0,0,0,0,0,0
,104,1,公立,一般大學,21,國立暨南國際大學,碩士班(日間),1056,108,52,56,208,113,95
,104,1,公立,一般大學,21,國立暨南國際大學,碩士在職專班,373,18,9,9,44,27,17
,104,1,公立,一般大學,21,國立暨南國際大學,博士班,317,52,26,26,86,47,39
,104,1,公立,一般大學,28,國立臺北藝術大學,五專,83,2,2,0,4,4,0
,104,1,公立,一般大學,28,國立臺北藝術大學,學士班(日間),1773,31,14,17,75,36,39
,104,1,公立,一般大學,28,國立臺北藝術大學,碩士班(日間),973,183,58,125,316,117,199
,104,1,公立,一般大學,28,國立臺北藝術大學,碩士在職專班,168,24,7,17,41,13,28
,104,1,公立,一般大學,28,國立臺北藝術大學,博士班,67,21,8,13,31,9,22
,104,1,公立,一般大學,29,國立臺灣藝術大學,學士班(日間),2331,48,25,23,83,42,41
,104,1,公立,一般大學,29,國立臺灣藝術大學,學士班(進修),1923,66,22,44,152,54,98
,104,1,公立,一般大學,29,國立臺灣藝術大學,碩士班(日間),726,101,38,63,212,90,122
,104,1,公立,一般大學,29,國立臺灣藝術大學,碩士在職專班,414,30,14,16,86,30,56
,104,1,公立,一般大學,29,國立臺灣藝術大學,博士班,90,7,1,6,18,3,15
,104,1,公立,一般大學,30,國立臺東大學,學士班(日間),3547,90,52,38,144,83,61
,104,1,公立,一般大學,30,國立臺東大學,學士班(進修),172,22,13,9,46,27,19
,104,1,公立,一般大學,30,國立臺東大學,碩士班(日間),302,24,6,18,91,30,61
,104,1,公立,一般大學,30,國立臺東大學,碩士在職專班,641,78,24,54,124,47,77
,104,1,公立,一般大學,30,國立臺東大學,博士班,38,11,0,11,15,3,12
,104,1,公立,一般大學,31,國立宜蘭大學,學士班(日間),4341,79,51,28,125,92,33
,104,1,公立,一般大學,31,國立宜蘭大學,學士班(進修),452,19,10,9,69,54,15
,104,1,公立,一般大學,31,國立宜蘭大學,碩士班(日間),492,26,22,4,53,42,11
,104,1,公立,一般大學,31,國立宜蘭大學,碩士在職專班,189,12,10,2,34,27,7
,104,1,公立,一般大學,31,國立宜蘭大學,博士班,14,3,2,1,3,2,1
,104,1,公立,一般大學,32,國立聯合大學,學士班(日間),6016,106,76,30,197,159,38
,104,1,公立,一般大學,32,國立聯合大學,學士班(進修),1429,61,41,20,123,86,37
,104,1,公立,一般大學,32,國立聯合大學,碩士班(日間),440,18,14,4,42,33,9
,104,1,公立,一般大學,32,國立聯合大學,博士班,9,0,0,0,2,2,0
,104,1,公立,一般大學,35,國立臺南藝術大學,五專,166,6,1,5,11,1,10
,104,1,公立,一般大學,35,國立臺南藝術大學,學士班(日間),729,15,7,8,34,15,19
,104,1,公立,一般大學,35,國立臺南藝術大學,學士班(進修),1,1,0,1,1,0,1
,104,1,公立,一般大學,35,國立臺南藝術大學,碩士班(日間),544,68,25,43,155,58,97
,104,1,公立,一般大學,35,國立臺南藝術大學,碩士在職專班,49,19,6,13,30,8,22
,104,1,公立,一般大學,35,國立臺南藝術大學,博士班,41,6,0,6,13,6,7
,104,1,公立,一般大學,36,國立臺南大學,學士班(日間),3896,51,25,26,87,44,43
,104,1,公立,一般大學,36,國立臺南大學,學士班(進修),211,3,1,2,19,11,8
,104,1,公立,一般大學,36,國立臺南大學,碩士班(日間),1022,147,58,89,271,111,160
,104,1,公立,一般大學,36,國立臺南大學,碩士在職專班,698,48,18,30,110,37,73
,104,1,公立,一般大學,36,國立臺南大學,博士班,169,22,12,10,45,26,19
,104,1,公立,一般大學,37,國立臺北教育大學,學士班(日間),3319,80,28,52,105,41,64
,104,1,公立,一般大學,37,國立臺北教育大學,碩士班(日間),1147,247,75,172,333,106,227
,104,1,公立,一般大學,37,國立臺北教育大學,碩士在職專班,1008,59,20,39,181,55,126
,104,1,公立,一般大學,37,國立臺北教育大學,博士班,132,41,18,23,45,21,24
,104,1,公立,一般大學,38,國立新竹教育大學,學士班(日間),2573,50,17,33,75,26,49
,104,1,公立,一般大學,38,國立新竹教育大學,碩士班(日間),797,74,20,54,175,38,137
,104,1,公立,一般大學,38,國立新竹教育大學,碩士在職專班,534,40,11,29,69,12,57
,104,1,公立,一般大學,38,國立新竹教育大學,博士班,82,10,2,8,14,3,11
,104,1,公立,一般大學,39,國立臺中教育大學,學士班(日間),3379,43,23,20,79,47,32
,104,1,公立,一般大學,39,國立臺中教育大學,碩士班(日間),833,89,31,58,175,66,109
,104,1,公立,一般大學,39,國立臺中教育大學,碩士在職專班,690,60,9,51,101,17,84
,104,1,公立,一般大學,39,國立臺中教育大學,博士班,126,14,9,5,20,9,11
,104,1,公立,一般大學,44,國立體育大學,學士班(日間),1599,50,40,10,96,76,20
,104,1,公立,一般大學,44,國立體育大學,學士班(進修),97,8,6,2,12,10,2
,104,1,公立,一般大學,44,國立體育大學,碩士班(日間),335,51,36,15,105,71,34
,104,1,公立,一般大學,44,國立體育大學,碩士在職專班,193,19,10,9,59,31,28
,104,1,公立,一般大學,44,國立體育大學,博士班,137,14,7,7,24,16,8
,104,1,公立,一般大學,48,國立金門大學,學士班(日間),3317,75,38,37,121,72,49
,104,1,公立,一般大學,48,國立金門大學,學士班(進修),820,58,33,25,44,26,18
,104,1,公立,一般大學,48,國立金門大學,碩士班(日間),199,23,15,8,28,18,10
,104,1,公立,一般大學,48,國立金門大學,碩士在職專班,53,3,3,0,3,3,0
,104,1,公立,一般大學,49,國立臺灣體育運動大學,學士班(日間),2422,108,84,24,204,159,45
,104,1,公立,一般大學,49,國立臺灣體育運動大學,學士班(進修),380,26,18,8,47,33,14
,104,1,公立,一般大學,49,國立臺灣體育運動大學,碩士班(日間),277,64,32,32,122,63,59
,104,1,公立,一般大學,49,國立臺灣體育運動大學,碩士在職專班,113,5,5,0,9,8,1
,104,1,公立,一般大學,52,國立屏東大學,學士班(日間),6708,84,45,39,148,83,65
,104,1,公立,一般大學,52,國立屏東大學,學士班(進修),597,29,15,14,61,28,33
,104,1,公立,一般大學,52,國立屏東大學,碩士班(日間),911,125,53,72,253,104,149
,104,1,公立,一般大學,52,國立屏東大學,碩士在職專班,480,34,5,29,87,22,65
,104,1,公立,一般大學,52,國立屏東大學,博士班,51,2,0,2,5,1,4
,104,1,公立,一般大學,3002,臺北市立大學,學士班(日間),5082,158,102,56,251,163,88
,104,1,公立,一般大學,3002,臺北市立大學,碩士班(日間),1255,165,54,111,304,108,196
,104,1,公立,一般大學,3002,臺北市立大學,碩士在職專班,985,52,15,37,123,41,82
,104,1,公立,一般大學,3002,臺北市立大學,博士班,251,34,15,19,56,23,33
,104,1,公立,技專校院,22,國立臺灣科技大學,學士班(日間),5483,86,59,27,143,98,45
,104,1,公立,技專校院,22,國立臺灣科技大學,學士班(進修),41,6,1,5,7,1,6
,104,1,公立,技專校院,22,國立臺灣科技大學,碩士班(日間),3208,143,88,55,219,147,72
,104,1,公立,技專校院,22,國立臺灣科技大學,碩士在職專班,756,110,90,20,178,147,31
,104,1,公立,技專校院,22,國立臺灣科技大學,博士班,958,134,103,31,235,185,50
,104,1,公立,技專校院,23,國立雲林科技大學,學士班(日間),6490,83,53,30,163,111,52
,104,1,公立,技專校院,23,國立雲林科技大學,碩士班(日間),2145,104,70,34,249,156,93
,104,1,公立,技專校院,23,國立雲林科技大學,碩士在職專班,749,62,31,31,159,90,69
,104,1,公立,技專校院,23,國立雲林科技大學,博士班,478,43,31,12,124,92,32
,104,1,公立,技專校院,24,國立屏東科技大學,學士班(日間),7842,99,53,46,184,107,77
,104,1,公立,技專校院,24,國立屏東科技大學,學士班(進修),1582,37,24,13,81,49,32
,104,1,公立,技專校院,24,國立屏東科技大學,碩士班(日間),1276,90,51,39,212,118,94
,104,1,公立,技專校院,24,國立屏東科技大學,碩士在職專班,509,28,20,8,80,59,21
,104,1,公立,技專校院,24,國立屏東科技大學,博士班,245,27,15,12,53,27,26
,104,1,公立,技專校院,25,國立臺北科技大學,學士班(日間),5929,105,76,29,153,115,38
,104,1,公立,技專校院,25,國立臺北科技大學,學士班(進修),1262,66,51,15,82,65,17
,104,1,公立,技專校院,25,國立臺北科技大學,碩士班(日間),2721,93,68,25,103,77,26
,104,1,公立,技專校院,25,國立臺北科技大學,碩士在職專班,1329,146,111,35,203,160,43
,104,1,公立,技專校院,25,國立臺北科技大學,博士班,684,88,70,18,133,103,30
,104,1,公立,技專校院,26,國立高雄第一科技大學,學士班(日間),5647,94,53,41,147,85,62
,104,1,公立,技專校院,26,國立高雄第一科技大學,碩士班(日間),1094,86,50,36,169,103,66
,104,1,公立,技專校院,26,國立高雄第一科技大學,碩士在職專班,736,39,31,8,126,99,27
,104,1,公立,技專校院,26,國立高雄第一科技大學,博士班,232,22,18,4,45,35,10
,104,1,公立,技專校院,27,國立高雄應用科技大學,學士班(日間),7603,117,88,29,194,142,52
,104,1,公立,技專校院,27,國立高雄應用科技大學,學士班(進修),1742,97,59,38,214,141,73
,104,1,公立,技專校院,27,國立高雄應用科技大學,碩士班(日間),1263,70,49,21,131,94,37
,104,1,公立,技專校院,27,國立高雄應用科技大學,碩士在職專班,1264,111,82,29,262,194,68
,104,1,公立,技專校院,27,國立高雄應用科技大學,博士班,299,19,14,5,39,34,5
,104,1,公立,技專校院,33,國立虎尾科技大學,學士班(日間),7615,89,75,14,218,178,40
,104,1,公立,技專校院,33,國立虎尾科技大學,學士班(進修),1321,55,40,15,109,84,25
,104,1,公立,技專校院,33,國立虎尾科技大學,碩士班(日間),856,36,29,7,111,86,25
,104,1,公立,技專校院,33,國立虎尾科技大學,碩士在職專班,244,25,18,7,25,18,7
,104,1,公立,技專校院,33,國立虎尾科技大學,博士班,26,1,1,0,8,8,0
,104,1,公立,技專校院,34,國立高雄海洋科技大學,五專,506,4,4,0,7,7,0
,104,1,公立,技專校院,34,國立高雄海洋科技大學,學士班(日間),4935,98,71,27,169,126,43
,104,1,公立,技專校院,34,國立高雄海洋科技大學,學士班(進修),1784,91,63,28,113,81,32
,104,1,公立,技專校院,34,國立高雄海洋科技大學,碩士班(日間),332,36,19,17,78,48,30
,104,1,公立,技專校院,34,國立高雄海洋科技大學,碩士在職專班,179,18,11,7,26,17,9
,104,1,公立,技專校院,34,國立高雄海洋科技大學,博士班,9,0,0,0,0,0,0
,104,1,公立,技專校院,42,國立澎湖科技大學,學士班(日間),2542,60,37,23,72,47,25
,104,1,公立,技專校院,42,國立澎湖科技大學,學士班(進修),327,20,10,10,23,13,10
,104,1,公立,技專校院,42,國立澎湖科技大學,碩士班(日間),70,17,8,9,23,13,10
,104,1,公立,技專校院,42,國立澎湖科技大學,碩士在職專班,45,7,5,2,8,5,3
,104,1,公立,技專校院,43,國立勤益科技大學,二專(日間),7,6,4,2,16,12,4
,104,1,公立,技專校院,43,國立勤益科技大學,二專(進修),1,0,0,0,1,1,0
,104,1,公立,技專校院,43,國立勤益科技大學,學士班(日間),6831,125,93,32,339,253,86
,104,1,公立,技專校院,43,國立勤益科技大學,學士班(進修),3565,135,109,26,199,157,42
,104,1,公立,技專校院,43,國立勤益科技大學,碩士班(日間),649,22,14,8,71,58,13
,104,1,公立,技專校院,43,國立勤益科技大學,碩士在職專班,253,23,20,3,15,12,3
,104,1,公立,技專校院,43,國立勤益科技大學,博士班,12,0,0,0,1,1,0
,104,1,公立,技專校院,46,國立臺北護理健康大學,學士班(日間),3133,59,16,43,109,26,83
,104,1,公立,技專校院,46,國立臺北護理健康大學,學士班(進修),696,33,1,32,91,1,90
,104,1,公立,技專校院,46,國立臺北護理健康大學,碩士班(日間),585,87,13,74,208,29,179
,104,1,公立,技專校院,46,國立臺北護理健康大學,碩士在職專班,183,22,3,19,55,8,47
,104,1,公立,技專校院,46,國立臺北護理健康大學,博士班,60,9,0,9,20,0,20
,104,1,公立,技專校院,47,國立高雄餐旅大學,二專(進修),278,8,5,3,27,14,13
,104,1,公立,技專校院,47,國立高雄餐旅大學,五專,213,5,2,3,9,5,4
,104,1,公立,技專校院,47,國立高雄餐旅大學,學士班(日間),3296,65,20,45,112,41,71
,104,1,公立,技專校院,47,國立高雄餐旅大學,學士班(進修),1206,23,5,18,57,16,41
,104,1,公立,技專校院,47,國立高雄餐旅大學,碩士班(日間),189,10,3,7,30,13,17
,104,1,公立,技專校院,47,國立高雄餐旅大學,碩士在職專班,95,6,3,3,12,7,5
,104,1,公立,技專校院,47,國立高雄餐旅大學,博士班,24,2,2,0,3,2,1
,104,1,公立,技專校院,50,國立臺中科技大學,二專(日間),67,2,0,2,3,0,3
,104,1,公立,技專校院,50,國立臺中科技大學,二專(進修),181,20,0,20,32,2,30
,104,1,公立,技專校院,50,國立臺中科技大學,五專,3825,76,19,57,105,27,78
,104,1,公立,技專校院,50,國立臺中科技大學,學士班(日間),6574,114,30,84,162,52,110
,104,1,公立,技專校院,50,國立臺中科技大學,學士班(進修),2671,149,67,82,207,89,118
,104,1,公立,技專校院,50,國立臺中科技大學,碩士班(日間),405,30,15,15,49,28,21
,104,1,公立,技專校院,50,國立臺中科技大學,碩士在職專班,152,11,7,4,20,10,10
,104,1,公立,技專校院,51,國立臺北商業大學,二專(進修),213,13,7,6,16,7,9
,104,1,公立,技專校院,51,國立臺北商業大學,五專,1978,49,20,29,90,35,55
,104,1,公立,技專校院,51,國立臺北商業大學,學士班(日間),2876,34,12,22,78,30,48
,104,1,公立,技專校院,51,國立臺北商業大學,學士班(進修),1602,44,21,23,111,48,63
,104,1,公立,技專校院,51,國立臺北商業大學,碩士班(日間),155,12,4,8,23,13,10
,104,1,公立,技專校院,51,國立臺北商業大學,碩士在職專班,21,0,0,0,10,5,5
,104,1,公立,技專校院,144,國立臺灣戲曲學院,學士班(日間),515,24,12,12,38,20,18
,104,1,公立,技專校院,144,國立臺灣戲曲學院,學士班(進修),60,5,2,3,7,3,4
,104,1,公立,技專校院,221,國立臺南護理專科學校,二專(日間),100,2,0,2,8,1,7
,104,1,公立,技專校院,221,國立臺南護理專科學校,二專(進修),83,5,2,3,15,4,11
,104,1,公立,技專校院,221,國立臺南護理專科學校,五專,1763,23,2,21,35,2,33
,104,1,公立,技專校院,222,國立臺東專科學校,二專(日間),494,16,9,7,20,12,8
,104,1,公立,技專校院,222,國立臺東專科學校,二專(進修),109,13,7,6,20,11,9
,104,1,公立,技專校院,222,國立臺東專科學校,五專,660,16,9,7,27,13,14
,104,1,私立,一般大學,1001,東海大學,學士班(日間),13844,287,151,136,556,320,236
,104,1,私立,一般大學,1001,東海大學,學士班(進修),625,43,22,21,140,83,57
,104,1,私立,一般大學,1001,東海大學,碩士班(日間),1459,118,53,65,359,168,191
,104,1,私立,一般大學,1001,東海大學,碩士在職專班,778,62,25,37,188,85,103
,104,1,私立,一般大學,1001,東海大學,博士班,227,23,17,6,74,43,31
,104,1,私立,一般大學,1002,輔仁大學,學士班(日間),18281,456,227,229,709,365,344
,104,1,私立,一般大學,1002,輔仁大學,學士班(進修),4887,201,91,110,362,161,201
,104,1,私立,一般大學,1002,輔仁大學,碩士班(日間),2165,296,130,166,641,272,369
,104,1,私立,一般大學,1002,輔仁大學,碩士在職專班,1641,117,42,75,354,148,206
,104,1,私立,一般大學,1002,輔仁大學,博士班,453,79,41,38,190,101,89
,104,1,私立,一般大學,1003,東吳大學,學士班(日間),12131,290,158,132,379,206,173
,104,1,私立,一般大學,1003,東吳大學,學士班(進修),1211,72,22,50,119,37,82
,104,1,私立,一般大學,1003,東吳大學,碩士班(日間),1197,181,91,90,260,140,120
,104,1,私立,一般大學,1003,東吳大學,碩士在職專班,1155,112,53,59,197,91,106
,104,1,私立,一般大學,1003,東吳大學,博士班,102,17,10,7,23,15,8
,104,1,私立,一般大學,1004,中原大學,學士班(日間),13279,238,151,87,490,324,166
,104,1,私立,一般大學,1004,中原大學,學士班(進修),1,0,0,0,0,0,0
,104,1,私立,一般大學,1004,中原大學,碩士班(日間),1696,93,44,49,301,166,135
,104,1,私立,一般大學,1004,中原大學,碩士在職專班,987,68,46,22,259,183,76
,104,1,私立,一般大學,1004,中原大學,博士班,354,26,20,6,119,86,33
,104,1,私立,一般大學,1005,淡江大學,學士班(日間),20972,447,260,187,887,538,349
,104,1,私立,一般大學,1005,淡江大學,學士班(進修),2374,124,68,56,303,175,128
,104,1,私立,一般大學,1005,淡江大學,碩士班(日間),1972,131,73,58,419,234,185
,104,1,私立,一般大學,1005,淡江大學,碩士在職專班,1227,86,46,40,253,131,122
,104,1,私立,一般大學,1005,淡江大學,博士班,496,49,30,19,135,90,45
,104,1,私立,一般大學,1006,中國文化大學,學士班(日間),21348,459,270,189,754,448,306
,104,1,私立,一般大學,1006,中國文化大學,學士班(進修),2657,236,121,115,567,281,286
,104,1,私立,一般大學,1006,中國文化大學,碩士班(日間),1581,196,109,87,412,233,179
,104,1,私立,一般大學,1006,中國文化大學,碩士在職專班,603,49,30,19,99,50,49
,104,1,私立,一般大學,1006,中國文化大學,博士班,505,67,45,22,114,75,39
,104,1,私立,一般大學,1007,逢甲大學,學士班(日間),17063,391,306,85,470,374,96
,104,1,私立,一般大學,1007,逢甲大學,學士班(進修),974,91,51,40,115,70,45
,104,1,私立,一般大學,1007,逢甲大學,碩士班(日間),1646,151,111,40,191,137,54
,104,1,私立,一般大學,1007,逢甲大學,碩士在職專班,1110,114,71,43,154,95,59
,104,1,私立,一般大學,1007,逢甲大學,博士班,408,60,42,18,85,61,24
,104,1,私立,一般大學,1008,靜宜大學,學士班(日間),11446,231,144,87,378,241,137
,104,1,私立,一般大學,1008,靜宜大學,學士班(進修),47,4,3,1,10,7,3
,104,1,私立,一般大學,1008,靜宜大學,碩士班(日間),580,63,24,39,125,53,72
,104,1,私立,一般大學,1008,靜宜大學,碩士在職專班,326,19,10,9,47,19,28
,104,1,私立,一般大學,1008,靜宜大學,博士班,36,6,4,2,10,5,5
,104,1,私立,一般大學,1009,長庚大學,學士班(日間),5218,129,71,58,168,95,73
,104,1,私立,一般大學,1009,長庚大學,碩士班(日間),1322,70,27,43,182,84,98
,104,1,私立,一般大學,1009,長庚大學,碩士在職專班,296,15,9,6,79,44,35
,104,1,私立,一般大學,1009,長庚大學,博士班,550,35,25,10,95,65,30
,104,1,私立,一般大學,1010,元智大學,學士班(日間),7223,91,56,35,138,85,53
,104,1,私立,一般大學,1010,元智大學,碩士班(日間),1053,34,21,13,82,58,24
,104,1,私立,一般大學,1010,元智大學,碩士在職專班,837,54,42,12,134,96,38
,104,1,私立,一般大學,1010,元智大學,博士班,307,26,18,8,52,39,13
,104,1,私立,一般大學,1011,中華大學,學士班(日間),7062,178,120,58,342,251,91
,104,1,私立,一般大學,1011,中華大學,學士班(進修),379,26,21,5,42,31,11
,104,1,私立,一般大學,1011,中華大學,碩士班(日間),645,23,14,9,75,55,20
,104,1,私立,一般大學,1011,中華大學,碩士在職專班,261,9,7,2,32,25,7
,104,1,私立,一般大學,1011,中華大學,博士班,126,15,10,5,44,32,12
,104,1,私立,一般大學,1012,大葉大學,學士班(日間),8920,188,119,69,358,242,116
,104,1,私立,一般大學,1012,大葉大學,學士班(進修),1522,62,46,16,123,94,29
,104,1,私立,一般大學,1012,大葉大學,碩士班(日間),758,57,30,27,134,72,62
,104,1,私立,一般大學,1012,大葉大學,碩士在職專班,563,26,6,20,70,34,36
,104,1,私立,一般大學,1012,大葉大學,博士班,128,14,9,5,57,40,17
,104,1,私立,一般大學,1013,華梵大學,學士班(日間),2613,87,48,39,146,89,57
,104,1,私立,一般大學,1013,華梵大學,碩士班(日間),306,36,24,12,76,49,27
,104,1,私立,一般大學,1013,華梵大學,碩士在職專班,270,25,18,7,59,40,19
,104,1,私立,一般大學,1013,華梵大學,博士班,53,6,4,2,11,8,3
,104,1,私立,一般大學,1014,義守大學,學士班(日間),13137,186,124,62,257,185,72
,104,1,私立,一般大學,1014,義守大學,學士班(進修),2364,79,50,29,343,224,119
,104,1,私立,一般大學,1014,義守大學,碩士班(日間),576,18,12,6,34,25,9
,104,1,私立,一般大學,1014,義守大學,碩士在職專班,452,14,11,3,80,50,30
,104,1,私立,一般大學,1014,義守大學,博士班,137,9,6,3,15,10,5
,104,1,私立,一般大學,1015,世新大學,學士班(日間),9959,211,103,108,338,175,163
,104,1,私立,一般大學,1015,世新大學,學士班(進修),204,9,3,6,18,6,12
,104,1,私立,一般大學,1015,世新大學,碩士班(日間),681,85,50,35,157,90,67
,104,1,私立,一般大學,1015,世新大學,碩士在職專班,930,79,42,37,237,114,123
,104,1,私立,一般大學,1015,世新大學,博士班,76,10,4,6,19,7,12
,104,1,私立,一般大學,1016,銘傳大學,學士班(日間),17787,434,232,202,718,431,287
,104,1,私立,一般大學,1016,銘傳大學,碩士班(日間),720,60,34,26,130,76,54
,104,1,私立,一般大學,1016,銘傳大學,碩士在職專班,847,49,23,26,94,41,53
,104,1,私立,一般大學,1016,銘傳大學,博士班,59,11,6,5,23,12,11
,104,1,私立,一般大學,1017,實踐大學,學士班(日間),12477,325,139,186,468,208,260
,104,1,私立,一般大學,1017,實踐大學,學士班(進修),2538,144,42,102,212,71,141
,104,1,私立,一般大學,1017,實踐大學,碩士班(日間),389,34,22,12,78,44,34
,104,1,私立,一般大學,1017,實踐大學,碩士在職專班,198,48,21,27,70,34,36
,104,1,私立,一般大學,1017,實踐大學,博士班,14,0,0,0,0,0,0
,104,1,私立,一般大學,1019,高雄醫學大學,學士班(日間),5638,172,74,98,234,107,127
,104,1,私立,一般大學,1019,高雄醫學大學,學士班(進修),123,4,1,3,6,1,5
,104,1,私立,一般大學,1019,高雄醫學大學,碩士班(日間),604,58,22,36,125,46,79
,104,1,私立,一般大學,1019,高雄醫學大學,碩士在職專班,204,28,13,15,64,28,36
,104,1,私立,一般大學,1019,高雄醫學大學,博士班,325,35,23,12,90,55,35
,104,1,私立,一般大學,1020,南華大學,學士班(日間),4237,107,66,41,239,144,95
,104,1,私立,一般大學,1020,南華大學,學士班(進修),227,6,1,5,14,9,5
,104,1,私立,一般大學,1020,南華大學,碩士班(日間),638,57,25,32,164,76,88
,104,1,私立,一般大學,1020,南華大學,碩士在職專班,417,18,8,10,73,40,33
,104,1,私立,一般大學,1020,南華大學,博士班,36,0,0,0,5,3,2
,104,1,私立,一般大學,1021,真理大學,學士班(日間),7791,172,110,62,272,175,97
,104,1,私立,一般大學,1021,真理大學,學士班(進修),558,20,15,5,48,32,16
,104,1,私立,一般大學,1021,真理大學,碩士班(日間),157,7,6,1,18,12,6
,104,1,私立,一般大學,1021,真理大學,碩士在職專班,13,0,0,0,0,0,0
,104,1,私立,一般大學,1022,大同大學,學士班(日間),3733,61,47,14,133,103,30
,104,1,私立,一般大學,1022,大同大學,碩士班(日間),426,17,13,4,43,36,7
,104,1,私立,一般大學,1022,大同大學,碩士在職專班,399,29,26,3,109,88,21
,104,1,私立,一般大學,1022,大同大學,博士班,134,13,9,4,33,27,6
,104,1,私立,一般大學,1027,慈濟大學,學士班(日間),2934,74,37,37,109,55,54
,104,1,私立,一般大學,1027,慈濟大學,碩士班(日間),347,47,12,35,78,28,50
,104,1,私立,一般大學,1027,慈濟大學,碩士在職專班,35,3,0,3,7,2,5
,104,1,私立,一般大學,1027,慈濟大學,博士班,104,21,3,18,42,12,30
,104,1,私立,一般大學,1028,臺北醫學大學,學士班(日間),4596,130,64,66,177,86,91
,104,1,私立,一般大學,1028,臺北醫學大學,學士班(進修),55,1,0,1,2,0,2
,104,1,私立,一般大學,1028,臺北醫學大學,碩士班(日間),608,40,14,26,92,34,58
,104,1,私立,一般大學,1028,臺北醫學大學,碩士在職專班,228,25,6,19,55,8,47
,104,1,私立,一般大學,1028,臺北醫學大學,博士班,408,25,16,9,65,41,24
,104,1,私立,一般大學,1029,中山醫學大學,學士班(日間),6420,179,76,103,236,110,126
,104,1,私立,一般大學,1029,中山醫學大學,學士班(進修),245,9,4,5,20,10,10
,104,1,私立,一般大學,1029,中山醫學大學,碩士班(日間),489,34,15,19,57,24,33
,104,1,私立,一般大學,1029,中山醫學大學,碩士在職專班,125,19,5,14,22,7,15
,104,1,私立,一般大學,1029,中山醫學大學,博士班,225,17,11,6,43,24,19
,104,1,私立,一般大學,1033,長榮大學,學士班(日間),9303,239,162,77,573,381,192
,104,1,私立,一般大學,1033,長榮大學,學士班(進修),627,23,13,10,68,49,19
,104,1,私立,一般大學,1033,長榮大學,碩士班(日間),472,77,28,49,168,69,99
,104,1,私立,一般大學,1033,長榮大學,碩士在職專班,155,28,8,20,62,28,34
,104,1,私立,一般大學,1033,長榮大學,博士班,37,13,4,9,28,14,14
,104,1,私立,一般大學,1035,中國醫藥大學,學士班(日間),6380,182,96,86,243,132,111
,104,1,私立,一般大學,1035,中國醫藥大學,學士班(進修),73,5,0,5,15,4,11
,104,1,私立,一般大學,1035,中國醫藥大學,碩士班(日間),490,55,16,39,103,39,64
,104,1,私立,一般大學,1035,中國醫藥大學,碩士在職專班,67,3,3,0,10,5,5
,104,1,私立,一般大學,1035,中國醫藥大學,博士班,356,33,21,12,86,49,37
,104,1,私立,一般大學,1039,玄奘大學,學士班(日間),4136,135,60,75,283,136,147
,104,1,私立,一般大學,1039,玄奘大學,學士班(進修),1124,98,57,41,199,117,82
,104,1,私立,一般大學,1039,玄奘大學,碩士班(日間),345,52,18,34,128,56,72
,104,1,私立,一般大學,1039,玄奘大學,碩士在職專班,245,17,4,13,36,13,23
,104,1,私立,一般大學,1039,玄奘大學,博士班,9,2,1,1,3,2,1
,104,1,私立,一般大學,1048,亞洲大學,學士班(日間),9861,235,138,97,780,464,316
,104,1,私立,一般大學,1048,亞洲大學,學士班(進修),1307,107,63,44,324,192,132
,104,1,私立,一般大學,1048,亞洲大學,碩士班(日間),611,70,38,32,235,120,115
,104,1,私立,一般大學,1048,亞洲大學,碩士在職專班,495,34,17,17,86,41,45
,104,1,私立,一般大學,1048,亞洲大學,博士班,159,15,11,4,50,32,18
,104,1,私立,一般大學,1049,開南大學,學士班(日間),7647,202,142,60,445,324,121
,104,1,私立,一般大學,1049,開南大學,學士班(進修),1239,54,35,19,140,95,45
,104,1,私立,一般大學,1049,開南大學,碩士班(日間),258,25,17,8,78,56,22
,104,1,私立,一般大學,1049,開南大學,碩士在職專班,370,11,8,3,22,16,6
,104,1,私立,一般大學,1050,佛光大學,學士班(日間),3017,67,33,34,124,68,56
,104,1,私立,一般大學,1050,佛光大學,碩士班(日間),627,84,41,43,191,111,80
,104,1,私立,一般大學,1050,佛光大學,碩士在職專班,245,12,5,7,20,10,10
,104,1,私立,一般大學,1050,佛光大學,博士班,52,3,3,0,8,4,4
,104,1,私立,一般大學,1058,明道大學,學士班(日間),3696,70,47,23,110,70,40
,104,1,私立,一般大學,1058,明道大學,學士班(進修),1569,58,41,17,103,76,27
,104,1,私立,一般大學,1058,明道大學,碩士班(日間),201,19,11,8,40,25,15
,104,1,私立,一般大學,1058,明道大學,碩士在職專班,92,2,1,1,3,1,2
,104,1,私立,一般大學,1058,明道大學,博士班,13,0,0,0,0,0,0
,104,1,私立,一般大學,1067,台灣首府大學,學士班(日間),3285,70,50,20,93,71,22
,104,1,私立,一般大學,1067,台灣首府大學,學士班(進修),735,30,25,5,27,22,5
,104,1,私立,一般大學,1067,台灣首府大學,碩士班(日間),67,0,0,0,0,0,0
,104,1,私立,一般大學,1067,台灣首府大學,碩士在職專班,7,0,0,0,0,0,0
,104,1,私立,一般大學,1079,康寧大學,二專(日間),76,4,0,4,8,0,8
,104,1,私立,一般大學,1079,康寧大學,二專(進修),329,3,1,2,11,4,7
,104,1,私立,一般大學,1079,康寧大學,五專,2903,56,14,42,80,26,54
,104,1,私立,一般大學,1079,康寧大學,學士班(日間),1275,73,51,22,193,156,37
,104,1,私立,一般大學,1079,康寧大學,學士班(進修),524,49,40,9,124,99,25
,104,1,私立,一般大學,1079,康寧大學,碩士班(日間),148,13,6,7,44,31,13
,104,1,私立,一般大學,1079,康寧大學,碩士在職專班,157,8,6,2,18,15,3
,104,1,私立,一般大學,1125,中信金融管理學院,學士班(日間),184,4,2,2,19,11,8
,104,1,私立,一般大學,1125,中信金融管理學院,學士班(進修),22,12,9,3,28,14,14
,104,1,私立,一般大學,1176,稻江科技暨管理學院,學士班(日間),1452,35,12,23,127,64,63
,104,1,私立,一般大學,1176,稻江科技暨管理學院,學士班(進修),792,20,13,7,67,39,28
,104,1,私立,一般大學,1176,稻江科技暨管理學院,碩士班(日間),74,6,3,3,11,5,6
,104,1,私立,一般大學,1176,稻江科技暨管理學院,碩士在職專班,63,2,2,0,4,4,0
,104,1,私立,一般大學,1195,馬偕醫學院,學士班(日間),600,16,7,9,22,10,12
,104,1,私立,一般大學,1195,馬偕醫學院,學士班(進修),17,0,0,0,0,0,0
,104,1,私立,一般大學,1195,馬偕醫學院,碩士班(日間),23,4,1,3,7,1,6
,104,1,私立,一般大學,1196,法鼓文理學院,學士班(日間),52,2,1,1,4,2,2
,104,1,私立,一般大學,1196,法鼓文理學院,碩士班(日間),116,11,4,7,14,4,10
,104,1,私立,一般大學,1196,法鼓文理學院,博士班,11,1,0,1,2,0,2
,104,1,私立,一般大學,1R02,基督教台灣浸會神學院,碩士班(日間),42,1,0,1,1,0,1
,104,1,私立,一般大學,1R03,臺北基督學院,學士班(日間),138,15,6,9,32,14,18
,104,1,私立,一般大學,1R04,一貫道天皇學院,碩士班(日間),12,0,0,0,0,0,0
,104,1,私立,技專校院,1018,朝陽科技大學,學士班(日間),11696,210,118,92,368,214,154
,104,1,私立,技專校院,1018,朝陽科技大學,學士班(進修),3337,178,92,86,343,190,153
,104,1,私立,技專校院,1018,朝陽科技大學,碩士班(日間),748,77,36,41,166,87,79
,104,1,私立,技專校院,1018,朝陽科技大學,碩士在職專班,479,25,14,11,78,36,42
,104,1,私立,技專校院,1018,朝陽科技大學,博士班,89,8,6,2,14,11,3
,104,1,私立,技專校院,1023,南臺科技大學,學士班(日間),13320,220,138,82,432,281,151
,104,1,私立,技專校院,1023,南臺科技大學,學士班(進修),4481,183,120,63,506,345,161
,104,1,私立,技專校院,1023,南臺科技大學,碩士班(日間),944,78,51,27,185,126,59
,104,1,私立,技專校院,1023,南臺科技大學,碩士在職專班,503,38,14,24,86,39,47
,104,1,私立,技專校院,1023,南臺科技大學,博士班,72,3,3,0,9,9,0
,104,1,私立,技專校院,1024,崑山科技大學,學士班(日間),8535,202,132,70,689,488,201
,104,1,私立,技專校院,1024,崑山科技大學,學士班(進修),3438,228,158,70,735,512,223
,104,1,私立,技專校院,1024,崑山科技大學,碩士班(日間),428,25,20,5,109,83,26
,104,1,私立,技專校院,1024,崑山科技大學,碩士在職專班,201,4,4,0,26,22,4
,104,1,私立,技專校院,1024,崑山科技大學,博士班,34,1,1,0,3,3,0
,104,1,私立,技專校院,1025,嘉南藥理大學,學士班(日間),13126,230,99,131,694,380,314
,104,1,私立,技專校院,1025,嘉南藥理大學,學士班(進修),3314,253,143,110,721,438,283
,104,1,私立,技專校院,1025,嘉南藥理大學,碩士班(日間),312,18,13,5,83,56,27
,104,1,私立,技專校院,1025,嘉南藥理大學,碩士在職專班,219,18,5,13,47,16,31
,104,1,私立,技專校院,1026,樹德科技大學,學士班(日間),8386,324,168,156,324,168,156
,104,1,私立,技專校院,1026,樹德科技大學,學士班(進修),2140,163,111,52,163,111,52
,104,1,私立,技專校院,1026,樹德科技大學,碩士班(日間),326,65,34,31,65,34,31
,104,1,私立,技專校院,1026,樹德科技大學,碩士在職專班,469,56,33,23,56,33,23
,104,1,私立,技專校院,1026,樹德科技大學,博士班,26,5,1,4,5,1,4
,104,1,私立,技專校院,1030,龍華科技大學,二專(日間),11,3,3,0,3,3,0
,104,1,私立,技專校院,1030,龍華科技大學,五專,38,0,0,0,0,0,0
,104,1,私立,技專校院,1030,龍華科技大學,學士班(日間),6766,130,94,36,321,241,80
,104,1,私立,技專校院,1030,龍華科技大學,學士班(進修),3928,173,139,34,270,214,56
,104,1,私立,技專校院,1030,龍華科技大學,碩士班(日間),349,13,10,3,39,33,6
,104,1,私立,技專校院,1030,龍華科技大學,碩士在職專班,76,2,1,1,3,1,2
,104,1,私立,技專校院,1031,輔英科技大學,五專,2901,38,6,32,67,15,52
,104,1,私立,技專校院,1031,輔英科技大學,學士班(日間),5369,150,62,88,346,160,186
,104,1,私立,技專校院,1031,輔英科技大學,學士班(進修),1140,75,42,33,168,97,71
,104,1,私立,技專校院,1031,輔英科技大學,碩士班(日間),123,9,2,7,27,4,23
,104,1,私立,技專校院,1031,輔英科技大學,碩士在職專班,46,9,0,9,15,0,15
,104,1,私立,技專校院,1032,明新科技大學,二專(日間),9,0,0,0,0,0,0
,104,1,私立,技專校院,1032,明新科技大學,二專(進修),54,0,0,0,0,0,0
,104,1,私立,技專校院,1032,明新科技大學,學士班(日間),8692,193,141,52,1207,760,447
,104,1,私立,技專校院,1032,明新科技大學,學士班(進修),4042,177,121,56,434,300,134
,104,1,私立,技專校院,1032,明新科技大學,碩士班(日間),343,10,9,1,192,140,52
,104,1,私立,技專校院,1032,明新科技大學,碩士在職專班,235,7,6,1,26,20,6
,104,1,私立,技專校院,1034,弘光科技大學,二專(進修),67,1,0,1,3,1,2
,104,1,私立,技專校院,1034,弘光科技大學,五專,269,0,0,0,0,0,0
,104,1,私立,技專校院,1034,弘光科技大學,學士班(日間),8036,118,56,62,352,163,189
,104,1,私立,技專校院,1034,弘光科技大學,學士班(進修),4340,165,54,111,537,246,291
,104,1,私立,技專校院,1034,弘光科技大學,碩士班(日間),201,21,3,18,61,24,37
,104,1,私立,技專校院,1034,弘光科技大學,碩士在職專班,93,14,1,13,36,8,28
,104,1,私立,技專校院,1036,健行科技大學,二專(日間),46,2,0,2,2,0,2
,104,1,私立,技專校院,1036,健行科技大學,五專,28,0,0,0,0,0,0
,104,1,私立,技專校院,1036,健行科技大學,學士班(日間),8088,186,141,45,373,292,81
,104,1,私立,技專校院,1036,健行科技大學,學士班(進修),3483,129,87,42,339,239,100
,104,1,私立,技專校院,1036,健行科技大學,碩士班(日間),355,9,8,1,27,23,4
,104,1,私立,技專校院,1036,健行科技大學,碩士在職專班,101,6,5,1,11,9,2
,104,1,私立,技專校院,1037,正修科技大學,二專(進修),2,0,0,0,0,0,0
,104,1,私立,技專校院,1037,正修科技大學,五專,13,0,0,0,0,0,0
,104,1,私立,技專校院,1037,正修科技大學,學士班(日間),9890,248,169,79,566,384,182
,104,1,私立,技專校院,1037,正修科技大學,學士班(進修),6875,438,272,166,943,615,328
,104,1,私立,技專校院,1037,正修科技大學,碩士班(日間),354,20,11,9,60,38,22
,104,1,私立,技專校院,1037,正修科技大學,碩士在職專班,115,7,5,2,13,10,3
,104,1,私立,技專校院,1037,正修科技大學,博士班,12,0,0,0,1,1,0
,104,1,私立,技專校院,1038,萬能科技大學,二專(進修),15,0,0,0,0,0,0
,104,1,私立,技專校院,1038,萬能科技大學,學士班(日間),6619,146,91,55,440,276,164
,104,1,私立,技專校院,1038,萬能科技大學,學士班(進修),4163,92,55,37,518,330,188
,104,1,私立,技專校院,1038,萬能科技大學,碩士班(日間),145,20,12,8,58,41,17
,104,1,私立,技專校院,1038,萬能科技大學,碩士在職專班,105,2,1,1,17,12,5
,104,1,私立,技專校院,1040,建國科技大學,二專(日間),1,0,0,0,0,0,0
,104,1,私立,技專校院,1040,建國科技大學,二專(進修),1,0,0,0,0,0,0
,104,1,私立,技專校院,1040,建國科技大學,學士班(日間),7063,179,131,48,348,258,90
,104,1,私立,技專校院,1040,建國科技大學,學士班(進修),1719,63,46,17,103,76,27
,104,1,私立,技專校院,1040,建國科技大學,碩士班(日間),225,5,5,0,12,10,2
,104,1,私立,技專校院,1041,明志科技大學,五專,15,0,0,0,0,0,0
,104,1,私立,技專校院,1041,明志科技大學,學士班(日間),3568,25,21,4,30,24,6
,104,1,私立,技專校院,1041,明志科技大學,學士班(進修),488,10,8,2,25,18,7
,104,1,私立,技專校院,1041,明志科技大學,碩士班(日間),409,26,22,4,34,30,4
,104,1,私立,技專校院,1041,明志科技大學,碩士在職專班,52,10,7,3,18,14,4
,104,1,私立,技專校院,1042,高苑科技大學,二專(日間),6,0,0,0,0,0,0
,104,1,私立,技專校院,1042,高苑科技大學,學士班(日間),5641,146,112,34,214,167,47
,104,1,私立,技專校院,1042,高苑科技大學,學士班(進修),1451,69,50,19,79,60,19
,104,1,私立,技專校院,1042,高苑科技大學,碩士班(日間),148,5,5,0,9,8,1
,104,1,私立,技專校院,1042,高苑科技大學,碩士在職專班,278,16,12,4,22,17,5
,104,1,私立,技專校院,1043,大仁科技大學,五專,1,0,0,0,5,3,2
,104,1,私立,技專校院,1043,大仁科技大學,學士班(日間),5471,201,109,92,647,397,250
,104,1,私立,技專校院,1043,大仁科技大學,學士班(進修),1790,65,42,23,400,249,151
,104,1,私立,技專校院,1043,大仁科技大學,碩士班(日間),62,7,5,2,22,16,6
,104,1,私立,技專校院,1043,大仁科技大學,碩士在職專班,144,16,6,10,38,18,20
,104,1,私立,技專校院,1044,聖約翰科技大學,五專,96,13,12,1,4,3,1
,104,1,私立,技專校院,1044,聖約翰科技大學,學士班(日間),4604,150,113,37,444,348,96
,104,1,私立,技專校院,1044,聖約翰科技大學,學士班(進修),323,27,17,10,96,69,27
,104,1,私立,技專校院,1044,聖約翰科技大學,碩士班(日間),166,13,13,0,38,36,2
,104,1,私立,技專校院,1044,聖約翰科技大學,碩士在職專班,69,3,2,1,14,12,2
,104,1,私立,技專校院,1045,嶺東科技大學,二專(日間),20,0,0,0,0,0,0
,104,1,私立,技專校院,1045,嶺東科技大學,學士班(日間),7526,111,47,64,176,85,91
,104,1,私立,技專校院,1045,嶺東科技大學,學士班(進修),2494,119,63,56,267,148,119
,104,1,私立,技專校院,1045,嶺東科技大學,碩士班(日間),258,23,9,14,36,15,21
,104,1,私立,技專校院,1045,嶺東科技大學,碩士在職專班,101,7,5,2,13,11,2
,104,1,私立,技專校院,1046,中國科技大學,學士班(日間),9542,227,114,113,472,244,228
,104,1,私立,技專校院,1046,中國科技大學,學士班(進修),2511,139,77,62,283,170,113
,104,1,私立,技專校院,1046,中國科技大學,碩士班(日間),145,23,16,7,38,23,15
,104,1,私立,技專校院,1046,中國科技大學,碩士在職專班,47,1,1,0,1,1,0
,104,1,私立,技專校院,1047,中臺科技大學,學士班(日間),6238,189,95,94,459,237,222
,104,1,私立,技專校院,1047,中臺科技大學,學士班(進修),2865,169,74,95,589,280,309
,104,1,私立,技專校院,1047,中臺科技大學,碩士班(日間),165,16,6,10,57,29,28
,104,1,私立,技專校院,1047,中臺科技大學,碩士在職專班,243,18,3,15,60,10,50
,104,1,私立,技專校院,1047,中臺科技大學,博士班,20,0,0,0,3,1,2
,104,1,私立,技專校院,1051,台南應用科技大學,五專,1199,23,8,15,52,15,37
,104,1,私立,技專校院,1051,台南應用科技大學,學士班(日間),8744,145,47,98,555,203,352
,104,1,私立,技專校院,1051,台南應用科技大學,學士班(進修),2699,173,81,92,305,138,167
,104,1,私立,技專校院,1051,台南應用科技大學,碩士班(日間),142,23,7,16,66,15,51
,104,1,私立,技專校院,1051,台南應用科技大學,碩士在職專班,163,29,8,21,57,12,45
,104,1,私立,技專校院,1052,遠東科技大學,二專(進修),39,3,3,0,5,5,0
,104,1,私立,技專校院,1052,遠東科技大學,學士班(日間),7242,202,136,66,579,414,165
,104,1,私立,技專校院,1052,遠東科技大學,學士班(進修),633,30,21,9,83,60,23
,104,1,私立,技專校院,1052,遠東科技大學,碩士班(日間),172,14,13,1,36,32,4
,104,1,私立,技專校院,1052,遠東科技大學,碩士在職專班,37,2,2,0,5,5,0
,104,1,私立,技專校院,1053,元培醫事科技大學,學士班(日間),5572,95,56,39,190,124,66
,104,1,私立,技專校院,1053,元培醫事科技大學,學士班(進修),1184,50,22,28,87,45,42
,104,1,私立,技專校院,1053,元培醫事科技大學,碩士班(日間),231,9,4,5,16,8,8
,104,1,私立,技專校院,1053,元培醫事科技大學,碩士在職專班,25,0,0,0,4,1,3
,104,1,私立,技專校院,1054,景文科技大學,學士班(日間),5843,92,33,59,162,66,96
,104,1,私立,技專校院,1054,景文科技大學,學士班(進修),2113,118,70,48,208,129,79
,104,1,私立,技專校院,1054,景文科技大學,碩士班(日間),51,2,1,1,3,1,2
,104,1,私立,技專校院,1054,景文科技大學,碩士在職專班,105,11,6,5,22,15,7
,104,1,私立,技專校院,1055,中華醫事科技大學,二專(日間),95,2,1,1,3,2,1
,104,1,私立,技專校院,1055,中華醫事科技大學,五專,2194,26,6,20,44,13,31
,104,1,私立,技專校院,1055,中華醫事科技大學,學士班(日間),5156,108,61,47,319,171,148
,104,1,私立,技專校院,1055,中華醫事科技大學,學士班(進修),1930,80,29,51,281,132,149
,104,1,私立,技專校院,1055,中華醫事科技大學,碩士班(日間),54,2,1,1,12,9,3
,104,1,私立,技專校院,1056,東南科技大學,二專(日間),19,3,2,1,5,3,2
,104,1,私立,技專校院,1056,東南科技大學,學士班(日間),6641,270,189,81,922,676,246
,104,1,私立,技專校院,1056,東南科技大學,學士班(進修),651,35,28,7,203,175,28
,104,1,私立,技專校院,1056,東南科技大學,碩士班(日間),114,5,4,1,25,22,3
,104,1,私立,技專校院,1056,東南科技大學,碩士在職專班,59,5,5,0,7,6,1
,104,1,私立,技專校院,1057,德明財經科技大學,二專(日間),1,0,0,0,4,1,3
,104,1,私立,技專校院,1057,德明財經科技大學,學士班(日間),7459,133,62,71,324,161,163
,104,1,私立,技專校院,1057,德明財經科技大學,學士班(進修),1637,136,87,49,205,124,81
,104,1,私立,技專校院,1057,德明財經科技大學,碩士班(日間),66,8,5,3,25,19,6
,104,1,私立,技專校院,1057,德明財經科技大學,碩士在職專班,63,6,5,1,15,8,7
,104,1,私立,技專校院,1060,南開科技大學,二專(日間),5,0,0,0,0,0,0
,104,1,私立,技專校院,1060,南開科技大學,五專,1088,44,35,9,101,76,25
,104,1,私立,技專校院,1060,南開科技大學,學士班(日間),3864,112,85,27,228,171,57
,104,1,私立,技專校院,1060,南開科技大學,學士班(進修),1123,56,36,20,97,64,33
,104,1,私立,技專校院,1060,南開科技大學,碩士班(日間),107,8,7,1,17,11,6
,104,1,私立,技專校院,1060,南開科技大學,碩士在職專班,132,4,1,3,11,5,6
,104,1,私立,技專校院,1061,中華科技大學,二專(進修),0,0,0,0,2,1,1
,104,1,私立,技專校院,1061,中華科技大學,學士班(日間),6430,219,129,90,721,539,182
,104,1,私立,技專校院,1061,中華科技大學,學士班(進修),1265,63,46,17,321,245,76
,104,1,私立,技專校院,1061,中華科技大學,碩士班(日間),267,18,16,2,59,52,7
,104,1,私立,技專校院,1061,中華科技大學,碩士在職專班,124,6,5,1,34,30,4
,104,1,私立,技專校院,1062,僑光科技大學,二專(日間),48,1,0,1,2,1,1
,104,1,私立,技專校院,1062,僑光科技大學,二專(進修),207,1,1,0,1,1,0
,104,1,私立,技專校院,1062,僑光科技大學,五專,149,8,6,2,17,13,4
,104,1,私立,技專校院,1062,僑光科技大學,學士班(日間),6328,69,40,29,142,87,55
,104,1,私立,技專校院,1062,僑光科技大學,學士班(進修),3614,111,66,45,198,128,70
,104,1,私立,技專校院,1062,僑光科技大學,碩士班(日間),84,4,3,1,9,7,2
,104,1,私立,技專校院,1062,僑光科技大學,碩士在職專班,56,3,2,1,3,2,1
,104,1,私立,技專校院,1063,育達科技大學,學士班(日間),3758,134,68,66,363,219,144
,104,1,私立,技專校院,1063,育達科技大學,學士班(進修),1498,76,47,29,349,228,121
,104,1,私立,技專校院,1063,育達科技大學,碩士班(日間),117,2,2,0,10,10,0
,104,1,私立,技專校院,1063,育達科技大學,碩士在職專班,92,3,2,1,5,3,2
,104,1,私立,技專校院,1064,美和科技大學,二專(進修),7,0,0,0,1,1,0
,104,1,私立,技專校院,1064,美和科技大學,五專,1824,47,13,34,77,24,53
,104,1,私立,技專校院,1064,美和科技大學,學士班(日間),4040,118,62,56,308,170,138
,104,1,私立,技專校院,1064,美和科技大學,學士班(進修),1888,73,34,39,250,120,130
,104,1,私立,技專校院,1064,美和科技大學,碩士班(日間),108,7,4,3,28,14,14
,104,1,私立,技專校院,1064,美和科技大學,碩士在職專班,202,13,8,5,22,12,10
,104,1,私立,技專校院,1065,吳鳳科技大學,二專(日間),1,1,0,1,2,1,1
,104,1,私立,技專校院,1065,吳鳳科技大學,二專(進修),2,1,1,0,9,8,1
,104,1,私立,技專校院,1065,吳鳳科技大學,學士班(日間),4214,161,120,41,339,245,94
,104,1,私立,技專校院,1065,吳鳳科技大學,學士班(進修),1113,71,57,14,244,193,51
,104,1,私立,技專校院,1065,吳鳳科技大學,碩士班(日間),44,1,0,1,14,12,2
,104,1,私立,技專校院,1065,吳鳳科技大學,碩士在職專班,82,1,0,1,4,2,2
,104,1,私立,技專校院,1066,環球科技大學,二專(日間),12,1,0,1,4,0,4
,104,1,私立,技專校院,1066,環球科技大學,二專(進修),285,10,7,3,13,10,3
,104,1,私立,技專校院,1066,環球科技大學,學士班(日間),4485,121,61,60,375,216,159
,104,1,私立,技專校院,1066,環球科技大學,學士班(進修),1446,21,12,9,48,30,18
,104,1,私立,技專校院,1066,環球科技大學,碩士班(日間),145,7,4,3,19,11,8
,104,1,私立,技專校院,1066,環球科技大學,碩士在職專班,43,4,3,1,7,5,2
,104,1,私立,技專校院,1068,中州科技大學,二專(日間),11,0,0,0,0,0,0
,104,1,私立,技專校院,1068,中州科技大學,學士班(日間),2829,91,71,20,152,112,40
,104,1,私立,技專校院,1068,中州科技大學,學士班(進修),1450,57,39,18,89,67,22
,104,1,私立,技專校院,1068,中州科技大學,碩士班(日間),64,2,1,1,2,1,1
,104,1,私立,技專校院,1068,中州科技大學,碩士在職專班,41,3,1,2,4,2,2
,104,1,私立,技專校院,1069,修平科技大學,二專(日間),2,1,1,0,1,1,0
,104,1,私立,技專校院,1069,修平科技大學,二專(進修),21,2,2,0,6,6,0
,104,1,私立,技專校院,1069,修平科技大學,學士班(日間),5582,214,155,59,311,224,87
,104,1,私立,技專校院,1069,修平科技大學,學士班(進修),723,63,62,1,84,83,1
,104,1,私立,技專校院,1069,修平科技大學,碩士班(日間),68,3,3,0,6,5,1
,104,1,私立,技專校院,1070,長庚科技大學,五專,1280,9,0,9,11,0,11
,104,1,私立,技專校院,1070,長庚科技大學,學士班(日間),4099,57,5,52,68,5,63
,104,1,私立,技專校院,1070,長庚科技大學,學士班(進修),1906,76,2,74,106,5,101
,104,1,私立,技專校院,1070,長庚科技大學,碩士班(日間),45,7,2,5,9,2,7
,104,1,私立,技專校院,1070,長庚科技大學,碩士在職專班,41,6,0,6,8,1,7
,104,1,私立,技專校院,1071,臺北城市科技大學,二專(日間),83,5,3,2,6,3,3
,104,1,私立,技專校院,1071,臺北城市科技大學,二專(進修),62,21,14,7,40,25,15
,104,1,私立,技專校院,1071,臺北城市科技大學,五專,1625,48,36,12,91,74,17
,104,1,私立,技專校院,1071,臺北城市科技大學,學士班(日間),7228,206,137,69,497,356,141
,104,1,私立,技專校院,1071,臺北城市科技大學,學士班(進修),909,58,49,9,132,103,29
,104,1,私立,技專校院,1071,臺北城市科技大學,碩士班(日間),111,12,11,1,23,21,2
,104,1,私立,技專校院,1072,大華科技大學,二專(進修),257,1,1,0,1,1,0
,104,1,私立,技專校院,1072,大華科技大學,五專,1136,43,27,16,76,47,29
,104,1,私立,技專校院,1072,大華科技大學,學士班(日間),1395,50,35,15,100,72,28
,104,1,私立,技專校院,1072,大華科技大學,學士班(進修),1329,19,15,4,38,27,11
,104,1,私立,技專校院,1072,大華科技大學,碩士班(日間),31,2,2,0,5,5,0
,104,1,私立,技專校院,1072,大華科技大學,碩士在職專班,2,1,1,0,1,1,0
,104,1,私立,技專校院,1073,醒吾科技大學,二專(日間),10,0,0,0,0,0,0
,104,1,私立,技專校院,1073,醒吾科技大學,五專,1302,42,16,26,148,45,103
,104,1,私立,技專校院,1073,醒吾科技大學,學士班(日間),6045,160,93,67,348,188,160
,104,1,私立,技專校院,1073,醒吾科技大學,學士班(進修),1199,79,44,35,344,214,130
,104,1,私立,技專校院,1073,醒吾科技大學,碩士班(日間),59,4,4,0,21,16,5
,104,1,私立,技專校院,1073,醒吾科技大學,碩士在職專班,70,0,0,0,3,0,3
,104,1,私立,技專校院,1074,南榮科技大學,二專(進修),257,12,8,4,13,8,5
,104,1,私立,技專校院,1074,南榮科技大學,五專,308,8,7,1,17,14,3
,104,1,私立,技專校院,1074,南榮科技大學,學士班(日間),1797,40,29,11,66,44,22
,104,1,私立,技專校院,1074,南榮科技大學,學士班(進修),1455,31,24,7,53,41,12
,104,1,私立,技專校院,1074,南榮科技大學,碩士班(日間),33,0,0,0,0,0,0
,104,1,私立,技專校院,1074,南榮科技大學,碩士在職專班,39,0,0,0,0,0,0
,104,1,私立,技專校院,1075,文藻外語大學,五專,1776,29,2,27,52,7,45
,104,1,私立,技專校院,1075,文藻外語大學,學士班(日間),5588,114,30,84,280,93,187
,104,1,私立,技專校院,1075,文藻外語大學,學士班(進修),1823,179,67,112,357,128,229
,104,1,私立,技專校院,1075,文藻外語大學,碩士班(日間),114,16,3,13,34,9,25
,104,1,私立,技專校院,1075,文藻外語大學,碩士在職專班,70,15,5,10,29,10,19
,104,1,私立,技專校院,1076,華夏科技大學,二專(日間),0,0,0,0,31,27,4
,104,1,私立,技專校院,1076,華夏科技大學,二專(進修),312,31,12,19,283,187,96
,104,1,私立,技專校院,1076,華夏科技大學,五專,527,16,13,3,209,181,28
,104,1,私立,技專校院,1076,華夏科技大學,學士班(日間),3237,109,70,39,578,377,201
,104,1,私立,技專校院,1076,華夏科技大學,學士班(進修),1018,69,51,18,517,375,142
,104,1,私立,技專校院,1076,華夏科技大學,碩士班(日間),30,1,1,0,4,4,0
,104,1,私立,技專校院,1076,華夏科技大學,碩士在職專班,59,6,5,1,14,12,2
,104,1,私立,技專校院,1077,慈濟科技大學,五專,1244,18,4,14,40,7,33
,104,1,私立,技專校院,1077,慈濟科技大學,學士班(日間),1371,37,14,23,78,36,42
,104,1,私立,技專校院,1077,慈濟科技大學,學士班(進修),104,6,0,6,13,1,12
,104,1,私立,技專校院,1077,慈濟科技大學,碩士班(日間),24,0,0,0,0,0,0
,104,1,私立,技專校院,1078,致理科技大學,二專(日間),90,8,6,2,23,19,4
,104,1,私立,技專校院,1078,致理科技大學,五專,1619,44,15,29,76,32,44
,104,1,私立,技專校院,1078,致理科技大學,學士班(日間),6776,132,59,73,319,159,160
,104,1,私立,技專校院,1078,致理科技大學,學士班(進修),3189,122,49,73,280,118,162
,104,1,私立,技專校院,1078,致理科技大學,碩士班(日間),31,0,0,0,2,1,1
,104,1,私立,技專校院,1078,致理科技大學,碩士在職專班,31,5,3,2,5,3,2
,104,1,私立,技專校院,1148,大漢技術學院,二專(進修),238,3,2,1,7,4,3
,104,1,私立,技專校院,1148,大漢技術學院,學士班(日間),698,47,27,20,124,82,42
,104,1,私立,技專校院,1148,大漢技術學院,學士班(進修),691,11,9,2,63,43,20
,104,1,私立,技專校院,1148,大漢技術學院,碩士班(日間),93,1,1,0,4,3,1
,104,1,私立,技專校院,1159,和春技術學院,二專(進修),484,2,2,0,23,21,2
,104,1,私立,技專校院,1159,和春技術學院,五專,358,14,8,6,23,14,9
,104,1,私立,技專校院,1159,和春技術學院,學士班(日間),1323,55,39,16,106,77,29
,104,1,私立,技專校院,1159,和春技術學院,學士班(進修),1121,18,16,2,179,145,34
,104,1,私立,技專校院,1159,和春技術學院,碩士班(日間),26,0,0,0,0,0,0
,104,1,私立,技專校院,1166,亞東技術學院,二專(日間),15,2,0,2,2,0,2
,104,1,私立,技專校院,1166,亞東技術學院,學士班(日間),4758,108,81,27,284,216,68
,104,1,私立,技專校院,1166,亞東技術學院,學士班(進修),97,14,10,4,46,30,16
,104,1,私立,技專校院,1166,亞東技術學院,碩士班(日間),47,2,2,0,12,10,2
,104,1,私立,技專校院,1168,南亞技術學院,二專(日間),93,0,0,0,0,0,0
,104,1,私立,技專校院,1168,南亞技術學院,五專,133,2,1,1,0,0,0
,104,1,私立,技專校院,1168,南亞技術學院,學士班(日間),3774,117,72,45,277,192,85
,104,1,私立,技專校院,1168,南亞技術學院,學士班(進修),1138,70,51,19,279,194,85
,104,1,私立,技專校院,1168,南亞技術學院,碩士班(日間),48,2,0,2,4,0,4
,104,1,私立,技專校院,1179,德霖技術學院,二專(日間),76,0,0,0,0,0,0
,104,1,私立,技專校院,1179,德霖技術學院,二專(進修),476,16,10,6,35,23,12
,104,1,私立,技專校院,1179,德霖技術學院,五專,1702,124,101,23,148,123,25
,104,1,私立,技專校院,1179,德霖技術學院,學士班(日間),3335,160,112,48,301,226,75
,104,1,私立,技專校院,1179,德霖技術學院,學士班(進修),1847,68,57,11,145,110,35
,104,1,私立,技專校院,1182,蘭陽技術學院,二專(日間),0,1,1,0,1,1,0
,104,1,私立,技專校院,1182,蘭陽技術學院,五專,747,30,17,13,39,23,16
,104,1,私立,技專校院,1182,蘭陽技術學院,學士班(日間),951,15,10,5,23,17,6
,104,1,私立,技專校院,1182,蘭陽技術學院,學士班(進修),1,0,0,0,0,0,0
,104,1,私立,技專校院,1183,黎明技術學院,二專(進修),69,6,0,6,17,8,9
,104,1,私立,技專校院,1183,黎明技術學院,五專,911,23,16,7,125,111,14
,104,1,私立,技專校院,1183,黎明技術學院,學士班(日間),2854,114,67,47,530,324,206
,104,1,私立,技專校院,1183,黎明技術學院,學士班(進修),837,44,25,19,373,281,92
,104,1,私立,技專校院,1184,東方設計學院,二專(日間),2,0,0,0,5,0,5
,104,1,私立,技專校院,1184,東方設計學院,五專,1643,58,29,29,154,66,88
,104,1,私立,技專校院,1184,東方設計學院,學士班(日間),1925,64,43,21,245,144,101
,104,1,私立,技專校院,1184,東方設計學院,學士班(進修),154,11,2,9,38,13,25
,104,1,私立,技專校院,1184,東方設計學院,碩士班(日間),71,7,2,5,30,18,12
,104,1,私立,技專校院,1184,東方設計學院,碩士在職專班,48,0,0,0,41,18,23
,104,1,私立,技專校院,1184,東方設計學院,博士班,14,0,0,0,0,0,0
,104,1,私立,技專校院,1185,經國管理暨健康學院,五專,1654,69,13,56,115,31,84
,104,1,私立,技專校院,1185,經國管理暨健康學院,學士班(日間),1971,79,37,42,177,96,81
,104,1,私立,技專校院,1185,經國管理暨健康學院,學士班(進修),517,29,13,16,45,20,25
,104,1,私立,技專校院,1185,經國管理暨健康學院,碩士班(日間),23,1,0,1,4,0,4
,104,1,私立,技專校院,1185,經國管理暨健康學院,碩士在職專班,45,3,1,2,4,2,2
,104,1,私立,技專校院,1187,崇右技術學院,五專,703,75,41,34,109,60,49
,104,1,私立,技專校院,1187,崇右技術學院,學士班(日間),2485,128,70,58,185,96,89
,104,1,私立,技專校院,1187,崇右技術學院,碩士班(日間),70,4,1,3,4,1,3
,104,1,私立,技專校院,1188,大同技術學院,二專(日間),0,0,0,0,19,15,4
,104,1,私立,技專校院,1188,大同技術學院,二專(進修),29,5,4,1,21,13,8
,104,1,私立,技專校院,1188,大同技術學院,五專,206,4,1,3,71,49,22
,104,1,私立,技專校院,1188,大同技術學院,學士班(日間),1655,71,39,32,464,280,184
,104,1,私立,技專校院,1188,大同技術學院,學士班(進修),758,53,22,31,174,85,89
,104,1,私立,技專校院,1189,亞太創意技術學院,二專(進修),128,1,0,1,4,0,4
,104,1,私立,技專校院,1189,亞太創意技術學院,學士班(日間),974,36,18,18,137,80,57
,104,1,私立,技專校院,1189,亞太創意技術學院,學士班(進修),315,0,0,0,0,0,0
,104,1,私立,技專校院,1189,亞太創意技術學院,碩士班(日間),73,9,4,5,16,6,10
,104,1,私立,技專校院,1192,臺灣觀光學院,二專(日間),6,3,3,0,5,4,1
,104,1,私立,技專校院,1192,臺灣觀光學院,二專(進修),70,0,0,0,0,0,0
,104,1,私立,技專校院,1192,臺灣觀光學院,五專,205,15,6,9,20,9,11
,104,1,私立,技專校院,1192,臺灣觀光學院,學士班(日間),998,114,70,44,130,80,50
,104,1,私立,技專校院,1192,臺灣觀光學院,學士班(進修),246,1,0,1,1,0,1
,104,1,私立,技專校院,1192,臺灣觀光學院,碩士班(日間),28,2,1,1,3,1,2
,104,1,私立,技專校院,1197,台北海洋技術學院,二專(日間),259,11,10,1,48,41,7
,104,1,私立,技專校院,1197,台北海洋技術學院,二專(進修),137,4,4,0,21,19,2
,104,1,私立,技專校院,1197,台北海洋技術學院,五專,1450,35,21,14,107,75,32
,104,1,私立,技專校院,1197,台北海洋技術學院,學士班(日間),4370,120,71,49,387,267,120
,104,1,私立,技專校院,1197,台北海洋技術學院,學士班(進修),259,8,2,6,58,42,16
,104,1,私立,技專校院,1197,台北海洋技術學院,碩士班(日間),15,1,0,1,1,0,1
,104,1,私立,技專校院,1282,馬偕醫護管理專科學校,二專(日間),54,4,1,3,6,1,5
,104,1,私立,技專校院,1282,馬偕醫護管理專科學校,二專(進修),340,9,2,7,17,4,13
,104,1,私立,技專校院,1282,馬偕醫護管理專科學校,五專,3922,69,18,51,95,24,71
,104,1,私立,技專校院,1283,仁德醫護管理專科學校,二專(進修),472,0,0,0,0,0,0
,104,1,私立,技專校院,1283,仁德醫護管理專科學校,五專,6031,141,53,88,142,53,89
,104,1,私立,技專校院,1284,樹人醫護管理專科學校,二專(進修),488,16,15,1,35,32,3
,104,1,私立,技專校院,1284,樹人醫護管理專科學校,五專,6543,125,36,89,218,69,149
,104,1,私立,技專校院,1285,慈惠醫護管理專科學校,二專(日間),139,7,3,4,9,3,6
,104,1,私立,技專校院,1285,慈惠醫護管理專科學校,二專(進修),323,6,3,3,23,11,12
,104,1,私立,技專校院,1285,慈惠醫護管理專科學校,五專,5883,124,36,88,237,83,154
,104,1,私立,技專校院,1286,耕莘健康管理專科學校,二專(日間),0,0,0,0,1,1,0
,104,1,私立,技專校院,1286,耕莘健康管理專科學校,二專(進修),73,2,1,1,4,1,3
,104,1,私立,技專校院,1286,耕莘健康管理專科學校,五專,4979,92,34,58,168,64,104
,104,1,私立,技專校院,1287,敏惠醫護管理專科學校,五專,3819,57,7,50,65,9,56
,104,1,私立,技專校院,1288,高美醫護管理專科學校,二專(進修),233,3,1,2,3,1,2
,104,1,私立,技專校院,1288,高美醫護管理專科學校,五專,619,20,9,11,20,9,11
,104,1,私立,技專校院,1289,育英醫護管理專科學校,五專,2009,20,3,17,54,7,47
,104,1,私立,技專校院,1290,崇仁醫護管理專科學校,五專,3387,26,1,25,53,6,47
,104,1,私立,技專校院,1291,聖母醫護管理專科學校,五專,3597,129,54,75,183,80,103
,104,1,私立,技專校院,1292,新生醫護管理專科學校,二專(進修),123,2,2,0,8,3,5
,104,1,私立,技專校院,1292,新生醫護管理專科學校,五專,5913,96,17,79,196,34,162
,104,2,公立,一般大學,1,國立政治大學,學士班(日間),9736,69,37,32,306,163,143
,104,2,公立,一般大學,1,國立政治大學,碩士班(日間),3882,217,93,124,832,395,437
,104,2,公立,一般大學,1,國立政治大學,碩士在職專班,1666,148,79,69,520,247,273
,104,2,公立,一般大學,1,國立政治大學,博士班,963,100,64,36,359,222,137
,104,2,公立,一般大學,2,國立清華大學,學士班(日間),6315,73,56,17,231,157,74
,104,2,公立,一般大學,2,國立清華大學,碩士班(日間),3987,110,60,50,254,141,113
,104,2,公立,一般大學,2,國立清華大學,碩士在職專班,352,15,7,8,42,23,19
,104,2,公立,一般大學,2,國立清華大學,博士班,1681,196,150,46,370,281,89
,104,2,公立,一般大學,3,國立臺灣大學,學士班(日間),16532,327,224,103,707,440,267
,104,2,公立,一般大學,3,國立臺灣大學,學士班(進修),1,0,0,0,1,1,0
,104,2,公立,一般大學,3,國立臺灣大學,碩士班(日間),10069,576,319,257,1154,647,507
,104,2,公立,一般大學,3,國立臺灣大學,碩士在職專班,1191,133,81,52,233,133,100
,104,2,公立,一般大學,3,國立臺灣大學,博士班,3965,596,408,188,1088,752,336
,104,2,公立,一般大學,4,國立臺灣師範大學,學士班(日間),7919,80,46,34,276,156,120
,104,2,公立,一般大學,4,國立臺灣師範大學,碩士班(日間),3923,399,153,246,832,312,520
,104,2,公立,一般大學,4,國立臺灣師範大學,碩士在職專班,1851,273,67,206,428,116,312
,104,2,公立,一般大學,4,國立臺灣師範大學,博士班,1388,223,95,128,418,194,224
,104,2,公立,一般大學,5,國立成功大學,學士班(日間),11402,108,84,24,460,318,142
,104,2,公立,一般大學,5,國立成功大學,碩士班(日間),6422,152,75,77,528,291,237
,104,2,公立,一般大學,5,國立成功大學,碩士在職專班,1241,62,46,16,218,141,77
,104,2,公立,一般大學,5,國立成功大學,博士班,2171,189,146,43,616,437,179
,104,2,公立,一般大學,6,國立中興大學,學士班(日間),8114,66,46,20,271,188,83
,104,2,公立,一般大學,6,國立中興大學,學士班(進修),1024,15,6,9,58,28,30
,104,2,公立,一般大學,6,國立中興大學,碩士班(日間),3324,81,39,42,391,217,174
,104,2,公立,一般大學,6,國立中興大學,碩士在職專班,1563,88,64,24,357,255,102
,104,2,公立,一般大學,6,國立中興大學,博士班,1116,82,62,20,275,202,73
,104,2,公立,一般大學,7,國立交通大學,學士班(日間),5437,58,45,13,136,95,41
,104,2,公立,一般大學,7,國立交通大學,碩士班(日間),5334,144,92,52,328,189,139
,104,2,公立,一般大學,7,國立交通大學,碩士在職專班,1476,184,141,43,392,296,96
,104,2,公立,一般大學,7,國立交通大學,博士班,1836,204,164,40,402,319,83
,104,2,公立,一般大學,8,國立中央大學,學士班(日間),6117,42,37,5,164,130,34
,104,2,公立,一般大學,8,國立中央大學,碩士班(日間),3401,77,37,40,241,154,87
,104,2,公立,一般大學,8,國立中央大學,碩士在職專班,1348,72,43,29,240,157,83
,104,2,公立,一般大學,8,國立中央大學,博士班,1096,91,69,22,264,206,58
,104,2,公立,一般大學,9,國立中山大學,學士班(日間),4681,51,32,19,149,98,51
,104,2,公立,一般大學,9,國立中山大學,碩士班(日間),2917,141,93,48,409,253,156
,104,2,公立,一般大學,9,國立中山大學,碩士在職專班,862,56,39,17,188,102,86
,104,2,公立,一般大學,9,國立中山大學,博士班,852,95,63,32,221,139,82
,104,2,公立,一般大學,12,國立臺灣海洋大學,學士班(日間),5626,42,32,10,125,97,28
,104,2,公立,一般大學,12,國立臺灣海洋大學,學士班(進修),662,32,19,13,91,54,37
,104,2,公立,一般大學,12,國立臺灣海洋大學,碩士班(日間),1431,41,35,6,162,110,52
,104,2,公立,一般大學,12,國立臺灣海洋大學,碩士在職專班,569,24,15,9,95,53,42
,104,2,公立,一般大學,12,國立臺灣海洋大學,博士班,321,23,20,3,66,52,14
,104,2,公立,一般大學,13,國立中正大學,學士班(日間),6727,77,54,23,174,108,66
,104,2,公立,一般大學,13,國立中正大學,碩士班(日間),2766,145,75,70,399,221,178
,104,2,公立,一般大學,13,國立中正大學,碩士在職專班,1595,148,77,71,350,178,172
,104,2,公立,一般大學,13,國立中正大學,博士班,591,78,53,25,159,107,52
,104,2,公立,一般大學,14,國立高雄師範大學,學士班(日間),3471,18,13,5,76,48,28
,104,2,公立,一般大學,14,國立高雄師範大學,碩士班(日間),1429,94,34,60,340,120,220
,104,2,公立,一般大學,14,國立高雄師範大學,碩士在職專班,1253,77,25,52,239,63,176
,104,2,公立,一般大學,14,國立高雄師範大學,博士班,478,38,16,22,108,45,63
,104,2,公立,一般大學,15,國立彰化師範大學,學士班(日間),4850,29,19,10,98,73,25
,104,2,公立,一般大學,15,國立彰化師範大學,碩士班(日間),1524,63,34,29,278,146,132
,104,2,公立,一般大學,15,國立彰化師範大學,碩士在職專班,1286,66,33,33,154,76,78
,104,2,公立,一般大學,15,國立彰化師範大學,博士班,464,34,18,16,100,57,43
,104,2,公立,一般大學,16,國立陽明大學,學士班(日間),2100,13,7,6,111,58,53
,104,2,公立,一般大學,16,國立陽明大學,碩士班(日間),1168,34,15,19,196,74,122
,104,2,公立,一般大學,16,國立陽明大學,碩士在職專班,125,5,1,4,17,5,12
,104,2,公立,一般大學,16,國立陽明大學,博士班,934,82,48,34,279,164,115
,104,2,公立,一般大學,17,國立臺北大學,學士班(日間),5856,50,27,23,167,86,81
,104,2,公立,一般大學,17,國立臺北大學,學士班(進修),1930,56,28,28,176,90,86
,104,2,公立,一般大學,17,國立臺北大學,碩士班(日間),1328,82,41,41,240,119,121
,104,2,公立,一般大學,17,國立臺北大學,碩士在職專班,469,39,19,20,94,48,46
,104,2,公立,一般大學,17,國立臺北大學,博士班,182,15,7,8,51,34,17
,104,2,公立,一般大學,18,國立嘉義大學,學士班(日間),7918,64,42,22,275,179,96
,104,2,公立,一般大學,18,國立嘉義大學,學士班(進修),2104,52,29,23,257,159,98
,104,2,公立,一般大學,18,國立嘉義大學,碩士班(日間),1488,82,40,42,336,162,174
,104,2,公立,一般大學,18,國立嘉義大學,碩士在職專班,998,45,15,30,225,98,127
,104,2,公立,一般大學,18,國立嘉義大學,博士班,185,13,7,6,48,30,18
,104,2,公立,一般大學,19,國立高雄大學,學士班(日間),4185,47,32,15,120,80,40
,104,2,公立,一般大學,19,國立高雄大學,學士班(進修),168,13,7,6,32,25,7
,104,2,公立,一般大學,19,國立高雄大學,碩士班(日間),619,66,44,22,129,87,42
,104,2,公立,一般大學,19,國立高雄大學,碩士在職專班,427,95,59,36,157,95,62
,104,2,公立,一般大學,19,國立高雄大學,博士班,17,1,1,0,2,2,0
,104,2,公立,一般大學,20,國立東華大學,學士班(日間),7477,62,29,33,248,152,96
,104,2,公立,一般大學,20,國立東華大學,碩士班(日間),1741,150,68,82,562,250,312
,104,2,公立,一般大學,20,國立東華大學,碩士在職專班,581,49,21,28,181,80,101
,104,2,公立,一般大學,20,國立東華大學,博士班,375,44,26,18,128,84,44
,104,2,公立,一般大學,21,國立暨南國際大學,學士班(日間),4392,30,21,9,106,64,42
,104,2,公立,一般大學,21,國立暨南國際大學,學士班(進修),1,0,0,0,0,0,0
,104,2,公立,一般大學,21,國立暨南國際大學,碩士班(日間),1056,89,43,46,211,118,93
,104,2,公立,一般大學,21,國立暨南國際大學,碩士在職專班,373,20,8,12,46,23,23
,104,2,公立,一般大學,21,國立暨南國際大學,博士班,317,34,24,10,94,60,34
,104,2,公立,一般大學,28,國立臺北藝術大學,五專,83,0,0,0,2,2,0
,104,2,公立,一般大學,28,國立臺北藝術大學,學士班(日間),1773,38,12,26,91,37,54
,104,2,公立,一般大學,28,國立臺北藝術大學,碩士班(日間),973,100,36,64,288,107,181
,104,2,公立,一般大學,28,國立臺北藝術大學,碩士在職專班,168,17,7,10,41,15,26
,104,2,公立,一般大學,28,國立臺北藝術大學,博士班,67,7,2,5,27,6,21
,104,2,公立,一般大學,29,國立臺灣藝術大學,學士班(日間),2331,32,11,21,95,44,51
,104,2,公立,一般大學,29,國立臺灣藝術大學,學士班(進修),1923,25,16,9,136,56,80
,104,2,公立,一般大學,29,國立臺灣藝術大學,碩士班(日間),726,47,24,23,181,81,100
,104,2,公立,一般大學,29,國立臺灣藝術大學,碩士在職專班,414,29,19,10,87,44,43
,104,2,公立,一般大學,29,國立臺灣藝術大學,博士班,90,9,7,2,21,9,12
,104,2,公立,一般大學,30,國立臺東大學,學士班(日間),3547,37,26,11,149,89,60
,104,2,公立,一般大學,30,國立臺東大學,學士班(進修),172,5,5,0,42,25,17
,104,2,公立,一般大學,30,國立臺東大學,碩士班(日間),302,28,10,18,88,28,60
,104,2,公立,一般大學,30,國立臺東大學,碩士在職專班,641,23,11,12,142,54,88
,104,2,公立,一般大學,30,國立臺東大學,博士班,38,3,1,2,12,3,9
,104,2,公立,一般大學,31,國立宜蘭大學,學士班(日間),4341,49,41,8,135,105,30
,104,2,公立,一般大學,31,國立宜蘭大學,學士班(進修),452,11,9,2,70,55,15
,104,2,公立,一般大學,31,國立宜蘭大學,碩士班(日間),492,21,15,6,55,42,13
,104,2,公立,一般大學,31,國立宜蘭大學,碩士在職專班,189,15,12,3,32,24,8
,104,2,公立,一般大學,31,國立宜蘭大學,博士班,14,1,1,0,4,3,1
,104,2,公立,一般大學,32,國立聯合大學,學士班(日間),6016,85,72,13,223,183,40
,104,2,公立,一般大學,32,國立聯合大學,學士班(進修),1429,29,20,9,104,75,29
,104,2,公立,一般大學,32,國立聯合大學,碩士班(日間),440,14,10,4,38,29,9
,104,2,公立,一般大學,32,國立聯合大學,博士班,9,0,0,0,0,0,0
,104,2,公立,一般大學,35,國立臺南藝術大學,五專,166,0,0,0,6,0,6
,104,2,公立,一般大學,35,國立臺南藝術大學,學士班(日間),729,12,4,8,40,16,24
,104,2,公立,一般大學,35,國立臺南藝術大學,學士班(進修),1,0,0,0,0,0,0
,104,2,公立,一般大學,35,國立臺南藝術大學,碩士班(日間),544,54,16,38,158,55,103
,104,2,公立,一般大學,35,國立臺南藝術大學,碩士在職專班,49,4,2,2,32,9,23
,104,2,公立,一般大學,35,國立臺南藝術大學,博士班,41,5,2,3,12,5,7
,104,2,公立,一般大學,36,國立臺南大學,學士班(日間),3896,29,17,12,98,48,50
,104,2,公立,一般大學,36,國立臺南大學,學士班(進修),211,4,2,2,17,9,8
,104,2,公立,一般大學,36,國立臺南大學,碩士班(日間),1022,67,27,40,257,102,155
,104,2,公立,一般大學,36,國立臺南大學,碩士在職專班,698,37,15,22,123,48,75
,104,2,公立,一般大學,36,國立臺南大學,博士班,169,15,7,8,40,20,20
,104,2,公立,一般大學,37,國立臺北教育大學,學士班(日間),3319,27,13,14,101,41,60
,104,2,公立,一般大學,37,國立臺北教育大學,碩士班(日間),1147,139,41,98,314,95,219
,104,2,公立,一般大學,37,國立臺北教育大學,碩士在職專班,1008,58,16,42,187,52,135
,104,2,公立,一般大學,37,國立臺北教育大學,博士班,132,24,11,13,43,19,24
,104,2,公立,一般大學,38,國立新竹教育大學,學士班(日間),2573,13,7,6,77,28,49
,104,2,公立,一般大學,38,國立新竹教育大學,碩士班(日間),797,52,16,36,183,45,138
,104,2,公立,一般大學,38,國立新竹教育大學,碩士在職專班,534,29,10,19,67,17,50
,104,2,公立,一般大學,38,國立新竹教育大學,博士班,82,5,2,3,16,5,11
,104,2,公立,一般大學,39,國立臺中教育大學,學士班(日間),3379,28,8,20,88,45,43
,104,2,公立,一般大學,39,國立臺中教育大學,碩士班(日間),833,46,18,28,168,62,106
,104,2,公立,一般大學,39,國立臺中教育大學,碩士在職專班,690,24,5,19,107,20,87
,104,2,公立,一般大學,39,國立臺中教育大學,博士班,126,8,3,5,23,11,12
,104,2,公立,一般大學,44,國立體育大學,學士班(日間),1599,42,37,5,119,99,20
,104,2,公立,一般大學,44,國立體育大學,學士班(進修),97,3,2,1,12,10,2
,104,2,公立,一般大學,44,國立體育大學,碩士班(日間),335,23,13,10,105,71,34
,104,2,公立,一般大學,44,國立體育大學,碩士在職專班,193,7,5,2,52,28,24
,104,2,公立,一般大學,44,國立體育大學,博士班,137,7,6,1,25,19,6
,104,2,公立,一般大學,48,國立金門大學,學士班(日間),3317,36,26,10,115,72,43
,104,2,公立,一般大學,48,國立金門大學,學士班(進修),820,16,11,5,54,34,20
,104,2,公立,一般大學,48,國立金門大學,碩士班(日間),199,10,5,5,31,18,13
,104,2,公立,一般大學,48,國立金門大學,碩士在職專班,53,1,1,0,4,4,0
,104,2,公立,一般大學,49,國立臺灣體育運動大學,學士班(日間),2422,56,41,15,193,149,44
,104,2,公立,一般大學,49,國立臺灣體育運動大學,學士班(進修),380,23,18,5,67,55,12
,104,2,公立,一般大學,49,國立臺灣體育運動大學,碩士班(日間),277,24,15,9,119,65,54
,104,2,公立,一般大學,49,國立臺灣體育運動大學,碩士在職專班,113,2,2,0,8,8,0
,104,2,公立,一般大學,52,國立屏東大學,學士班(日間),6708,43,27,16,130,77,53
,104,2,公立,一般大學,52,國立屏東大學,學士班(進修),597,15,9,6,54,27,27
,104,2,公立,一般大學,52,國立屏東大學,碩士班(日間),911,95,35,60,255,102,153
,104,2,公立,一般大學,52,國立屏東大學,碩士在職專班,480,20,5,15,78,21,57
,104,2,公立,一般大學,52,國立屏東大學,博士班,51,2,1,1,6,2,4
,104,2,公立,一般大學,3002,臺北市立大學,學士班(日間),5082,59,39,20,221,141,80
,104,2,公立,一般大學,3002,臺北市立大學,碩士班(日間),1255,55,14,41,261,87,174
,104,2,公立,一般大學,3002,臺北市立大學,碩士在職專班,985,35,14,21,120,42,78
,104,2,公立,一般大學,3002,臺北市立大學,博士班,251,29,8,21,64,20,44
,104,2,公立,技專校院,22,國立臺灣科技大學,學士班(日間),5483,67,46,21,142,97,45
,104,2,公立,技專校院,22,國立臺灣科技大學,學士班(進修),41,0,0,0,3,0,3
,104,2,公立,技專校院,22,國立臺灣科技大學,碩士班(日間),3208,59,37,22,217,139,78
,104,2,公立,技專校院,22,國立臺灣科技大學,碩士在職專班,756,79,69,10,168,141,27
,104,2,公立,技專校院,22,國立臺灣科技大學,博士班,958,116,86,30,238,187,51
,104,2,公立,技專校院,23,國立雲林科技大學,學士班(日間),6490,37,26,11,148,102,46
,104,2,公立,技專校院,23,國立雲林科技大學,碩士班(日間),2145,53,30,23,245,152,93
,104,2,公立,技專校院,23,國立雲林科技大學,碩士在職專班,749,43,23,20,178,100,78
,104,2,公立,技專校院,23,國立雲林科技大學,博士班,478,45,33,12,141,105,36
,104,2,公立,技專校院,24,國立屏東科技大學,學士班(日間),7842,66,46,20,204,121,83
,104,2,公立,技專校院,24,國立屏東科技大學,學士班(進修),1582,35,24,11,82,54,28
,104,2,公立,技專校院,24,國立屏東科技大學,碩士班(日間),1276,59,33,26,221,122,99
,104,2,公立,技專校院,24,國立屏東科技大學,碩士在職專班,509,10,9,1,70,52,18
,104,2,公立,技專校院,24,國立屏東科技大學,博士班,245,9,7,2,52,29,23
,104,2,公立,技專校院,25,國立臺北科技大學,學士班(日間),5929,52,36,16,156,118,38
,104,2,公立,技專校院,25,國立臺北科技大學,學士班(進修),1262,29,19,10,76,56,20
,104,2,公立,技專校院,25,國立臺北科技大學,碩士班(日間),2721,53,34,19,156,113,43
,104,2,公立,技專校院,25,國立臺北科技大學,碩士在職專班,1329,84,64,20,161,116,45
,104,2,公立,技專校院,25,國立臺北科技大學,博士班,684,64,49,15,159,130,29
,104,2,公立,技專校院,26,國立高雄第一科技大學,學士班(日間),5647,62,36,26,167,103,64
,104,2,公立,技專校院,26,國立高雄第一科技大學,碩士班(日間),1094,36,21,15,170,100,70
,104,2,公立,技專校院,26,國立高雄第一科技大學,碩士在職專班,736,37,26,11,126,92,34
,104,2,公立,技專校院,26,國立高雄第一科技大學,博士班,232,21,17,4,52,43,9
,104,2,公立,技專校院,27,國立高雄應用科技大學,學士班(日間),7603,55,37,18,188,134,54
,104,2,公立,技專校院,27,國立高雄應用科技大學,學士班(進修),1742,53,38,15,224,149,75
,104,2,公立,技專校院,27,國立高雄應用科技大學,碩士班(日間),1263,36,24,12,132,92,40
,104,2,公立,技專校院,27,國立高雄應用科技大學,碩士在職專班,1264,60,44,16,266,194,72
,104,2,公立,技專校院,27,國立高雄應用科技大學,博士班,299,15,11,4,43,36,7
,104,2,公立,技專校院,33,國立虎尾科技大學,學士班(日間),7615,51,44,7,249,202,47
,104,2,公立,技專校院,33,國立虎尾科技大學,學士班(進修),1321,30,21,9,103,81,22
,104,2,公立,技專校院,33,國立虎尾科技大學,碩士班(日間),856,29,27,2,138,111,27
,104,2,公立,技專校院,33,國立虎尾科技大學,碩士在職專班,244,20,16,4,38,29,9
,104,2,公立,技專校院,33,國立虎尾科技大學,博士班,26,3,3,0,9,9,0
,104,2,公立,技專校院,34,國立高雄海洋科技大學,五專,506,5,3,2,7,5,2
,104,2,公立,技專校院,34,國立高雄海洋科技大學,學士班(日間),4935,50,38,12,178,135,43
,104,2,公立,技專校院,34,國立高雄海洋科技大學,學士班(進修),1784,43,29,14,97,69,28
,104,2,公立,技專校院,34,國立高雄海洋科技大學,碩士班(日間),332,8,7,1,74,48,26
,104,2,公立,技專校院,34,國立高雄海洋科技大學,碩士在職專班,179,14,6,8,31,14,17
,104,2,公立,技專校院,34,國立高雄海洋科技大學,博士班,9,0,0,0,0,0,0
,104,2,公立,技專校院,42,國立澎湖科技大學,學士班(日間),2542,26,17,9,67,43,24
,104,2,公立,技專校院,42,國立澎湖科技大學,學士班(進修),327,7,4,3,21,10,11
,104,2,公立,技專校院,42,國立澎湖科技大學,碩士班(日間),70,6,2,4,18,7,11
,104,2,公立,技專校院,42,國立澎湖科技大學,碩士在職專班,45,1,0,1,8,5,3
,104,2,公立,技專校院,43,國立勤益科技大學,二專(日間),7,0,0,0,16,12,4
,104,2,公立,技專校院,43,國立勤益科技大學,二專(進修),1,0,0,0,1,1,0
,104,2,公立,技專校院,43,國立勤益科技大學,學士班(日間),6831,73,60,13,356,269,87
,104,2,公立,技專校院,43,國立勤益科技大學,學士班(進修),3565,85,63,22,210,163,47
,104,2,公立,技專校院,43,國立勤益科技大學,碩士班(日間),649,34,29,5,84,69,15
,104,2,公立,技專校院,43,國立勤益科技大學,碩士在職專班,253,17,16,1,35,30,5
,104,2,公立,技專校院,43,國立勤益科技大學,博士班,12,0,0,0,0,0,0
,104,2,公立,技專校院,46,國立臺北護理健康大學,學士班(日間),3133,17,4,13,99,22,77
,104,2,公立,技專校院,46,國立臺北護理健康大學,學士班(進修),696,13,0,13,89,1,88
,104,2,公立,技專校院,46,國立臺北護理健康大學,碩士班(日間),585,61,8,53,208,32,176
,104,2,公立,技專校院,46,國立臺北護理健康大學,碩士在職專班,183,28,3,25,63,8,55
,104,2,公立,技專校院,46,國立臺北護理健康大學,博士班,60,7,0,7,16,0,16
,104,2,公立,技專校院,47,國立高雄餐旅大學,二專(進修),278,1,1,0,24,13,11
,104,2,公立,技專校院,47,國立高雄餐旅大學,五專,213,1,0,1,7,3,4
,104,2,公立,技專校院,47,國立高雄餐旅大學,學士班(日間),3296,14,9,5,99,38,61
,104,2,公立,技專校院,47,國立高雄餐旅大學,學士班(進修),1206,5,2,3,49,16,33
,104,2,公立,技專校院,47,國立高雄餐旅大學,碩士班(日間),189,7,2,5,28,10,18
,104,2,公立,技專校院,47,國立高雄餐旅大學,碩士在職專班,95,10,5,5,21,12,9
,104,2,公立,技專校院,47,國立高雄餐旅大學,博士班,24,1,0,1,4,2,2
,104,2,公立,技專校院,50,國立臺中科技大學,二專(日間),67,1,0,1,2,0,2
,104,2,公立,技專校院,50,國立臺中科技大學,二專(進修),181,6,1,5,31,3,28
,104,2,公立,技專校院,50,國立臺中科技大學,五專,3825,27,6,21,96,25,71
,104,2,公立,技專校院,50,國立臺中科技大學,學士班(日間),6574,61,19,42,171,57,114
,104,2,公立,技專校院,50,國立臺中科技大學,學士班(進修),2671,80,32,48,227,97,130
,104,2,公立,技專校院,50,國立臺中科技大學,碩士班(日間),405,10,8,2,49,31,18
,104,2,公立,技專校院,50,國立臺中科技大學,碩士在職專班,152,10,8,2,25,16,9
,104,2,公立,技專校院,51,國立臺北商業大學,二專(進修),213,0,0,0,8,4,4
,104,2,公立,技專校院,51,國立臺北商業大學,五專,1978,20,6,14,106,37,69
,104,2,公立,技專校院,51,國立臺北商業大學,學士班(日間),2876,26,11,15,92,35,57
,104,2,公立,技專校院,51,國立臺北商業大學,學士班(進修),1602,19,10,9,78,38,40
,104,2,公立,技專校院,51,國立臺北商業大學,碩士班(日間),155,4,2,2,27,13,14
,104,2,公立,技專校院,51,國立臺北商業大學,碩士在職專班,21,1,1,0,5,2,3
,104,2,公立,技專校院,144,國立臺灣戲曲學院,學士班(日間),515,9,4,5,37,17,20
,104,2,公立,技專校院,144,國立臺灣戲曲學院,學士班(進修),60,0,0,0,8,3,5
,104,2,公立,技專校院,221,國立臺南護理專科學校,二專(日間),100,2,0,2,6,0,6
,104,2,公立,技專校院,221,國立臺南護理專科學校,二專(進修),83,4,1,3,17,4,13
,104,2,公立,技專校院,221,國立臺南護理專科學校,五專,1763,6,0,6,34,2,32
,104,2,公立,技專校院,222,國立臺東專科學校,二專(日間),494,5,4,1,22,15,7
,104,2,公立,技專校院,222,國立臺東專科學校,二專(進修),109,13,7,6,31,18,13
,104,2,公立,技專校院,222,國立臺東專科學校,五專,660,23,11,12,52,26,26
,104,2,私立,一般大學,1001,東海大學,學士班(日間),13844,161,103,58,561,339,222
,104,2,私立,一般大學,1001,東海大學,學士班(進修),625,39,19,20,145,81,64
,104,2,私立,一般大學,1001,東海大學,碩士班(日間),1459,96,56,40,342,163,179
,104,2,私立,一般大學,1001,東海大學,碩士在職專班,778,52,27,25,187,87,100
,104,2,私立,一般大學,1001,東海大學,博士班,227,17,6,11,67,36,31
,104,2,私立,一般大學,1002,輔仁大學,學士班(日間),18281,245,142,103,695,370,325
,104,2,私立,一般大學,1002,輔仁大學,學士班(進修),4887,108,55,53,343,153,190
,104,2,私立,一般大學,1002,輔仁大學,碩士班(日間),2165,225,85,140,601,243,358
,104,2,私立,一般大學,1002,輔仁大學,碩士在職專班,1641,101,58,43,372,168,204
,104,2,私立,一般大學,1002,輔仁大學,博士班,453,70,32,38,194,100,94
,104,2,私立,一般大學,1003,東吳大學,學士班(日間),12131,153,87,66,397,219,178
,104,2,私立,一般大學,1003,東吳大學,學士班(進修),1211,39,12,27,127,39,88
,104,2,私立,一般大學,1003,東吳大學,碩士班(日間),1197,147,77,70,257,137,120
,104,2,私立,一般大學,1003,東吳大學,碩士在職專班,1155,100,47,53,219,100,119
,104,2,私立,一般大學,1003,東吳大學,博士班,102,9,7,2,20,14,6
,104,2,私立,一般大學,1004,中原大學,學士班(日間),13279,156,103,53,457,304,153
,104,2,私立,一般大學,1004,中原大學,學士班(進修),1,0,0,0,0,0,0
,104,2,私立,一般大學,1004,中原大學,碩士班(日間),1696,66,37,29,296,166,130
,104,2,私立,一般大學,1004,中原大學,碩士在職專班,987,54,41,13,250,178,72
,104,2,私立,一般大學,1004,中原大學,博士班,354,28,24,4,114,86,28
,104,2,私立,一般大學,1005,淡江大學,學士班(日間),20972,315,227,88,941,612,329
,104,2,私立,一般大學,1005,淡江大學,學士班(進修),2374,115,76,39,328,197,131
,104,2,私立,一般大學,1005,淡江大學,碩士班(日間),1972,87,47,40,391,217,174
,104,2,私立,一般大學,1005,淡江大學,碩士在職專班,1227,59,33,26,243,132,111
,104,2,私立,一般大學,1005,淡江大學,博士班,496,39,26,13,143,92,51
,104,2,私立,一般大學,1006,中國文化大學,學士班(日間),21348,287,182,105,778,474,304
,104,2,私立,一般大學,1006,中國文化大學,學士班(進修),2657,183,102,81,540,275,265
,104,2,私立,一般大學,1006,中國文化大學,碩士班(日間),1581,99,54,45,381,220,161
,104,2,私立,一般大學,1006,中國文化大學,碩士在職專班,603,32,15,17,114,54,60
,104,2,私立,一般大學,1006,中國文化大學,博士班,505,23,11,12,113,68,45
,104,2,私立,一般大學,1007,逢甲大學,學士班(日間),17063,200,160,40,468,369,99
,104,2,私立,一般大學,1007,逢甲大學,學士班(進修),974,43,29,14,111,68,43
,104,2,私立,一般大學,1007,逢甲大學,碩士班(日間),1646,64,43,21,184,137,47
,104,2,私立,一般大學,1007,逢甲大學,碩士在職專班,1110,74,48,26,155,101,54
,104,2,私立,一般大學,1007,逢甲大學,博士班,408,51,33,18,92,61,31
,104,2,私立,一般大學,1008,靜宜大學,學士班(日間),11446,163,83,80,404,246,158
,104,2,私立,一般大學,1008,靜宜大學,學士班(進修),47,1,1,0,4,3,1
,104,2,私立,一般大學,1008,靜宜大學,碩士班(日間),580,37,19,18,115,54,61
,104,2,私立,一般大學,1008,靜宜大學,碩士在職專班,326,19,11,8,49,22,27
,104,2,私立,一般大學,1008,靜宜大學,博士班,36,1,1,0,6,3,3
,104,2,私立,一般大學,1009,長庚大學,學士班(日間),5218,44,32,12,155,93,62
,104,2,私立,一般大學,1009,長庚大學,碩士班(日間),1322,52,19,33,184,79,105
,104,2,私立,一般大學,1009,長庚大學,碩士在職專班,296,36,22,14,68,35,33
,104,2,私立,一般大學,1009,長庚大學,博士班,550,34,24,10,90,61,29
,104,2,私立,一般大學,1010,元智大學,學士班(日間),7223,75,39,36,178,101,77
,104,2,私立,一般大學,1010,元智大學,碩士班(日間),1053,33,23,10,92,66,26
,104,2,私立,一般大學,1010,元智大學,碩士在職專班,837,40,32,8,132,101,31
,104,2,私立,一般大學,1010,元智大學,博士班,307,27,23,4,56,47,9
,104,2,私立,一般大學,1011,中華大學,學士班(日間),7062,100,76,24,371,280,91
,104,2,私立,一般大學,1011,中華大學,學士班(進修),379,2,1,1,35,26,9
,104,2,私立,一般大學,1011,中華大學,碩士班(日間),645,23,20,3,79,63,16
,104,2,私立,一般大學,1011,中華大學,碩士在職專班,261,20,14,6,47,34,13
,104,2,私立,一般大學,1011,中華大學,博士班,126,9,8,1,42,32,10
,104,2,私立,一般大學,1012,大葉大學,學士班(日間),8920,101,73,28,399,273,126
,104,2,私立,一般大學,1012,大葉大學,學士班(進修),1522,36,28,8,134,101,33
,104,2,私立,一般大學,1012,大葉大學,碩士班(日間),758,46,27,19,150,83,67
,104,2,私立,一般大學,1012,大葉大學,碩士在職專班,563,15,7,8,63,33,30
,104,2,私立,一般大學,1012,大葉大學,博士班,128,10,5,5,53,33,20
,104,2,私立,一般大學,1013,華梵大學,學士班(日間),2613,46,29,17,149,96,53
,104,2,私立,一般大學,1013,華梵大學,碩士班(日間),306,33,19,14,73,40,33
,104,2,私立,一般大學,1013,華梵大學,碩士在職專班,270,22,12,10,45,27,18
,104,2,私立,一般大學,1013,華梵大學,博士班,53,6,3,3,10,7,3
,104,2,私立,一般大學,1014,義守大學,學士班(日間),13137,114,73,41,303,208,95
,104,2,私立,一般大學,1014,義守大學,學士班(進修),2364,52,33,19,365,242,123
,104,2,私立,一般大學,1014,義守大學,碩士班(日間),576,14,10,4,41,32,9
,104,2,私立,一般大學,1014,義守大學,碩士在職專班,452,10,5,5,80,51,29
,104,2,私立,一般大學,1014,義守大學,博士班,137,9,7,2,17,12,5
,104,2,私立,一般大學,1015,世新大學,學士班(日間),9959,126,65,61,339,176,163
,104,2,私立,一般大學,1015,世新大學,學士班(進修),204,10,4,6,22,9,13
,104,2,私立,一般大學,1015,世新大學,碩士班(日間),681,79,49,30,153,89,64
,104,2,私立,一般大學,1015,世新大學,碩士在職專班,930,90,48,42,255,127,128
,104,2,私立,一般大學,1015,世新大學,博士班,76,5,2,3,20,8,12
,104,2,私立,一般大學,1016,銘傳大學,學士班(日間),17787,319,212,107,724,460,264
,104,2,私立,一般大學,1016,銘傳大學,碩士班(日間),720,39,24,15,124,77,47
,104,2,私立,一般大學,1016,銘傳大學,碩士在職專班,847,31,11,20,99,46,53
,104,2,私立,一般大學,1016,銘傳大學,博士班,59,4,3,1,17,11,6
,104,2,私立,一般大學,1017,實踐大學,學士班(日間),12477,139,56,83,463,203,260
,104,2,私立,一般大學,1017,實踐大學,學士班(進修),2538,81,24,57,204,62,142
,104,2,私立,一般大學,1017,實踐大學,碩士班(日間),389,27,15,12,65,36,29
,104,2,私立,一般大學,1017,實踐大學,碩士在職專班,198,16,7,9,59,25,34
,104,2,私立,一般大學,1017,實踐大學,博士班,14,1,0,1,1,0,1
,104,2,私立,一般大學,1019,高雄醫學大學,學士班(日間),5638,38,15,23,243,111,132
,104,2,私立,一般大學,1019,高雄醫學大學,學士班(進修),123,1,0,1,7,1,6
,104,2,私立,一般大學,1019,高雄醫學大學,碩士班(日間),604,27,10,17,111,40,71
,104,2,私立,一般大學,1019,高雄醫學大學,碩士在職專班,204,10,4,6,56,26,30
,104,2,私立,一般大學,1019,高雄醫學大學,博士班,325,34,13,21,98,58,40
,104,2,私立,一般大學,1020,南華大學,學士班(日間),4237,71,47,24,256,162,94
,104,2,私立,一般大學,1020,南華大學,學士班(進修),227,6,3,3,18,11,7
,104,2,私立,一般大學,1020,南華大學,碩士班(日間),638,42,15,27,152,70,82
,104,2,私立,一般大學,1020,南華大學,碩士在職專班,417,19,10,9,73,40,33
,104,2,私立,一般大學,1020,南華大學,博士班,36,0,0,0,4,2,2
,104,2,私立,一般大學,1021,真理大學,學士班(日間),7791,89,51,38,268,172,96
,104,2,私立,一般大學,1021,真理大學,學士班(進修),558,14,8,6,38,28,10
,104,2,私立,一般大學,1021,真理大學,碩士班(日間),157,8,5,3,19,12,7
,104,2,私立,一般大學,1021,真理大學,碩士在職專班,13,1,0,1,1,0,1
,104,2,私立,一般大學,1022,大同大學,學士班(日間),3733,31,26,5,114,91,23
,104,2,私立,一般大學,1022,大同大學,碩士班(日間),426,3,3,0,28,22,6
,104,2,私立,一般大學,1022,大同大學,碩士在職專班,399,25,20,5,90,71,19
,104,2,私立,一般大學,1022,大同大學,博士班,134,16,13,3,34,28,6
,104,2,私立,一般大學,1027,慈濟大學,學士班(日間),2934,35,16,19,114,54,60
,104,2,私立,一般大學,1027,慈濟大學,碩士班(日間),347,31,7,24,74,26,48
,104,2,私立,一般大學,1027,慈濟大學,碩士在職專班,35,5,3,2,11,4,7
,104,2,私立,一般大學,1027,慈濟大學,博士班,104,10,7,3,42,14,28
,104,2,私立,一般大學,1028,臺北醫學大學,學士班(日間),4596,23,11,12,148,72,76
,104,2,私立,一般大學,1028,臺北醫學大學,學士班(進修),55,0,0,0,2,0,2
,104,2,私立,一般大學,1028,臺北醫學大學,碩士班(日間),608,25,7,18,93,34,59
,104,2,私立,一般大學,1028,臺北醫學大學,碩士在職專班,228,16,1,15,54,9,45
,104,2,私立,一般大學,1028,臺北醫學大學,博士班,408,20,14,6,64,40,24
,104,2,私立,一般大學,1029,中山醫學大學,學士班(日間),6420,50,18,32,208,93,115
,104,2,私立,一般大學,1029,中山醫學大學,學士班(進修),245,5,2,3,16,7,9
,104,2,私立,一般大學,1029,中山醫學大學,碩士班(日間),489,19,8,11,58,21,37
,104,2,私立,一般大學,1029,中山醫學大學,碩士在職專班,125,2,1,1,22,6,16
,104,2,私立,一般大學,1029,中山醫學大學,博士班,225,12,5,7,41,22,19
,104,2,私立,一般大學,1033,長榮大學,學士班(日間),9303,122,81,41,626,425,201
,104,2,私立,一般大學,1033,長榮大學,學士班(進修),627,10,8,2,73,54,19
,104,2,私立,一般大學,1033,長榮大學,碩士班(日間),472,58,28,30,195,87,108
,104,2,私立,一般大學,1033,長榮大學,碩士在職專班,155,18,10,8,63,30,33
,104,2,私立,一般大學,1033,長榮大學,博士班,37,6,2,4,28,15,13
,104,2,私立,一般大學,1035,中國醫藥大學,學士班(日間),6380,53,31,22,247,137,110
,104,2,私立,一般大學,1035,中國醫藥大學,學士班(進修),73,1,0,1,12,3,9
,104,2,私立,一般大學,1035,中國醫藥大學,碩士班(日間),490,20,11,9,97,39,58
,104,2,私立,一般大學,1035,中國醫藥大學,碩士在職專班,67,3,1,2,11,6,5
,104,2,私立,一般大學,1035,中國醫藥大學,博士班,356,27,13,14,94,52,42
,104,2,私立,一般大學,1039,玄奘大學,學士班(日間),4136,153,76,77,282,144,138
,104,2,私立,一般大學,1039,玄奘大學,學士班(進修),1124,112,64,48,197,115,82
,104,2,私立,一般大學,1039,玄奘大學,碩士班(日間),345,71,30,41,104,42,62
,104,2,私立,一般大學,1039,玄奘大學,碩士在職專班,245,38,15,23,46,17,29
,104,2,私立,一般大學,1039,玄奘大學,博士班,9,2,1,1,4,2,2
,104,2,私立,一般大學,1048,亞洲大學,學士班(日間),9861,133,81,52,861,518,343
,104,2,私立,一般大學,1048,亞洲大學,學士班(進修),1307,56,32,24,371,220,151
,104,2,私立,一般大學,1048,亞洲大學,碩士班(日間),611,48,27,21,271,141,130
,104,2,私立,一般大學,1048,亞洲大學,碩士在職專班,495,9,1,8,85,35,50
,104,2,私立,一般大學,1048,亞洲大學,博士班,159,13,11,2,56,38,18
,104,2,私立,一般大學,1049,開南大學,學士班(日間),7647,107,65,42,409,281,128
,104,2,私立,一般大學,1049,開南大學,學士班(進修),1239,44,24,20,143,88,55
,104,2,私立,一般大學,1049,開南大學,碩士班(日間),258,21,10,11,77,50,27
,104,2,私立,一般大學,1049,開南大學,碩士在職專班,370,7,6,1,21,15,6
,104,2,私立,一般大學,1050,佛光大學,學士班(日間),3017,46,26,20,135,77,58
,104,2,私立,一般大學,1050,佛光大學,碩士班(日間),627,56,24,32,178,91,87
,104,2,私立,一般大學,1050,佛光大學,碩士在職專班,245,21,14,7,35,19,16
,104,2,私立,一般大學,1050,佛光大學,博士班,52,1,0,1,8,4,4
,104,2,私立,一般大學,1058,明道大學,學士班(日間),3696,27,16,11,111,76,35
,104,2,私立,一般大學,1058,明道大學,學士班(進修),1569,25,21,4,102,75,27
,104,2,私立,一般大學,1058,明道大學,碩士班(日間),201,15,7,8,43,21,22
,104,2,私立,一般大學,1058,明道大學,碩士在職專班,92,0,0,0,3,1,2
,104,2,私立,一般大學,1058,明道大學,博士班,13,0,0,0,0,0,0
,104,2,私立,一般大學,1067,台灣首府大學,學士班(日間),3285,43,34,9,119,88,31
,104,2,私立,一般大學,1067,台灣首府大學,學士班(進修),735,25,18,7,59,45,14
,104,2,私立,一般大學,1067,台灣首府大學,碩士班(日間),67,0,0,0,0,0,0
,104,2,私立,一般大學,1067,台灣首府大學,碩士在職專班,7,0,0,0,0,0,0
,104,2,私立,一般大學,1079,康寧大學,二專(日間),76,1,0,1,4,0,4
,104,2,私立,一般大學,1079,康寧大學,二專(進修),329,9,1,8,14,2,12
,104,2,私立,一般大學,1079,康寧大學,五專,2903,22,7,15,77,26,51
,104,2,私立,一般大學,1079,康寧大學,學士班(日間),1275,37,23,14,182,159,23
,104,2,私立,一般大學,1079,康寧大學,學士班(進修),524,66,40,26,150,109,41
,104,2,私立,一般大學,1079,康寧大學,碩士班(日間),148,23,9,14,53,36,17
,104,2,私立,一般大學,1079,康寧大學,碩士在職專班,157,14,10,4,24,22,2
,104,2,私立,一般大學,1125,中信金融管理學院,學士班(日間),184,3,2,1,21,13,8
,104,2,私立,一般大學,1125,中信金融管理學院,學士班(進修),22,0,0,0,17,7,10
,104,2,私立,一般大學,1176,稻江科技暨管理學院,學士班(日間),1452,18,6,12,95,44,51
,104,2,私立,一般大學,1176,稻江科技暨管理學院,學士班(進修),792,8,4,4,60,39,21
,104,2,私立,一般大學,1176,稻江科技暨管理學院,碩士班(日間),74,1,1,0,12,6,6
,104,2,私立,一般大學,1176,稻江科技暨管理學院,碩士在職專班,63,3,2,1,6,5,1
,104,2,私立,一般大學,1195,馬偕醫學院,學士班(日間),600,8,2,6,22,10,12
,104,2,私立,一般大學,1195,馬偕醫學院,學士班(進修),17,0,0,0,0,0,0
,104,2,私立,一般大學,1195,馬偕醫學院,碩士班(日間),23,0,0,0,5,1,4
,104,2,私立,一般大學,1196,法鼓文理學院,學士班(日間),52,1,0,1,5,2,3
,104,2,私立,一般大學,1196,法鼓文理學院,碩士班(日間),116,15,6,9,12,6,6
,104,2,私立,一般大學,1196,法鼓文理學院,博士班,11,2,1,1,3,1,2
,104,2,私立,一般大學,1R02,基督教台灣浸會神學院,碩士班(日間),42,0,0,0,1,0,1
,104,2,私立,一般大學,1R03,臺北基督學院,學士班(日間),138,10,4,6,28,12,16
,104,2,私立,一般大學,1R04,一貫道天皇學院,碩士班(日間),12,0,0,0,0,0,0
,104,2,私立,技專校院,1018,朝陽科技大學,學士班(日間),11696,116,58,58,362,200,162
,104,2,私立,技專校院,1018,朝陽科技大學,學士班(進修),3337,91,51,40,336,174,162
,104,2,私立,技專校院,1018,朝陽科技大學,碩士班(日間),748,37,17,20,146,76,70
,104,2,私立,技專校院,1018,朝陽科技大學,碩士在職專班,479,25,10,15,79,36,43
,104,2,私立,技專校院,1018,朝陽科技大學,博士班,89,3,2,1,15,12,3
,104,2,私立,技專校院,1023,南臺科技大學,學士班(日間),13320,124,74,50,434,278,156
,104,2,私立,技專校院,1023,南臺科技大學,學士班(進修),4481,98,54,44,479,306,173
,104,2,私立,技專校院,1023,南臺科技大學,碩士班(日間),944,37,27,10,177,120,57
,104,2,私立,技專校院,1023,南臺科技大學,碩士在職專班,503,15,8,7,78,32,46
,104,2,私立,技專校院,1023,南臺科技大學,博士班,72,4,4,0,12,12,0
,104,2,私立,技專校院,1024,崑山科技大學,學士班(日間),8535,112,51,61,672,471,201
,104,2,私立,技專校院,1024,崑山科技大學,學士班(進修),3438,175,114,61,730,498,232
,104,2,私立,技專校院,1024,崑山科技大學,碩士班(日間),428,27,17,10,102,80,22
,104,2,私立,技專校院,1024,崑山科技大學,碩士在職專班,201,9,8,1,28,25,3
,104,2,私立,技專校院,1024,崑山科技大學,博士班,34,1,1,0,3,3,0
,104,2,私立,技專校院,1025,嘉南藥理大學,學士班(日間),13126,114,59,55,702,388,314
,104,2,私立,技專校院,1025,嘉南藥理大學,學士班(進修),3314,175,93,82,791,472,319
,104,2,私立,技專校院,1025,嘉南藥理大學,碩士班(日間),312,15,8,7,84,56,28
,104,2,私立,技專校院,1025,嘉南藥理大學,碩士在職專班,219,11,5,6,51,19,32
,104,2,私立,技專校院,1026,樹德科技大學,學士班(日間),8386,293,157,136,293,157,136
,104,2,私立,技專校院,1026,樹德科技大學,學士班(進修),2140,134,93,41,134,93,41
,104,2,私立,技專校院,1026,樹德科技大學,碩士班(日間),326,49,17,32,49,17,32
,104,2,私立,技專校院,1026,樹德科技大學,碩士在職專班,469,49,31,18,49,31,18
,104,2,私立,技專校院,1026,樹德科技大學,博士班,26,9,4,5,9,4,5
,104,2,私立,技專校院,1030,龍華科技大學,二專(日間),11,0,0,0,3,3,0
,104,2,私立,技專校院,1030,龍華科技大學,五專,38,2,2,0,1,1,0
,104,2,私立,技專校院,1030,龍華科技大學,學士班(日間),6766,72,53,19,280,207,73
,104,2,私立,技專校院,1030,龍華科技大學,學士班(進修),3928,116,86,30,306,238,68
,104,2,私立,技專校院,1030,龍華科技大學,碩士班(日間),349,7,5,2,34,28,6
,104,2,私立,技專校院,1030,龍華科技大學,碩士在職專班,76,2,2,0,4,3,1
,104,2,私立,技專校院,1031,輔英科技大學,五專,2901,15,3,12,54,9,45
,104,2,私立,技專校院,1031,輔英科技大學,學士班(日間),5369,70,28,42,324,142,182
,104,2,私立,技專校院,1031,輔英科技大學,學士班(進修),1140,38,19,19,169,90,79
,104,2,私立,技專校院,1031,輔英科技大學,碩士班(日間),123,11,5,6,33,8,25
,104,2,私立,技專校院,1031,輔英科技大學,碩士在職專班,46,2,0,2,16,0,16
,104,2,私立,技專校院,1032,明新科技大學,二專(日間),9,0,0,0,0,0,0
,104,2,私立,技專校院,1032,明新科技大學,二專(進修),54,2,2,0,1,1,0
,104,2,私立,技專校院,1032,明新科技大學,學士班(日間),8692,118,86,32,1255,805,450
,104,2,私立,技專校院,1032,明新科技大學,學士班(進修),4042,144,105,39,482,336,146
,104,2,私立,技專校院,1032,明新科技大學,碩士班(日間),343,17,12,5,208,151,57
,104,2,私立,技專校院,1032,明新科技大學,碩士在職專班,235,12,10,2,27,21,6
,104,2,私立,技專校院,1034,弘光科技大學,二專(進修),67,1,0,1,4,1,3
,104,2,私立,技專校院,1034,弘光科技大學,五專,269,1,0,1,1,0,1
,104,2,私立,技專校院,1034,弘光科技大學,學士班(日間),8036,67,31,36,343,171,172
,104,2,私立,技專校院,1034,弘光科技大學,學士班(進修),4340,98,42,56,517,237,280
,104,2,私立,技專校院,1034,弘光科技大學,碩士班(日間),201,7,3,4,54,20,34
,104,2,私立,技專校院,1034,弘光科技大學,碩士在職專班,93,7,3,4,35,10,25
,104,2,私立,技專校院,1036,健行科技大學,二專(日間),46,1,1,0,1,1,0
,104,2,私立,技專校院,1036,健行科技大學,五專,28,0,0,0,0,0,0
,104,2,私立,技專校院,1036,健行科技大學,學士班(日間),8088,131,91,40,386,298,88
,104,2,私立,技專校院,1036,健行科技大學,學士班(進修),3483,221,158,63,326,217,109
,104,2,私立,技專校院,1036,健行科技大學,碩士班(日間),355,10,10,0,25,23,2
,104,2,私立,技專校院,1036,健行科技大學,碩士在職專班,101,2,1,1,9,7,2
,104,2,私立,技專校院,1037,正修科技大學,二專(進修),2,0,0,0,0,0,0
,104,2,私立,技專校院,1037,正修科技大學,五專,13,0,0,0,0,0,0
,104,2,私立,技專校院,1037,正修科技大學,學士班(日間),9890,164,98,66,567,375,192
,104,2,私立,技專校院,1037,正修科技大學,學士班(進修),6875,232,143,89,806,520,286
,104,2,私立,技專校院,1037,正修科技大學,碩士班(日間),354,13,7,6,64,38,26
,104,2,私立,技專校院,1037,正修科技大學,碩士在職專班,115,6,6,0,13,12,1
,104,2,私立,技專校院,1037,正修科技大學,博士班,12,0,0,0,0,0,0
,104,2,私立,技專校院,1038,萬能科技大學,二專(進修),15,0,0,0,0,0,0
,104,2,私立,技專校院,1038,萬能科技大學,學士班(日間),6619,50,33,17,453,283,170
,104,2,私立,技專校院,1038,萬能科技大學,學士班(進修),4163,0,0,0,529,340,189
,104,2,私立,技專校院,1038,萬能科技大學,碩士班(日間),145,11,5,6,65,43,22
,104,2,私立,技專校院,1038,萬能科技大學,碩士在職專班,105,0,0,0,15,11,4
,104,2,私立,技專校院,1040,建國科技大學,二專(日間),1,0,0,0,0,0,0
,104,2,私立,技專校院,1040,建國科技大學,二專(進修),1,1,1,0,1,1,0
,104,2,私立,技專校院,1040,建國科技大學,學士班(日間),7063,99,70,29,337,252,85
,104,2,私立,技專校院,1040,建國科技大學,學士班(進修),1719,32,15,17,101,67,34
,104,2,私立,技專校院,1040,建國科技大學,碩士班(日間),225,11,11,0,20,19,1
,104,2,私立,技專校院,1041,明志科技大學,五專,15,0,0,0,0,0,0
,104,2,私立,技專校院,1041,明志科技大學,學士班(日間),3568,16,14,2,55,42,13
,104,2,私立,技專校院,1041,明志科技大學,學士班(進修),488,8,8,0,25,20,5
,104,2,私立,技專校院,1041,明志科技大學,碩士班(日間),409,10,7,3,32,25,7
,104,2,私立,技專校院,1041,明志科技大學,碩士在職專班,52,3,3,0,18,14,4
,104,2,私立,技專校院,1042,高苑科技大學,二專(日間),6,0,0,0,0,0,0
,104,2,私立,技專校院,1042,高苑科技大學,學士班(日間),5641,78,52,26,277,202,75
,104,2,私立,技專校院,1042,高苑科技大學,學士班(進修),1451,42,27,15,114,81,33
,104,2,私立,技專校院,1042,高苑科技大學,碩士班(日間),148,5,2,3,14,10,4
,104,2,私立,技專校院,1042,高苑科技大學,碩士在職專班,278,3,3,0,17,13,4
,104,2,私立,技專校院,1043,大仁科技大學,五專,1,0,0,0,5,3,2
,104,2,私立,技專校院,1043,大仁科技大學,學士班(日間),5471,89,55,34,688,427,261
,104,2,私立,技專校院,1043,大仁科技大學,學士班(進修),1790,30,14,16,332,224,108
,104,2,私立,技專校院,1043,大仁科技大學,碩士班(日間),62,8,7,1,29,22,7
,104,2,私立,技專校院,1043,大仁科技大學,碩士在職專班,144,3,2,1,38,18,20
,104,2,私立,技專校院,1044,聖約翰科技大學,五專,96,1,0,1,5,3,2
,104,2,私立,技專校院,1044,聖約翰科技大學,學士班(日間),4604,102,80,22,421,336,85
,104,2,私立,技專校院,1044,聖約翰科技大學,學士班(進修),323,9,5,4,78,53,25
,104,2,私立,技專校院,1044,聖約翰科技大學,碩士班(日間),166,14,14,0,42,41,1
,104,2,私立,技專校院,1044,聖約翰科技大學,碩士在職專班,69,4,3,1,17,14,3
,104,2,私立,技專校院,1045,嶺東科技大學,二專(日間),20,0,0,0,0,0,0
,104,2,私立,技專校院,1045,嶺東科技大學,學士班(日間),7526,56,20,36,162,64,98
,104,2,私立,技專校院,1045,嶺東科技大學,學士班(進修),2494,94,52,42,267,153,114
,104,2,私立,技專校院,1045,嶺東科技大學,碩士班(日間),258,7,4,3,29,13,16
,104,2,私立,技專校院,1045,嶺東科技大學,碩士在職專班,101,2,2,0,12,10,2
,104,2,私立,技專校院,1046,中國科技大學,學士班(日間),9542,120,51,69,420,210,210
,104,2,私立,技專校院,1046,中國科技大學,學士班(進修),2511,99,51,48,285,165,120
,104,2,私立,技專校院,1046,中國科技大學,碩士班(日間),145,7,4,3,37,24,13
,104,2,私立,技專校院,1046,中國科技大學,碩士在職專班,47,0,0,0,1,1,0
,104,2,私立,技專校院,1047,中臺科技大學,學士班(日間),6238,109,52,57,455,228,227
,104,2,私立,技專校院,1047,中臺科技大學,學士班(進修),2865,116,53,63,571,277,294
,104,2,私立,技專校院,1047,中臺科技大學,碩士班(日間),165,5,1,4,52,25,27
,104,2,私立,技專校院,1047,中臺科技大學,碩士在職專班,243,20,3,17,68,10,58
,104,2,私立,技專校院,1047,中臺科技大學,博士班,20,4,3,1,4,3,1
,104,2,私立,技專校院,1051,台南應用科技大學,五專,1199,21,4,17,65,14,51
,104,2,私立,技專校院,1051,台南應用科技大學,學士班(日間),8744,113,46,67,634,237,397
,104,2,私立,技專校院,1051,台南應用科技大學,學士班(進修),2699,103,46,57,315,152,163
,104,2,私立,技專校院,1051,台南應用科技大學,碩士班(日間),142,9,2,7,71,16,55
,104,2,私立,技專校院,1051,台南應用科技大學,碩士在職專班,163,11,4,7,48,13,35
,104,2,私立,技專校院,1052,遠東科技大學,二專(進修),39,0,0,0,4,4,0
,104,2,私立,技專校院,1052,遠東科技大學,學士班(日間),7242,112,81,31,574,410,164
,104,2,私立,技專校院,1052,遠東科技大學,學士班(進修),633,20,14,6,86,61,25
,104,2,私立,技專校院,1052,遠東科技大學,碩士班(日間),172,7,5,2,40,34,6
,104,2,私立,技專校院,1052,遠東科技大學,碩士在職專班,37,0,0,0,4,4,0
,104,2,私立,技專校院,1053,元培醫事科技大學,學士班(日間),5572,63,44,19,164,105,59
,104,2,私立,技專校院,1053,元培醫事科技大學,學士班(進修),1184,31,17,14,83,44,39
,104,2,私立,技專校院,1053,元培醫事科技大學,碩士班(日間),231,11,4,7,21,9,12
,104,2,私立,技專校院,1053,元培醫事科技大學,碩士在職專班,25,0,0,0,1,0,1
,104,2,私立,技專校院,1054,景文科技大學,學士班(日間),5843,48,29,19,175,79,96
,104,2,私立,技專校院,1054,景文科技大學,學士班(進修),2113,59,38,21,192,123,69
,104,2,私立,技專校院,1054,景文科技大學,碩士班(日間),51,5,5,0,7,6,1
,104,2,私立,技專校院,1054,景文科技大學,碩士在職專班,105,9,9,0,22,16,6
,104,2,私立,技專校院,1055,中華醫事科技大學,二專(日間),95,3,1,2,5,2,3
,104,2,私立,技專校院,1055,中華醫事科技大學,五專,2194,19,7,12,49,15,34
,104,2,私立,技專校院,1055,中華醫事科技大學,學士班(日間),5156,75,31,44,344,167,177
,104,2,私立,技專校院,1055,中華醫事科技大學,學士班(進修),1930,90,39,51,322,141,181
,104,2,私立,技專校院,1055,中華醫事科技大學,碩士班(日間),54,3,1,2,15,7,8
,104,2,私立,技專校院,1056,東南科技大學,二專(日間),19,0,0,0,5,3,2
,104,2,私立,技專校院,1056,東南科技大學,學士班(日間),6641,170,125,45,895,659,236
,104,2,私立,技專校院,1056,東南科技大學,學士班(進修),651,44,31,13,213,177,36
,104,2,私立,技專校院,1056,東南科技大學,碩士班(日間),114,5,4,1,23,20,3
,104,2,私立,技專校院,1056,東南科技大學,碩士在職專班,59,2,2,0,4,4,0
,104,2,私立,技專校院,1057,德明財經科技大學,二專(日間),1,0,0,0,3,1,2
,104,2,私立,技專校院,1057,德明財經科技大學,學士班(日間),7459,106,62,44,355,188,167
,104,2,私立,技專校院,1057,德明財經科技大學,學士班(進修),1637,82,48,34,98,57,41
,104,2,私立,技專校院,1057,德明財經科技大學,碩士班(日間),66,3,3,0,18,14,4
,104,2,私立,技專校院,1057,德明財經科技大學,碩士在職專班,63,5,5,0,13,8,5
,104,2,私立,技專校院,1060,南開科技大學,二專(日間),5,0,0,0,0,0,0
,104,2,私立,技專校院,1060,南開科技大學,五專,1088,20,18,2,105,83,22
,104,2,私立,技專校院,1060,南開科技大學,學士班(日間),3864,62,48,14,234,177,57
,104,2,私立,技專校院,1060,南開科技大學,學士班(進修),1123,36,23,13,114,74,40
,104,2,私立,技專校院,1060,南開科技大學,碩士班(日間),107,8,7,1,24,18,6
,104,2,私立,技專校院,1060,南開科技大學,碩士在職專班,132,9,5,4,14,6,8
,104,2,私立,技專校院,1061,中華科技大學,二專(進修),0,0,0,0,2,1,1
,104,2,私立,技專校院,1061,中華科技大學,學士班(日間),6430,118,77,41,660,477,183
,104,2,私立,技專校院,1061,中華科技大學,學士班(進修),1265,59,45,14,323,246,77
,104,2,私立,技專校院,1061,中華科技大學,碩士班(日間),267,11,8,3,51,43,8
,104,2,私立,技專校院,1061,中華科技大學,碩士在職專班,124,4,4,0,26,23,3
,104,2,私立,技專校院,1062,僑光科技大學,二專(日間),48,0,0,0,2,1,1
,104,2,私立,技專校院,1062,僑光科技大學,二專(進修),207,2,0,2,3,1,2
,104,2,私立,技專校院,1062,僑光科技大學,五專,149,3,2,1,15,11,4
,104,2,私立,技專校院,1062,僑光科技大學,學士班(日間),6328,41,19,22,133,78,55
,104,2,私立,技專校院,1062,僑光科技大學,學士班(進修),3614,53,28,25,195,113,82
,104,2,私立,技專校院,1062,僑光科技大學,碩士班(日間),84,1,1,0,8,6,2
,104,2,私立,技專校院,1062,僑光科技大學,碩士在職專班,56,3,0,3,6,2,4
,104,2,私立,技專校院,1063,育達科技大學,學士班(日間),3758,63,38,25,325,193,132
,104,2,私立,技專校院,1063,育達科技大學,學士班(進修),1498,41,27,14,275,187,88
,104,2,私立,技專校院,1063,育達科技大學,碩士班(日間),117,2,1,1,7,6,1
,104,2,私立,技專校院,1063,育達科技大學,碩士在職專班,92,5,3,2,7,4,3
,104,2,私立,技專校院,1064,美和科技大學,二專(進修),7,0,0,0,1,1,0
,104,2,私立,技專校院,1064,美和科技大學,五專,1824,13,1,12,69,18,51
,104,2,私立,技專校院,1064,美和科技大學,學士班(日間),4040,59,34,25,310,181,129
,104,2,私立,技專校院,1064,美和科技大學,學士班(進修),1888,38,18,20,240,120,120
,104,2,私立,技專校院,1064,美和科技大學,碩士班(日間),108,3,2,1,26,15,11
,104,2,私立,技專校院,1064,美和科技大學,碩士在職專班,202,2,1,1,20,11,9
,104,2,私立,技專校院,1065,吳鳳科技大學,二專(日間),1,0,0,0,1,1,0
,104,2,私立,技專校院,1065,吳鳳科技大學,二專(進修),2,0,0,0,5,4,1
,104,2,私立,技專校院,1065,吳鳳科技大學,學士班(日間),4214,87,53,34,334,235,99
,104,2,私立,技專校院,1065,吳鳳科技大學,學士班(進修),1113,53,43,10,241,191,50
,104,2,私立,技專校院,1065,吳鳳科技大學,碩士班(日間),44,5,5,0,14,12,2
,104,2,私立,技專校院,1065,吳鳳科技大學,碩士在職專班,82,0,0,0,2,1,1
,104,2,私立,技專校院,1066,環球科技大學,二專(日間),12,2,2,0,4,2,2
,104,2,私立,技專校院,1066,環球科技大學,二專(進修),285,8,5,3,19,13,6
,104,2,私立,技專校院,1066,環球科技大學,學士班(日間),4485,125,68,57,442,259,183
,104,2,私立,技專校院,1066,環球科技大學,學士班(進修),1446,21,11,10,44,24,20
,104,2,私立,技專校院,1066,環球科技大學,碩士班(日間),145,2,2,0,17,11,6
,104,2,私立,技專校院,1066,環球科技大學,碩士在職專班,43,0,0,0,7,5,2
,104,2,私立,技專校院,1068,中州科技大學,二專(日間),11,0,0,0,0,0,0
,104,2,私立,技專校院,1068,中州科技大學,學士班(日間),2829,45,28,17,157,114,43
,104,2,私立,技專校院,1068,中州科技大學,學士班(進修),1450,33,21,12,97,66,31
,104,2,私立,技專校院,1068,中州科技大學,碩士班(日間),64,6,2,4,8,3,5
,104,2,私立,技專校院,1068,中州科技大學,碩士在職專班,41,1,1,0,3,1,2
,104,2,私立,技專校院,1069,修平科技大學,二專(日間),2,1,1,0,2,2,0
,104,2,私立,技專校院,1069,修平科技大學,二專(進修),21,1,1,0,3,3,0
,104,2,私立,技專校院,1069,修平科技大學,學士班(日間),5582,110,72,38,279,194,85
,104,2,私立,技專校院,1069,修平科技大學,學士班(進修),723,38,34,4,89,84,5
,104,2,私立,技專校院,1069,修平科技大學,碩士班(日間),68,7,7,0,8,8,0
,104,2,私立,技專校院,1070,長庚科技大學,五專,1280,6,0,6,12,0,12
,104,2,私立,技專校院,1070,長庚科技大學,學士班(日間),4099,25,3,22,79,7,72
,104,2,私立,技專校院,1070,長庚科技大學,學士班(進修),1906,29,2,27,93,3,90
,104,2,私立,技專校院,1070,長庚科技大學,碩士班(日間),45,1,0,1,8,2,6
,104,2,私立,技專校院,1070,長庚科技大學,碩士在職專班,41,2,1,1,5,1,4
,104,2,私立,技專校院,1071,臺北城市科技大學,二專(日間),83,3,3,0,6,5,1
,104,2,私立,技專校院,1071,臺北城市科技大學,二專(進修),62,7,5,2,26,18,8
,104,2,私立,技專校院,1071,臺北城市科技大學,五專,1625,39,25,14,100,76,24
,104,2,私立,技專校院,1071,臺北城市科技大學,學士班(日間),7228,169,113,56,512,365,147
,104,2,私立,技專校院,1071,臺北城市科技大學,學士班(進修),909,61,47,14,136,106,30
,104,2,私立,技專校院,1071,臺北城市科技大學,碩士班(日間),111,8,6,2,23,20,3
,104,2,私立,技專校院,1072,大華科技大學,二專(進修),257,0,0,0,0,0,0
,104,2,私立,技專校院,1072,大華科技大學,五專,1136,25,16,9,100,61,39
,104,2,私立,技專校院,1072,大華科技大學,學士班(日間),1395,37,27,10,122,86,36
,104,2,私立,技專校院,1072,大華科技大學,學士班(進修),1329,29,24,5,69,53,16
,104,2,私立,技專校院,1072,大華科技大學,碩士班(日間),31,4,4,0,5,5,0
,104,2,私立,技專校院,1072,大華科技大學,碩士在職專班,2,0,0,0,1,1,0
,104,2,私立,技專校院,1073,醒吾科技大學,二專(日間),10,0,0,0,0,0,0
,104,2,私立,技專校院,1073,醒吾科技大學,二專(進修),0,0,0,0,21,12,9
,104,2,私立,技專校院,1073,醒吾科技大學,五專,1302,18,7,11,150,47,103
,104,2,私立,技專校院,1073,醒吾科技大學,學士班(日間),6045,89,51,38,367,211,156
,104,2,私立,技專校院,1073,醒吾科技大學,學士班(進修),1199,63,40,23,362,228,134
,104,2,私立,技專校院,1073,醒吾科技大學,碩士班(日間),59,0,0,0,21,16,5
,104,2,私立,技專校院,1073,醒吾科技大學,碩士在職專班,70,1,1,0,3,0,3
,104,2,私立,技專校院,1074,南榮科技大學,二專(進修),257,4,2,2,10,7,3
,104,2,私立,技專校院,1074,南榮科技大學,五專,308,6,3,3,14,11,3
,104,2,私立,技專校院,1074,南榮科技大學,學士班(日間),1797,26,21,5,73,54,19
,104,2,私立,技專校院,1074,南榮科技大學,學士班(進修),1455,23,19,4,59,47,12
,104,2,私立,技專校院,1074,南榮科技大學,碩士班(日間),33,0,0,0,0,0,0
,104,2,私立,技專校院,1074,南榮科技大學,碩士在職專班,39,0,0,0,0,0,0
,104,2,私立,技專校院,1075,文藻外語大學,五專,1776,10,2,8,56,8,48
,104,2,私立,技專校院,1075,文藻外語大學,學士班(日間),5588,102,23,79,319,93,226
,104,2,私立,技專校院,1075,文藻外語大學,學士班(進修),1823,84,27,57,335,122,213
,104,2,私立,技專校院,1075,文藻外語大學,碩士班(日間),114,16,6,10,42,13,29
,104,2,私立,技專校院,1075,文藻外語大學,碩士在職專班,70,8,4,4,32,13,19
,104,2,私立,技專校院,1076,華夏科技大學,二專(進修),312,10,4,6,220,127,93
,104,2,私立,技專校院,1076,華夏科技大學,五專,527,5,3,2,119,100,19
,104,2,私立,技專校院,1076,華夏科技大學,學士班(日間),3237,66,52,14,560,364,196
,104,2,私立,技專校院,1076,華夏科技大學,學士班(進修),1018,37,25,12,470,341,129
,104,2,私立,技專校院,1076,華夏科技大學,碩士班(日間),30,6,5,1,10,9,1
,104,2,私立,技專校院,1076,華夏科技大學,碩士在職專班,59,3,2,1,17,14,3
,104,2,私立,技專校院,1077,慈濟科技大學,五專,1244,13,2,11,38,5,33
,104,2,私立,技專校院,1077,慈濟科技大學,學士班(日間),1371,28,13,15,83,41,42
,104,2,私立,技專校院,1077,慈濟科技大學,學士班(進修),104,1,1,0,12,2,10
,104,2,私立,技專校院,1077,慈濟科技大學,碩士班(日間),24,1,1,0,1,1,0
,104,2,私立,技專校院,1078,致理科技大學,二專(日間),90,4,2,2,21,16,5
,104,2,私立,技專校院,1078,致理科技大學,五專,1619,18,4,14,70,28,42
,104,2,私立,技專校院,1078,致理科技大學,學士班(日間),6776,64,30,34,309,150,159
,104,2,私立,技專校院,1078,致理科技大學,學士班(進修),3189,58,23,35,266,120,146
,104,2,私立,技專校院,1078,致理科技大學,碩士班(日間),31,3,3,0,5,4,1
,104,2,私立,技專校院,1078,致理科技大學,碩士在職專班,31,0,0,0,4,2,2
,104,2,私立,技專校院,1148,大漢技術學院,二專(進修),238,0,0,0,7,5,2
,104,2,私立,技專校院,1148,大漢技術學院,學士班(日間),698,13,8,5,173,118,55
,104,2,私立,技專校院,1148,大漢技術學院,學士班(進修),691,2,2,0,54,41,13
,104,2,私立,技專校院,1148,大漢技術學院,碩士班(日間),93,3,3,0,10,9,1
,104,2,私立,技專校院,1159,和春技術學院,二專(進修),484,12,11,1,35,32,3
,104,2,私立,技專校院,1159,和春技術學院,五專,358,4,4,0,21,15,6
,104,2,私立,技專校院,1159,和春技術學院,學士班(日間),1323,31,22,9,96,66,30
,104,2,私立,技專校院,1159,和春技術學院,學士班(進修),1121,49,38,11,218,173,45
,104,2,私立,技專校院,1159,和春技術學院,碩士班(日間),26,0,0,0,0,0,0
,104,2,私立,技專校院,1166,亞東技術學院,二專(日間),15,0,0,0,2,0,2
,104,2,私立,技專校院,1166,亞東技術學院,學士班(日間),4758,63,48,15,274,204,70
,104,2,私立,技專校院,1166,亞東技術學院,學士班(進修),97,3,3,0,36,24,12
,104,2,私立,技專校院,1166,亞東技術學院,碩士班(日間),47,3,2,1,9,7,2
,104,2,私立,技專校院,1168,南亞技術學院,二專(日間),93,0,0,0,0,0,0
,104,2,私立,技專校院,1168,南亞技術學院,五專,133,4,1,3,6,2,4
,104,2,私立,技專校院,1168,南亞技術學院,學士班(日間),3774,71,46,25,301,204,97
,104,2,私立,技專校院,1168,南亞技術學院,學士班(進修),1138,26,20,6,232,172,60
,104,2,私立,技專校院,1168,南亞技術學院,碩士班(日間),48,2,2,0,4,2,2
,104,2,私立,技專校院,1179,德霖技術學院,二專(日間),76,0,0,0,0,0,0
,104,2,私立,技專校院,1179,德霖技術學院,二專(進修),476,13,6,7,29,18,11
,104,2,私立,技專校院,1179,德霖技術學院,五專,1702,33,22,11,116,90,26
,104,2,私立,技專校院,1179,德霖技術學院,學士班(日間),3335,134,95,39,318,232,86
,104,2,私立,技專校院,1179,德霖技術學院,學士班(進修),1847,36,25,11,114,91,23
,104,2,私立,技專校院,1182,蘭陽技術學院,五專,747,22,17,5,46,28,18
,104,2,私立,技專校院,1182,蘭陽技術學院,學士班(日間),951,13,6,7,19,11,8
,104,2,私立,技專校院,1182,蘭陽技術學院,學士班(進修),1,0,0,0,0,0,0
,104,2,私立,技專校院,1183,黎明技術學院,二專(進修),69,0,0,0,16,8,8
,104,2,私立,技專校院,1183,黎明技術學院,五專,911,14,10,4,137,120,17
,104,2,私立,技專校院,1183,黎明技術學院,學士班(日間),2854,71,40,31,592,364,228
,104,2,私立,技專校院,1183,黎明技術學院,學士班(進修),837,40,32,8,347,263,84
,104,2,私立,技專校院,1184,東方設計學院,二專(日間),2,0,0,0,0,0,0
,104,2,私立,技專校院,1184,東方設計學院,五專,1643,30,8,22,154,64,90
,104,2,私立,技專校院,1184,東方設計學院,學士班(日間),1925,45,30,15,272,165,107
,104,2,私立,技專校院,1184,東方設計學院,學士班(進修),154,12,11,1,45,21,24
,104,2,私立,技專校院,1184,東方設計學院,碩士班(日間),71,6,2,4,35,20,15
,104,2,私立,技專校院,1184,東方設計學院,碩士在職專班,48,3,3,0,44,21,23
,104,2,私立,技專校院,1184,東方設計學院,博士班,14,1,1,0,0,0,0
,104,2,私立,技專校院,1185,經國管理暨健康學院,五專,1654,41,14,27,114,35,79
,104,2,私立,技專校院,1185,經國管理暨健康學院,學士班(日間),1971,62,32,30,190,102,88
,104,2,私立,技專校院,1185,經國管理暨健康學院,學士班(進修),517,20,12,8,50,25,25
,104,2,私立,技專校院,1185,經國管理暨健康學院,碩士班(日間),23,0,0,0,4,0,4
,104,2,私立,技專校院,1185,經國管理暨健康學院,碩士在職專班,45,4,1,3,7,3,4
,104,2,私立,技專校院,1187,崇右技術學院,五專,703,40,22,18,92,52,40
,104,2,私立,技專校院,1187,崇右技術學院,學士班(日間),2485,102,55,47,201,111,90
,104,2,私立,技專校院,1187,崇右技術學院,碩士班(日間),70,0,0,0,3,1,2
,104,2,私立,技專校院,1188,大同技術學院,二專(日間),0,0,0,0,19,15,4
,104,2,私立,技專校院,1188,大同技術學院,二專(進修),29,0,0,0,16,10,6
,104,2,私立,技專校院,1188,大同技術學院,五專,206,5,5,0,76,54,22
,104,2,私立,技專校院,1188,大同技術學院,學士班(日間),1655,41,21,20,490,286,204
,104,2,私立,技專校院,1188,大同技術學院,學士班(進修),758,43,23,20,181,90,91
,104,2,私立,技專校院,1189,亞太創意技術學院,二專(進修),128,0,0,0,4,0,4
,104,2,私立,技專校院,1189,亞太創意技術學院,學士班(日間),974,23,14,9,142,84,58
,104,2,私立,技專校院,1189,亞太創意技術學院,學士班(進修),315,0,0,0,0,0,0
,104,2,私立,技專校院,1189,亞太創意技術學院,碩士班(日間),73,2,2,0,15,7,8
,104,2,私立,技專校院,1192,臺灣觀光學院,二專(日間),6,0,0,0,3,2,1
,104,2,私立,技專校院,1192,臺灣觀光學院,二專(進修),70,0,0,0,0,0,0
,104,2,私立,技專校院,1192,臺灣觀光學院,五專,205,12,6,6,15,7,8
,104,2,私立,技專校院,1192,臺灣觀光學院,學士班(日間),998,44,21,23,85,47,38
,104,2,私立,技專校院,1192,臺灣觀光學院,學士班(進修),246,13,5,8,2,0,2
,104,2,私立,技專校院,1192,臺灣觀光學院,碩士班(日間),28,1,0,1,3,1,2
,104,2,私立,技專校院,1197,台北海洋技術學院,二專(日間),259,7,6,1,36,30,6
,104,2,私立,技專校院,1197,台北海洋技術學院,二專(進修),137,1,1,0,13,13,0
,104,2,私立,技專校院,1197,台北海洋技術學院,五專,1450,40,25,15,101,67,34
,104,2,私立,技專校院,1197,台北海洋技術學院,學士班(日間),4370,120,86,34,406,281,125
,104,2,私立,技專校院,1197,台北海洋技術學院,學士班(進修),259,1,1,0,29,18,11
,104,2,私立,技專校院,1197,台北海洋技術學院,碩士班(日間),15,1,1,0,2,1,1
,104,2,私立,技專校院,1282,馬偕醫護管理專科學校,二專(日間),54,1,0,1,4,1,3
,104,2,私立,技專校院,1282,馬偕醫護管理專科學校,二專(進修),340,4,3,1,17,7,10
,104,2,私立,技專校院,1282,馬偕醫護管理專科學校,五專,3922,38,5,33,94,14,80
,104,2,私立,技專校院,1283,仁德醫護管理專科學校,二專(進修),472,1,1,0,1,1,0
,104,2,私立,技專校院,1283,仁德醫護管理專科學校,五專,6031,65,27,38,137,57,80
,104,2,私立,技專校院,1284,樹人醫護管理專科學校,二專(進修),488,12,8,4,35,29,6
,104,2,私立,技專校院,1284,樹人醫護管理專科學校,五專,6543,85,34,51,219,76,143
,104,2,私立,技專校院,1285,慈惠醫護管理專科學校,二專(日間),139,0,0,0,7,2,5
,104,2,私立,技專校院,1285,慈惠醫護管理專科學校,二專(進修),323,9,3,6,31,12,19
,104,2,私立,技專校院,1285,慈惠醫護管理專科學校,五專,5883,84,32,52,223,78,145
,104,2,私立,技專校院,1286,耕莘健康管理專科學校,二專(進修),73,1,0,1,3,1,2
,104,2,私立,技專校院,1286,耕莘健康管理專科學校,五專,4979,53,13,40,175,61,114
,104,2,私立,技專校院,1287,敏惠醫護管理專科學校,五專,3819,41,10,31,91,18,73
,104,2,私立,技專校院,1288,高美醫護管理專科學校,二專(進修),233,0,0,0,0,0,0
,104,2,私立,技專校院,1288,高美醫護管理專科學校,五專,619,16,5,11,16,5,11
,104,2,私立,技專校院,1289,育英醫護管理專科學校,五專,2009,25,0,25,47,3,44
,104,2,私立,技專校院,1290,崇仁醫護管理專科學校,五專,3387,30,5,25,45,6,39
,104,2,私立,技專校院,1291,聖母醫護管理專科學校,五專,3597,71,21,50,190,71,119
,104,2,私立,技專校院,1292,新生醫護管理專科學校,二專(進修),123,2,2,0,8,5,3
,104,2,私立,技專校院,1292,新生醫護管理專科學校,五專,5913,66,9,57,193,32,161
