學年度,設立別,學校類別,學校統計處代碼,學校名稱,學制班別(日間),國家(地區)別,國家(地區)區域別,境外學位生總人數(A)(A=B+C+D+E)小計,境外學生總人數(A)(A=B+C+D+E)男,境外學生總人數(A)(A=B+C+D+E)女,外國學生(B)小計,外國學生(B)男,外國學生(B)女,僑生(C)小計,僑生(C)男,僑生(C)女,港澳生(D)小計,港澳生(D)男,港澳生(D)女,大陸地區來臺學位生(E)小計,大陸地區來臺學位生(E)男,大陸地區來臺學位生(E)女
108,公立,一般大學,0001,國立政治大學,學士班(日間),大陸地區,大陸地區,18,2,16,0,0,0,0,0,0,0,0,0,18,2,16
108,公立,一般大學,0001,國立政治大學,學士班(日間),日本,其他亞洲地區,49,20,29,41,16,25,8,4,4,0,0,0,0,0,0
108,公立,一般大學,0001,國立政治大學,學士班(日間),土耳其共和國,其他亞洲地區,1,0,1,1,0,1,0,0,0,0,0,0,0,0,0
108,公立,一般大學,0001,國立政治大學,學士班(日間),大韓民國(南韓),其他亞洲地區,39,22,17,35,20,15,4,2,2,0,0,0,0,0,0
108,公立,一般大學,0001,國立政治大學,學士班(日間),厄瓜多共和國,中南美洲,1,1,0,0,0,0,1,1,0,0,0,0,0,0,0
108,公立,一般大學,0001,國立政治大學,學士班(日間),巴拉圭,中南美洲,7,3,4,6,2,4,1,1,0,0,0,0,0,0,0
108,公立,一般大學,0001,國立政治大學,學士班(日間),巴拿馬共和國,中南美洲,5,2,3,5,2,3,0,0,0,0,0,0,0,0,0
108,公立,一般大學,0001,國立政治大學,學士班(日間),尼加拉瓜,中南美洲,3,2,1,2,1,1,1,1,0,0,0,0,0,0,0
108,公立,一般大學,0001,國立政治大學,學士班(日間),瓜地馬拉共和國,中南美洲,3,1,2,3,1,2,0,0,0,0,0,0,0,0,0
108,公立,一般大學,0001,國立政治大學,學士班(日間),貝里斯,中南美洲,5,2,3,5,2,3,0,0,0,0,0,0,0,0,0
108,公立,一般大學,0001,國立政治大學,學士班(日間),美國,北美洲,5,4,1,3,3,0,2,1,1,0,0,0,0,0,0
108,公立,一般大學,0001,國立政治大學,學士班(日間),海地共和國,中南美洲,1,1,0,1,1,0,0,0,0,0,0,0,0,0,0
108,公立,一般大學,0001,國立政治大學,學士班(日間),智利,中南美洲,2,0,2,0,0,0,2,0,2,0,0,0,0,0,0
108,公立,一般大學,0001,國立政治大學,學士班(日間),新加坡共和國,東協,7,1,6,4,0,4,3,1,2,0,0,0,0,0,0
108,公立,一般大學,0001,國立政治大學,學士班(日間),聖文森(及格瑞那丁),中南美洲,2,1,1,2,1,1,0,0,0,0,0,0,0,0,0
108,公立,一般大學,0001,國立政治大學,學士班(日間),聖露西亞,中南美洲,1,0,1,1,0,1,0,0,0,0,0,0,0,0,0
108,公立,一般大學,0001,國立政治大學,學士班(日間),蒙古國,其他亞洲地區,1,0,1,1,0,1,0,0,0,0,0,0,0,0,0
108,公立,一般大學,0001,國立政治大學,學士班(日間),緬甸,東協,12,3,9,0,0,0,12,3,9,0,0,0,0,0,0
108,公立,一般大學,0001,國立政治大學,學士班(日間),薩爾瓦多,中南美洲,4,2,2,4,2,2,0,0,0,0,0,0,0,0,0
108,公立,一般大學,0001,國立政治大學,學士班(日間),加拿大,北美洲,3,1,2,1,1,0,2,0,2,0,0,0,0,0,0
108,公立,一般大學,0001,國立政治大學,學士班(日間),史瓦帝尼王國,非洲,1,0,1,1,0,1,0,0,0,0,0,0,0,0,0
108,公立,一般大學,0001,國立政治大學,學士班(日間),印度尼西亞共和國,東協,69,23,46,12,5,7,57,18,39,0,0,0,0,0,0
108,公立,一般大學,0001,國立政治大學,學士班(日間),多明尼加共和國,中南美洲,3,1,2,1,0,1,2,1,1,0,0,0,0,0,0
108,公立,一般大學,0001,國立政治大學,學士班(日間),宏都拉斯共和國,中南美洲,15,3,12,15,3,12,0,0,0,0,0,0,0,0,0
108,公立,一般大學,0001,國立政治大學,學士班(日間),法國,歐洲,1,1,0,1,1,0,0,0,0,0,0,0,0,0,0
108,公立,一般大學,0001,國立政治大學,學士班(日間),阿根廷,中南美洲,1,1,0,0,0,0,1,1,0,0,0,0,0,0,0
108,公立,一般大學,0001,國立政治大學,學士班(日間),俄羅斯聯邦,其他亞洲地區,3,2,1,3,2,1,0,0,0,0,0,0,0,0,0
108,公立,一般大學,0001,國立政治大學,學士班(日間),南非共和國,非洲,2,1,1,0,0,0,2,1,1,0,0,0,0,0,0
108,公立,一般大學,0001,國立政治大學,學士班(日間),香港,港澳,76,38,38,0,0,0,0,0,0,76,38,38,0,0,0
108,公立,一般大學,0001,國立政治大學,學士班(日間),泰國,東協,9,2,7,3,1,2,6,1,5,0,0,0,0,0,0
108,公立,一般大學,0001,國立政治大學,學士班(日間),馬來西亞,東協,216,63,153,11,4,7,205,59,146,0,0,0,0,0,0
108,公立,一般大學,0001,國立政治大學,學士班(日間),越南社會主義共和國,東協,28,9,19,10,4,6,18,5,13,0,0,0,0,0,0
108,公立,一般大學,0001,國立政治大學,學士班(日間),塞內加爾共和國,非洲,2,2,0,2,2,0,0,0,0,0,0,0,0,0,0
108,公立,一般大學,0001,國立政治大學,學士班(日間),墨西哥合眾國,中南美洲,3,1,2,1,0,1,2,1,1,0,0,0,0,0,0
108,公立,一般大學,0001,國立政治大學,學士班(日間),澳門,港澳,114,53,61,0,0,0,0,0,0,114,53,61,0,0,0
108,公立,一般大學,0001,國立政治大學,學士班(日間),諾魯共和國,其他亞洲地區,1,0,1,0,0,0,1,0,1,0,0,0,0,0,0
108,公立,一般大學,0001,國立政治大學,碩士班(日間),大陸地區,大陸地區,245,86,159,0,0,0,0,0,0,0,0,0,245,86,159
108,公立,一般大學,0001,國立政治大學,碩士班(日間),大韓民國(南韓),其他亞洲地區,18,7,11,18,7,11,0,0,0,0,0,0,0,0,0
108,公立,一般大學,0001,國立政治大學,碩士班(日間),巴西聯邦共和國,中南美洲,2,2,0,1,1,0,1,1,0,0,0,0,0,0,0
108,公立,一般大學,0001,國立政治大學,碩士班(日間),日本,其他亞洲地區,16,7,9,12,5,7,4,2,2,0,0,0,0,0,0
108,公立,一般大學,0001,國立政治大學,碩士班(日間),比利時王國,歐洲,1,1,0,1,1,0,0,0,0,0,0,0,0,0,0
108,公立,一般大學,0001,國立政治大學,碩士班(日間),加拿大,北美洲,7,6,1,5,5,0,2,1,1,0,0,0,0,0,0
108,公立,一般大學,0001,國立政治大學,碩士班(日間),白俄羅斯共和國,其他亞洲地區,1,0,1,1,0,1,0,0,0,0,0,0,0,0,0
108,公立,一般大學,0001,國立政治大學,碩士班(日間),冰島共和國,歐洲,1,1,0,1,1,0,0,0,0,0,0,0,0,0,0
108,公立,一般大學,0001,國立政治大學,碩士班(日間),土耳其共和國,其他亞洲地區,4,2,2,4,2,2,0,0,0,0,0,0,0,0,0
108,公立,一般大學,0001,國立政治大學,碩士班(日間),厄瓜多共和國,中南美洲,1,0,1,1,0,1,0,0,0,0,0,0,0,0,0
108,公立,一般大學,0001,國立政治大學,碩士班(日間),巴拉圭,中南美洲,1,1,0,0,0,0,1,1,0,0,0,0,0,0,0
108,公立,一般大學,0001,國立政治大學,碩士班(日間),巴拿馬共和國,中南美洲,1,0,1,1,0,1,0,0,0,0,0,0,0,0,0
108,公立,一般大學,0001,國立政治大學,碩士班(日間),尼加拉瓜,中南美洲,10,4,6,9,3,6,1,1,0,0,0,0,0,0,0
108,公立,一般大學,0001,國立政治大學,碩士班(日間),瓜地馬拉共和國,中南美洲,6,3,3,6,3,3,0,0,0,0,0,0,0,0,0
108,公立,一般大學,0001,國立政治大學,碩士班(日間),貝里斯,中南美洲,4,2,2,4,2,2,0,0,0,0,0,0,0,0,0
108,公立,一般大學,0001,國立政治大學,碩士班(日間),美國,北美洲,27,18,9,26,18,8,1,0,1,0,0,0,0,0,0
108,公立,一般大學,0001,國立政治大學,碩士班(日間),海地共和國,中南美洲,1,1,0,1,1,0,0,0,0,0,0,0,0,0,0
108,公立,一般大學,0001,國立政治大學,碩士班(日間),捷克共和國,歐洲,6,2,4,6,2,4,0,0,0,0,0,0,0,0,0
108,公立,一般大學,0001,國立政治大學,碩士班(日間),斯洛伐克共和國,歐洲,2,1,1,2,1,1,0,0,0,0,0,0,0,0,0
108,公立,一般大學,0001,國立政治大學,碩士班(日間),智利,中南美洲,1,1,0,1,1,0,0,0,0,0,0,0,0,0,0
108,公立,一般大學,0001,國立政治大學,碩士班(日間),義大利共和國,歐洲,3,1,2,3,1,2,0,0,0,0,0,0,0,0,0
108,公立,一般大學,0001,國立政治大學,碩士班(日間),聖克里斯多福及尼維斯,中南美洲,1,0,1,1,0,1,0,0,0,0,0,0,0,0,0
108,公立,一般大學,0001,國立政治大學,碩士班(日間),聖露西亞,中南美洲,1,1,0,1,1,0,0,0,0,0,0,0,0,0,0
108,公立,一般大學,0001,國立政治大學,碩士班(日間),德意志聯邦共和國,歐洲,10,9,1,10,9,1,0,0,0,0,0,0,0,0,0
108,公立,一般大學,0001,國立政治大學,碩士班(日間),澳大利亞,其他亞洲地區,1,1,0,1,1,0,0,0,0,0,0,0,0,0,0
108,公立,一般大學,0001,國立政治大學,碩士班(日間),匈牙利共和國,歐洲,2,0,2,2,0,2,0,0,0,0,0,0,0,0,0
108,公立,一般大學,0001,國立政治大學,碩士班(日間),印度尼西亞共和國,東協,9,2,7,8,1,7,1,1,0,0,0,0,0,0,0
108,公立,一般大學,0001,國立政治大學,碩士班(日間),西班牙王國,歐洲,1,1,0,1,1,0,0,0,0,0,0,0,0,0,0
108,公立,一般大學,0001,國立政治大學,碩士班(日間),宏都拉斯共和國,中南美洲,7,3,4,7,3,4,0,0,0,0,0,0,0,0,0
108,公立,一般大學,0001,國立政治大學,碩士班(日間),委內瑞拉共和國,中南美洲,1,1,0,0,0,0,1,1,0,0,0,0,0,0,0
108,公立,一般大學,0001,國立政治大學,碩士班(日間),波蘭共和國,歐洲,4,2,2,4,2,2,0,0,0,0,0,0,0,0,0
108,公立,一般大學,0001,國立政治大學,碩士班(日間),法國,歐洲,10,4,6,10,4,6,0,0,0,0,0,0,0,0,0
108,公立,一般大學,0001,國立政治大學,碩士班(日間),阿根廷,中南美洲,1,1,0,1,1,0,0,0,0,0,0,0,0,0,0
108,公立,一般大學,0001,國立政治大學,碩士班(日間),俄羅斯聯邦,其他亞洲地區,15,2,13,15,2,13,0,0,0,0,0,0,0,0,0
108,公立,一般大學,0001,國立政治大學,碩士班(日間),南非共和國,非洲,1,0,1,0,0,0,1,0,1,0,0,0,0,0,0
108,公立,一般大學,0001,國立政治大學,碩士班(日間),科索沃共和國,歐洲,1,1,0,1,1,0,0,0,0,0,0,0,0,0,0
108,公立,一般大學,0001,國立政治大學,碩士班(日間),英國,歐洲,3,2,1,3,2,1,0,0,0,0,0,0,0,0,0
108,公立,一般大學,0001,國立政治大學,碩士班(日間),香港,港澳,38,21,17,0,0,0,0,0,0,38,21,17,0,0,0
108,公立,一般大學,0001,國立政治大學,碩士班(日間),哥倫比亞共和國,中南美洲,1,0,1,1,0,1,0,0,0,0,0,0,0,0,0
108,公立,一般大學,0001,國立政治大學,碩士班(日間),哥斯大黎加共和國,中南美洲,1,0,1,1,0,1,0,0,0,0,0,0,0,0,0
108,公立,一般大學,0001,國立政治大學,碩士班(日間),泰國,東協,22,9,13,20,9,11,2,0,2,0,0,0,0,0,0
108,公立,一般大學,0001,國立政治大學,碩士班(日間),秘魯共和國,中南美洲,1,0,1,1,0,1,0,0,0,0,0,0,0,0,0
108,公立,一般大學,0001,國立政治大學,碩士班(日間),馬來西亞,東協,58,27,31,21,7,14,37,20,17,0,0,0,0,0,0
108,公立,一般大學,0001,國立政治大學,碩士班(日間),斯洛維尼亞共和國,歐洲,1,1,0,1,1,0,0,0,0,0,0,0,0,0,0
108,公立,一般大學,0001,國立政治大學,碩士班(日間),菲律賓共和國,東協,7,3,4,6,3,3,1,0,1,0,0,0,0,0,0
108,公立,一般大學,0001,國立政治大學,碩士班(日間),越南社會主義共和國,東協,13,2,11,12,2,10,1,0,1,0,0,0,0,0,0
108,公立,一般大學,0001,國立政治大學,碩士班(日間),愛爾蘭共和國,歐洲,3,2,1,3,2,1,0,0,0,0,0,0,0,0,0
108,公立,一般大學,0001,國立政治大學,碩士班(日間),瑞士聯邦,歐洲,1,1,0,1,1,0,0,0,0,0,0,0,0,0,0
108,公立,一般大學,0001,國立政治大學,碩士班(日間),聖文森(及格瑞那丁),中南美洲,1,1,0,1,1,0,0,0,0,0,0,0,0,0,0
108,公立,一般大學,0001,國立政治大學,碩士班(日間),寮人民民主共和國(寮國),東協,1,1,0,1,1,0,0,0,0,0,0,0,0,0,0
108,公立,一般大學,0001,國立政治大學,碩士班(日間),墨西哥合眾國,中南美洲,6,4,2,6,4,2,0,0,0,0,0,0,0,0,0
108,公立,一般大學,0001,國立政治大學,碩士班(日間),澳門,港澳,23,16,7,0,0,0,0,0,0,23,16,7,0,0,0
108,公立,一般大學,0001,國立政治大學,碩士班(日間),薩爾瓦多,中南美洲,2,1,1,2,1,1,0,0,0,0,0,0,0,0,0
108,公立,一般大學,0001,國立政治大學,碩士班(日間),羅馬尼亞,歐洲,1,0,1,1,0,1,0,0,0,0,0,0,0,0,0
108,公立,一般大學,0001,國立政治大學,博士班,土耳其共和國,其他亞洲地區,1,1,0,1,1,0,0,0,0,0,0,0,0,0,0
108,公立,一般大學,0001,國立政治大學,博士班,大陸地區,大陸地區,138,63,75,0,0,0,0,0,0,0,0,0,138,63,75
108,公立,一般大學,0001,國立政治大學,博士班,大韓民國(南韓),其他亞洲地區,12,6,6,12,6,6,0,0,0,0,0,0,0,0,0
108,公立,一般大學,0001,國立政治大學,博士班,巴基斯坦,南亞,4,4,0,4,4,0,0,0,0,0,0,0,0,0,0
108,公立,一般大學,0001,國立政治大學,博士班,比利時王國,歐洲,1,1,0,1,1,0,0,0,0,0,0,0,0,0,0
108,公立,一般大學,0001,國立政治大學,博士班,加拿大,北美洲,2,2,0,2,2,0,0,0,0,0,0,0,0,0,0
108,公立,一般大學,0001,國立政治大學,博士班,尼加拉瓜,中南美洲,2,1,1,2,1,1,0,0,0,0,0,0,0,0,0
108,公立,一般大學,0001,國立政治大學,博士班,白俄羅斯共和國,其他亞洲地區,1,1,0,1,1,0,0,0,0,0,0,0,0,0,0
108,公立,一般大學,0001,國立政治大學,博士班,印度,南亞,4,2,2,4,2,2,0,0,0,0,0,0,0,0,0
108,公立,一般大學,0001,國立政治大學,博士班,印度尼西亞共和國,東協,8,4,4,8,4,4,0,0,0,0,0,0,0,0,0
108,公立,一般大學,0001,國立政治大學,博士班,坦尚尼亞聯合共和國,非洲,1,1,0,1,1,0,0,0,0,0,0,0,0,0,0
108,公立,一般大學,0001,國立政治大學,博士班,孟加拉人民共和國,南亞,1,1,0,1,1,0,0,0,0,0,0,0,0,0,0
108,公立,一般大學,0001,國立政治大學,博士班,拉脫維亞共和國,歐洲,1,1,0,1,1,0,0,0,0,0,0,0,0,0,0
108,公立,一般大學,0001,國立政治大學,博士班,波蘭共和國,歐洲,5,2,3,5,2,3,0,0,0,0,0,0,0,0,0
108,公立,一般大學,0001,國立政治大學,博士班,法國,歐洲,1,0,1,1,0,1,0,0,0,0,0,0,0,0,0
108,公立,一般大學,0001,國立政治大學,博士班,南非共和國,非洲,1,0,1,0,0,0,1,0,1,0,0,0,0,0,0
108,公立,一般大學,0001,國立政治大學,博士班,香港,港澳,2,2,0,0,0,0,0,0,0,2,2,0,0,0,0
108,公立,一般大學,0001,國立政治大學,博士班,埃及阿拉伯共和國,非洲,1,0,1,1,0,1,0,0,0,0,0,0,0,0,0
108,公立,一般大學,0001,國立政治大學,博士班,烏克蘭,其他亞洲地區,1,0,1,1,0,1,0,0,0,0,0,0,0,0,0
108,公立,一般大學,0001,國立政治大學,博士班,紐西蘭,其他亞洲地區,1,1,0,1,1,0,0,0,0,0,0,0,0,0,0
108,公立,一般大學,0001,國立政治大學,博士班,斯洛伐克共和國,歐洲,1,1,0,1,1,0,0,0,0,0,0,0,0,0,0
108,公立,一般大學,0001,國立政治大學,博士班,越南社會主義共和國,東協,13,3,10,13,3,10,0,0,0,0,0,0,0,0,0
108,公立,一般大學,0001,國立政治大學,博士班,蒙古國,其他亞洲地區,2,0,2,2,0,2,0,0,0,0,0,0,0,0,0
108,公立,一般大學,0001,國立政治大學,博士班,巴西聯邦共和國,中南美洲,1,0,1,1,0,1,0,0,0,0,0,0,0,0,0
108,公立,一般大學,0001,國立政治大學,博士班,日本,其他亞洲地區,7,6,1,7,6,1,0,0,0,0,0,0,0,0,0
108,公立,一般大學,0001,國立政治大學,博士班,史瓦帝尼王國,非洲,1,1,0,1,1,0,0,0,0,0,0,0,0,0,0
108,公立,一般大學,0001,國立政治大學,博士班,布吉納法索,非洲,1,0,1,1,0,1,0,0,0,0,0,0,0,0,0
108,公立,一般大學,0001,國立政治大學,博士班,西班牙王國,歐洲,1,0,1,1,0,1,0,0,0,0,0,0,0,0,0
108,公立,一般大學,0001,國立政治大學,博士班,肯亞共和國,非洲,1,1,0,1,1,0,0,0,0,0,0,0,0,0,0
108,公立,一般大學,0001,國立政治大學,博士班,俄羅斯聯邦,其他亞洲地區,2,1,1,2,1,1,0,0,0,0,0,0,0,0,0
108,公立,一般大學,0001,國立政治大學,博士班,美國,北美洲,12,7,5,10,6,4,2,1,1,0,0,0,0,0,0
108,公立,一般大學,0001,國立政治大學,博士班,英國,歐洲,2,2,0,2,2,0,0,0,0,0,0,0,0,0,0
108,公立,一般大學,0001,國立政治大學,博士班,泰國,東協,5,4,1,5,4,1,0,0,0,0,0,0,0,0,0
108,公立,一般大學,0001,國立政治大學,博士班,馬來西亞,東協,13,6,7,4,1,3,9,5,4,0,0,0,0,0,0
108,公立,一般大學,0001,國立政治大學,博士班,捷克共和國,歐洲,1,0,1,1,0,1,0,0,0,0,0,0,0,0,0
108,公立,一般大學,0001,國立政治大學,博士班,菲律賓共和國,東協,3,2,1,3,2,1,0,0,0,0,0,0,0,0,0
108,公立,一般大學,0001,國立政治大學,博士班,新加坡共和國,東協,1,0,1,0,0,0,1,0,1,0,0,0,0,0,0
108,公立,一般大學,0001,國立政治大學,博士班,義大利共和國,歐洲,1,1,0,1,1,0,0,0,0,0,0,0,0,0,0
108,公立,一般大學,0001,國立政治大學,博士班,德意志聯邦共和國,歐洲,1,1,0,1,1,0,0,0,0,0,0,0,0,0,0
108,公立,一般大學,0001,國立政治大學,博士班,墨西哥合眾國,中南美洲,1,1,0,1,1,0,0,0,0,0,0,0,0,0,0
108,公立,一般大學,0001,國立政治大學,博士班,澳大利亞,其他亞洲地區,1,1,0,1,1,0,0,0,0,0,0,0,0,0,0
108,公立,一般大學,0001,國立政治大學,博士班,澳門,港澳,3,3,0,0,0,0,0,0,0,3,3,0,0,0,0
108,公立,一般大學,0002,國立清華大學,學士班(日間),大陸地區,大陸地區,21,10,11,0,0,0,0,0,0,0,0,0,21,10,11
108,公立,一般大學,0002,國立清華大學,學士班(日間),大韓民國(南韓),其他亞洲地區,20,9,11,20,9,11,0,0,0,0,0,0,0,0,0
108,公立,一般大學,0002,國立清華大學,學士班(日間),巴拉圭,中南美洲,2,1,1,1,0,1,1,1,0,0,0,0,0,0,0
108,公立,一般大學,0002,國立清華大學,學士班(日間),尼加拉瓜,中南美洲,1,1,0,1,1,0,0,0,0,0,0,0,0,0,0
108,公立,一般大學,0002,國立清華大學,學士班(日間),瓜地馬拉共和國,中南美洲,2,1,1,2,1,1,0,0,0,0,0,0,0,0,0
108,公立,一般大學,0002,國立清華大學,學士班(日間),印度,南亞,1,0,1,0,0,0,1,0,1,0,0,0,0,0,0
108,公立,一般大學,0002,國立清華大學,學士班(日間),印度尼西亞共和國,東協,78,48,30,48,31,17,30,17,13,0,0,0,0,0,0
108,公立,一般大學,0002,國立清華大學,學士班(日間),宏都拉斯共和國,中南美洲,4,4,0,4,4,0,0,0,0,0,0,0,0,0,0
108,公立,一般大學,0002,國立清華大學,學士班(日間),貝里斯,中南美洲,1,1,0,1,1,0,0,0,0,0,0,0,0,0,0
108,公立,一般大學,0002,國立清華大學,學士班(日間),委內瑞拉共和國,中南美洲,1,1,0,0,0,0,1,1,0,0,0,0,0,0,0
108,公立,一般大學,0002,國立清華大學,學士班(日間),波蘭共和國,歐洲,1,0,1,1,0,1,0,0,0,0,0,0,0,0,0
108,公立,一般大學,0002,國立清華大學,學士班(日間),阿根廷,中南美洲,1,1,0,0,0,0,1,1,0,0,0,0,0,0,0
108,公立,一般大學,0002,國立清華大學,學士班(日間),南非共和國,非洲,2,2,0,0,0,0,2,2,0,0,0,0,0,0,0
108,公立,一般大學,0002,國立清華大學,學士班(日間),香港,港澳,65,35,30,0,0,0,0,0,0,65,35,30,0,0,0
108,公立,一般大學,0002,國立清華大學,學士班(日間),哥斯大黎加共和國,中南美洲,1,0,1,0,0,0,1,0,1,0,0,0,0,0,0
108,公立,一般大學,0002,國立清華大學,學士班(日間),海地共和國,中南美洲,8,7,1,8,7,1,0,0,0,0,0,0,0,0,0
108,公立,一般大學,0002,國立清華大學,學士班(日間),智利,中南美洲,1,0,1,0,0,0,1,0,1,0,0,0,0,0,0
108,公立,一般大學,0002,國立清華大學,學士班(日間),越南社會主義共和國,東協,16,6,10,9,1,8,7,5,2,0,0,0,0,0,0
108,公立,一般大學,0002,國立清華大學,學士班(日間),聖文森(及格瑞那丁),中南美洲,1,1,0,1,1,0,0,0,0,0,0,0,0,0,0
108,公立,一般大學,0002,國立清華大學,學士班(日間),聖露西亞,中南美洲,2,0,2,2,0,2,0,0,0,0,0,0,0,0,0
108,公立,一般大學,0002,國立清華大學,學士班(日間),蒙古國,其他亞洲地區,5,4,1,5,4,1,0,0,0,0,0,0,0,0,0
108,公立,一般大學,0002,國立清華大學,學士班(日間),緬甸,東協,19,8,11,0,0,0,19,8,11,0,0,0,0,0,0
108,公立,一般大學,0002,國立清華大學,學士班(日間),墨西哥合眾國,中南美洲,1,1,0,0,0,0,1,1,0,0,0,0,0,0,0
108,公立,一般大學,0002,國立清華大學,學士班(日間),澳門,港澳,88,52,36,0,0,0,0,0,0,88,52,36,0,0,0
108,公立,一般大學,0002,國立清華大學,學士班(日間),巴西聯邦共和國,中南美洲,1,0,1,1,0,1,0,0,0,0,0,0,0,0,0
108,公立,一般大學,0002,國立清華大學,學士班(日間),巴基斯坦,南亞,1,0,1,1,0,1,0,0,0,0,0,0,0,0,0
108,公立,一般大學,0002,國立清華大學,學士班(日間),日本,其他亞洲地區,9,5,4,6,3,3,3,2,1,0,0,0,0,0,0
108,公立,一般大學,0002,國立清華大學,學士班(日間),史瓦帝尼王國,非洲,1,1,0,1,1,0,0,0,0,0,0,0,0,0,0
108,公立,一般大學,0002,國立清華大學,學士班(日間),尼泊爾聯邦民主共和國,南亞,1,1,0,1,1,0,0,0,0,0,0,0,0,0,0
108,公立,一般大學,0002,國立清華大學,學士班(日間),吉里巴斯共和國,其他亞洲地區,1,1,0,1,1,0,0,0,0,0,0,0,0,0,0
108,公立,一般大學,0002,國立清華大學,學士班(日間),西班牙王國,歐洲,2,1,1,0,0,0,2,1,1,0,0,0,0,0,0
108,公立,一般大學,0002,國立清華大學,學士班(日間),美國,北美洲,1,1,0,1,1,0,0,0,0,0,0,0,0,0,0
108,公立,一般大學,0002,國立清華大學,學士班(日間),泰國,東協,12,3,9,3,1,2,9,2,7,0,0,0,0,0,0
108,公立,一般大學,0002,國立清華大學,學士班(日間),烏克蘭,其他亞洲地區,1,0,1,1,0,1,0,0,0,0,0,0,0,0,0
108,公立,一般大學,0002,國立清華大學,學士班(日間),馬來西亞,東協,164,81,83,7,2,5,157,79,78,0,0,0,0,0,0
108,公立,一般大學,0002,國立清華大學,學士班(日間),菲律賓共和國,東協,3,1,2,0,0,0,3,1,2,0,0,0,0,0,0
108,公立,一般大學,0002,國立清華大學,學士班(日間),新加坡共和國,東協,2,1,1,1,0,1,1,1,0,0,0,0,0,0,0
108,公立,一般大學,0002,國立清華大學,學士班(日間),葡萄牙共和國,歐洲,1,1,0,1,1,0,0,0,0,0,0,0,0,0,0
108,公立,一般大學,0002,國立清華大學,碩士班(日間),日本,其他亞洲地區,1,1,0,1,1,0,0,0,0,0,0,0,0,0,0
108,公立,一般大學,0002,國立清華大學,碩士班(日間),史瓦帝尼王國,非洲,3,1,2,3,1,2,0,0,0,0,0,0,0,0,0
108,公立,一般大學,0002,國立清華大學,碩士班(日間),吉里巴斯共和國,其他亞洲地區,1,1,0,1,1,0,0,0,0,0,0,0,0,0,0
108,公立,一般大學,0002,國立清華大學,碩士班(日間),西班牙王國,歐洲,4,4,0,3,3,0,1,1,0,0,0,0,0,0,0
108,公立,一般大學,0002,國立清華大學,碩士班(日間),法國,歐洲,2,2,0,2,2,0,0,0,0,0,0,0,0,0,0
108,公立,一般大學,0002,國立清華大學,碩士班(日間),俄羅斯聯邦,其他亞洲地區,2,1,1,2,1,1,0,0,0,0,0,0,0,0,0
108,公立,一般大學,0002,國立清華大學,碩士班(日間),美國,北美洲,6,5,1,4,3,1,2,2,0,0,0,0,0,0,0
108,公立,一般大學,0002,國立清華大學,碩士班(日間),英國,歐洲,1,1,0,1,1,0,0,0,0,0,0,0,0,0,0
108,公立,一般大學,0002,國立清華大學,碩士班(日間),埃及阿拉伯共和國,非洲,2,2,0,2,2,0,0,0,0,0,0,0,0,0,0
108,公立,一般大學,0002,國立清華大學,碩士班(日間),泰國,東協,18,2,16,17,2,15,1,0,1,0,0,0,0,0,0
108,公立,一般大學,0002,國立清華大學,碩士班(日間),馬來西亞,東協,51,23,28,19,9,10,32,14,18,0,0,0,0,0,0
108,公立,一般大學,0002,國立清華大學,碩士班(日間),菲律賓共和國,東協,7,3,4,7,3,4,0,0,0,0,0,0,0,0,0
108,公立,一般大學,0002,國立清華大學,碩士班(日間),德意志聯邦共和國,歐洲,1,1,0,1,1,0,0,0,0,0,0,0,0,0,0
108,公立,一般大學,0002,國立清華大學,碩士班(日間),薩爾瓦多,中南美洲,2,2,0,2,2,0,0,0,0,0,0,0,0,0,0
108,公立,一般大學,0002,國立清華大學,碩士班(日間),土耳其共和國,其他亞洲地區,1,0,1,1,0,1,0,0,0,0,0,0,0,0,0
108,公立,一般大學,0002,國立清華大學,碩士班(日間),大陸地區,大陸地區,196,101,95,0,0,0,0,0,0,0,0,0,196,101,95
108,公立,一般大學,0002,國立清華大學,碩士班(日間),大韓民國(南韓),其他亞洲地區,5,3,2,5,3,2,0,0,0,0,0,0,0,0,0
108,公立,一般大學,0002,國立清華大學,碩士班(日間),巴拉圭,中南美洲,1,1,0,1,1,0,0,0,0,0,0,0,0,0,0
108,公立,一般大學,0002,國立清華大學,碩士班(日間),加拿大,北美洲,2,1,1,1,0,1,1,1,0,0,0,0,0,0,0
108,公立,一般大學,0002,國立清華大學,碩士班(日間),尼加拉瓜,中南美洲,3,2,1,3,2,1,0,0,0,0,0,0,0,0,0
108,公立,一般大學,0002,國立清華大學,碩士班(日間),瓜地馬拉共和國,中南美洲,4,2,2,4,2,2,0,0,0,0,0,0,0,0,0
108,公立,一般大學,0002,國立清華大學,碩士班(日間),印度,南亞,26,21,5,26,21,5,0,0,0,0,0,0,0,0,0
108,公立,一般大學,0002,國立清華大學,碩士班(日間),印度尼西亞共和國,東協,16,10,6,11,6,5,5,4,1,0,0,0,0,0,0
108,公立,一般大學,0002,國立清華大學,碩士班(日間),吐瓦魯,其他亞洲地區,1,1,0,1,1,0,0,0,0,0,0,0,0,0,0
108,公立,一般大學,0002,國立清華大學,碩士班(日間),多明尼加共和國,中南美洲,1,0,1,0,0,0,1,0,1,0,0,0,0,0,0
108,公立,一般大學,0002,國立清華大學,碩士班(日間),宏都拉斯共和國,中南美洲,9,6,3,9,6,3,0,0,0,0,0,0,0,0,0
108,公立,一般大學,0002,國立清華大學,碩士班(日間),貝里斯,中南美洲,5,2,3,5,2,3,0,0,0,0,0,0,0,0,0
108,公立,一般大學,0002,國立清華大學,碩士班(日間),坦尚尼亞聯合共和國,非洲,1,0,1,1,0,1,0,0,0,0,0,0,0,0,0
108,公立,一般大學,0002,國立清華大學,碩士班(日間),波蘭共和國,歐洲,1,0,1,1,0,1,0,0,0,0,0,0,0,0,0
108,公立,一般大學,0002,國立清華大學,碩士班(日間),南非共和國,非洲,2,0,2,0,0,0,2,0,2,0,0,0,0,0,0
108,公立,一般大學,0002,國立清華大學,碩士班(日間),香港,港澳,18,12,6,0,0,0,0,0,0,18,12,6,0,0,0
108,公立,一般大學,0002,國立清華大學,碩士班(日間),海地共和國,中南美洲,5,4,1,5,4,1,0,0,0,0,0,0,0,0,0
108,公立,一般大學,0002,國立清華大學,碩士班(日間),烏克蘭,其他亞洲地區,2,1,1,2,1,1,0,0,0,0,0,0,0,0,0
108,公立,一般大學,0002,國立清華大學,碩士班(日間),越南社會主義共和國,東協,38,13,25,35,12,23,3,1,2,0,0,0,0,0,0
108,公立,一般大學,0002,國立清華大學,碩士班(日間),新加坡共和國,東協,2,2,0,1,1,0,1,1,0,0,0,0,0,0,0
108,公立,一般大學,0002,國立清華大學,碩士班(日間),聖文森(及格瑞那丁),中南美洲,2,1,1,2,1,1,0,0,0,0,0,0,0,0,0
108,公立,一般大學,0002,國立清華大學,碩士班(日間),聖露西亞,中南美洲,3,1,2,3,1,2,0,0,0,0,0,0,0,0,0
108,公立,一般大學,0002,國立清華大學,碩士班(日間),蒙古國,其他亞洲地區,3,2,1,3,2,1,0,0,0,0,0,0,0,0,0
108,公立,一般大學,0002,國立清華大學,碩士班(日間),緬甸,東協,1,0,1,1,0,1,0,0,0,0,0,0,0,0,0
108,公立,一般大學,0002,國立清華大學,碩士班(日間),澳門,港澳,14,13,1,0,0,0,0,0,0,14,13,1,0,0,0
108,公立,一般大學,0002,國立清華大學,博士班,土耳其共和國,其他亞洲地區,1,1,0,1,1,0,0,0,0,0,0,0,0,0,0
108,公立,一般大學,0002,國立清華大學,博士班,大陸地區,大陸地區,89,47,42,0,0,0,0,0,0,0,0,0,89,47,42
108,公立,一般大學,0002,國立清華大學,博士班,大韓民國(南韓),其他亞洲地區,1,1,0,1,1,0,0,0,0,0,0,0,0,0,0
108,公立,一般大學,0002,國立清華大學,博士班,厄瓜多共和國,中南美洲,1,1,0,1,1,0,0,0,0,0,0,0,0,0,0
108,公立,一般大學,0002,國立清華大學,博士班,巴西聯邦共和國,中南美洲,1,1,0,1,1,0,0,0,0,0,0,0,0,0,0
108,公立,一般大學,0002,國立清華大學,博士班,巴基斯坦,南亞,12,9,3,12,9,3,0,0,0,0,0,0,0,0,0
108,公立,一般大學,0002,國立清華大學,博士班,瓜地馬拉共和國,中南美洲,1,0,1,1,0,1,0,0,0,0,0,0,0,0,0
108,公立,一般大學,0002,國立清華大學,博士班,甘比亞共和國,非洲,1,1,0,1,1,0,0,0,0,0,0,0,0,0,0
108,公立,一般大學,0002,國立清華大學,博士班,衣索比亞聯邦民主共和國,非洲,3,3,0,3,3,0,0,0,0,0,0,0,0,0,0
108,公立,一般大學,0002,國立清華大學,博士班,孟加拉人民共和國,南亞,1,1,0,1,1,0,0,0,0,0,0,0,0,0,0
108,公立,一般大學,0002,國立清華大學,博士班,哈薩克共和國,其他亞洲地區,1,1,0,1,1,0,0,0,0,0,0,0,0,0,0
108,公立,一般大學,0002,國立清華大學,博士班,美國,北美洲,10,8,2,9,7,2,1,1,0,0,0,0,0,0,0
108,公立,一般大學,0002,國立清華大學,博士班,埃及阿拉伯共和國,非洲,5,5,0,5,5,0,0,0,0,0,0,0,0,0,0
108,公立,一般大學,0002,國立清華大學,博士班,泰國,東協,6,3,3,6,3,3,0,0,0,0,0,0,0,0,0
108,公立,一般大學,0002,國立清華大學,博士班,海地共和國,中南美洲,1,1,0,1,1,0,0,0,0,0,0,0,0,0,0
108,公立,一般大學,0002,國立清華大學,博士班,塞爾維亞共和國,歐洲,1,1,0,1,1,0,0,0,0,0,0,0,0,0,0
108,公立,一般大學,0002,國立清華大學,博士班,德意志聯邦共和國,歐洲,3,2,1,3,2,1,0,0,0,0,0,0,0,0,0
108,公立,一般大學,0002,國立清華大學,博士班,墨西哥合眾國,中南美洲,1,1,0,1,1,0,0,0,0,0,0,0,0,0,0
108,公立,一般大學,0002,國立清華大學,博士班,以色列,其他亞洲地區,1,1,0,1,1,0,0,0,0,0,0,0,0,0,0
108,公立,一般大學,0002,國立清華大學,博士班,尼泊爾聯邦民主共和國,南亞,4,3,1,4,3,1,0,0,0,0,0,0,0,0,0
108,公立,一般大學,0002,國立清華大學,博士班,白俄羅斯共和國,其他亞洲地區,1,0,1,1,0,1,0,0,0,0,0,0,0,0,0
108,公立,一般大學,0002,國立清華大學,博士班,伊朗伊斯蘭共和國,其他亞洲地區,8,6,2,8,6,2,0,0,0,0,0,0,0,0,0
108,公立,一般大學,0002,國立清華大學,博士班,印度,南亞,181,139,42,181,139,42,0,0,0,0,0,0,0,0,0
108,公立,一般大學,0002,國立清華大學,博士班,印度尼西亞共和國,東協,11,6,5,11,6,5,0,0,0,0,0,0,0,0,0
108,公立,一般大學,0002,國立清華大學,博士班,宏都拉斯共和國,中南美洲,3,3,0,3,3,0,0,0,0,0,0,0,0,0,0
108,公立,一般大學,0002,國立清華大學,博士班,辛巴威共和國,非洲,1,0,1,1,0,1,0,0,0,0,0,0,0,0,0
108,公立,一般大學,0002,國立清華大學,博士班,波士尼亞與赫塞哥維納,歐洲,1,0,1,1,0,1,0,0,0,0,0,0,0,0,0
108,公立,一般大學,0002,國立清華大學,博士班,阿根廷,中南美洲,1,1,0,1,1,0,0,0,0,0,0,0,0,0,0
108,公立,一般大學,0002,國立清華大學,博士班,俄羅斯聯邦,其他亞洲地區,4,2,2,4,2,2,0,0,0,0,0,0,0,0,0
108,公立,一般大學,0002,國立清華大學,博士班,南非共和國,非洲,1,1,0,1,1,0,0,0,0,0,0,0,0,0,0
108,公立,一般大學,0002,國立清華大學,博士班,英國,歐洲,2,2,0,2,2,0,0,0,0,0,0,0,0,0,0
108,公立,一般大學,0002,國立清華大學,博士班,香港,港澳,5,3,2,0,0,0,0,0,0,5,3,2,0,0,0
108,公立,一般大學,0002,國立清華大學,博士班,秘魯共和國,中南美洲,1,1,0,1,1,0,0,0,0,0,0,0,0,0,0
108,公立,一般大學,0002,國立清華大學,博士班,馬來西亞,東協,13,6,7,6,2,4,7,4,3,0,0,0,0,0,0
108,公立,一般大學,0002,國立清華大學,博士班,捷克共和國,歐洲,2,1,1,2,1,1,0,0,0,0,0,0,0,0,0
108,公立,一般大學,0002,國立清華大學,博士班,喀麥隆共和國,非洲,1,1,0,1,1,0,0,0,0,0,0,0,0,0,0
108,公立,一般大學,0002,國立清華大學,博士班,菲律賓共和國,東協,10,10,0,10,10,0,0,0,0,0,0,0,0,0,0
108,公立,一般大學,0002,國立清華大學,博士班,越南社會主義共和國,東協,37,19,18,37,19,18,0,0,0,0,0,0,0,0,0
108,公立,一般大學,0002,國立清華大學,博士班,奧地利共和國,歐洲,1,0,1,1,0,1,0,0,0,0,0,0,0,0,0
108,公立,一般大學,0002,國立清華大學,博士班,新加坡共和國,東協,2,2,0,2,2,0,0,0,0,0,0,0,0,0,0
108,公立,一般大學,0002,國立清華大學,博士班,瑞士聯邦,歐洲,1,1,0,1,1,0,0,0,0,0,0,0,0,0,0
108,公立,一般大學,0002,國立清華大學,博士班,蒙古國,其他亞洲地區,1,0,1,1,0,1,0,0,0,0,0,0,0,0,0
108,公立,一般大學,0002,國立清華大學,博士班,澳門,港澳,3,1,2,0,0,0,0,0,0,3,1,2,0,0,0
108,公立,一般大學,0003,國立臺灣大學,學士班(日間),大韓民國(南韓),其他亞洲地區,103,43,60,91,37,54,12,6,6,0,0,0,0,0,0
108,公立,一般大學,0003,國立臺灣大學,學士班(日間),巴西聯邦共和國,中南美洲,3,1,2,0,0,0,3,1,2,0,0,0,0,0,0
108,公立,一般大學,0003,國立臺灣大學,學士班(日間),日本,其他亞洲地區,109,42,67,87,35,52,22,7,15,0,0,0,0,0,0
108,公立,一般大學,0003,國立臺灣大學,學士班(日間),加拿大,北美洲,17,9,8,0,0,0,17,9,8,0,0,0,0,0,0
108,公立,一般大學,0003,國立臺灣大學,學士班(日間),布吉納法索,非洲,1,1,0,1,1,0,0,0,0,0,0,0,0,0,0
108,公立,一般大學,0003,國立臺灣大學,學士班(日間),冰島共和國,歐洲,1,1,0,1,1,0,0,0,0,0,0,0,0,0,0
108,公立,一般大學,0003,國立臺灣大學,學士班(日間),印度尼西亞共和國,東協,240,123,117,68,33,35,172,90,82,0,0,0,0,0,0
108,公立,一般大學,0003,國立臺灣大學,學士班(日間),多明尼加共和國,中南美洲,1,1,0,0,0,0,1,1,0,0,0,0,0,0,0
108,公立,一般大學,0003,國立臺灣大學,學士班(日間),西班牙王國,歐洲,1,1,0,1,1,0,0,0,0,0,0,0,0,0,0
108,公立,一般大學,0003,國立臺灣大學,學士班(日間),汶萊和平之國,東協,2,0,2,0,0,0,2,0,2,0,0,0,0,0,0
108,公立,一般大學,0003,國立臺灣大學,學士班(日間),法國,歐洲,1,0,1,0,0,0,1,0,1,0,0,0,0,0,0
108,公立,一般大學,0003,國立臺灣大學,學士班(日間),俄羅斯聯邦,其他亞洲地區,3,3,0,3,3,0,0,0,0,0,0,0,0,0,0
108,公立,一般大學,0003,國立臺灣大學,學士班(日間),土耳其共和國,其他亞洲地區,2,2,0,2,2,0,0,0,0,0,0,0,0,0,0
108,公立,一般大學,0003,國立臺灣大學,學士班(日間),大陸地區,大陸地區,20,6,14,0,0,0,0,0,0,0,0,0,20,6,14
108,公立,一般大學,0003,國立臺灣大學,學士班(日間),巴拉圭,中南美洲,18,12,6,13,9,4,5,3,2,0,0,0,0,0,0
108,公立,一般大學,0003,國立臺灣大學,學士班(日間),巴拿馬共和國,中南美洲,10,5,5,10,5,5,0,0,0,0,0,0,0,0,0
108,公立,一般大學,0003,國立臺灣大學,學士班(日間),尼加拉瓜,中南美洲,2,1,1,1,1,0,1,0,1,0,0,0,0,0,0
108,公立,一般大學,0003,國立臺灣大學,學士班(日間),瓜地馬拉共和國,中南美洲,2,2,0,2,2,0,0,0,0,0,0,0,0,0,0
108,公立,一般大學,0003,國立臺灣大學,學士班(日間),白俄羅斯共和國,其他亞洲地區,1,1,0,1,1,0,0,0,0,0,0,0,0,0,0
108,公立,一般大學,0003,國立臺灣大學,學士班(日間),宏都拉斯共和國,中南美洲,12,8,4,11,7,4,1,1,0,0,0,0,0,0,0
108,公立,一般大學,0003,國立臺灣大學,學士班(日間),貝里斯,中南美洲,2,2,0,2,2,0,0,0,0,0,0,0,0,0,0
108,公立,一般大學,0003,國立臺灣大學,學士班(日間),帛琉共和國,其他亞洲地區,2,0,2,1,0,1,1,0,1,0,0,0,0,0,0
108,公立,一般大學,0003,國立臺灣大學,學士班(日間),阿根廷,中南美洲,1,0,1,1,0,1,0,0,0,0,0,0,0,0,0
108,公立,一般大學,0003,國立臺灣大學,學士班(日間),香港,港澳,166,90,76,0,0,0,0,0,0,166,90,76,0,0,0
108,公立,一般大學,0003,國立臺灣大學,學士班(日間),哥倫比亞共和國,中南美洲,1,0,1,0,0,0,1,0,1,0,0,0,0,0,0
108,公立,一般大學,0003,國立臺灣大學,學士班(日間),海地共和國,中南美洲,4,4,0,4,4,0,0,0,0,0,0,0,0,0,0
108,公立,一般大學,0003,國立臺灣大學,學士班(日間),馬紹爾群島共和國,其他亞洲地區,1,1,0,1,1,0,0,0,0,0,0,0,0,0,0
108,公立,一般大學,0003,國立臺灣大學,學士班(日間),智利,中南美洲,4,2,2,0,0,0,4,2,2,0,0,0,0,0,0
108,公立,一般大學,0003,國立臺灣大學,學士班(日間),越南社會主義共和國,東協,38,14,24,7,2,5,31,12,19,0,0,0,0,0,0
108,公立,一般大學,0003,國立臺灣大學,學士班(日間),新加坡共和國,東協,7,1,6,3,0,3,4,1,3,0,0,0,0,0,0
108,公立,一般大學,0003,國立臺灣大學,學士班(日間),聖露西亞,中南美洲,2,0,2,2,0,2,0,0,0,0,0,0,0,0,0
108,公立,一般大學,0003,國立臺灣大學,學士班(日間),葉門共和國,其他亞洲地區,1,0,1,0,0,0,1,0,1,0,0,0,0,0,0
108,公立,一般大學,0003,國立臺灣大學,學士班(日間),葡萄牙共和國,歐洲,1,1,0,1,1,0,0,0,0,0,0,0,0,0,0
108,公立,一般大學,0003,國立臺灣大學,學士班(日間),蒙古國,其他亞洲地區,5,1,4,5,1,4,0,0,0,0,0,0,0,0,0
108,公立,一般大學,0003,國立臺灣大學,學士班(日間),德意志聯邦共和國,歐洲,2,1,1,2,1,1,0,0,0,0,0,0,0,0,0
108,公立,一般大學,0003,國立臺灣大學,學士班(日間),緬甸,東協,15,6,9,0,0,0,15,6,9,0,0,0,0,0,0
108,公立,一般大學,0003,國立臺灣大學,學士班(日間),澳大利亞,其他亞洲地區,1,1,0,1,1,0,0,0,0,0,0,0,0,0,0
108,公立,一般大學,0003,國立臺灣大學,學士班(日間),澳門,港澳,215,127,88,0,0,0,0,0,0,215,127,88,0,0,0
108,公立,一般大學,0003,國立臺灣大學,學士班(日間),美國,北美洲,31,21,10,16,11,5,15,10,5,0,0,0,0,0,0
108,公立,一般大學,0003,國立臺灣大學,學士班(日間),英國,歐洲,4,2,2,4,2,2,0,0,0,0,0,0,0,0,0
108,公立,一般大學,0003,國立臺灣大學,學士班(日間),泰國,東協,37,15,22,10,5,5,27,10,17,0,0,0,0,0,0
108,公立,一般大學,0003,國立臺灣大學,學士班(日間),馬來西亞,東協,517,234,283,39,12,27,478,222,256,0,0,0,0,0,0
108,公立,一般大學,0003,國立臺灣大學,學士班(日間),菲律賓共和國,東協,8,5,3,2,1,1,6,4,2,0,0,0,0,0,0
108,公立,一般大學,0003,國立臺灣大學,學士班(日間),塔吉克共和國,其他亞洲地區,1,1,0,1,1,0,0,0,0,0,0,0,0,0,0
108,公立,一般大學,0003,國立臺灣大學,學士班(日間),義大利共和國,歐洲,1,0,1,0,0,0,1,0,1,0,0,0,0,0,0
108,公立,一般大學,0003,國立臺灣大學,學士班(日間),聖克里斯多福及尼維斯,中南美洲,1,0,1,1,0,1,0,0,0,0,0,0,0,0,0
108,公立,一般大學,0003,國立臺灣大學,學士班(日間),寮人民民主共和國(寮國),東協,2,1,1,0,0,0,2,1,1,0,0,0,0,0,0
108,公立,一般大學,0003,國立臺灣大學,學士班(日間),墨西哥合眾國,中南美洲,2,1,1,1,1,0,1,0,1,0,0,0,0,0,0
108,公立,一般大學,0003,國立臺灣大學,學士班(日間),薩爾瓦多,中南美洲,5,4,1,4,4,0,1,0,1,0,0,0,0,0,0
108,公立,一般大學,0003,國立臺灣大學,碩士班(日間),土耳其共和國,其他亞洲地區,1,1,0,1,1,0,0,0,0,0,0,0,0,0,0
108,公立,一般大學,0003,國立臺灣大學,碩士班(日間),大韓民國(南韓),其他亞洲地區,23,7,16,20,7,13,3,0,3,0,0,0,0,0,0
108,公立,一般大學,0003,國立臺灣大學,碩士班(日間),大陸地區,大陸地區,399,199,200,0,0,0,0,0,0,0,0,0,399,199,200
108,公立,一般大學,0003,國立臺灣大學,碩士班(日間),厄瓜多共和國,中南美洲,1,1,0,1,1,0,0,0,0,0,0,0,0,0,0
108,公立,一般大學,0003,國立臺灣大學,碩士班(日間),巴拉圭,中南美洲,3,1,2,1,1,0,2,0,2,0,0,0,0,0,0
108,公立,一般大學,0003,國立臺灣大學,碩士班(日間),日本,其他亞洲地區,33,15,18,30,14,16,3,1,2,0,0,0,0,0,0
108,公立,一般大學,0003,國立臺灣大學,碩士班(日間),比利時王國,歐洲,1,1,0,1,1,0,0,0,0,0,0,0,0,0,0
108,公立,一般大學,0003,國立臺灣大學,碩士班(日間),史瓦帝尼王國,非洲,1,0,1,1,0,1,0,0,0,0,0,0,0,0,0
108,公立,一般大學,0003,國立臺灣大學,碩士班(日間),尼加拉瓜,中南美洲,4,1,3,3,1,2,1,0,1,0,0,0,0,0,0
108,公立,一般大學,0003,國立臺灣大學,碩士班(日間),瓜地馬拉共和國,中南美洲,2,1,1,2,1,1,0,0,0,0,0,0,0,0,0
108,公立,一般大學,0003,國立臺灣大學,碩士班(日間),印度,南亞,25,13,12,25,13,12,0,0,0,0,0,0,0,0,0
108,公立,一般大學,0003,國立臺灣大學,碩士班(日間),西班牙王國,歐洲,2,2,0,2,2,0,0,0,0,0,0,0,0,0,0
108,公立,一般大學,0003,國立臺灣大學,碩士班(日間),宏都拉斯共和國,中南美洲,2,2,0,2,2,0,0,0,0,0,0,0,0,0,0
108,公立,一般大學,0003,國立臺灣大學,碩士班(日間),貝里斯,中南美洲,2,1,1,1,1,0,1,0,1,0,0,0,0,0,0
108,公立,一般大學,0003,國立臺灣大學,碩士班(日間),波蘭共和國,歐洲,1,1,0,1,1,0,0,0,0,0,0,0,0,0,0
108,公立,一般大學,0003,國立臺灣大學,碩士班(日間),南非共和國,非洲,1,1,0,1,1,0,0,0,0,0,0,0,0,0,0
108,公立,一般大學,0003,國立臺灣大學,碩士班(日間),迦納共和國,非洲,1,1,0,1,1,0,0,0,0,0,0,0,0,0,0
108,公立,一般大學,0003,國立臺灣大學,碩士班(日間),香港,港澳,57,27,30,0,0,0,0,0,0,57,27,30,0,0,0
108,公立,一般大學,0003,國立臺灣大學,碩士班(日間),加拿大,北美洲,8,7,1,4,3,1,4,4,0,0,0,0,0,0,0
108,公立,一般大學,0003,國立臺灣大學,碩士班(日間),尼泊爾聯邦民主共和國,南亞,2,2,0,2,2,0,0,0,0,0,0,0,0,0,0
108,公立,一般大學,0003,國立臺灣大學,碩士班(日間),布吉納法索,非洲,1,1,0,1,1,0,0,0,0,0,0,0,0,0,0
108,公立,一般大學,0003,國立臺灣大學,碩士班(日間),印度尼西亞共和國,東協,28,16,12,23,14,9,5,2,3,0,0,0,0,0,0
108,公立,一般大學,0003,國立臺灣大學,碩士班(日間),法國,歐洲,5,3,2,5,3,2,0,0,0,0,0,0,0,0,0
108,公立,一般大學,0003,國立臺灣大學,碩士班(日間),芬蘭共和國,歐洲,2,2,0,2,2,0,0,0,0,0,0,0,0,0,0
108,公立,一般大學,0003,國立臺灣大學,碩士班(日間),俄羅斯聯邦,其他亞洲地區,1,0,1,1,0,1,0,0,0,0,0,0,0,0,0
108,公立,一般大學,0003,國立臺灣大學,碩士班(日間),約旦哈什米王國,其他亞洲地區,1,1,0,1,1,0,0,0,0,0,0,0,0,0,0
108,公立,一般大學,0003,國立臺灣大學,碩士班(日間),美國,北美洲,54,32,22,49,29,20,5,3,2,0,0,0,0,0,0
108,公立,一般大學,0003,國立臺灣大學,碩士班(日間),英國,歐洲,5,4,1,5,4,1,0,0,0,0,0,0,0,0,0
108,公立,一般大學,0003,國立臺灣大學,碩士班(日間),泰國,東協,31,9,22,26,8,18,5,1,4,0,0,0,0,0,0
108,公立,一般大學,0003,國立臺灣大學,碩士班(日間),馬來西亞,東協,148,76,72,35,10,25,113,66,47,0,0,0,0,0,0
108,公立,一般大學,0003,國立臺灣大學,碩士班(日間),莫三比克共和國,非洲,2,1,1,2,1,1,0,0,0,0,0,0,0,0,0
108,公立,一般大學,0003,國立臺灣大學,碩士班(日間),荷蘭王國,歐洲,2,1,1,2,1,1,0,0,0,0,0,0,0,0,0
108,公立,一般大學,0003,國立臺灣大學,碩士班(日間),菲律賓共和國,東協,11,4,7,9,2,7,2,2,0,0,0,0,0,0,0
108,公立,一般大學,0003,國立臺灣大學,碩士班(日間),奧地利共和國,歐洲,3,2,1,3,2,1,0,0,0,0,0,0,0,0,0
108,公立,一般大學,0003,國立臺灣大學,碩士班(日間),義大利共和國,歐洲,2,2,0,2,2,0,0,0,0,0,0,0,0,0,0
108,公立,一般大學,0003,國立臺灣大學,碩士班(日間),蒙古國,其他亞洲地區,3,1,2,3,1,2,0,0,0,0,0,0,0,0,0
108,公立,一般大學,0003,國立臺灣大學,碩士班(日間),寮人民民主共和國(寮國),東協,1,0,1,0,0,0,1,0,1,0,0,0,0,0,0
108,公立,一般大學,0003,國立臺灣大學,碩士班(日間),墨西哥合眾國,中南美洲,2,2,0,2,2,0,0,0,0,0,0,0,0,0,0
108,公立,一般大學,0003,國立臺灣大學,碩士班(日間),澳大利亞,其他亞洲地區,3,2,1,1,1,0,2,1,1,0,0,0,0,0,0
108,公立,一般大學,0003,國立臺灣大學,碩士班(日間),賽普勒斯共和國,歐洲,2,1,1,0,0,0,2,1,1,0,0,0,0,0,0
108,公立,一般大學,0003,國立臺灣大學,碩士班(日間),薩爾瓦多,中南美洲,1,1,0,0,0,0,1,1,0,0,0,0,0,0,0
108,公立,一般大學,0003,國立臺灣大學,碩士班(日間),哥倫比亞共和國,中南美洲,6,5,1,6,5,1,0,0,0,0,0,0,0,0,0
108,公立,一般大學,0003,國立臺灣大學,碩士班(日間),海地共和國,中南美洲,4,2,2,4,2,2,0,0,0,0,0,0,0,0,0
108,公立,一般大學,0003,國立臺灣大學,碩士班(日間),紐西蘭,其他亞洲地區,1,1,0,0,0,0,1,1,0,0,0,0,0,0,0
108,公立,一般大學,0003,國立臺灣大學,碩士班(日間),越南社會主義共和國,東協,22,8,14,17,6,11,5,2,3,0,0,0,0,0,0
108,公立,一般大學,0003,國立臺灣大學,碩士班(日間),愛爾蘭共和國,歐洲,1,1,0,1,1,0,0,0,0,0,0,0,0,0,0
108,公立,一般大學,0003,國立臺灣大學,碩士班(日間),新加坡共和國,東協,7,2,5,7,2,5,0,0,0,0,0,0,0,0,0
108,公立,一般大學,0003,國立臺灣大學,碩士班(日間),瑞士聯邦,歐洲,2,1,1,2,1,1,0,0,0,0,0,0,0,0,0
108,公立,一般大學,0003,國立臺灣大學,碩士班(日間),瑞典王國,歐洲,1,0,1,1,0,1,0,0,0,0,0,0,0,0,0
108,公立,一般大學,0003,國立臺灣大學,碩士班(日間),葡萄牙共和國,歐洲,1,1,0,1,1,0,0,0,0,0,0,0,0,0,0
108,公立,一般大學,0003,國立臺灣大學,碩士班(日間),德意志聯邦共和國,歐洲,8,6,2,8,6,2,0,0,0,0,0,0,0,0,0
108,公立,一般大學,0003,國立臺灣大學,碩士班(日間),澳門,港澳,48,36,12,0,0,0,0,0,0,48,36,12,0,0,0
108,公立,一般大學,0003,國立臺灣大學,博士班,大陸地區,大陸地區,79,54,25,0,0,0,0,0,0,0,0,0,79,54,25
108,公立,一般大學,0003,國立臺灣大學,博士班,大韓民國(南韓),其他亞洲地區,7,3,4,6,2,4,1,1,0,0,0,0,0,0,0
108,公立,一般大學,0003,國立臺灣大學,博士班,厄瓜多共和國,中南美洲,1,1,0,1,1,0,0,0,0,0,0,0,0,0,0
108,公立,一般大學,0003,國立臺灣大學,博士班,巴基斯坦,南亞,7,5,2,7,5,2,0,0,0,0,0,0,0,0,0
108,公立,一般大學,0003,國立臺灣大學,博士班,日本,其他亞洲地區,11,8,3,11,8,3,0,0,0,0,0,0,0,0,0
108,公立,一般大學,0003,國立臺灣大學,博士班,加拿大,北美洲,5,5,0,1,1,0,4,4,0,0,0,0,0,0,0
108,公立,一般大學,0003,國立臺灣大學,博士班,尼泊爾聯邦民主共和國,南亞,2,1,1,2,1,1,0,0,0,0,0,0,0,0,0
108,公立,一般大學,0003,國立臺灣大學,博士班,伊朗伊斯蘭共和國,其他亞洲地區,3,3,0,3,3,0,0,0,0,0,0,0,0,0,0
108,公立,一般大學,0003,國立臺灣大學,博士班,印度,南亞,63,41,22,63,41,22,0,0,0,0,0,0,0,0,0
108,公立,一般大學,0003,國立臺灣大學,博士班,印度尼西亞共和國,東協,13,10,3,12,10,2,1,0,1,0,0,0,0,0,0
108,公立,一般大學,0003,國立臺灣大學,博士班,衣索比亞聯邦民主共和國,非洲,2,2,0,2,2,0,0,0,0,0,0,0,0,0,0
108,公立,一般大學,0003,國立臺灣大學,博士班,西班牙王國,歐洲,1,1,0,1,1,0,0,0,0,0,0,0,0,0,0
108,公立,一般大學,0003,國立臺灣大學,博士班,貝里斯,中南美洲,2,1,1,1,1,0,1,0,1,0,0,0,0,0,0
108,公立,一般大學,0003,國立臺灣大學,博士班,香港,港澳,11,9,2,0,0,0,0,0,0,11,9,2,0,0,0
108,公立,一般大學,0003,國立臺灣大學,博士班,哥倫比亞共和國,中南美洲,2,2,0,2,2,0,0,0,0,0,0,0,0,0,0
108,公立,一般大學,0003,國立臺灣大學,博士班,馬來西亞,東協,39,27,12,21,14,7,18,13,5,0,0,0,0,0,0
108,公立,一般大學,0003,國立臺灣大學,博士班,捷克共和國,歐洲,1,1,0,1,1,0,0,0,0,0,0,0,0,0,0
108,公立,一般大學,0003,國立臺灣大學,博士班,荷蘭王國,歐洲,2,2,0,2,2,0,0,0,0,0,0,0,0,0,0
108,公立,一般大學,0003,國立臺灣大學,博士班,斯里蘭卡民主社會主義共和國,南亞,1,1,0,1,1,0,0,0,0,0,0,0,0,0,0
108,公立,一般大學,0003,國立臺灣大學,博士班,土耳其共和國,其他亞洲地區,2,2,0,2,2,0,0,0,0,0,0,0,0,0,0
108,公立,一般大學,0003,國立臺灣大學,博士班,巴西聯邦共和國,中南美洲,1,0,1,1,0,1,0,0,0,0,0,0,0,0,0
108,公立,一般大學,0003,國立臺灣大學,博士班,比利時王國,歐洲,2,2,0,2,2,0,0,0,0,0,0,0,0,0,0
108,公立,一般大學,0003,國立臺灣大學,博士班,北馬其頓共和國,歐洲,1,0,1,1,0,1,0,0,0,0,0,0,0,0,0
108,公立,一般大學,0003,國立臺灣大學,博士班,史瓦帝尼王國,非洲,1,1,0,1,1,0,0,0,0,0,0,0,0,0,0
108,公立,一般大學,0003,國立臺灣大學,博士班,布吉納法索,非洲,1,1,0,1,1,0,0,0,0,0,0,0,0,0,0
108,公立,一般大學,0003,國立臺灣大學,博士班,瓜地馬拉共和國,中南美洲,2,2,0,2,2,0,0,0,0,0,0,0,0,0,0
108,公立,一般大學,0003,國立臺灣大學,博士班,克羅埃西亞共和國,歐洲,1,1,0,1,1,0,0,0,0,0,0,0,0,0,0
108,公立,一般大學,0003,國立臺灣大學,博士班,希臘共和國,歐洲,1,1,0,1,1,0,0,0,0,0,0,0,0,0,0
108,公立,一般大學,0003,國立臺灣大學,博士班,奈及利亞聯邦共和國,非洲,1,1,0,1,1,0,0,0,0,0,0,0,0,0,0
108,公立,一般大學,0003,國立臺灣大學,博士班,法國,歐洲,5,5,0,5,5,0,0,0,0,0,0,0,0,0,0
108,公立,一般大學,0003,國立臺灣大學,博士班,俄羅斯聯邦,其他亞洲地區,2,0,2,2,0,2,0,0,0,0,0,0,0,0,0
108,公立,一般大學,0003,國立臺灣大學,博士班,約旦哈什米王國,其他亞洲地區,1,1,0,1,1,0,0,0,0,0,0,0,0,0,0
108,公立,一般大學,0003,國立臺灣大學,博士班,美國,北美洲,11,9,2,11,9,2,0,0,0,0,0,0,0,0,0
108,公立,一般大學,0003,國立臺灣大學,博士班,埃及阿拉伯共和國,非洲,1,1,0,1,1,0,0,0,0,0,0,0,0,0,0
108,公立,一般大學,0003,國立臺灣大學,博士班,泰國,東協,12,8,4,12,8,4,0,0,0,0,0,0,0,0,0
108,公立,一般大學,0003,國立臺灣大學,博士班,海地共和國,中南美洲,1,1,0,1,1,0,0,0,0,0,0,0,0,0,0
108,公立,一般大學,0003,國立臺灣大學,博士班,紐西蘭,其他亞洲地區,2,2,0,0,0,0,2,2,0,0,0,0,0,0,0
108,公立,一般大學,0003,國立臺灣大學,博士班,斯洛伐克共和國,歐洲,1,1,0,1,1,0,0,0,0,0,0,0,0,0,0
108,公立,一般大學,0003,國立臺灣大學,博士班,斯洛維尼亞共和國,歐洲,1,0,1,1,0,1,0,0,0,0,0,0,0,0,0
108,公立,一般大學,0003,國立臺灣大學,博士班,菲律賓共和國,東協,7,5,2,7,5,2,0,0,0,0,0,0,0,0,0
108,公立,一般大學,0003,國立臺灣大學,博士班,越南社會主義共和國,東協,23,13,10,23,13,10,0,0,0,0,0,0,0,0,0
108,公立,一般大學,0003,國立臺灣大學,博士班,義大利共和國,歐洲,1,1,0,0,0,0,1,1,0,0,0,0,0,0,0
108,公立,一般大學,0003,國立臺灣大學,博士班,葉門共和國,其他亞洲地區,1,1,0,1,1,0,0,0,0,0,0,0,0,0,0
108,公立,一般大學,0003,國立臺灣大學,博士班,德意志聯邦共和國,歐洲,8,8,0,8,8,0,0,0,0,0,0,0,0,0,0
108,公立,一般大學,0003,國立臺灣大學,博士班,愛爾蘭共和國,歐洲,1,1,0,1,1,0,0,0,0,0,0,0,0,0,0
108,公立,一般大學,0003,國立臺灣大學,博士班,新加坡共和國,東協,2,2,0,2,2,0,0,0,0,0,0,0,0,0,0
108,公立,一般大學,0003,國立臺灣大學,博士班,瑞士聯邦,歐洲,1,1,0,1,1,0,0,0,0,0,0,0,0,0,0
108,公立,一般大學,0003,國立臺灣大學,博士班,蒙古國,其他亞洲地區,7,3,4,7,3,4,0,0,0,0,0,0,0,0,0
108,公立,一般大學,0003,國立臺灣大學,博士班,緬甸,東協,1,0,1,1,0,1,0,0,0,0,0,0,0,0,0
108,公立,一般大學,0003,國立臺灣大學,博士班,澳大利亞,其他亞洲地區,1,1,0,1,1,0,0,0,0,0,0,0,0,0,0
108,公立,一般大學,0003,國立臺灣大學,博士班,澳門,港澳,11,9,2,0,0,0,0,0,0,11,9,2,0,0,0
108,公立,一般大學,0004,國立臺灣師範大學,學士班(日間),土耳其共和國,其他亞洲地區,2,1,1,2,1,1,0,0,0,0,0,0,0,0,0
108,公立,一般大學,0004,國立臺灣師範大學,學士班(日間),大陸地區,大陸地區,19,5,14,0,0,0,0,0,0,0,0,0,19,5,14
108,公立,一般大學,0004,國立臺灣師範大學,學士班(日間),巴拉圭,中南美洲,4,3,1,2,1,1,2,2,0,0,0,0,0,0,0
108,公立,一般大學,0004,國立臺灣師範大學,學士班(日間),比利時王國,歐洲,1,1,0,1,1,0,0,0,0,0,0,0,0,0,0
108,公立,一般大學,0004,國立臺灣師範大學,學士班(日間),大韓民國(南韓),其他亞洲地區,50,23,27,44,21,23,6,2,4,0,0,0,0,0,0
108,公立,一般大學,0004,國立臺灣師範大學,學士班(日間),巴西聯邦共和國,中南美洲,1,0,1,0,0,0,1,0,1,0,0,0,0,0,0
108,公立,一般大學,0004,國立臺灣師範大學,學士班(日間),日本,其他亞洲地區,73,20,53,62,15,47,11,5,6,0,0,0,0,0,0
108,公立,一般大學,0004,國立臺灣師範大學,學士班(日間),印度,南亞,1,0,1,1,0,1,0,0,0,0,0,0,0,0,0
108,公立,一般大學,0004,國立臺灣師範大學,學士班(日間),宏都拉斯共和國,中南美洲,2,2,0,2,2,0,0,0,0,0,0,0,0,0,0
108,公立,一般大學,0004,國立臺灣師範大學,學士班(日間),法國,歐洲,4,1,3,4,1,3,0,0,0,0,0,0,0,0,0
108,公立,一般大學,0004,國立臺灣師範大學,學士班(日間),阿根廷,中南美洲,1,1,0,0,0,0,1,1,0,0,0,0,0,0,0
108,公立,一般大學,0004,國立臺灣師範大學,學士班(日間),美國,北美洲,17,7,10,14,6,8,3,1,2,0,0,0,0,0,0
108,公立,一般大學,0004,國立臺灣師範大學,學士班(日間),香港,港澳,94,44,50,0,0,0,0,0,0,94,44,50,0,0,0
108,公立,一般大學,0004,國立臺灣師範大學,學士班(日間),哥倫比亞共和國,中南美洲,1,0,1,1,0,1,0,0,0,0,0,0,0,0,0
108,公立,一般大學,0004,國立臺灣師範大學,學士班(日間),馬拉威共和國,非洲,1,1,0,1,1,0,0,0,0,0,0,0,0,0,0
108,公立,一般大學,0004,國立臺灣師範大學,學士班(日間),智利,中南美洲,1,1,0,0,0,0,1,1,0,0,0,0,0,0,0
108,公立,一般大學,0004,國立臺灣師範大學,學士班(日間),越南社會主義共和國,東協,76,12,64,52,9,43,24,3,21,0,0,0,0,0,0
108,公立,一般大學,0004,國立臺灣師範大學,學士班(日間),瑞士聯邦,歐洲,1,0,1,1,0,1,0,0,0,0,0,0,0,0,0
108,公立,一般大學,0004,國立臺灣師範大學,學士班(日間),瑞典王國,歐洲,2,1,1,2,1,1,0,0,0,0,0,0,0,0,0
108,公立,一般大學,0004,國立臺灣師範大學,學士班(日間),德意志聯邦共和國,歐洲,2,1,1,2,1,1,0,0,0,0,0,0,0,0,0
108,公立,一般大學,0004,國立臺灣師範大學,學士班(日間),緬甸,東協,60,14,46,1,0,1,59,14,45,0,0,0,0,0,0
108,公立,一般大學,0004,國立臺灣師範大學,學士班(日間),墨西哥合眾國,中南美洲,1,0,1,1,0,1,0,0,0,0,0,0,0,0,0
108,公立,一般大學,0004,國立臺灣師範大學,學士班(日間),澳大利亞,其他亞洲地區,2,2,0,2,2,0,0,0,0,0,0,0,0,0,0
108,公立,一般大學,0004,國立臺灣師範大學,學士班(日間),澳門,港澳,152,83,69,0,0,0,0,0,0,152,83,69,0,0,0
108,公立,一般大學,0004,國立臺灣師範大學,學士班(日間),加拿大,北美洲,3,1,2,1,0,1,2,1,1,0,0,0,0,0,0
108,公立,一般大學,0004,國立臺灣師範大學,學士班(日間),印度尼西亞共和國,東協,42,14,28,12,4,8,30,10,20,0,0,0,0,0,0
108,公立,一般大學,0004,國立臺灣師範大學,學士班(日間),西班牙王國,歐洲,1,0,1,1,0,1,0,0,0,0,0,0,0,0,0
108,公立,一般大學,0004,國立臺灣師範大學,學士班(日間),克羅埃西亞共和國,歐洲,1,1,0,1,1,0,0,0,0,0,0,0,0,0,0
108,公立,一般大學,0004,國立臺灣師範大學,學士班(日間),波蘭共和國,歐洲,2,0,2,2,0,2,0,0,0,0,0,0,0,0,0
108,公立,一般大學,0004,國立臺灣師範大學,學士班(日間),俄羅斯聯邦,其他亞洲地區,4,2,2,4,2,2,0,0,0,0,0,0,0,0,0
108,公立,一般大學,0004,國立臺灣師範大學,學士班(日間),南非共和國,非洲,1,1,0,1,1,0,0,0,0,0,0,0,0,0,0
108,公立,一般大學,0004,國立臺灣師範大學,學士班(日間),柬埔寨王國,東協,1,0,1,1,0,1,0,0,0,0,0,0,0,0,0
108,公立,一般大學,0004,國立臺灣師範大學,學士班(日間),英國,歐洲,1,1,0,1,1,0,0,0,0,0,0,0,0,0,0
108,公立,一般大學,0004,國立臺灣師範大學,學士班(日間),泰國,東協,23,7,16,11,4,7,12,3,9,0,0,0,0,0,0
108,公立,一般大學,0004,國立臺灣師範大學,學士班(日間),烏克蘭,其他亞洲地區,1,0,1,1,0,1,0,0,0,0,0,0,0,0,0
108,公立,一般大學,0004,國立臺灣師範大學,學士班(日間),秘魯共和國,中南美洲,1,1,0,1,1,0,0,0,0,0,0,0,0,0,0
108,公立,一般大學,0004,國立臺灣師範大學,學士班(日間),馬來西亞,東協,195,72,123,14,7,7,181,65,116,0,0,0,0,0,0
108,公立,一般大學,0004,國立臺灣師範大學,學士班(日間),菲律賓共和國,東協,3,0,3,2,0,2,1,0,1,0,0,0,0,0,0
108,公立,一般大學,0004,國立臺灣師範大學,學士班(日間),新加坡共和國,東協,2,0,2,1,0,1,1,0,1,0,0,0,0,0,0
108,公立,一般大學,0004,國立臺灣師範大學,學士班(日間),義大利共和國,歐洲,1,1,0,1,1,0,0,0,0,0,0,0,0,0,0
108,公立,一般大學,0004,國立臺灣師範大學,學士班(日間),聖克里斯多福及尼維斯,中南美洲,1,0,1,1,0,1,0,0,0,0,0,0,0,0,0
108,公立,一般大學,0004,國立臺灣師範大學,學士班(日間),葡萄牙共和國,歐洲,2,0,2,2,0,2,0,0,0,0,0,0,0,0,0
108,公立,一般大學,0004,國立臺灣師範大學,學士班(日間),薩爾瓦多,中南美洲,1,1,0,1,1,0,0,0,0,0,0,0,0,0,0
108,公立,一般大學,0004,國立臺灣師範大學,碩士班(日間),大韓民國(南韓),其他亞洲地區,18,4,14,17,4,13,1,0,1,0,0,0,0,0,0
108,公立,一般大學,0004,國立臺灣師範大學,碩士班(日間),厄瓜多共和國,中南美洲,2,0,2,2,0,2,0,0,0,0,0,0,0,0,0
108,公立,一般大學,0004,國立臺灣師範大學,碩士班(日間),巴西聯邦共和國,中南美洲,2,1,1,1,1,0,1,0,1,0,0,0,0,0,0
108,公立,一般大學,0004,國立臺灣師範大學,碩士班(日間),日本,其他亞洲地區,17,8,9,17,8,9,0,0,0,0,0,0,0,0,0
108,公立,一般大學,0004,國立臺灣師範大學,碩士班(日間),加拿大,北美洲,1,1,0,1,1,0,0,0,0,0,0,0,0,0,0
108,公立,一般大學,0004,國立臺灣師範大學,碩士班(日間),印度尼西亞共和國,東協,14,5,9,11,5,6,3,0,3,0,0,0,0,0,0
108,公立,一般大學,0004,國立臺灣師範大學,碩士班(日間),西班牙王國,歐洲,1,1,0,1,1,0,0,0,0,0,0,0,0,0,0
108,公立,一般大學,0004,國立臺灣師範大學,碩士班(日間),汶萊和平之國,東協,1,1,0,0,0,0,1,1,0,0,0,0,0,0,0
108,公立,一般大學,0004,國立臺灣師範大學,碩士班(日間),波蘭共和國,歐洲,3,2,1,3,2,1,0,0,0,0,0,0,0,0,0
108,公立,一般大學,0004,國立臺灣師範大學,碩士班(日間),阿爾巴尼亞共和國,歐洲,1,0,1,1,0,1,0,0,0,0,0,0,0,0,0
108,公立,一般大學,0004,國立臺灣師範大學,碩士班(日間),俄羅斯聯邦,其他亞洲地區,7,1,6,7,1,6,0,0,0,0,0,0,0,0,0
108,公立,一般大學,0004,國立臺灣師範大學,碩士班(日間),南非共和國,非洲,1,1,0,0,0,0,1,1,0,0,0,0,0,0,0
108,公立,一般大學,0004,國立臺灣師範大學,碩士班(日間),英國,歐洲,2,2,0,2,2,0,0,0,0,0,0,0,0,0,0
108,公立,一般大學,0004,國立臺灣師範大學,碩士班(日間),泰國,東協,15,8,7,13,6,7,2,2,0,0,0,0,0,0,0
108,公立,一般大學,0004,國立臺灣師範大學,碩士班(日間),烏克蘭,其他亞洲地區,1,1,0,1,1,0,0,0,0,0,0,0,0,0,0
108,公立,一般大學,0004,國立臺灣師範大學,碩士班(日間),秘魯共和國,中南美洲,1,1,0,1,1,0,0,0,0,0,0,0,0,0,0
108,公立,一般大學,0004,國立臺灣師範大學,碩士班(日間),馬來西亞,東協,64,18,46,26,7,19,38,11,27,0,0,0,0,0,0
108,公立,一般大學,0004,國立臺灣師範大學,碩士班(日間),荷蘭王國,歐洲,1,1,0,1,1,0,0,0,0,0,0,0,0,0,0
108,公立,一般大學,0004,國立臺灣師範大學,碩士班(日間),菲律賓共和國,東協,8,4,4,7,4,3,1,0,1,0,0,0,0,0,0
108,公立,一般大學,0004,國立臺灣師範大學,碩士班(日間),義大利共和國,歐洲,1,0,1,1,0,1,0,0,0,0,0,0,0,0,0
108,公立,一般大學,0004,國立臺灣師範大學,碩士班(日間),聖文森(及格瑞那丁),中南美洲,1,0,1,1,0,1,0,0,0,0,0,0,0,0,0
108,公立,一般大學,0004,國立臺灣師範大學,碩士班(日間),蒙古國,其他亞洲地區,1,0,1,1,0,1,0,0,0,0,0,0,0,0,0
108,公立,一般大學,0004,國立臺灣師範大學,碩士班(日間),土耳其共和國,其他亞洲地區,3,1,2,3,1,2,0,0,0,0,0,0,0,0,0
108,公立,一般大學,0004,國立臺灣師範大學,碩士班(日間),大陸地區,大陸地區,104,29,75,0,0,0,0,0,0,0,0,0,104,29,75
108,公立,一般大學,0004,國立臺灣師範大學,碩士班(日間),丹麥王國,歐洲,1,0,1,1,0,1,0,0,0,0,0,0,0,0,0
108,公立,一般大學,0004,國立臺灣師範大學,碩士班(日間),比利時王國,歐洲,1,0,1,1,0,1,0,0,0,0,0,0,0,0,0
108,公立,一般大學,0004,國立臺灣師範大學,碩士班(日間),史瓦帝尼王國,非洲,1,0,1,1,0,1,0,0,0,0,0,0,0,0,0
108,公立,一般大學,0004,國立臺灣師範大學,碩士班(日間),瓜地馬拉共和國,中南美洲,2,0,2,2,0,2,0,0,0,0,0,0,0,0,0
108,公立,一般大學,0004,國立臺灣師範大學,碩士班(日間),印度,南亞,4,2,2,4,2,2,0,0,0,0,0,0,0,0,0
108,公立,一般大學,0004,國立臺灣師範大學,碩士班(日間),宏都拉斯共和國,中南美洲,2,1,1,2,1,1,0,0,0,0,0,0,0,0,0
108,公立,一般大學,0004,國立臺灣師範大學,碩士班(日間),貝里斯,中南美洲,3,0,3,3,0,3,0,0,0,0,0,0,0,0,0
108,公立,一般大學,0004,國立臺灣師範大學,碩士班(日間),美國,北美洲,25,15,10,22,15,7,3,0,3,0,0,0,0,0,0
108,公立,一般大學,0004,國立臺灣師範大學,碩士班(日間),香港,港澳,44,29,15,0,0,0,0,0,0,44,29,15,0,0,0
108,公立,一般大學,0004,國立臺灣師範大學,碩士班(日間),越南社會主義共和國,東協,40,9,31,37,8,29,3,1,2,0,0,0,0,0,0
108,公立,一般大學,0004,國立臺灣師範大學,碩士班(日間),愛爾蘭共和國,歐洲,1,1,0,1,1,0,0,0,0,0,0,0,0,0,0
108,公立,一般大學,0004,國立臺灣師範大學,碩士班(日間),新加坡共和國,東協,1,0,1,0,0,0,1,0,1,0,0,0,0,0,0
108,公立,一般大學,0004,國立臺灣師範大學,碩士班(日間),瑞典王國,歐洲,1,1,0,1,1,0,0,0,0,0,0,0,0,0,0
108,公立,一般大學,0004,國立臺灣師範大學,碩士班(日間),德意志聯邦共和國,歐洲,6,5,1,6,5,1,0,0,0,0,0,0,0,0,0
108,公立,一般大學,0004,國立臺灣師範大學,碩士班(日間),緬甸,東協,5,0,5,1,0,1,4,0,4,0,0,0,0,0,0
108,公立,一般大學,0004,國立臺灣師範大學,碩士班(日間),墨西哥合眾國,中南美洲,1,1,0,1,1,0,0,0,0,0,0,0,0,0,0
108,公立,一般大學,0004,國立臺灣師範大學,碩士班(日間),澳門,港澳,29,16,13,0,0,0,0,0,0,29,16,13,0,0,0
108,公立,一般大學,0004,國立臺灣師範大學,博士班,大陸地區,大陸地區,59,16,43,0,0,0,0,0,0,0,0,0,59,16,43
108,公立,一般大學,0004,國立臺灣師範大學,博士班,大韓民國(南韓),其他亞洲地區,8,3,5,8,3,5,0,0,0,0,0,0,0,0,0
108,公立,一般大學,0004,國立臺灣師範大學,博士班,丹麥王國,歐洲,2,1,1,2,1,1,0,0,0,0,0,0,0,0,0
108,公立,一般大學,0004,國立臺灣師範大學,博士班,巴基斯坦,南亞,1,1,0,1,1,0,0,0,0,0,0,0,0,0,0
108,公立,一般大學,0004,國立臺灣師範大學,博士班,日本,其他亞洲地區,5,2,3,5,2,3,0,0,0,0,0,0,0,0,0
108,公立,一般大學,0004,國立臺灣師範大學,博士班,加拿大,北美洲,2,1,1,1,1,0,1,0,1,0,0,0,0,0,0
108,公立,一般大學,0004,國立臺灣師範大學,博士班,印度,南亞,10,8,2,10,8,2,0,0,0,0,0,0,0,0,0
108,公立,一般大學,0004,國立臺灣師範大學,博士班,印度尼西亞共和國,東協,12,5,7,12,5,7,0,0,0,0,0,0,0,0,0
108,公立,一般大學,0004,國立臺灣師範大學,博士班,衣索比亞聯邦民主共和國,非洲,1,1,0,1,1,0,0,0,0,0,0,0,0,0,0
108,公立,一般大學,0004,國立臺灣師範大學,博士班,西班牙王國,歐洲,2,2,0,2,2,0,0,0,0,0,0,0,0,0,0
108,公立,一般大學,0004,國立臺灣師範大學,博士班,肯亞共和國,非洲,1,0,1,1,0,1,0,0,0,0,0,0,0,0,0
108,公立,一般大學,0004,國立臺灣師範大學,博士班,南非共和國,非洲,5,5,0,2,2,0,3,3,0,0,0,0,0,0,0
108,公立,一般大學,0004,國立臺灣師範大學,博士班,英國,歐洲,2,2,0,2,2,0,0,0,0,0,0,0,0,0,0
108,公立,一般大學,0004,國立臺灣師範大學,博士班,香港,港澳,4,2,2,0,0,0,0,0,0,4,2,2,0,0,0
108,公立,一般大學,0004,國立臺灣師範大學,博士班,秘魯共和國,中南美洲,1,0,1,1,0,1,0,0,0,0,0,0,0,0,0
108,公立,一般大學,0004,國立臺灣師範大學,博士班,馬來西亞,東協,13,5,8,10,3,7,3,2,1,0,0,0,0,0,0
108,公立,一般大學,0004,國立臺灣師範大學,博士班,荷蘭王國,歐洲,2,0,2,2,0,2,0,0,0,0,0,0,0,0,0
108,公立,一般大學,0004,國立臺灣師範大學,博士班,越南社會主義共和國,東協,18,7,11,18,7,11,0,0,0,0,0,0,0,0,0
108,公立,一般大學,0004,國立臺灣師範大學,博士班,新加坡共和國,東協,1,0,1,1,0,1,0,0,0,0,0,0,0,0,0
108,公立,一般大學,0004,國立臺灣師範大學,博士班,薩爾瓦多,中南美洲,1,1,0,1,1,0,0,0,0,0,0,0,0,0,0
108,公立,一般大學,0004,國立臺灣師範大學,博士班,巴西聯邦共和國,中南美洲,1,0,1,0,0,0,1,0,1,0,0,0,0,0,0
108,公立,一般大學,0004,國立臺灣師範大學,博士班,比利時王國,歐洲,1,1,0,1,1,0,0,0,0,0,0,0,0,0,0
108,公立,一般大學,0004,國立臺灣師範大學,博士班,甘比亞共和國,非洲,1,1,0,1,1,0,0,0,0,0,0,0,0,0,0
108,公立,一般大學,0004,國立臺灣師範大學,博士班,法國,歐洲,6,4,2,6,4,2,0,0,0,0,0,0,0,0,0
108,公立,一般大學,0004,國立臺灣師範大學,博士班,俄羅斯聯邦,其他亞洲地區,4,1,3,4,1,3,0,0,0,0,0,0,0,0,0
108,公立,一般大學,0004,國立臺灣師範大學,博士班,美國,北美洲,5,5,0,5,5,0,0,0,0,0,0,0,0,0,0
108,公立,一般大學,0004,國立臺灣師範大學,博士班,泰國,東協,3,2,1,3,2,1,0,0,0,0,0,0,0,0,0
108,公立,一般大學,0004,國立臺灣師範大學,博士班,菲律賓共和國,東協,11,7,4,11,7,4,0,0,0,0,0,0,0,0,0
108,公立,一般大學,0004,國立臺灣師範大學,博士班,義大利共和國,歐洲,2,1,1,2,1,1,0,0,0,0,0,0,0,0,0
108,公立,一般大學,0004,國立臺灣師範大學,博士班,羅馬尼亞,歐洲,1,0,1,1,0,1,0,0,0,0,0,0,0,0,0
108,公立,一般大學,0005,國立成功大學,學士班(日間),大韓民國(南韓),其他亞洲地區,11,8,3,9,6,3,2,2,0,0,0,0,0,0,0
108,公立,一般大學,0005,國立成功大學,學士班(日間),巴西聯邦共和國,中南美洲,1,1,0,0,0,0,1,1,0,0,0,0,0,0,0
108,公立,一般大學,0005,國立成功大學,學士班(日間),巴拉圭,中南美洲,14,7,7,12,6,6,2,1,1,0,0,0,0,0,0
108,公立,一般大學,0005,國立成功大學,學士班(日間),加拿大,北美洲,2,2,0,0,0,0,2,2,0,0,0,0,0,0,0
108,公立,一般大學,0005,國立成功大學,學士班(日間),尼加拉瓜,中南美洲,8,6,2,8,6,2,0,0,0,0,0,0,0,0,0
108,公立,一般大學,0005,國立成功大學,學士班(日間),布吉納法索,非洲,1,1,0,1,1,0,0,0,0,0,0,0,0,0,0
108,公立,一般大學,0005,國立成功大學,學士班(日間),瓜地馬拉共和國,中南美洲,1,1,0,1,1,0,0,0,0,0,0,0,0,0,0
108,公立,一般大學,0005,國立成功大學,學士班(日間),多明尼加共和國,中南美洲,2,1,1,0,0,0,2,1,1,0,0,0,0,0,0
108,公立,一般大學,0005,國立成功大學,學士班(日間),法國,歐洲,1,1,0,1,1,0,0,0,0,0,0,0,0,0,0
108,公立,一般大學,0005,國立成功大學,學士班(日間),俄羅斯聯邦,其他亞洲地區,1,0,1,1,0,1,0,0,0,0,0,0,0,0,0
108,公立,一般大學,0005,國立成功大學,學士班(日間),南非共和國,非洲,9,6,3,2,1,1,7,5,2,0,0,0,0,0,0
108,公立,一般大學,0005,國立成功大學,學士班(日間),大陸地區,大陸地區,16,6,10,0,0,0,0,0,0,0,0,0,16,6,10
108,公立,一般大學,0005,國立成功大學,學士班(日間),厄瓜多共和國,中南美洲,2,1,1,0,0,0,2,1,1,0,0,0,0,0,0
108,公立,一般大學,0005,國立成功大學,學士班(日間),巴拿馬共和國,中南美洲,1,1,0,1,1,0,0,0,0,0,0,0,0,0,0
108,公立,一般大學,0005,國立成功大學,學士班(日間),日本,其他亞洲地區,30,15,15,23,10,13,7,5,2,0,0,0,0,0,0
108,公立,一般大學,0005,國立成功大學,學士班(日間),比利時王國,歐洲,1,1,0,1,1,0,0,0,0,0,0,0,0,0,0
108,公立,一般大學,0005,國立成功大學,學士班(日間),玻利維亞共和國,中南美洲,1,0,1,0,0,0,1,0,1,0,0,0,0,0,0
108,公立,一般大學,0005,國立成功大學,學士班(日間),美國,北美洲,5,1,4,3,0,3,2,1,1,0,0,0,0,0,0
108,公立,一般大學,0005,國立成功大學,學士班(日間),英國,歐洲,1,0,1,1,0,1,0,0,0,0,0,0,0,0,0
108,公立,一般大學,0005,國立成功大學,學士班(日間),泰國,東協,17,11,6,4,1,3,13,10,3,0,0,0,0,0,0
108,公立,一般大學,0005,國立成功大學,學士班(日間),索羅門群島,其他亞洲地區,3,3,0,3,3,0,0,0,0,0,0,0,0,0,0
108,公立,一般大學,0005,國立成功大學,學士班(日間),紐西蘭,其他亞洲地區,1,1,0,0,0,0,1,1,0,0,0,0,0,0,0
108,公立,一般大學,0005,國立成功大學,學士班(日間),馬來西亞,東協,346,206,140,83,51,32,263,155,108,0,0,0,0,0,0
108,公立,一般大學,0005,國立成功大學,學士班(日間),馬紹爾群島共和國,其他亞洲地區,1,0,1,1,0,1,0,0,0,0,0,0,0,0,0
108,公立,一般大學,0005,國立成功大學,學士班(日間),菲律賓共和國,東協,5,3,2,1,1,0,4,2,2,0,0,0,0,0,0
108,公立,一般大學,0005,國立成功大學,學士班(日間),越南社會主義共和國,東協,29,16,13,15,8,7,14,8,6,0,0,0,0,0,0
108,公立,一般大學,0005,國立成功大學,學士班(日間),塞爾維亞共和國,歐洲,2,1,1,2,1,1,0,0,0,0,0,0,0,0,0
108,公立,一般大學,0005,國立成功大學,學士班(日間),瑞士聯邦,歐洲,1,0,1,1,0,1,0,0,0,0,0,0,0,0,0
108,公立,一般大學,0005,國立成功大學,學士班(日間),聖文森(及格瑞那丁),中南美洲,1,0,1,1,0,1,0,0,0,0,0,0,0,0,0
108,公立,一般大學,0005,國立成功大學,學士班(日間),聖克里斯多福及尼維斯,中南美洲,2,2,0,2,2,0,0,0,0,0,0,0,0,0,0
108,公立,一般大學,0005,國立成功大學,學士班(日間),聖露西亞,中南美洲,5,2,3,5,2,3,0,0,0,0,0,0,0,0,0
108,公立,一般大學,0005,國立成功大學,學士班(日間),蒙古國,其他亞洲地區,11,7,4,11,7,4,0,0,0,0,0,0,0,0,0
108,公立,一般大學,0005,國立成功大學,學士班(日間),澳大利亞,其他亞洲地區,1,1,0,1,1,0,0,0,0,0,0,0,0,0,0
108,公立,一般大學,0005,國立成功大學,學士班(日間),薩爾瓦多,中南美洲,5,3,2,5,3,2,0,0,0,0,0,0,0,0,0
108,公立,一般大學,0005,國立成功大學,學士班(日間),史瓦帝尼王國,非洲,5,1,4,5,1,4,0,0,0,0,0,0,0,0,0
108,公立,一般大學,0005,國立成功大學,學士班(日間),印度,南亞,2,1,1,2,1,1,0,0,0,0,0,0,0,0,0
108,公立,一般大學,0005,國立成功大學,學士班(日間),印度尼西亞共和國,東協,92,52,40,16,6,10,76,46,30,0,0,0,0,0,0
108,公立,一般大學,0005,國立成功大學,學士班(日間),西班牙王國,歐洲,1,1,0,0,0,0,1,1,0,0,0,0,0,0,0
108,公立,一般大學,0005,國立成功大學,學士班(日間),宏都拉斯共和國,中南美洲,8,8,0,8,8,0,0,0,0,0,0,0,0,0,0
108,公立,一般大學,0005,國立成功大學,學士班(日間),貝里斯,中南美洲,7,6,1,7,6,1,0,0,0,0,0,0,0,0,0
108,公立,一般大學,0005,國立成功大學,學士班(日間),哈薩克共和國,其他亞洲地區,1,1,0,1,1,0,0,0,0,0,0,0,0,0,0
108,公立,一般大學,0005,國立成功大學,學士班(日間),約旦哈什米王國,其他亞洲地區,1,1,0,1,1,0,0,0,0,0,0,0,0,0,0
108,公立,一般大學,0005,國立成功大學,學士班(日間),迦納共和國,非洲,1,1,0,1,1,0,0,0,0,0,0,0,0,0,0
108,公立,一般大學,0005,國立成功大學,學士班(日間),香港,港澳,88,52,36,0,0,0,0,0,0,88,52,36,0,0,0
108,公立,一般大學,0005,國立成功大學,學士班(日間),海地共和國,中南美洲,4,4,0,4,4,0,0,0,0,0,0,0,0,0,0
108,公立,一般大學,0005,國立成功大學,學士班(日間),新加坡共和國,東協,2,1,1,1,1,0,1,0,1,0,0,0,0,0,0
108,公立,一般大學,0005,國立成功大學,學士班(日間),緬甸,東協,20,8,12,0,0,0,20,8,12,0,0,0,0,0,0
108,公立,一般大學,0005,國立成功大學,學士班(日間),墨西哥合眾國,中南美洲,1,1,0,1,1,0,0,0,0,0,0,0,0,0,0
108,公立,一般大學,0005,國立成功大學,學士班(日間),澳門,港澳,111,84,27,0,0,0,0,0,0,111,84,27,0,0,0
108,公立,一般大學,0005,國立成功大學,學士班(日間),諾魯共和國,其他亞洲地區,1,1,0,1,1,0,0,0,0,0,0,0,0,0,0
108,公立,一般大學,0005,國立成功大學,碩士班(日間),大韓民國(南韓),其他亞洲地區,6,4,2,5,3,2,1,1,0,0,0,0,0,0,0
108,公立,一般大學,0005,國立成功大學,碩士班(日間),巴基斯坦,南亞,6,4,2,6,4,2,0,0,0,0,0,0,0,0,0
108,公立,一般大學,0005,國立成功大學,碩士班(日間),尼加拉瓜,中南美洲,5,4,1,5,4,1,0,0,0,0,0,0,0,0,0
108,公立,一般大學,0005,國立成功大學,碩士班(日間),尼泊爾聯邦民主共和國,南亞,2,1,1,2,1,1,0,0,0,0,0,0,0,0,0
108,公立,一般大學,0005,國立成功大學,碩士班(日間),瓜地馬拉共和國,中南美洲,2,1,1,2,1,1,0,0,0,0,0,0,0,0,0
108,公立,一般大學,0005,國立成功大學,碩士班(日間),大陸地區,大陸地區,127,57,70,0,0,0,0,0,0,0,0,0,127,57,70
108,公立,一般大學,0005,國立成功大學,碩士班(日間),厄瓜多共和國,中南美洲,1,0,1,1,0,1,0,0,0,0,0,0,0,0,0
108,公立,一般大學,0005,國立成功大學,碩士班(日間),日本,其他亞洲地區,3,1,2,2,1,1,1,0,1,0,0,0,0,0,0
108,公立,一般大學,0005,國立成功大學,碩士班(日間),加拿大,北美洲,5,4,1,2,2,0,3,2,1,0,0,0,0,0,0
108,公立,一般大學,0005,國立成功大學,碩士班(日間),史瓦帝尼王國,非洲,5,2,3,5,2,3,0,0,0,0,0,0,0,0,0
108,公立,一般大學,0005,國立成功大學,碩士班(日間),布吉納法索,非洲,2,2,0,2,2,0,0,0,0,0,0,0,0,0,0
108,公立,一般大學,0005,國立成功大學,碩士班(日間),印度,南亞,30,22,8,30,22,8,0,0,0,0,0,0,0,0,0
108,公立,一般大學,0005,國立成功大學,碩士班(日間),印度尼西亞共和國,東協,125,60,65,121,56,65,4,4,0,0,0,0,0,0,0
108,公立,一般大學,0005,國立成功大學,碩士班(日間),西班牙王國,歐洲,1,1,0,1,1,0,0,0,0,0,0,0,0,0,0
108,公立,一般大學,0005,國立成功大學,碩士班(日間),宏都拉斯共和國,中南美洲,2,2,0,2,2,0,0,0,0,0,0,0,0,0,0
108,公立,一般大學,0005,國立成功大學,碩士班(日間),貝里斯,中南美洲,6,5,1,6,5,1,0,0,0,0,0,0,0,0,0
108,公立,一般大學,0005,國立成功大學,碩士班(日間),香港,港澳,28,16,12,0,0,0,0,0,0,28,16,12,0,0,0
108,公立,一般大學,0005,國立成功大學,碩士班(日間),荷蘭王國,歐洲,1,1,0,1,1,0,0,0,0,0,0,0,0,0,0
108,公立,一般大學,0005,國立成功大學,碩士班(日間),智利,中南美洲,1,1,0,0,0,0,1,1,0,0,0,0,0,0,0
108,公立,一般大學,0005,國立成功大學,碩士班(日間),愛沙尼亞共和國,歐洲,1,1,0,1,1,0,0,0,0,0,0,0,0,0,0
108,公立,一般大學,0005,國立成功大學,碩士班(日間),瑞典王國,歐洲,1,1,0,1,1,0,0,0,0,0,0,0,0,0,0
108,公立,一般大學,0005,國立成功大學,碩士班(日間),義大利共和國,歐洲,1,1,0,1,1,0,0,0,0,0,0,0,0,0,0
108,公立,一般大學,0005,國立成功大學,碩士班(日間),摩納哥侯國,歐洲,1,1,0,1,1,0,0,0,0,0,0,0,0,0,0
108,公立,一般大學,0005,國立成功大學,碩士班(日間),緬甸,東協,4,1,3,2,1,1,2,0,2,0,0,0,0,0,0
108,公立,一般大學,0005,國立成功大學,碩士班(日間),孟加拉人民共和國,南亞,3,1,2,3,1,2,0,0,0,0,0,0,0,0,0
108,公立,一般大學,0005,國立成功大學,碩士班(日間),法國,歐洲,3,2,1,3,2,1,0,0,0,0,0,0,0,0,0
108,公立,一般大學,0005,國立成功大學,碩士班(日間),俄羅斯聯邦,其他亞洲地區,2,2,0,2,2,0,0,0,0,0,0,0,0,0,0
108,公立,一般大學,0005,國立成功大學,碩士班(日間),美國,北美洲,10,6,4,7,6,1,3,0,3,0,0,0,0,0,0
108,公立,一般大學,0005,國立成功大學,碩士班(日間),英國,歐洲,1,1,0,1,1,0,0,0,0,0,0,0,0,0,0
108,公立,一般大學,0005,國立成功大學,碩士班(日間),埃及阿拉伯共和國,非洲,1,0,1,1,0,1,0,0,0,0,0,0,0,0,0
108,公立,一般大學,0005,國立成功大學,碩士班(日間),泰國,東協,30,7,23,29,6,23,1,1,0,0,0,0,0,0,0
108,公立,一般大學,0005,國立成功大學,碩士班(日間),海地共和國,中南美洲,3,2,1,3,2,1,0,0,0,0,0,0,0,0,0
108,公立,一般大學,0005,國立成功大學,碩士班(日間),馬來西亞,東協,70,45,25,24,14,10,46,31,15,0,0,0,0,0,0
108,公立,一般大學,0005,國立成功大學,碩士班(日間),馬拉威共和國,非洲,1,0,1,0,0,0,1,0,1,0,0,0,0,0,0
108,公立,一般大學,0005,國立成功大學,碩士班(日間),捷克共和國,歐洲,2,2,0,2,2,0,0,0,0,0,0,0,0,0,0
108,公立,一般大學,0005,國立成功大學,碩士班(日間),菲律賓共和國,東協,10,6,4,10,6,4,0,0,0,0,0,0,0,0,0
108,公立,一般大學,0005,國立成功大學,碩士班(日間),越南社會主義共和國,東協,95,32,63,94,31,63,1,1,0,0,0,0,0,0,0
108,公立,一般大學,0005,國立成功大學,碩士班(日間),聖文森(及格瑞那丁),中南美洲,2,0,2,2,0,2,0,0,0,0,0,0,0,0,0
108,公立,一般大學,0005,國立成功大學,碩士班(日間),聖露西亞,中南美洲,1,0,1,1,0,1,0,0,0,0,0,0,0,0,0
108,公立,一般大學,0005,國立成功大學,碩士班(日間),蒙古國,其他亞洲地區,8,1,7,8,1,7,0,0,0,0,0,0,0,0,0
108,公立,一般大學,0005,國立成功大學,碩士班(日間),澳門,港澳,23,13,10,0,0,0,0,0,0,23,13,10,0,0,0
108,公立,一般大學,0005,國立成功大學,碩士班(日間),薩爾瓦多,中南美洲,1,1,0,1,1,0,0,0,0,0,0,0,0,0,0
108,公立,一般大學,0005,國立成功大學,博士班,土耳其共和國,其他亞洲地區,1,1,0,1,1,0,0,0,0,0,0,0,0,0,0
108,公立,一般大學,0005,國立成功大學,博士班,大陸地區,大陸地區,68,38,30,0,0,0,0,0,0,0,0,0,68,38,30
108,公立,一般大學,0005,國立成功大學,博士班,加拿大,北美洲,1,1,0,1,1,0,0,0,0,0,0,0,0,0,0
108,公立,一般大學,0005,國立成功大學,博士班,瓜地馬拉共和國,中南美洲,1,1,0,1,1,0,0,0,0,0,0,0,0,0,0
108,公立,一般大學,0005,國立成功大學,博士班,甘比亞共和國,非洲,1,1,0,1,1,0,0,0,0,0,0,0,0,0,0
108,公立,一般大學,0005,國立成功大學,博士班,伊朗伊斯蘭共和國,其他亞洲地區,4,4,0,4,4,0,0,0,0,0,0,0,0,0,0
108,公立,一般大學,0005,國立成功大學,博士班,大韓民國(南韓),其他亞洲地區,2,0,2,2,0,2,0,0,0,0,0,0,0,0,0
108,公立,一般大學,0005,國立成功大學,博士班,厄瓜多共和國,中南美洲,1,1,0,1,1,0,0,0,0,0,0,0,0,0,0
108,公立,一般大學,0005,國立成功大學,博士班,巴基斯坦,南亞,6,5,1,6,5,1,0,0,0,0,0,0,0,0,0
108,公立,一般大學,0005,國立成功大學,博士班,日本,其他亞洲地區,2,2,0,2,2,0,0,0,0,0,0,0,0,0,0
108,公立,一般大學,0005,國立成功大學,博士班,匈牙利共和國,歐洲,1,0,1,1,0,1,0,0,0,0,0,0,0,0,0
108,公立,一般大學,0005,國立成功大學,博士班,印度尼西亞共和國,東協,75,40,35,75,40,35,0,0,0,0,0,0,0,0,0
108,公立,一般大學,0005,國立成功大學,博士班,衣索比亞聯邦民主共和國,非洲,2,2,0,2,2,0,0,0,0,0,0,0,0,0,0
108,公立,一般大學,0005,國立成功大學,博士班,貝里斯,中南美洲,3,2,1,3,2,1,0,0,0,0,0,0,0,0,0
108,公立,一般大學,0005,國立成功大學,博士班,孟加拉人民共和國,南亞,4,2,2,4,2,2,0,0,0,0,0,0,0,0,0
108,公立,一般大學,0005,國立成功大學,博士班,波蘭共和國,歐洲,1,1,0,1,1,0,0,0,0,0,0,0,0,0,0
108,公立,一般大學,0005,國立成功大學,博士班,法國,歐洲,1,1,0,1,1,0,0,0,0,0,0,0,0,0,0
108,公立,一般大學,0005,國立成功大學,博士班,肯亞共和國,非洲,2,2,0,2,2,0,0,0,0,0,0,0,0,0,0
108,公立,一般大學,0005,國立成功大學,博士班,俄羅斯聯邦,其他亞洲地區,1,0,1,1,0,1,0,0,0,0,0,0,0,0,0
108,公立,一般大學,0005,國立成功大學,博士班,哥倫比亞共和國,中南美洲,3,2,1,3,2,1,0,0,0,0,0,0,0,0,0
108,公立,一般大學,0005,國立成功大學,博士班,埃及阿拉伯共和國,非洲,1,1,0,1,1,0,0,0,0,0,0,0,0,0,0
108,公立,一般大學,0005,國立成功大學,博士班,泰國,東協,16,8,8,16,8,8,0,0,0,0,0,0,0,0,0
108,公立,一般大學,0005,國立成功大學,博士班,智利,中南美洲,1,1,0,1,1,0,0,0,0,0,0,0,0,0,0
108,公立,一般大學,0005,國立成功大學,博士班,菲律賓共和國,東協,14,9,5,14,9,5,0,0,0,0,0,0,0,0,0
108,公立,一般大學,0005,國立成功大學,博士班,越南社會主義共和國,東協,91,54,37,91,54,37,0,0,0,0,0,0,0,0,0
108,公立,一般大學,0005,國立成功大學,博士班,瑞士聯邦,歐洲,1,1,0,1,1,0,0,0,0,0,0,0,0,0,0
108,公立,一般大學,0005,國立成功大學,博士班,葉門共和國,其他亞洲地區,1,1,0,1,1,0,0,0,0,0,0,0,0,0,0
108,公立,一般大學,0005,國立成功大學,博士班,澳門,港澳,3,2,1,0,0,0,0,0,0,3,2,1,0,0,0
108,公立,一般大學,0005,國立成功大學,博士班,布吉納法索,非洲,1,0,1,1,0,1,0,0,0,0,0,0,0,0,0
108,公立,一般大學,0005,國立成功大學,博士班,伊拉克共和國,其他亞洲地區,1,1,0,1,1,0,0,0,0,0,0,0,0,0,0
108,公立,一般大學,0005,國立成功大學,博士班,印度,南亞,41,31,10,41,31,10,0,0,0,0,0,0,0,0,0
108,公立,一般大學,0005,國立成功大學,博士班,宏都拉斯共和國,中南美洲,3,3,0,3,3,0,0,0,0,0,0,0,0,0,0
108,公立,一般大學,0005,國立成功大學,博士班,辛巴威共和國,非洲,1,1,0,1,1,0,0,0,0,0,0,0,0,0,0
108,公立,一般大學,0005,國立成功大學,博士班,奈及利亞聯邦共和國,非洲,2,2,0,2,2,0,0,0,0,0,0,0,0,0,0
108,公立,一般大學,0005,國立成功大學,博士班,美國,北美洲,5,4,1,5,4,1,0,0,0,0,0,0,0,0,0
108,公立,一般大學,0005,國立成功大學,博士班,香港,港澳,5,4,1,0,0,0,0,0,0,5,4,1,0,0,0
108,公立,一般大學,0005,國立成功大學,博士班,馬來西亞,東協,9,5,4,5,2,3,4,3,1,0,0,0,0,0,0
108,公立,一般大學,0005,國立成功大學,博士班,馬拉威共和國,非洲,1,0,1,1,0,1,0,0,0,0,0,0,0,0,0
108,公立,一般大學,0005,國立成功大學,博士班,斯里蘭卡民主社會主義共和國,南亞,1,0,1,1,0,1,0,0,0,0,0,0,0,0,0
108,公立,一般大學,0005,國立成功大學,博士班,斯洛伐克共和國,歐洲,1,0,1,1,0,1,0,0,0,0,0,0,0,0,0
108,公立,一般大學,0005,國立成功大學,博士班,蒙古國,其他亞洲地區,1,1,0,1,1,0,0,0,0,0,0,0,0,0,0
108,公立,一般大學,0005,國立成功大學,博士班,德意志聯邦共和國,歐洲,1,1,0,1,1,0,0,0,0,0,0,0,0,0,0
108,公立,一般大學,0005,國立成功大學,博士班,緬甸,東協,1,0,1,1,0,1,0,0,0,0,0,0,0,0,0
108,公立,一般大學,0005,國立成功大學,博士班,澳大利亞,其他亞洲地區,2,1,1,1,1,0,1,0,1,0,0,0,0,0,0
108,公立,一般大學,0006,國立中興大學,學士班(日間),日本,其他亞洲地區,19,8,11,17,6,11,2,2,0,0,0,0,0,0,0
108,公立,一般大學,0006,國立中興大學,學士班(日間),史瓦帝尼王國,非洲,4,2,2,4,2,2,0,0,0,0,0,0,0,0,0
108,公立,一般大學,0006,國立中興大學,學士班(日間),布吉納法索,非洲,1,1,0,1,1,0,0,0,0,0,0,0,0,0,0
108,公立,一般大學,0006,國立中興大學,學士班(日間),吉里巴斯共和國,其他亞洲地區,3,1,2,3,1,2,0,0,0,0,0,0,0,0,0
108,公立,一般大學,0006,國立中興大學,學士班(日間),帛琉共和國,其他亞洲地區,1,0,1,1,0,1,0,0,0,0,0,0,0,0,0
108,公立,一般大學,0006,國立中興大學,學士班(日間),大陸地區,大陸地區,18,12,6,0,0,0,0,0,0,0,0,0,18,12,6
108,公立,一般大學,0006,國立中興大學,學士班(日間),大韓民國(南韓),其他亞洲地區,5,3,2,2,1,1,3,2,1,0,0,0,0,0,0
108,公立,一般大學,0006,國立中興大學,學士班(日間),加拿大,北美洲,2,1,1,2,1,1,0,0,0,0,0,0,0,0,0
108,公立,一般大學,0006,國立中興大學,學士班(日間),尼加拉瓜,中南美洲,1,1,0,1,1,0,0,0,0,0,0,0,0,0,0
108,公立,一般大學,0006,國立中興大學,學士班(日間),瓜地馬拉共和國,中南美洲,3,2,1,3,2,1,0,0,0,0,0,0,0,0,0
108,公立,一般大學,0006,國立中興大學,學士班(日間),印度尼西亞共和國,東協,69,31,38,9,4,5,60,27,33,0,0,0,0,0,0
108,公立,一般大學,0006,國立中興大學,學士班(日間),吐瓦魯,其他亞洲地區,1,1,0,1,1,0,0,0,0,0,0,0,0,0,0
108,公立,一般大學,0006,國立中興大學,學士班(日間),宏都拉斯共和國,中南美洲,2,1,1,2,1,1,0,0,0,0,0,0,0,0,0
108,公立,一般大學,0006,國立中興大學,學士班(日間),貝里斯,中南美洲,2,2,0,2,2,0,0,0,0,0,0,0,0,0,0
108,公立,一般大學,0006,國立中興大學,學士班(日間),香港,港澳,72,42,30,0,0,0,0,0,0,72,42,30,0,0,0
108,公立,一般大學,0006,國立中興大學,學士班(日間),哥倫比亞共和國,中南美洲,1,1,0,1,1,0,0,0,0,0,0,0,0,0,0
108,公立,一般大學,0006,國立中興大學,學士班(日間),馬來西亞,東協,156,86,70,22,12,10,134,74,60,0,0,0,0,0,0
108,公立,一般大學,0006,國立中興大學,學士班(日間),越南社會主義共和國,東協,21,10,11,15,7,8,6,3,3,0,0,0,0,0,0
108,公立,一般大學,0006,國立中興大學,學士班(日間),聖文森(及格瑞那丁),中南美洲,3,2,1,3,2,1,0,0,0,0,0,0,0,0,0
108,公立,一般大學,0006,國立中興大學,學士班(日間),緬甸,東協,10,2,8,0,0,0,10,2,8,0,0,0,0,0,0
108,公立,一般大學,0006,國立中興大學,學士班(日間),澳門,港澳,42,29,13,0,0,0,0,0,0,42,29,13,0,0,0
108,公立,一般大學,0006,國立中興大學,學士班(日間),薩爾瓦多,中南美洲,3,2,1,2,1,1,1,1,0,0,0,0,0,0,0
108,公立,一般大學,0006,國立中興大學,學士班(日間),俄羅斯聯邦,其他亞洲地區,1,1,0,1,1,0,0,0,0,0,0,0,0,0,0
108,公立,一般大學,0006,國立中興大學,學士班(日間),約旦哈什米王國,其他亞洲地區,1,1,0,1,1,0,0,0,0,0,0,0,0,0,0
108,公立,一般大學,0006,國立中興大學,學士班(日間),美國,北美洲,1,0,1,0,0,0,1,0,1,0,0,0,0,0,0
108,公立,一般大學,0006,國立中興大學,學士班(日間),泰國,東協,6,3,3,2,0,2,4,3,1,0,0,0,0,0,0
108,公立,一般大學,0006,國立中興大學,學士班(日間),海地共和國,中南美洲,7,5,2,7,5,2,0,0,0,0,0,0,0,0,0
108,公立,一般大學,0006,國立中興大學,學士班(日間),索羅門群島,其他亞洲地區,1,1,0,1,1,0,0,0,0,0,0,0,0,0,0
108,公立,一般大學,0006,國立中興大學,學士班(日間),斯里蘭卡民主社會主義共和國,南亞,2,0,2,2,0,2,0,0,0,0,0,0,0,0,0
108,公立,一般大學,0006,國立中興大學,學士班(日間),智利,中南美洲,1,1,0,0,0,0,1,1,0,0,0,0,0,0,0
108,公立,一般大學,0006,國立中興大學,學士班(日間),菲律賓共和國,東協,2,1,1,1,0,1,1,1,0,0,0,0,0,0,0
108,公立,一般大學,0006,國立中興大學,學士班(日間),聖露西亞,中南美洲,1,1,0,1,1,0,0,0,0,0,0,0,0,0,0
108,公立,一般大學,0006,國立中興大學,學士班(日間),蒙古國,其他亞洲地區,5,2,3,5,2,3,0,0,0,0,0,0,0,0,0
108,公立,一般大學,0006,國立中興大學,學士班(日間),德意志聯邦共和國,歐洲,1,1,0,1,1,0,0,0,0,0,0,0,0,0,0
108,公立,一般大學,0006,國立中興大學,碩士班(日間),巴基斯坦,南亞,1,1,0,1,1,0,0,0,0,0,0,0,0,0,0
108,公立,一般大學,0006,國立中興大學,碩士班(日間),日本,其他亞洲地區,3,3,0,3,3,0,0,0,0,0,0,0,0,0,0
108,公立,一般大學,0006,國立中興大學,碩士班(日間),史瓦帝尼王國,非洲,4,3,1,4,3,1,0,0,0,0,0,0,0,0,0
108,公立,一般大學,0006,國立中興大學,碩士班(日間),尼泊爾聯邦民主共和國,南亞,3,2,1,3,2,1,0,0,0,0,0,0,0,0,0
108,公立,一般大學,0006,國立中興大學,碩士班(日間),孟加拉人民共和國,南亞,2,2,0,2,2,0,0,0,0,0,0,0,0,0,0
108,公立,一般大學,0006,國立中興大學,碩士班(日間),美國,北美洲,2,0,2,2,0,2,0,0,0,0,0,0,0,0,0
108,公立,一般大學,0006,國立中興大學,碩士班(日間),埃及阿拉伯共和國,非洲,1,1,0,1,1,0,0,0,0,0,0,0,0,0,0
108,公立,一般大學,0006,國立中興大學,碩士班(日間),泰國,東協,14,3,11,13,3,10,1,0,1,0,0,0,0,0,0
108,公立,一般大學,0006,國立中興大學,碩士班(日間),海地共和國,中南美洲,4,4,0,4,4,0,0,0,0,0,0,0,0,0,0
108,公立,一般大學,0006,國立中興大學,碩士班(日間),斯里蘭卡民主社會主義共和國,南亞,5,4,1,5,4,1,0,0,0,0,0,0,0,0,0
108,公立,一般大學,0006,國立中興大學,碩士班(日間),菲律賓共和國,東協,3,1,2,3,1,2,0,0,0,0,0,0,0,0,0
108,公立,一般大學,0006,國立中興大學,碩士班(日間),聖露西亞,中南美洲,1,1,0,1,1,0,0,0,0,0,0,0,0,0,0
108,公立,一般大學,0006,國立中興大學,碩士班(日間),蒙古國,其他亞洲地區,2,0,2,2,0,2,0,0,0,0,0,0,0,0,0
108,公立,一般大學,0006,國立中興大學,碩士班(日間),德意志聯邦共和國,歐洲,25,7,18,25,7,18,0,0,0,0,0,0,0,0,0
108,公立,一般大學,0006,國立中興大學,碩士班(日間),土耳其共和國,其他亞洲地區,7,6,1,7,6,1,0,0,0,0,0,0,0,0,0
108,公立,一般大學,0006,國立中興大學,碩士班(日間),大陸地區,大陸地區,23,10,13,0,0,0,0,0,0,0,0,0,23,10,13
108,公立,一般大學,0006,國立中興大學,碩士班(日間),大韓民國(南韓),其他亞洲地區,2,2,0,2,2,0,0,0,0,0,0,0,0,0,0
108,公立,一般大學,0006,國立中興大學,碩士班(日間),尼加拉瓜,中南美洲,4,3,1,4,3,1,0,0,0,0,0,0,0,0,0
108,公立,一般大學,0006,國立中興大學,碩士班(日間),瓜地馬拉共和國,中南美洲,1,1,0,1,1,0,0,0,0,0,0,0,0,0,0
108,公立,一般大學,0006,國立中興大學,碩士班(日間),印度,南亞,5,3,2,5,3,2,0,0,0,0,0,0,0,0,0
108,公立,一般大學,0006,國立中興大學,碩士班(日間),印度尼西亞共和國,東協,24,15,9,22,14,8,2,1,1,0,0,0,0,0,0
108,公立,一般大學,0006,國立中興大學,碩士班(日間),貝里斯,中南美洲,1,0,1,1,0,1,0,0,0,0,0,0,0,0,0
108,公立,一般大學,0006,國立中興大學,碩士班(日間),保加利亞共和國,歐洲,1,0,1,1,0,1,0,0,0,0,0,0,0,0,0
108,公立,一般大學,0006,國立中興大學,碩士班(日間),英國,歐洲,1,1,0,1,1,0,0,0,0,0,0,0,0,0,0
108,公立,一般大學,0006,國立中興大學,碩士班(日間),香港,港澳,18,14,4,0,0,0,0,0,0,18,14,4,0,0,0
108,公立,一般大學,0006,國立中興大學,碩士班(日間),馬來西亞,東協,34,20,14,7,3,4,27,17,10,0,0,0,0,0,0
108,公立,一般大學,0006,國立中興大學,碩士班(日間),馬拉威共和國,非洲,1,0,1,1,0,1,0,0,0,0,0,0,0,0,0
108,公立,一般大學,0006,國立中興大學,碩士班(日間),越南社會主義共和國,東協,26,12,14,25,12,13,1,0,1,0,0,0,0,0,0
108,公立,一般大學,0006,國立中興大學,碩士班(日間),澳門,港澳,5,2,3,0,0,0,0,0,0,5,2,3,0,0,0
108,公立,一般大學,0006,國立中興大學,碩士班(日間),墨西哥合眾國,中南美洲,3,2,1,3,2,1,0,0,0,0,0,0,0,0,0
108,公立,一般大學,0006,國立中興大學,博士班,土耳其共和國,其他亞洲地區,1,1,0,1,1,0,0,0,0,0,0,0,0,0,0
108,公立,一般大學,0006,國立中興大學,博士班,大陸地區,大陸地區,8,4,4,0,0,0,0,0,0,0,0,0,8,4,4
108,公立,一般大學,0006,國立中興大學,博士班,甘比亞共和國,非洲,3,3,0,3,3,0,0,0,0,0,0,0,0,0,0
108,公立,一般大學,0006,國立中興大學,博士班,印度,南亞,39,25,14,39,25,14,0,0,0,0,0,0,0,0,0
108,公立,一般大學,0006,國立中興大學,博士班,衣索比亞聯邦民主共和國,非洲,5,5,0,5,5,0,0,0,0,0,0,0,0,0,0
108,公立,一般大學,0006,國立中興大學,博士班,大韓民國(南韓),其他亞洲地區,3,2,1,2,1,1,1,1,0,0,0,0,0,0,0
108,公立,一般大學,0006,國立中興大學,博士班,巴基斯坦,南亞,2,1,1,2,1,1,0,0,0,0,0,0,0,0,0
108,公立,一般大學,0006,國立中興大學,博士班,尼泊爾聯邦民主共和國,南亞,5,3,2,5,3,2,0,0,0,0,0,0,0,0,0
108,公立,一般大學,0006,國立中興大學,博士班,布吉納法索,非洲,1,1,0,1,1,0,0,0,0,0,0,0,0,0,0
108,公立,一般大學,0006,國立中興大學,博士班,印度尼西亞共和國,東協,4,2,2,4,2,2,0,0,0,0,0,0,0,0,0
108,公立,一般大學,0006,國立中興大學,博士班,南非共和國,非洲,1,1,0,1,1,0,0,0,0,0,0,0,0,0,0
108,公立,一般大學,0006,國立中興大學,博士班,馬來西亞,東協,11,6,5,4,2,2,7,4,3,0,0,0,0,0,0
108,公立,一般大學,0006,國立中興大學,博士班,貝里斯,中南美洲,2,2,0,2,2,0,0,0,0,0,0,0,0,0,0
108,公立,一般大學,0006,國立中興大學,博士班,孟加拉人民共和國,南亞,4,3,1,4,3,1,0,0,0,0,0,0,0,0,0
108,公立,一般大學,0006,國立中興大學,博士班,迦納共和國,非洲,1,1,0,1,1,0,0,0,0,0,0,0,0,0,0
108,公立,一般大學,0006,國立中興大學,博士班,哥倫比亞共和國,中南美洲,1,1,0,1,1,0,0,0,0,0,0,0,0,0,0
108,公立,一般大學,0006,國立中興大學,博士班,泰國,東協,32,10,22,32,10,22,0,0,0,0,0,0,0,0,0
108,公立,一般大學,0006,國立中興大學,博士班,斯里蘭卡民主社會主義共和國,南亞,1,1,0,1,1,0,0,0,0,0,0,0,0,0,0
108,公立,一般大學,0006,國立中興大學,博士班,越南社會主義共和國,東協,20,12,8,20,12,8,0,0,0,0,0,0,0,0,0
108,公立,一般大學,0006,國立中興大學,博士班,德意志聯邦共和國,歐洲,1,1,0,1,1,0,0,0,0,0,0,0,0,0,0
108,公立,一般大學,0006,國立中興大學,博士班,澳門,港澳,1,0,1,0,0,0,0,0,0,1,0,1,0,0,0
108,公立,一般大學,0006,國立中興大學,博士班,荷蘭王國,歐洲,1,1,0,1,1,0,0,0,0,0,0,0,0,0,0
108,公立,一般大學,0006,國立中興大學,博士班,菲律賓共和國,東協,10,6,4,10,6,4,0,0,0,0,0,0,0,0,0
108,公立,一般大學,0006,國立中興大學,博士班,蒙古國,其他亞洲地區,1,0,1,1,0,1,0,0,0,0,0,0,0,0,0
108,公立,一般大學,0007,國立陽明交通大學,學士班(日間),大陸地區,大陸地區,17,13,4,0,0,0,0,0,0,0,0,0,17,13,4
108,公立,一般大學,0007,國立陽明交通大學,學士班(日間),大韓民國(南韓),其他亞洲地區,5,4,1,1,0,1,4,4,0,0,0,0,0,0,0
108,公立,一般大學,0007,國立陽明交通大學,學士班(日間),巴西聯邦共和國,中南美洲,1,1,0,1,1,0,0,0,0,0,0,0,0,0,0
108,公立,一般大學,0007,國立陽明交通大學,學士班(日間),巴拉圭,中南美洲,4,3,1,3,2,1,1,1,0,0,0,0,0,0,0
108,公立,一般大學,0007,國立陽明交通大學,學士班(日間),日本,其他亞洲地區,5,4,1,4,3,1,1,1,0,0,0,0,0,0,0
108,公立,一般大學,0007,國立陽明交通大學,學士班(日間),加拿大,北美洲,2,2,0,0,0,0,2,2,0,0,0,0,0,0,0
108,公立,一般大學,0007,國立陽明交通大學,學士班(日間),伊朗伊斯蘭共和國,其他亞洲地區,2,0,2,0,0,0,2,0,2,0,0,0,0,0,0
108,公立,一般大學,0007,國立陽明交通大學,學士班(日間),印度,南亞,3,2,1,3,2,1,0,0,0,0,0,0,0,0,0
108,公立,一般大學,0007,國立陽明交通大學,學士班(日間),印度尼西亞共和國,東協,74,52,22,26,20,6,48,32,16,0,0,0,0,0,0
108,公立,一般大學,0007,國立陽明交通大學,學士班(日間),宏都拉斯共和國,中南美洲,4,3,1,4,3,1,0,0,0,0,0,0,0,0,0
108,公立,一般大學,0007,國立陽明交通大學,學士班(日間),香港,港澳,33,23,10,0,0,0,0,0,0,33,23,10,0,0,0
108,公立,一般大學,0007,國立陽明交通大學,學士班(日間),泰國,東協,6,6,0,1,1,0,5,5,0,0,0,0,0,0,0
108,公立,一般大學,0007,國立陽明交通大學,學士班(日間),馬來西亞,東協,129,93,36,20,12,8,109,81,28,0,0,0,0,0,0
108,公立,一般大學,0007,國立陽明交通大學,學士班(日間),菲律賓共和國,東協,2,1,1,2,1,1,0,0,0,0,0,0,0,0,0
108,公立,一般大學,0007,國立陽明交通大學,學士班(日間),越南社會主義共和國,東協,12,7,5,7,3,4,5,4,1,0,0,0,0,0,0
108,公立,一般大學,0007,國立陽明交通大學,學士班(日間),聖文森(及格瑞那丁),中南美洲,1,0,1,1,0,1,0,0,0,0,0,0,0,0,0
108,公立,一般大學,0007,國立陽明交通大學,學士班(日間),澳門,港澳,56,48,8,0,0,0,0,0,0,56,48,8,0,0,0
108,公立,一般大學,0007,國立陽明交通大學,學士班(日間),厄瓜多共和國,中南美洲,1,0,1,0,0,0,1,0,1,0,0,0,0,0,0
108,公立,一般大學,0007,國立陽明交通大學,學士班(日間),哈薩克共和國,其他亞洲地區,2,2,0,2,2,0,0,0,0,0,0,0,0,0,0
108,公立,一般大學,0007,國立陽明交通大學,學士班(日間),美國,北美洲,4,3,1,4,3,1,0,0,0,0,0,0,0,0,0
108,公立,一般大學,0007,國立陽明交通大學,學士班(日間),海地共和國,中南美洲,8,7,1,8,7,1,0,0,0,0,0,0,0,0,0
108,公立,一般大學,0007,國立陽明交通大學,學士班(日間),烏克蘭,其他亞洲地區,4,3,1,4,3,1,0,0,0,0,0,0,0,0,0
108,公立,一般大學,0007,國立陽明交通大學,學士班(日間),烏茲別克共和國,其他亞洲地區,1,1,0,1,1,0,0,0,0,0,0,0,0,0,0
108,公立,一般大學,0007,國立陽明交通大學,學士班(日間),新加坡共和國,東協,1,0,1,0,0,0,1,0,1,0,0,0,0,0,0
108,公立,一般大學,0007,國立陽明交通大學,學士班(日間),聖露西亞,中南美洲,2,1,1,2,1,1,0,0,0,0,0,0,0,0,0
108,公立,一般大學,0007,國立陽明交通大學,學士班(日間),蒙古國,其他亞洲地區,4,3,1,4,3,1,0,0,0,0,0,0,0,0,0
108,公立,一般大學,0007,國立陽明交通大學,學士班(日間),緬甸,東協,13,8,5,0,0,0,13,8,5,0,0,0,0,0,0
108,公立,一般大學,0007,國立陽明交通大學,碩士班(日間),土耳其共和國,其他亞洲地區,2,2,0,2,2,0,0,0,0,0,0,0,0,0,0
108,公立,一般大學,0007,國立陽明交通大學,碩士班(日間),巴基斯坦,南亞,7,7,0,7,7,0,0,0,0,0,0,0,0,0,0
108,公立,一般大學,0007,國立陽明交通大學,碩士班(日間),尼加拉瓜,中南美洲,2,2,0,2,2,0,0,0,0,0,0,0,0,0,0
108,公立,一般大學,0007,國立陽明交通大學,碩士班(日間),甘比亞共和國,非洲,1,0,1,1,0,1,0,0,0,0,0,0,0,0,0
108,公立,一般大學,0007,國立陽明交通大學,碩士班(日間),汶萊和平之國,東協,1,1,0,1,1,0,0,0,0,0,0,0,0,0,0
108,公立,一般大學,0007,國立陽明交通大學,碩士班(日間),貝里斯,中南美洲,1,1,0,1,1,0,0,0,0,0,0,0,0,0,0
108,公立,一般大學,0007,國立陽明交通大學,碩士班(日間),孟加拉人民共和國,南亞,2,2,0,2,2,0,0,0,0,0,0,0,0,0,0
108,公立,一般大學,0007,國立陽明交通大學,碩士班(日間),美國,北美洲,8,5,3,6,3,3,2,2,0,0,0,0,0,0,0
108,公立,一般大學,0007,國立陽明交通大學,碩士班(日間),泰國,東協,10,5,5,9,5,4,1,0,1,0,0,0,0,0,0
108,公立,一般大學,0007,國立陽明交通大學,碩士班(日間),海地共和國,中南美洲,4,2,2,4,2,2,0,0,0,0,0,0,0,0,0
108,公立,一般大學,0007,國立陽明交通大學,碩士班(日間),紐西蘭,其他亞洲地區,1,1,0,0,0,0,1,1,0,0,0,0,0,0,0
108,公立,一般大學,0007,國立陽明交通大學,碩士班(日間),大陸地區,大陸地區,136,84,52,0,0,0,0,0,0,0,0,0,136,84,52
108,公立,一般大學,0007,國立陽明交通大學,碩士班(日間),大韓民國(南韓),其他亞洲地區,1,1,0,0,0,0,1,1,0,0,0,0,0,0,0
108,公立,一般大學,0007,國立陽明交通大學,碩士班(日間),厄瓜多共和國,中南美洲,1,1,0,1,1,0,0,0,0,0,0,0,0,0,0
108,公立,一般大學,0007,國立陽明交通大學,碩士班(日間),巴拉圭,中南美洲,2,2,0,1,1,0,1,1,0,0,0,0,0,0,0
108,公立,一般大學,0007,國立陽明交通大學,碩士班(日間),巴拿馬共和國,中南美洲,2,2,0,2,2,0,0,0,0,0,0,0,0,0,0
108,公立,一般大學,0007,國立陽明交通大學,碩士班(日間),日本,其他亞洲地區,5,3,2,5,3,2,0,0,0,0,0,0,0,0,0
108,公立,一般大學,0007,國立陽明交通大學,碩士班(日間),加拿大,北美洲,4,4,0,2,2,0,2,2,0,0,0,0,0,0,0
108,公立,一般大學,0007,國立陽明交通大學,碩士班(日間),布吉納法索,非洲,2,2,0,2,2,0,0,0,0,0,0,0,0,0,0
108,公立,一般大學,0007,國立陽明交通大學,碩士班(日間),白俄羅斯共和國,其他亞洲地區,1,1,0,1,1,0,0,0,0,0,0,0,0,0,0
108,公立,一般大學,0007,國立陽明交通大學,碩士班(日間),伊朗伊斯蘭共和國,其他亞洲地區,1,1,0,1,1,0,0,0,0,0,0,0,0,0,0
108,公立,一般大學,0007,國立陽明交通大學,碩士班(日間),印度,南亞,41,25,16,41,25,16,0,0,0,0,0,0,0,0,0
108,公立,一般大學,0007,國立陽明交通大學,碩士班(日間),義大利共和國,歐洲,1,0,1,1,0,1,0,0,0,0,0,0,0,0,0
108,公立,一般大學,0007,國立陽明交通大學,碩士班(日間),葉門共和國,其他亞洲地區,1,0,1,0,0,0,1,0,1,0,0,0,0,0,0
108,公立,一般大學,0007,國立陽明交通大學,碩士班(日間),蒙古國,其他亞洲地區,1,1,0,1,1,0,0,0,0,0,0,0,0,0,0
108,公立,一般大學,0007,國立陽明交通大學,碩士班(日間),德意志聯邦共和國,歐洲,3,2,1,3,2,1,0,0,0,0,0,0,0,0,0
108,公立,一般大學,0007,國立陽明交通大學,碩士班(日間),緬甸,東協,4,3,1,2,1,1,2,2,0,0,0,0,0,0,0
108,公立,一般大學,0007,國立陽明交通大學,碩士班(日間),澳大利亞,其他亞洲地區,1,1,0,1,1,0,0,0,0,0,0,0,0,0,0
108,公立,一般大學,0007,國立陽明交通大學,碩士班(日間),印度尼西亞共和國,東協,44,24,20,38,19,19,6,5,1,0,0,0,0,0,0
108,公立,一般大學,0007,國立陽明交通大學,碩士班(日間),多明尼加共和國,中南美洲,1,0,1,0,0,0,1,0,1,0,0,0,0,0,0
108,公立,一般大學,0007,國立陽明交通大學,碩士班(日間),宏都拉斯共和國,中南美洲,1,1,0,1,1,0,0,0,0,0,0,0,0,0,0
108,公立,一般大學,0007,國立陽明交通大學,碩士班(日間),波蘭共和國,歐洲,1,1,0,1,1,0,0,0,0,0,0,0,0,0,0
108,公立,一般大學,0007,國立陽明交通大學,碩士班(日間),南非共和國,非洲,1,0,1,1,0,1,0,0,0,0,0,0,0,0,0
108,公立,一般大學,0007,國立陽明交通大學,碩士班(日間),約旦哈什米王國,其他亞洲地區,3,1,2,3,1,2,0,0,0,0,0,0,0,0,0
108,公立,一般大學,0007,國立陽明交通大學,碩士班(日間),香港,港澳,29,18,11,0,0,0,0,0,0,29,18,11,0,0,0
108,公立,一般大學,0007,國立陽明交通大學,碩士班(日間),哥倫比亞共和國,中南美洲,1,1,0,1,1,0,0,0,0,0,0,0,0,0,0
108,公立,一般大學,0007,國立陽明交通大學,碩士班(日間),埃及阿拉伯共和國,非洲,2,2,0,2,2,0,0,0,0,0,0,0,0,0,0
108,公立,一般大學,0007,國立陽明交通大學,碩士班(日間),烏克蘭,其他亞洲地區,2,2,0,2,2,0,0,0,0,0,0,0,0,0,0
108,公立,一般大學,0007,國立陽明交通大學,碩士班(日間),馬來西亞,東協,44,29,15,7,4,3,37,25,12,0,0,0,0,0,0
108,公立,一般大學,0007,國立陽明交通大學,碩士班(日間),菲律賓共和國,東協,4,3,1,4,3,1,0,0,0,0,0,0,0,0,0
108,公立,一般大學,0007,國立陽明交通大學,碩士班(日間),越南社會主義共和國,東協,43,19,24,42,18,24,1,1,0,0,0,0,0,0,0
108,公立,一般大學,0007,國立陽明交通大學,碩士班(日間),塔吉克共和國,其他亞洲地區,1,1,0,1,1,0,0,0,0,0,0,0,0,0,0
108,公立,一般大學,0007,國立陽明交通大學,碩士班(日間),聖文森(及格瑞那丁),中南美洲,1,1,0,1,1,0,0,0,0,0,0,0,0,0,0
108,公立,一般大學,0007,國立陽明交通大學,碩士班(日間),澳門,港澳,15,7,8,0,0,0,0,0,0,15,7,8,0,0,0
108,公立,一般大學,0007,國立陽明交通大學,碩士班(日間),薩爾瓦多,中南美洲,1,1,0,1,1,0,0,0,0,0,0,0,0,0,0
108,公立,一般大學,0007,國立陽明交通大學,博士班,大韓民國(南韓),其他亞洲地區,2,2,0,2,2,0,0,0,0,0,0,0,0,0,0
108,公立,一般大學,0007,國立陽明交通大學,博士班,日本,其他亞洲地區,1,1,0,1,1,0,0,0,0,0,0,0,0,0,0
108,公立,一般大學,0007,國立陽明交通大學,博士班,印度尼西亞共和國,東協,33,26,7,32,25,7,1,1,0,0,0,0,0,0,0
108,公立,一般大學,0007,國立陽明交通大學,博士班,西班牙王國,歐洲,1,1,0,1,1,0,0,0,0,0,0,0,0,0,0
108,公立,一般大學,0007,國立陽明交通大學,博士班,法國,歐洲,2,2,0,2,2,0,0,0,0,0,0,0,0,0,0
108,公立,一般大學,0007,國立陽明交通大學,博士班,大陸地區,大陸地區,50,27,23,0,0,0,0,0,0,0,0,0,50,27,23
108,公立,一般大學,0007,國立陽明交通大學,博士班,厄瓜多共和國,中南美洲,3,3,0,3,3,0,0,0,0,0,0,0,0,0,0
108,公立,一般大學,0007,國立陽明交通大學,博士班,巴基斯坦,南亞,16,14,2,16,14,2,0,0,0,0,0,0,0,0,0
108,公立,一般大學,0007,國立陽明交通大學,博士班,尼加拉瓜,中南美洲,1,1,0,1,1,0,0,0,0,0,0,0,0,0,0
108,公立,一般大學,0007,國立陽明交通大學,博士班,瓜地馬拉共和國,中南美洲,1,1,0,1,1,0,0,0,0,0,0,0,0,0,0
108,公立,一般大學,0007,國立陽明交通大學,博士班,甘比亞共和國,非洲,3,3,0,3,3,0,0,0,0,0,0,0,0,0,0
108,公立,一般大學,0007,國立陽明交通大學,博士班,伊朗伊斯蘭共和國,其他亞洲地區,3,2,1,3,2,1,0,0,0,0,0,0,0,0,0
108,公立,一般大學,0007,國立陽明交通大學,博士班,印度,南亞,136,107,29,136,107,29,0,0,0,0,0,0,0,0,0
108,公立,一般大學,0007,國立陽明交通大學,博士班,衣索比亞聯邦民主共和國,非洲,19,19,0,19,19,0,0,0,0,0,0,0,0,0,0
108,公立,一般大學,0007,國立陽明交通大學,博士班,亞美尼亞共和國,其他亞洲地區,1,1,0,1,1,0,0,0,0,0,0,0,0,0,0
108,公立,一般大學,0007,國立陽明交通大學,博士班,奈及利亞聯邦共和國,非洲,1,1,0,1,1,0,0,0,0,0,0,0,0,0,0
108,公立,一般大學,0007,國立陽明交通大學,博士班,波蘭共和國,歐洲,1,0,1,1,0,1,0,0,0,0,0,0,0,0,0
108,公立,一般大學,0007,國立陽明交通大學,博士班,南非共和國,非洲,1,1,0,1,1,0,0,0,0,0,0,0,0,0,0
108,公立,一般大學,0007,國立陽明交通大學,博士班,哈薩克共和國,其他亞洲地區,1,1,0,1,1,0,0,0,0,0,0,0,0,0,0
108,公立,一般大學,0007,國立陽明交通大學,博士班,香港,港澳,2,1,1,0,0,0,0,0,0,2,1,1,0,0,0
108,公立,一般大學,0007,國立陽明交通大學,博士班,剛果民主共和國,非洲,1,1,0,1,1,0,0,0,0,0,0,0,0,0,0
108,公立,一般大學,0007,國立陽明交通大學,博士班,哥倫比亞共和國,中南美洲,1,1,0,1,1,0,0,0,0,0,0,0,0,0,0
108,公立,一般大學,0007,國立陽明交通大學,博士班,海地共和國,中南美洲,2,2,0,2,2,0,0,0,0,0,0,0,0,0,0
108,公立,一般大學,0007,國立陽明交通大學,博士班,索羅門群島,其他亞洲地區,1,1,0,1,1,0,0,0,0,0,0,0,0,0,0
108,公立,一般大學,0007,國立陽明交通大學,博士班,越南社會主義共和國,東協,44,27,17,44,27,17,0,0,0,0,0,0,0,0,0
108,公立,一般大學,0007,國立陽明交通大學,博士班,葉門共和國,其他亞洲地區,2,2,0,2,2,0,0,0,0,0,0,0,0,0,0
108,公立,一般大學,0007,國立陽明交通大學,博士班,德意志聯邦共和國,歐洲,4,3,1,4,3,1,0,0,0,0,0,0,0,0,0
108,公立,一般大學,0007,國立陽明交通大學,博士班,蘇丹共和國,非洲,1,1,0,1,1,0,0,0,0,0,0,0,0,0,0
108,公立,一般大學,0007,國立陽明交通大學,博士班,保加利亞共和國,歐洲,1,1,0,1,1,0,0,0,0,0,0,0,0,0,0
108,公立,一般大學,0007,國立陽明交通大學,博士班,玻利維亞共和國,中南美洲,1,1,0,1,1,0,0,0,0,0,0,0,0,0,0
108,公立,一般大學,0007,國立陽明交通大學,博士班,約旦哈什米王國,其他亞洲地區,3,3,0,3,3,0,0,0,0,0,0,0,0,0,0
108,公立,一般大學,0007,國立陽明交通大學,博士班,美國,北美洲,2,2,0,2,2,0,0,0,0,0,0,0,0,0,0
108,公立,一般大學,0007,國立陽明交通大學,博士班,英國,歐洲,1,1,0,1,1,0,0,0,0,0,0,0,0,0,0
108,公立,一般大學,0007,國立陽明交通大學,博士班,埃及阿拉伯共和國,非洲,8,8,0,8,8,0,0,0,0,0,0,0,0,0,0
108,公立,一般大學,0007,國立陽明交通大學,博士班,泰國,東協,3,1,2,2,0,2,1,1,0,0,0,0,0,0,0
108,公立,一般大學,0007,國立陽明交通大學,博士班,烏克蘭,其他亞洲地區,4,3,1,4,3,1,0,0,0,0,0,0,0,0,0
108,公立,一般大學,0007,國立陽明交通大學,博士班,馬來西亞,東協,17,10,7,11,6,5,6,4,2,0,0,0,0,0,0
108,公立,一般大學,0007,國立陽明交通大學,博士班,菲律賓共和國,東協,10,6,4,10,6,4,0,0,0,0,0,0,0,0,0
108,公立,一般大學,0007,國立陽明交通大學,博士班,聖克里斯多福及尼維斯,中南美洲,1,1,0,1,1,0,0,0,0,0,0,0,0,0,0
108,公立,一般大學,0007,國立陽明交通大學,博士班,蒙古國,其他亞洲地區,1,0,1,1,0,1,0,0,0,0,0,0,0,0,0
108,公立,一般大學,0008,國立中央大學,學士班(日間),大陸地區,大陸地區,18,10,8,0,0,0,0,0,0,0,0,0,18,10,8
108,公立,一般大學,0008,國立中央大學,學士班(日間),尼加拉瓜,中南美洲,1,1,0,1,1,0,0,0,0,0,0,0,0,0,0
108,公立,一般大學,0008,國立中央大學,學士班(日間),美國,北美洲,2,2,0,1,1,0,1,1,0,0,0,0,0,0,0
108,公立,一般大學,0008,國立中央大學,學士班(日間),香港,港澳,44,27,17,0,0,0,0,0,0,44,27,17,0,0,0
108,公立,一般大學,0008,國立中央大學,學士班(日間),越南社會主義共和國,東協,4,1,3,1,0,1,3,1,2,0,0,0,0,0,0
108,公立,一般大學,0008,國立中央大學,學士班(日間),新加坡共和國,東協,1,1,0,0,0,0,1,1,0,0,0,0,0,0,0
108,公立,一般大學,0008,國立中央大學,學士班(日間),蒙古國,其他亞洲地區,1,0,1,1,0,1,0,0,0,0,0,0,0,0,0
108,公立,一般大學,0008,國立中央大學,學士班(日間),緬甸,東協,5,3,2,0,0,0,5,3,2,0,0,0,0,0,0
108,公立,一般大學,0008,國立中央大學,學士班(日間),澳門,港澳,34,29,5,0,0,0,0,0,0,34,29,5,0,0,0
108,公立,一般大學,0008,國立中央大學,學士班(日間),大韓民國(南韓),其他亞洲地區,1,1,0,1,1,0,0,0,0,0,0,0,0,0,0
108,公立,一般大學,0008,國立中央大學,學士班(日間),日本,其他亞洲地區,4,0,4,4,0,4,0,0,0,0,0,0,0,0,0
108,公立,一般大學,0008,國立中央大學,學士班(日間),加拿大,北美洲,1,0,1,0,0,0,1,0,1,0,0,0,0,0,0
108,公立,一般大學,0008,國立中央大學,學士班(日間),印度尼西亞共和國,東協,27,17,10,1,1,0,26,16,10,0,0,0,0,0,0
108,公立,一般大學,0008,國立中央大學,學士班(日間),南非共和國,非洲,1,0,1,0,0,0,1,0,1,0,0,0,0,0,0
108,公立,一般大學,0008,國立中央大學,學士班(日間),泰國,東協,2,1,1,0,0,0,2,1,1,0,0,0,0,0,0
108,公立,一般大學,0008,國立中央大學,學士班(日間),馬來西亞,東協,56,33,23,3,1,2,53,32,21,0,0,0,0,0,0
108,公立,一般大學,0008,國立中央大學,碩士班(日間),巴基斯坦,南亞,2,1,1,2,1,1,0,0,0,0,0,0,0,0,0
108,公立,一般大學,0008,國立中央大學,碩士班(日間),日本,其他亞洲地區,1,1,0,1,1,0,0,0,0,0,0,0,0,0,0
108,公立,一般大學,0008,國立中央大學,碩士班(日間),加拿大,北美洲,1,1,0,0,0,0,1,1,0,0,0,0,0,0,0
108,公立,一般大學,0008,國立中央大學,碩士班(日間),尼泊爾聯邦民主共和國,南亞,1,1,0,1,1,0,0,0,0,0,0,0,0,0,0
108,公立,一般大學,0008,國立中央大學,碩士班(日間),印度尼西亞共和國,東協,128,60,68,128,60,68,0,0,0,0,0,0,0,0,0
108,公立,一般大學,0008,國立中央大學,碩士班(日間),法國,歐洲,2,2,0,2,2,0,0,0,0,0,0,0,0,0,0
108,公立,一般大學,0008,國立中央大學,碩士班(日間),俄羅斯聯邦,其他亞洲地區,2,1,1,2,1,1,0,0,0,0,0,0,0,0,0
108,公立,一般大學,0008,國立中央大學,碩士班(日間),埃及阿拉伯共和國,非洲,3,3,0,3,3,0,0,0,0,0,0,0,0,0,0
108,公立,一般大學,0008,國立中央大學,碩士班(日間),泰國,東協,10,6,4,10,6,4,0,0,0,0,0,0,0,0,0
108,公立,一般大學,0008,國立中央大學,碩士班(日間),馬來西亞,東協,14,9,5,2,1,1,12,8,4,0,0,0,0,0,0
108,公立,一般大學,0008,國立中央大學,碩士班(日間),菲律賓共和國,東協,11,7,4,11,7,4,0,0,0,0,0,0,0,0,0
108,公立,一般大學,0008,國立中央大學,碩士班(日間),蒙古國,其他亞洲地區,4,2,2,4,2,2,0,0,0,0,0,0,0,0,0
108,公立,一般大學,0008,國立中央大學,碩士班(日間),澳大利亞,其他亞洲地區,2,1,1,2,1,1,0,0,0,0,0,0,0,0,0
108,公立,一般大學,0008,國立中央大學,碩士班(日間),大陸地區,大陸地區,70,44,26,0,0,0,0,0,0,0,0,0,70,44,26
108,公立,一般大學,0008,國立中央大學,碩士班(日間),史瓦帝尼王國,非洲,1,1,0,1,1,0,0,0,0,0,0,0,0,0,0
108,公立,一般大學,0008,國立中央大學,碩士班(日間),印度,南亞,5,3,2,5,3,2,0,0,0,0,0,0,0,0,0
108,公立,一般大學,0008,國立中央大學,碩士班(日間),宏都拉斯共和國,中南美洲,1,1,0,1,1,0,0,0,0,0,0,0,0,0,0
108,公立,一般大學,0008,國立中央大學,碩士班(日間),貝里斯,中南美洲,1,0,1,1,0,1,0,0,0,0,0,0,0,0,0
108,公立,一般大學,0008,國立中央大學,碩士班(日間),香港,港澳,15,9,6,0,0,0,0,0,0,15,9,6,0,0,0
108,公立,一般大學,0008,國立中央大學,碩士班(日間),斯里蘭卡民主社會主義共和國,南亞,2,0,2,2,0,2,0,0,0,0,0,0,0,0,0
108,公立,一般大學,0008,國立中央大學,碩士班(日間),越南社會主義共和國,東協,71,30,41,71,30,41,0,0,0,0,0,0,0,0,0
108,公立,一般大學,0008,國立中央大學,碩士班(日間),澳門,港澳,5,3,2,0,0,0,0,0,0,5,3,2,0,0,0
108,公立,一般大學,0008,國立中央大學,博士班,甘比亞共和國,非洲,1,1,0,1,1,0,0,0,0,0,0,0,0,0,0
108,公立,一般大學,0008,國立中央大學,博士班,匈牙利共和國,歐洲,1,1,0,1,1,0,0,0,0,0,0,0,0,0,0
108,公立,一般大學,0008,國立中央大學,博士班,波蘭共和國,歐洲,1,0,1,1,0,1,0,0,0,0,0,0,0,0,0
108,公立,一般大學,0008,國立中央大學,博士班,埃及阿拉伯共和國,非洲,1,1,0,1,1,0,0,0,0,0,0,0,0,0,0
108,公立,一般大學,0008,國立中央大學,博士班,泰國,東協,7,3,4,7,3,4,0,0,0,0,0,0,0,0,0
108,公立,一般大學,0008,國立中央大學,博士班,菲律賓共和國,東協,8,3,5,8,3,5,0,0,0,0,0,0,0,0,0
108,公立,一般大學,0008,國立中央大學,博士班,德意志聯邦共和國,歐洲,2,1,1,2,1,1,0,0,0,0,0,0,0,0,0
108,公立,一般大學,0008,國立中央大學,博士班,大陸地區,大陸地區,25,12,13,0,0,0,0,0,0,0,0,0,25,12,13
108,公立,一般大學,0008,國立中央大學,博士班,巴基斯坦,南亞,10,8,2,10,8,2,0,0,0,0,0,0,0,0,0
108,公立,一般大學,0008,國立中央大學,博士班,日本,其他亞洲地區,1,1,0,1,1,0,0,0,0,0,0,0,0,0,0
108,公立,一般大學,0008,國立中央大學,博士班,加拿大,北美洲,1,1,0,1,1,0,0,0,0,0,0,0,0,0,0
108,公立,一般大學,0008,國立中央大學,博士班,尼加拉瓜,中南美洲,1,1,0,1,1,0,0,0,0,0,0,0,0,0,0
108,公立,一般大學,0008,國立中央大學,博士班,尼泊爾聯邦民主共和國,南亞,3,3,0,3,3,0,0,0,0,0,0,0,0,0,0
108,公立,一般大學,0008,國立中央大學,博士班,伊朗伊斯蘭共和國,其他亞洲地區,4,3,1,4,3,1,0,0,0,0,0,0,0,0,0
108,公立,一般大學,0008,國立中央大學,博士班,印度,南亞,41,26,15,41,26,15,0,0,0,0,0,0,0,0,0
108,公立,一般大學,0008,國立中央大學,博士班,印度尼西亞共和國,東協,90,51,39,90,51,39,0,0,0,0,0,0,0,0,0
108,公立,一般大學,0008,國立中央大學,博士班,衣索比亞聯邦民主共和國,非洲,6,6,0,6,6,0,0,0,0,0,0,0,0,0,0
108,公立,一般大學,0008,國立中央大學,博士班,孟加拉人民共和國,南亞,1,0,1,1,0,1,0,0,0,0,0,0,0,0,0
108,公立,一般大學,0008,國立中央大學,博士班,柬埔寨王國,東協,1,0,1,1,0,1,0,0,0,0,0,0,0,0,0
108,公立,一般大學,0008,國立中央大學,博士班,哥倫比亞共和國,中南美洲,1,0,1,1,0,1,0,0,0,0,0,0,0,0,0
108,公立,一般大學,0008,國立中央大學,博士班,海地共和國,中南美洲,3,3,0,3,3,0,0,0,0,0,0,0,0,0,0
108,公立,一般大學,0008,國立中央大學,博士班,秘魯共和國,中南美洲,1,1,0,1,1,0,0,0,0,0,0,0,0,0,0
108,公立,一般大學,0008,國立中央大學,博士班,馬來西亞,東協,8,7,1,6,6,0,2,1,1,0,0,0,0,0,0
108,公立,一般大學,0008,國立中央大學,博士班,斯里蘭卡民主社會主義共和國,南亞,5,3,2,5,3,2,0,0,0,0,0,0,0,0,0
108,公立,一般大學,0008,國立中央大學,博士班,越南社會主義共和國,東協,117,79,38,117,79,38,0,0,0,0,0,0,0,0,0
108,公立,一般大學,0008,國立中央大學,博士班,葉門共和國,其他亞洲地區,2,2,0,2,2,0,0,0,0,0,0,0,0,0,0
108,公立,一般大學,0008,國立中央大學,博士班,蒙古國,其他亞洲地區,5,2,3,5,2,3,0,0,0,0,0,0,0,0,0
108,公立,一般大學,0008,國立中央大學,博士班,緬甸,東協,1,0,1,1,0,1,0,0,0,0,0,0,0,0,0
108,公立,一般大學,0009,國立中山大學,學士班(日間),土庫曼,其他亞洲地區,1,0,1,1,0,1,0,0,0,0,0,0,0,0,0
108,公立,一般大學,0009,國立中山大學,學士班(日間),巴拉圭,中南美洲,1,1,0,0,0,0,1,1,0,0,0,0,0,0,0
108,公立,一般大學,0009,國立中山大學,學士班(日間),加拿大,北美洲,1,0,1,1,0,1,0,0,0,0,0,0,0,0,0
108,公立,一般大學,0009,國立中山大學,學士班(日間),印度尼西亞共和國,東協,23,14,9,1,1,0,22,13,9,0,0,0,0,0,0
108,公立,一般大學,0009,國立中山大學,學士班(日間),俄羅斯聯邦,其他亞洲地區,2,0,2,2,0,2,0,0,0,0,0,0,0,0,0
108,公立,一般大學,0009,國立中山大學,學士班(日間),美國,北美洲,3,2,1,1,1,0,2,1,1,0,0,0,0,0,0
108,公立,一般大學,0009,國立中山大學,學士班(日間),哥倫比亞共和國,中南美洲,1,1,0,0,0,0,1,1,0,0,0,0,0,0,0
108,公立,一般大學,0009,國立中山大學,學士班(日間),泰國,東協,3,2,1,0,0,0,3,2,1,0,0,0,0,0,0
108,公立,一般大學,0009,國立中山大學,學士班(日間),海地共和國,中南美洲,1,1,0,1,1,0,0,0,0,0,0,0,0,0,0
108,公立,一般大學,0009,國立中山大學,學士班(日間),越南社會主義共和國,東協,5,2,3,4,1,3,1,1,0,0,0,0,0,0,0
108,公立,一般大學,0009,國立中山大學,學士班(日間),墨西哥合眾國,中南美洲,1,1,0,0,0,0,1,1,0,0,0,0,0,0,0
108,公立,一般大學,0009,國立中山大學,學士班(日間),澳門,港澳,17,12,5,0,0,0,0,0,0,17,12,5,0,0,0
108,公立,一般大學,0009,國立中山大學,學士班(日間),大陸地區,大陸地區,18,7,11,0,0,0,0,0,0,0,0,0,18,7,11
108,公立,一般大學,0009,國立中山大學,學士班(日間),大韓民國(南韓),其他亞洲地區,2,2,0,1,1,0,1,1,0,0,0,0,0,0,0
108,公立,一般大學,0009,國立中山大學,學士班(日間),日本,其他亞洲地區,14,5,9,11,3,8,3,2,1,0,0,0,0,0,0
108,公立,一般大學,0009,國立中山大學,學士班(日間),南非共和國,非洲,2,2,0,0,0,0,2,2,0,0,0,0,0,0,0
108,公立,一般大學,0009,國立中山大學,學士班(日間),香港,港澳,49,26,23,0,0,0,0,0,0,49,26,23,0,0,0
108,公立,一般大學,0009,國立中山大學,學士班(日間),馬來西亞,東協,82,43,39,2,2,0,80,41,39,0,0,0,0,0,0
108,公立,一般大學,0009,國立中山大學,學士班(日間),緬甸,東協,1,1,0,0,0,0,1,1,0,0,0,0,0,0,0
108,公立,一般大學,0009,國立中山大學,學士班(日間),薩爾瓦多,中南美洲,1,0,1,1,0,1,0,0,0,0,0,0,0,0,0
108,公立,一般大學,0009,國立中山大學,碩士班(日間),大陸地區,大陸地區,45,23,22,0,0,0,0,0,0,0,0,0,45,23,22
108,公立,一般大學,0009,國立中山大學,碩士班(日間),大韓民國(南韓),其他亞洲地區,2,1,1,2,1,1,0,0,0,0,0,0,0,0,0
108,公立,一般大學,0009,國立中山大學,碩士班(日間),伊朗伊斯蘭共和國,其他亞洲地區,1,0,1,1,0,1,0,0,0,0,0,0,0,0,0
108,公立,一般大學,0009,國立中山大學,碩士班(日間),印度,南亞,11,9,2,11,9,2,0,0,0,0,0,0,0,0,0
108,公立,一般大學,0009,國立中山大學,碩士班(日間),多明尼加共和國,中南美洲,1,0,1,1,0,1,0,0,0,0,0,0,0,0,0
108,公立,一般大學,0009,國立中山大學,碩士班(日間),西班牙王國,歐洲,1,0,1,1,0,1,0,0,0,0,0,0,0,0,0
108,公立,一般大學,0009,國立中山大學,碩士班(日間),宏都拉斯共和國,中南美洲,1,1,0,1,1,0,0,0,0,0,0,0,0,0,0
108,公立,一般大學,0009,國立中山大學,碩士班(日間),美國,北美洲,15,11,4,14,11,3,1,0,1,0,0,0,0,0,0
108,公立,一般大學,0009,國立中山大學,碩士班(日間),英國,歐洲,4,3,1,4,3,1,0,0,0,0,0,0,0,0,0
108,公立,一般大學,0009,國立中山大學,碩士班(日間),香港,港澳,17,13,4,0,0,0,0,0,0,17,13,4,0,0,0
108,公立,一般大學,0009,國立中山大學,碩士班(日間),海地共和國,中南美洲,1,1,0,1,1,0,0,0,0,0,0,0,0,0,0
108,公立,一般大學,0009,國立中山大學,碩士班(日間),秘魯共和國,中南美洲,1,0,1,1,0,1,0,0,0,0,0,0,0,0,0
108,公立,一般大學,0009,國立中山大學,碩士班(日間),馬來西亞,東協,10,5,5,5,1,4,5,4,1,0,0,0,0,0,0
108,公立,一般大學,0009,國立中山大學,碩士班(日間),捷克共和國,歐洲,1,1,0,1,1,0,0,0,0,0,0,0,0,0,0
108,公立,一般大學,0009,國立中山大學,碩士班(日間),斯里蘭卡民主社會主義共和國,南亞,8,5,3,8,5,3,0,0,0,0,0,0,0,0,0
108,公立,一般大學,0009,國立中山大學,碩士班(日間),蒙古國,其他亞洲地區,1,0,1,1,0,1,0,0,0,0,0,0,0,0,0
108,公立,一般大學,0009,國立中山大學,碩士班(日間),緬甸,東協,2,0,2,1,0,1,1,0,1,0,0,0,0,0,0
108,公立,一般大學,0009,國立中山大學,碩士班(日間),諾魯共和國,其他亞洲地區,1,0,1,1,0,1,0,0,0,0,0,0,0,0,0
108,公立,一般大學,0009,國立中山大學,碩士班(日間),土耳其共和國,其他亞洲地區,2,2,0,2,2,0,0,0,0,0,0,0,0,0,0
108,公立,一般大學,0009,國立中山大學,碩士班(日間),巴布亞紐幾內亞獨立國,其他亞洲地區,1,0,1,1,0,1,0,0,0,0,0,0,0,0,0
108,公立,一般大學,0009,國立中山大學,碩士班(日間),巴西聯邦共和國,中南美洲,2,2,0,2,2,0,0,0,0,0,0,0,0,0,0
108,公立,一般大學,0009,國立中山大學,碩士班(日間),巴拉圭,中南美洲,1,1,0,1,1,0,0,0,0,0,0,0,0,0,0
108,公立,一般大學,0009,國立中山大學,碩士班(日間),以色列,其他亞洲地區,1,1,0,1,1,0,0,0,0,0,0,0,0,0,0
108,公立,一般大學,0009,國立中山大學,碩士班(日間),加拿大,北美洲,6,5,1,6,5,1,0,0,0,0,0,0,0,0,0
108,公立,一般大學,0009,國立中山大學,碩士班(日間),尼加拉瓜,中南美洲,1,0,1,1,0,1,0,0,0,0,0,0,0,0,0
108,公立,一般大學,0009,國立中山大學,碩士班(日間),瓜地馬拉共和國,中南美洲,1,1,0,1,1,0,0,0,0,0,0,0,0,0,0
108,公立,一般大學,0009,國立中山大學,碩士班(日間),白俄羅斯共和國,其他亞洲地區,1,0,1,1,0,1,0,0,0,0,0,0,0,0,0
108,公立,一般大學,0009,國立中山大學,碩士班(日間),匈牙利共和國,歐洲,1,0,1,1,0,1,0,0,0,0,0,0,0,0,0
108,公立,一般大學,0009,國立中山大學,碩士班(日間),印度尼西亞共和國,東協,19,11,8,18,10,8,1,1,0,0,0,0,0,0,0
108,公立,一般大學,0009,國立中山大學,碩士班(日間),波蘭共和國,歐洲,5,4,1,5,4,1,0,0,0,0,0,0,0,0,0
108,公立,一般大學,0009,國立中山大學,碩士班(日間),法國,歐洲,13,5,8,13,5,8,0,0,0,0,0,0,0,0,0
108,公立,一般大學,0009,國立中山大學,碩士班(日間),俄羅斯聯邦,其他亞洲地區,11,8,3,11,8,3,0,0,0,0,0,0,0,0,0
108,公立,一般大學,0009,國立中山大學,碩士班(日間),南非共和國,非洲,1,1,0,1,1,0,0,0,0,0,0,0,0,0,0
108,公立,一般大學,0009,國立中山大學,碩士班(日間),哥倫比亞共和國,中南美洲,1,0,1,1,0,1,0,0,0,0,0,0,0,0,0
108,公立,一般大學,0009,國立中山大學,碩士班(日間),埃及阿拉伯共和國,非洲,1,0,1,1,0,1,0,0,0,0,0,0,0,0,0
108,公立,一般大學,0009,國立中山大學,碩士班(日間),泰國,東協,5,1,4,5,1,4,0,0,0,0,0,0,0,0,0
108,公立,一般大學,0009,國立中山大學,碩士班(日間),索羅門群島,其他亞洲地區,2,2,0,2,2,0,0,0,0,0,0,0,0,0,0
108,公立,一般大學,0009,國立中山大學,碩士班(日間),荷蘭王國,歐洲,1,1,0,1,1,0,0,0,0,0,0,0,0,0,0
108,公立,一般大學,0009,國立中山大學,碩士班(日間),菲律賓共和國,東協,7,6,1,6,5,1,1,1,0,0,0,0,0,0,0
108,公立,一般大學,0009,國立中山大學,碩士班(日間),越南社會主義共和國,東協,16,2,14,16,2,14,0,0,0,0,0,0,0,0,0
108,公立,一般大學,0009,國立中山大學,碩士班(日間),奧地利共和國,歐洲,16,3,13,16,3,13,0,0,0,0,0,0,0,0,0
108,公立,一般大學,0009,國立中山大學,碩士班(日間),瑞士聯邦,歐洲,1,1,0,1,1,0,0,0,0,0,0,0,0,0,0
108,公立,一般大學,0009,國立中山大學,碩士班(日間),德意志聯邦共和國,歐洲,3,1,2,3,1,2,0,0,0,0,0,0,0,0,0
108,公立,一般大學,0009,國立中山大學,碩士班(日間),澳門,港澳,3,1,2,0,0,0,0,0,0,3,1,2,0,0,0
108,公立,一般大學,0009,國立中山大學,博士班,土耳其共和國,其他亞洲地區,1,1,0,1,1,0,0,0,0,0,0,0,0,0,0
108,公立,一般大學,0009,國立中山大學,博士班,土庫曼,其他亞洲地區,4,1,3,4,1,3,0,0,0,0,0,0,0,0,0
108,公立,一般大學,0009,國立中山大學,博士班,大陸地區,大陸地區,19,8,11,0,0,0,0,0,0,0,0,0,19,8,11
108,公立,一般大學,0009,國立中山大學,博士班,巴基斯坦,南亞,1,1,0,1,1,0,0,0,0,0,0,0,0,0,0
108,公立,一般大學,0009,國立中山大學,博士班,伊朗伊斯蘭共和國,其他亞洲地區,2,1,1,2,1,1,0,0,0,0,0,0,0,0,0
108,公立,一般大學,0009,國立中山大學,博士班,匈牙利共和國,歐洲,1,0,1,1,0,1,0,0,0,0,0,0,0,0,0
108,公立,一般大學,0009,國立中山大學,博士班,哈薩克共和國,其他亞洲地區,1,0,1,1,0,1,0,0,0,0,0,0,0,0,0
108,公立,一般大學,0009,國立中山大學,博士班,美國,北美洲,3,2,1,3,2,1,0,0,0,0,0,0,0,0,0
108,公立,一般大學,0009,國立中山大學,博士班,英國,歐洲,3,2,1,3,2,1,0,0,0,0,0,0,0,0,0
108,公立,一般大學,0009,國立中山大學,博士班,香港,港澳,1,1,0,0,0,0,0,0,0,1,1,0,0,0,0
108,公立,一般大學,0009,國立中山大學,博士班,剛果共和國,非洲,1,1,0,1,1,0,0,0,0,0,0,0,0,0,0
108,公立,一般大學,0009,國立中山大學,博士班,埃及阿拉伯共和國,非洲,2,1,1,2,1,1,0,0,0,0,0,0,0,0,0
108,公立,一般大學,0009,國立中山大學,博士班,烏克蘭,其他亞洲地區,1,0,1,1,0,1,0,0,0,0,0,0,0,0,0
108,公立,一般大學,0009,國立中山大學,博士班,馬來西亞,東協,8,3,5,7,2,5,1,1,0,0,0,0,0,0,0
108,公立,一般大學,0009,國立中山大學,博士班,捷克共和國,歐洲,2,2,0,2,2,0,0,0,0,0,0,0,0,0,0
108,公立,一般大學,0009,國立中山大學,博士班,菲律賓共和國,東協,18,13,5,18,13,5,0,0,0,0,0,0,0,0,0
108,公立,一般大學,0009,國立中山大學,博士班,越南社會主義共和國,東協,11,6,5,11,6,5,0,0,0,0,0,0,0,0,0
108,公立,一般大學,0009,國立中山大學,博士班,義大利共和國,歐洲,1,1,0,1,1,0,0,0,0,0,0,0,0,0,0
108,公立,一般大學,0009,國立中山大學,博士班,德意志聯邦共和國,歐洲,2,2,0,2,2,0,0,0,0,0,0,0,0,0,0
108,公立,一般大學,0009,國立中山大學,博士班,澳門,港澳,1,1,0,0,0,0,0,0,0,1,1,0,0,0,0
108,公立,一般大學,0009,國立中山大學,博士班,日本,其他亞洲地區,1,1,0,1,1,0,0,0,0,0,0,0,0,0,0
108,公立,一般大學,0009,國立中山大學,博士班,加拿大,北美洲,1,1,0,1,1,0,0,0,0,0,0,0,0,0,0
108,公立,一般大學,0009,國立中山大學,博士班,印度,南亞,33,22,11,33,22,11,0,0,0,0,0,0,0,0,0
108,公立,一般大學,0009,國立中山大學,博士班,印度尼西亞共和國,東協,26,13,13,26,13,13,0,0,0,0,0,0,0,0,0
108,公立,一般大學,0009,國立中山大學,博士班,宏都拉斯共和國,中南美洲,1,1,0,1,1,0,0,0,0,0,0,0,0,0,0
108,公立,一般大學,0009,國立中山大學,博士班,南非共和國,非洲,1,1,0,1,1,0,0,0,0,0,0,0,0,0,0
108,公立,一般大學,0009,國立中山大學,博士班,泰國,東協,3,2,1,3,2,1,0,0,0,0,0,0,0,0,0
108,公立,一般大學,0009,國立中山大學,博士班,納米比亞共和國,非洲,1,1,0,1,1,0,0,0,0,0,0,0,0,0,0
108,公立,一般大學,0009,國立中山大學,博士班,斯里蘭卡民主社會主義共和國,南亞,2,2,0,2,2,0,0,0,0,0,0,0,0,0,0
108,公立,一般大學,0009,國立中山大學,博士班,新加坡共和國,東協,1,0,1,1,0,1,0,0,0,0,0,0,0,0,0
108,公立,一般大學,0012,國立臺灣海洋大學,學士班(日間),大陸地區,大陸地區,14,9,5,0,0,0,0,0,0,0,0,0,14,9,5
108,公立,一般大學,0012,國立臺灣海洋大學,學士班(日間),巴拿馬共和國,中南美洲,1,0,1,1,0,1,0,0,0,0,0,0,0,0,0
108,公立,一般大學,0012,國立臺灣海洋大學,學士班(日間),日本,其他亞洲地區,3,2,1,3,2,1,0,0,0,0,0,0,0,0,0
108,公立,一般大學,0012,國立臺灣海洋大學,學士班(日間),印度尼西亞共和國,東協,65,27,38,7,4,3,58,23,35,0,0,0,0,0,0
108,公立,一般大學,0012,國立臺灣海洋大學,學士班(日間),多明尼加共和國,中南美洲,1,0,1,0,0,0,1,0,1,0,0,0,0,0,0
108,公立,一般大學,0012,國立臺灣海洋大學,學士班(日間),貝里斯,中南美洲,1,0,1,1,0,1,0,0,0,0,0,0,0,0,0
108,公立,一般大學,0012,國立臺灣海洋大學,學士班(日間),南非共和國,非洲,1,1,0,0,0,0,1,1,0,0,0,0,0,0,0
108,公立,一般大學,0012,國立臺灣海洋大學,學士班(日間),香港,港澳,76,62,14,0,0,0,0,0,0,76,62,14,0,0,0
108,公立,一般大學,0012,國立臺灣海洋大學,學士班(日間),新加坡共和國,東協,1,0,1,0,0,0,1,0,1,0,0,0,0,0,0
108,公立,一般大學,0012,國立臺灣海洋大學,學士班(日間),聖文森(及格瑞那丁),中南美洲,1,0,1,1,0,1,0,0,0,0,0,0,0,0,0
108,公立,一般大學,0012,國立臺灣海洋大學,學士班(日間),緬甸,東協,22,17,5,0,0,0,22,17,5,0,0,0,0,0,0
108,公立,一般大學,0012,國立臺灣海洋大學,學士班(日間),澳門,港澳,33,28,5,0,0,0,0,0,0,33,28,5,0,0,0
108,公立,一般大學,0012,國立臺灣海洋大學,學士班(日間),俄羅斯聯邦,其他亞洲地區,1,0,1,1,0,1,0,0,0,0,0,0,0,0,0
108,公立,一般大學,0012,國立臺灣海洋大學,學士班(日間),美國,北美洲,1,1,0,1,1,0,0,0,0,0,0,0,0,0,0
108,公立,一般大學,0012,國立臺灣海洋大學,學士班(日間),馬來西亞,東協,183,128,55,21,19,2,162,109,53,0,0,0,0,0,0
108,公立,一般大學,0012,國立臺灣海洋大學,學士班(日間),菲律賓共和國,東協,1,1,0,0,0,0,1,1,0,0,0,0,0,0,0
108,公立,一般大學,0012,國立臺灣海洋大學,學士班(日間),越南社會主義共和國,東協,7,6,1,1,1,0,6,5,1,0,0,0,0,0,0
108,公立,一般大學,0012,國立臺灣海洋大學,學士班(日間),聖露西亞,中南美洲,1,0,1,1,0,1,0,0,0,0,0,0,0,0,0
108,公立,一般大學,0012,國立臺灣海洋大學,碩士班(日間),土耳其共和國,其他亞洲地區,1,1,0,1,1,0,0,0,0,0,0,0,0,0,0
108,公立,一般大學,0012,國立臺灣海洋大學,碩士班(日間),印度尼西亞共和國,東協,23,6,17,18,4,14,5,2,3,0,0,0,0,0,0
108,公立,一般大學,0012,國立臺灣海洋大學,碩士班(日間),吉里巴斯共和國,其他亞洲地區,5,1,4,5,1,4,0,0,0,0,0,0,0,0,0
108,公立,一般大學,0012,國立臺灣海洋大學,碩士班(日間),美國,北美洲,1,1,0,1,1,0,0,0,0,0,0,0,0,0,0
108,公立,一般大學,0012,國立臺灣海洋大學,碩士班(日間),馬來西亞,東協,18,7,11,3,1,2,15,6,9,0,0,0,0,0,0
108,公立,一般大學,0012,國立臺灣海洋大學,碩士班(日間),斐濟群島共和國,其他亞洲地區,2,1,1,2,1,1,0,0,0,0,0,0,0,0,0
108,公立,一般大學,0012,國立臺灣海洋大學,碩士班(日間),菲律賓共和國,東協,3,2,1,3,2,1,0,0,0,0,0,0,0,0,0
108,公立,一般大學,0012,國立臺灣海洋大學,碩士班(日間),越南社會主義共和國,東協,8,3,5,7,2,5,1,1,0,0,0,0,0,0,0
108,公立,一般大學,0012,國立臺灣海洋大學,碩士班(日間),蒙古國,其他亞洲地區,2,0,2,2,0,2,0,0,0,0,0,0,0,0,0
108,公立,一般大學,0012,國立臺灣海洋大學,碩士班(日間),澳門,港澳,1,1,0,0,0,0,0,0,0,1,1,0,0,0,0
108,公立,一般大學,0012,國立臺灣海洋大學,碩士班(日間),大陸地區,大陸地區,3,1,2,0,0,0,0,0,0,0,0,0,3,1,2
108,公立,一般大學,0012,國立臺灣海洋大學,碩士班(日間),大韓民國(南韓),其他亞洲地區,1,0,1,1,0,1,0,0,0,0,0,0,0,0,0
108,公立,一般大學,0012,國立臺灣海洋大學,碩士班(日間),布吉納法索,非洲,1,1,0,1,1,0,0,0,0,0,0,0,0,0,0
108,公立,一般大學,0012,國立臺灣海洋大學,碩士班(日間),印度,南亞,1,1,0,1,1,0,0,0,0,0,0,0,0,0,0
108,公立,一般大學,0012,國立臺灣海洋大學,碩士班(日間),宏都拉斯共和國,中南美洲,1,1,0,1,1,0,0,0,0,0,0,0,0,0,0
108,公立,一般大學,0012,國立臺灣海洋大學,碩士班(日間),南非共和國,非洲,1,1,0,1,1,0,0,0,0,0,0,0,0,0,0
108,公立,一般大學,0012,國立臺灣海洋大學,碩士班(日間),香港,港澳,8,4,4,0,0,0,0,0,0,8,4,4,0,0,0
108,公立,一般大學,0012,國立臺灣海洋大學,碩士班(日間),海地共和國,中南美洲,1,1,0,1,1,0,0,0,0,0,0,0,0,0,0
108,公立,一般大學,0012,國立臺灣海洋大學,碩士班(日間),秘魯共和國,中南美洲,1,0,1,1,0,1,0,0,0,0,0,0,0,0,0
108,公立,一般大學,0012,國立臺灣海洋大學,碩士班(日間),澳大利亞,其他亞洲地區,1,1,0,1,1,0,0,0,0,0,0,0,0,0,0
108,公立,一般大學,0012,國立臺灣海洋大學,博士班,加拿大,北美洲,2,2,0,2,2,0,0,0,0,0,0,0,0,0,0
108,公立,一般大學,0012,國立臺灣海洋大學,博士班,印度尼西亞共和國,東協,12,8,4,12,8,4,0,0,0,0,0,0,0,0,0
108,公立,一般大學,0012,國立臺灣海洋大學,博士班,泰國,東協,1,1,0,1,1,0,0,0,0,0,0,0,0,0,0
108,公立,一般大學,0012,國立臺灣海洋大學,博士班,越南社會主義共和國,東協,7,5,2,7,5,2,0,0,0,0,0,0,0,0,0
108,公立,一般大學,0012,國立臺灣海洋大學,博士班,德意志聯邦共和國,歐洲,1,1,0,1,1,0,0,0,0,0,0,0,0,0,0
108,公立,一般大學,0012,國立臺灣海洋大學,博士班,大陸地區,大陸地區,9,4,5,0,0,0,0,0,0,0,0,0,9,4,5
108,公立,一般大學,0012,國立臺灣海洋大學,博士班,大韓民國(南韓),其他亞洲地區,2,0,2,2,0,2,0,0,0,0,0,0,0,0,0
108,公立,一般大學,0012,國立臺灣海洋大學,博士班,印度,南亞,3,2,1,3,2,1,0,0,0,0,0,0,0,0,0
108,公立,一般大學,0012,國立臺灣海洋大學,博士班,海地共和國,中南美洲,1,1,0,1,1,0,0,0,0,0,0,0,0,0,0
108,公立,一般大學,0012,國立臺灣海洋大學,博士班,馬來西亞,東協,3,1,2,2,1,1,1,0,1,0,0,0,0,0,0
108,公立,一般大學,0012,國立臺灣海洋大學,博士班,菲律賓共和國,東協,4,1,3,4,1,3,0,0,0,0,0,0,0,0,0
108,公立,一般大學,0013,國立中正大學,學士班(日間),大陸地區,大陸地區,16,8,8,0,0,0,0,0,0,0,0,0,16,8,8
108,公立,一般大學,0013,國立中正大學,學士班(日間),大韓民國(南韓),其他亞洲地區,1,1,0,0,0,0,1,1,0,0,0,0,0,0,0
108,公立,一般大學,0013,國立中正大學,學士班(日間),日本,其他亞洲地區,11,3,8,9,2,7,2,1,1,0,0,0,0,0,0
108,公立,一般大學,0013,國立中正大學,學士班(日間),印度尼西亞共和國,東協,38,18,20,1,1,0,37,17,20,0,0,0,0,0,0
108,公立,一般大學,0013,國立中正大學,學士班(日間),俄羅斯聯邦,其他亞洲地區,9,1,8,9,1,8,0,0,0,0,0,0,0,0,0
108,公立,一般大學,0013,國立中正大學,學士班(日間),泰國,東協,1,1,0,0,0,0,1,1,0,0,0,0,0,0,0
108,公立,一般大學,0013,國立中正大學,學士班(日間),香港,港澳,34,24,10,0,0,0,0,0,0,34,24,10,0,0,0
108,公立,一般大學,0013,國立中正大學,學士班(日間),馬來西亞,東協,115,53,62,6,2,4,109,51,58,0,0,0,0,0,0
108,公立,一般大學,0013,國立中正大學,學士班(日間),越南社會主義共和國,東協,7,5,2,4,3,1,3,2,1,0,0,0,0,0,0
108,公立,一般大學,0013,國立中正大學,學士班(日間),澳門,港澳,58,42,16,0,0,0,0,0,0,58,42,16,0,0,0
108,公立,一般大學,0013,國立中正大學,學士班(日間),緬甸,東協,3,1,2,0,0,0,3,1,2,0,0,0,0,0,0
108,公立,一般大學,0013,國立中正大學,碩士班(日間),巴西聯邦共和國,中南美洲,1,0,1,1,0,1,0,0,0,0,0,0,0,0,0
108,公立,一般大學,0013,國立中正大學,碩士班(日間),尼加拉瓜,中南美洲,2,2,0,2,2,0,0,0,0,0,0,0,0,0,0
108,公立,一般大學,0013,國立中正大學,碩士班(日間),甘比亞共和國,非洲,2,2,0,2,2,0,0,0,0,0,0,0,0,0,0
108,公立,一般大學,0013,國立中正大學,碩士班(日間),孟加拉人民共和國,南亞,1,1,0,1,1,0,0,0,0,0,0,0,0,0,0
108,公立,一般大學,0013,國立中正大學,碩士班(日間),俄羅斯聯邦,其他亞洲地區,1,0,1,1,0,1,0,0,0,0,0,0,0,0,0
108,公立,一般大學,0013,國立中正大學,碩士班(日間),泰國,東協,15,5,10,15,5,10,0,0,0,0,0,0,0,0,0
108,公立,一般大學,0013,國立中正大學,碩士班(日間),海地共和國,中南美洲,1,1,0,1,1,0,0,0,0,0,0,0,0,0,0
108,公立,一般大學,0013,國立中正大學,碩士班(日間),索羅門群島,其他亞洲地區,1,1,0,1,1,0,0,0,0,0,0,0,0,0,0
108,公立,一般大學,0013,國立中正大學,碩士班(日間),蒙古國,其他亞洲地區,6,3,3,6,3,3,0,0,0,0,0,0,0,0,0
108,公立,一般大學,0013,國立中正大學,碩士班(日間),墨西哥合眾國,中南美洲,1,0,1,1,0,1,0,0,0,0,0,0,0,0,0
108,公立,一般大學,0013,國立中正大學,碩士班(日間),澳大利亞,其他亞洲地區,1,1,0,1,1,0,0,0,0,0,0,0,0,0,0
108,公立,一般大學,0013,國立中正大學,碩士班(日間),大陸地區,大陸地區,13,8,5,0,0,0,0,0,0,0,0,0,13,8,5
108,公立,一般大學,0013,國立中正大學,碩士班(日間),大韓民國(南韓),其他亞洲地區,2,0,2,1,0,1,1,0,1,0,0,0,0,0,0
108,公立,一般大學,0013,國立中正大學,碩士班(日間),厄瓜多共和國,中南美洲,1,0,1,1,0,1,0,0,0,0,0,0,0,0,0
108,公立,一般大學,0013,國立中正大學,碩士班(日間),日本,其他亞洲地區,2,0,2,2,0,2,0,0,0,0,0,0,0,0,0
108,公立,一般大學,0013,國立中正大學,碩士班(日間),伊朗伊斯蘭共和國,其他亞洲地區,1,0,1,1,0,1,0,0,0,0,0,0,0,0,0
108,公立,一般大學,0013,國立中正大學,碩士班(日間),印度,南亞,18,16,2,18,16,2,0,0,0,0,0,0,0,0,0
108,公立,一般大學,0013,國立中正大學,碩士班(日間),印度尼西亞共和國,東協,17,7,10,17,7,10,0,0,0,0,0,0,0,0,0
108,公立,一般大學,0013,國立中正大學,碩士班(日間),宏都拉斯共和國,中南美洲,1,0,1,1,0,1,0,0,0,0,0,0,0,0,0
108,公立,一般大學,0013,國立中正大學,碩士班(日間),貝里斯,中南美洲,4,2,2,4,2,2,0,0,0,0,0,0,0,0,0
108,公立,一般大學,0013,國立中正大學,碩士班(日間),波蘭共和國,歐洲,2,1,1,2,1,1,0,0,0,0,0,0,0,0,0
108,公立,一般大學,0013,國立中正大學,碩士班(日間),南非共和國,非洲,2,1,1,2,1,1,0,0,0,0,0,0,0,0,0
108,公立,一般大學,0013,國立中正大學,碩士班(日間),香港,港澳,7,4,3,0,0,0,0,0,0,7,4,3,0,0,0
108,公立,一般大學,0013,國立中正大學,碩士班(日間),哥倫比亞共和國,中南美洲,1,1,0,1,1,0,0,0,0,0,0,0,0,0,0
108,公立,一般大學,0013,國立中正大學,碩士班(日間),馬來西亞,東協,11,5,6,6,2,4,5,3,2,0,0,0,0,0,0
108,公立,一般大學,0013,國立中正大學,碩士班(日間),菲律賓共和國,東協,3,0,3,3,0,3,0,0,0,0,0,0,0,0,0
108,公立,一般大學,0013,國立中正大學,碩士班(日間),越南社會主義共和國,東協,19,11,8,19,11,8,0,0,0,0,0,0,0,0,0
108,公立,一般大學,0013,國立中正大學,碩士班(日間),澳門,港澳,2,1,1,0,0,0,0,0,0,2,1,1,0,0,0
108,公立,一般大學,0013,國立中正大學,博士班,大陸地區,大陸地區,12,9,3,0,0,0,0,0,0,0,0,0,12,9,3
108,公立,一般大學,0013,國立中正大學,博士班,日本,其他亞洲地區,1,1,0,1,1,0,0,0,0,0,0,0,0,0,0
108,公立,一般大學,0013,國立中正大學,博士班,尼加拉瓜,中南美洲,1,1,0,1,1,0,0,0,0,0,0,0,0,0,0
108,公立,一般大學,0013,國立中正大學,博士班,甘比亞共和國,非洲,1,1,0,1,1,0,0,0,0,0,0,0,0,0,0
108,公立,一般大學,0013,國立中正大學,博士班,伊朗伊斯蘭共和國,其他亞洲地區,1,1,0,1,1,0,0,0,0,0,0,0,0,0,0
108,公立,一般大學,0013,國立中正大學,博士班,印度,南亞,14,9,5,14,9,5,0,0,0,0,0,0,0,0,0
108,公立,一般大學,0013,國立中正大學,博士班,貝里斯,中南美洲,1,1,0,1,1,0,0,0,0,0,0,0,0,0,0
108,公立,一般大學,0013,國立中正大學,博士班,香港,港澳,2,2,0,0,0,0,0,0,0,2,2,0,0,0,0
108,公立,一般大學,0013,國立中正大學,博士班,越南社會主義共和國,東協,25,15,10,25,15,10,0,0,0,0,0,0,0,0,0
108,公立,一般大學,0013,國立中正大學,博士班,澳門,港澳,3,3,0,0,0,0,0,0,0,3,3,0,0,0,0
108,公立,一般大學,0013,國立中正大學,博士班,巴基斯坦,南亞,2,2,0,2,2,0,0,0,0,0,0,0,0,0,0
108,公立,一般大學,0013,國立中正大學,博士班,布吉納法索,非洲,1,1,0,1,1,0,0,0,0,0,0,0,0,0,0
108,公立,一般大學,0013,國立中正大學,博士班,印度尼西亞共和國,東協,11,6,5,11,6,5,0,0,0,0,0,0,0,0,0
108,公立,一般大學,0013,國立中正大學,博士班,柬埔寨王國,東協,1,1,0,1,1,0,0,0,0,0,0,0,0,0,0
108,公立,一般大學,0013,國立中正大學,博士班,泰國,東協,4,2,2,4,2,2,0,0,0,0,0,0,0,0,0
108,公立,一般大學,0013,國立中正大學,博士班,馬來西亞,東協,7,5,2,5,3,2,2,2,0,0,0,0,0,0,0
108,公立,一般大學,0014,國立高雄師範大學,學士班(日間),大韓民國(南韓),其他亞洲地區,1,0,1,0,0,0,1,0,1,0,0,0,0,0,0
108,公立,一般大學,0014,國立高雄師範大學,學士班(日間),日本,其他亞洲地區,3,1,2,2,1,1,1,0,1,0,0,0,0,0,0
108,公立,一般大學,0014,國立高雄師範大學,學士班(日間),印度尼西亞共和國,東協,8,3,5,0,0,0,8,3,5,0,0,0,0,0,0
108,公立,一般大學,0014,國立高雄師範大學,學士班(日間),美國,北美洲,1,1,0,1,1,0,0,0,0,0,0,0,0,0,0
108,公立,一般大學,0014,國立高雄師範大學,學士班(日間),馬來西亞,東協,30,11,19,1,0,1,29,11,18,0,0,0,0,0,0
108,公立,一般大學,0014,國立高雄師範大學,學士班(日間),新加坡共和國,東協,1,0,1,0,0,0,1,0,1,0,0,0,0,0,0
108,公立,一般大學,0014,國立高雄師範大學,學士班(日間),大陸地區,大陸地區,15,5,10,0,0,0,0,0,0,0,0,0,15,5,10
108,公立,一般大學,0014,國立高雄師範大學,學士班(日間),阿根廷,中南美洲,1,0,1,0,0,0,1,0,1,0,0,0,0,0,0
108,公立,一般大學,0014,國立高雄師範大學,學士班(日間),香港,港澳,7,4,3,0,0,0,0,0,0,7,4,3,0,0,0
108,公立,一般大學,0014,國立高雄師範大學,學士班(日間),越南社會主義共和國,東協,5,0,5,5,0,5,0,0,0,0,0,0,0,0,0
108,公立,一般大學,0014,國立高雄師範大學,學士班(日間),澳門,港澳,39,25,14,0,0,0,0,0,0,39,25,14,0,0,0
108,公立,一般大學,0014,國立高雄師範大學,碩士班(日間),大陸地區,大陸地區,17,9,8,0,0,0,0,0,0,0,0,0,17,9,8
108,公立,一般大學,0014,國立高雄師範大學,碩士班(日間),印度,南亞,2,2,0,2,2,0,0,0,0,0,0,0,0,0,0
108,公立,一般大學,0014,國立高雄師範大學,碩士班(日間),波蘭共和國,歐洲,1,0,1,1,0,1,0,0,0,0,0,0,0,0,0
108,公立,一般大學,0014,國立高雄師範大學,碩士班(日間),阿富汗伊斯蘭共和國,其他亞洲地區,1,1,0,1,1,0,0,0,0,0,0,0,0,0,0
108,公立,一般大學,0014,國立高雄師範大學,碩士班(日間),香港,港澳,5,3,2,0,0,0,0,0,0,5,3,2,0,0,0
108,公立,一般大學,0014,國立高雄師範大學,碩士班(日間),越南社會主義共和國,東協,5,0,5,4,0,4,1,0,1,0,0,0,0,0,0
108,公立,一般大學,0014,國立高雄師範大學,碩士班(日間),澳門,港澳,6,1,5,0,0,0,0,0,0,6,1,5,0,0,0
108,公立,一般大學,0014,國立高雄師範大學,碩士班(日間),大韓民國(南韓),其他亞洲地區,6,3,3,6,3,3,0,0,0,0,0,0,0,0,0
108,公立,一般大學,0014,國立高雄師範大學,碩士班(日間),日本,其他亞洲地區,2,1,1,2,1,1,0,0,0,0,0,0,0,0,0
108,公立,一般大學,0014,國立高雄師範大學,碩士班(日間),印度尼西亞共和國,東協,1,1,0,1,1,0,0,0,0,0,0,0,0,0,0
108,公立,一般大學,0014,國立高雄師範大學,碩士班(日間),泰國,東協,5,1,4,4,0,4,1,1,0,0,0,0,0,0,0
108,公立,一般大學,0014,國立高雄師範大學,碩士班(日間),馬來西亞,東協,6,1,5,1,0,1,5,1,4,0,0,0,0,0,0
108,公立,一般大學,0014,國立高雄師範大學,博士班,大陸地區,大陸地區,12,6,6,0,0,0,0,0,0,0,0,0,12,6,6
108,公立,一般大學,0014,國立高雄師範大學,博士班,大韓民國(南韓),其他亞洲地區,1,0,1,1,0,1,0,0,0,0,0,0,0,0,0
108,公立,一般大學,0014,國立高雄師範大學,博士班,英國,歐洲,1,1,0,1,1,0,0,0,0,0,0,0,0,0,0
108,公立,一般大學,0014,國立高雄師範大學,博士班,香港,港澳,1,0,1,0,0,0,0,0,0,1,0,1,0,0,0
108,公立,一般大學,0014,國立高雄師範大學,博士班,越南社會主義共和國,東協,2,1,1,2,1,1,0,0,0,0,0,0,0,0,0
108,公立,一般大學,0014,國立高雄師範大學,博士班,澳門,港澳,2,2,0,0,0,0,0,0,0,2,2,0,0,0,0
108,公立,一般大學,0014,國立高雄師範大學,博士班,蒙古國,其他亞洲地區,1,0,1,1,0,1,0,0,0,0,0,0,0,0,0
108,公立,一般大學,0014,國立高雄師範大學,博士班,德意志聯邦共和國,歐洲,1,1,0,1,1,0,0,0,0,0,0,0,0,0,0
108,公立,一般大學,0015,國立彰化師範大學,學士班(日間),大陸地區,大陸地區,16,6,10,0,0,0,0,0,0,0,0,0,16,6,10
108,公立,一般大學,0015,國立彰化師範大學,學士班(日間),日本,其他亞洲地區,4,3,1,4,3,1,0,0,0,0,0,0,0,0,0
108,公立,一般大學,0015,國立彰化師範大學,學士班(日間),印度尼西亞共和國,東協,2,1,1,0,0,0,2,1,1,0,0,0,0,0,0
108,公立,一般大學,0015,國立彰化師範大學,學士班(日間),香港,港澳,40,23,17,0,0,0,0,0,0,40,23,17,0,0,0
108,公立,一般大學,0015,國立彰化師範大學,學士班(日間),越南社會主義共和國,東協,10,5,5,4,0,4,6,5,1,0,0,0,0,0,0
108,公立,一般大學,0015,國立彰化師範大學,學士班(日間),緬甸,東協,2,0,2,0,0,0,2,0,2,0,0,0,0,0,0
108,公立,一般大學,0015,國立彰化師範大學,學士班(日間),澳門,港澳,63,28,35,0,0,0,0,0,0,63,28,35,0,0,0
108,公立,一般大學,0015,國立彰化師範大學,學士班(日間),美國,北美洲,1,1,0,1,1,0,0,0,0,0,0,0,0,0,0
108,公立,一般大學,0015,國立彰化師範大學,學士班(日間),馬來西亞,東協,119,54,65,13,2,11,106,52,54,0,0,0,0,0,0
108,公立,一般大學,0015,國立彰化師範大學,學士班(日間),菲律賓共和國,東協,2,0,2,0,0,0,2,0,2,0,0,0,0,0,0
108,公立,一般大學,0015,國立彰化師範大學,碩士班(日間),大陸地區,大陸地區,6,1,5,0,0,0,0,0,0,0,0,0,6,1,5
108,公立,一般大學,0015,國立彰化師範大學,碩士班(日間),香港,港澳,4,2,2,0,0,0,0,0,0,4,2,2,0,0,0
108,公立,一般大學,0015,國立彰化師範大學,碩士班(日間),新加坡共和國,東協,1,1,0,0,0,0,1,1,0,0,0,0,0,0,0
108,公立,一般大學,0015,國立彰化師範大學,碩士班(日間),澳門,港澳,7,3,4,0,0,0,0,0,0,7,3,4,0,0,0
108,公立,一般大學,0015,國立彰化師範大學,碩士班(日間),美國,北美洲,1,1,0,1,1,0,0,0,0,0,0,0,0,0,0
108,公立,一般大學,0015,國立彰化師範大學,碩士班(日間),泰國,東協,1,1,0,0,0,0,1,1,0,0,0,0,0,0,0
108,公立,一般大學,0015,國立彰化師範大學,碩士班(日間),馬來西亞,東協,15,3,12,9,1,8,6,2,4,0,0,0,0,0,0
108,公立,一般大學,0015,國立彰化師範大學,碩士班(日間),菲律賓共和國,東協,1,0,1,0,0,0,1,0,1,0,0,0,0,0,0
108,公立,一般大學,0015,國立彰化師範大學,博士班,大陸地區,大陸地區,14,6,8,0,0,0,0,0,0,0,0,0,14,6,8
108,公立,一般大學,0015,國立彰化師範大學,博士班,印度,南亞,5,4,1,5,4,1,0,0,0,0,0,0,0,0,0
108,公立,一般大學,0015,國立彰化師範大學,博士班,香港,港澳,1,1,0,0,0,0,0,0,0,1,1,0,0,0,0
108,公立,一般大學,0015,國立彰化師範大學,博士班,馬來西亞,東協,2,0,2,2,0,2,0,0,0,0,0,0,0,0,0
108,公立,一般大學,0015,國立彰化師範大學,博士班,越南社會主義共和國,東協,3,3,0,3,3,0,0,0,0,0,0,0,0,0,0
108,公立,一般大學,0015,國立彰化師範大學,博士班,新加坡共和國,東協,1,1,0,1,1,0,0,0,0,0,0,0,0,0,0
108,公立,一般大學,0016,國立陽明大學,學士班(日間),大陸地區,大陸地區,14,5,9,0,0,0,0,0,0,0,0,0,14,5,9
108,公立,一般大學,0016,國立陽明大學,學士班(日間),日本,其他亞洲地區,3,3,0,2,2,0,1,1,0,0,0,0,0,0,0
108,公立,一般大學,0016,國立陽明大學,學士班(日間),加拿大,北美洲,2,2,0,0,0,0,2,2,0,0,0,0,0,0,0
108,公立,一般大學,0016,國立陽明大學,學士班(日間),印度尼西亞共和國,東協,8,5,3,0,0,0,8,5,3,0,0,0,0,0,0
108,公立,一般大學,0016,國立陽明大學,學士班(日間),香港,港澳,17,6,11,0,0,0,0,0,0,17,6,11,0,0,0
108,公立,一般大學,0016,國立陽明大學,學士班(日間),泰國,東協,1,0,1,0,0,0,1,0,1,0,0,0,0,0,0
108,公立,一般大學,0016,國立陽明大學,學士班(日間),新加坡共和國,東協,2,1,1,0,0,0,2,1,1,0,0,0,0,0,0
108,公立,一般大學,0016,國立陽明大學,學士班(日間),緬甸,東協,1,0,1,0,0,0,1,0,1,0,0,0,0,0,0
108,公立,一般大學,0016,國立陽明大學,學士班(日間),大韓民國(南韓),其他亞洲地區,7,3,4,2,1,1,5,2,3,0,0,0,0,0,0
108,公立,一般大學,0016,國立陽明大學,學士班(日間),巴拉圭,中南美洲,3,0,3,2,0,2,1,0,1,0,0,0,0,0,0
108,公立,一般大學,0016,國立陽明大學,學士班(日間),美國,北美洲,7,4,3,1,0,1,6,4,2,0,0,0,0,0,0
108,公立,一般大學,0016,國立陽明大學,學士班(日間),英國,歐洲,1,0,1,1,0,1,0,0,0,0,0,0,0,0,0
108,公立,一般大學,0016,國立陽明大學,學士班(日間),馬來西亞,東協,58,15,43,1,0,1,57,15,42,0,0,0,0,0,0
108,公立,一般大學,0016,國立陽明大學,學士班(日間),菲律賓共和國,東協,2,1,1,2,1,1,0,0,0,0,0,0,0,0,0
108,公立,一般大學,0016,國立陽明大學,學士班(日間),越南社會主義共和國,東協,1,0,1,0,0,0,1,0,1,0,0,0,0,0,0
108,公立,一般大學,0016,國立陽明大學,學士班(日間),蒙古國,其他亞洲地區,2,0,2,1,0,1,1,0,1,0,0,0,0,0,0
108,公立,一般大學,0016,國立陽明大學,學士班(日間),澳門,港澳,10,7,3,0,0,0,0,0,0,10,7,3,0,0,0
108,公立,一般大學,0016,國立陽明大學,碩士班(日間),大陸地區,大陸地區,5,2,3,0,0,0,0,0,0,0,0,0,5,2,3
108,公立,一般大學,0016,國立陽明大學,碩士班(日間),巴拉圭,中南美洲,1,1,0,0,0,0,1,1,0,0,0,0,0,0,0
108,公立,一般大學,0016,國立陽明大學,碩士班(日間),巴基斯坦,南亞,1,0,1,1,0,1,0,0,0,0,0,0,0,0,0
108,公立,一般大學,0016,國立陽明大學,碩士班(日間),貝里斯,中南美洲,3,0,3,3,0,3,0,0,0,0,0,0,0,0,0
108,公立,一般大學,0016,國立陽明大學,碩士班(日間),香港,港澳,3,2,1,0,0,0,0,0,0,3,2,1,0,0,0
108,公立,一般大學,0016,國立陽明大學,碩士班(日間),馬拉威共和國,非洲,1,0,1,1,0,1,0,0,0,0,0,0,0,0,0
108,公立,一般大學,0016,國立陽明大學,碩士班(日間),菲律賓共和國,東協,4,3,1,3,2,1,1,1,0,0,0,0,0,0,0
108,公立,一般大學,0016,國立陽明大學,碩士班(日間),越南社會主義共和國,東協,19,6,13,19,6,13,0,0,0,0,0,0,0,0,0
108,公立,一般大學,0016,國立陽明大學,碩士班(日間),聖文森(及格瑞那丁),中南美洲,1,0,1,1,0,1,0,0,0,0,0,0,0,0,0
108,公立,一般大學,0016,國立陽明大學,碩士班(日間),摩洛哥王國,非洲,1,1,0,1,1,0,0,0,0,0,0,0,0,0,0
108,公立,一般大學,0016,國立陽明大學,碩士班(日間),澳門,港澳,5,2,3,0,0,0,0,0,0,5,2,3,0,0,0
108,公立,一般大學,0016,國立陽明大學,碩士班(日間),加拿大,北美洲,1,1,0,0,0,0,1,1,0,0,0,0,0,0,0
108,公立,一般大學,0016,國立陽明大學,碩士班(日間),史瓦帝尼王國,非洲,5,2,3,5,2,3,0,0,0,0,0,0,0,0,0
108,公立,一般大學,0016,國立陽明大學,碩士班(日間),印度尼西亞共和國,東協,1,0,1,1,0,1,0,0,0,0,0,0,0,0,0
108,公立,一般大學,0016,國立陽明大學,碩士班(日間),宏都拉斯共和國,中南美洲,2,1,1,2,1,1,0,0,0,0,0,0,0,0,0
108,公立,一般大學,0016,國立陽明大學,碩士班(日間),英國,歐洲,1,0,1,1,0,1,0,0,0,0,0,0,0,0,0
108,公立,一般大學,0016,國立陽明大學,碩士班(日間),馬來西亞,東協,11,5,6,6,2,4,5,3,2,0,0,0,0,0,0
108,公立,一般大學,0016,國立陽明大學,博士班,加拿大,北美洲,1,1,0,0,0,0,1,1,0,0,0,0,0,0,0
108,公立,一般大學,0016,國立陽明大學,博士班,史瓦帝尼王國,非洲,6,5,1,6,5,1,0,0,0,0,0,0,0,0,0
108,公立,一般大學,0016,國立陽明大學,博士班,印度尼西亞共和國,東協,8,1,7,8,1,7,0,0,0,0,0,0,0,0,0
108,公立,一般大學,0016,國立陽明大學,博士班,衣索比亞聯邦民主共和國,非洲,1,1,0,1,1,0,0,0,0,0,0,0,0,0,0
108,公立,一般大學,0016,國立陽明大學,博士班,宏都拉斯共和國,中南美洲,1,0,1,1,0,1,0,0,0,0,0,0,0,0,0
108,公立,一般大學,0016,國立陽明大學,博士班,孟加拉人民共和國,南亞,2,2,0,2,2,0,0,0,0,0,0,0,0,0,0
108,公立,一般大學,0016,國立陽明大學,博士班,法國,歐洲,1,1,0,1,1,0,0,0,0,0,0,0,0,0,0
108,公立,一般大學,0016,國立陽明大學,博士班,泰國,東協,2,2,0,2,2,0,0,0,0,0,0,0,0,0,0
108,公立,一般大學,0016,國立陽明大學,博士班,越南社會主義共和國,東協,12,5,7,12,5,7,0,0,0,0,0,0,0,0,0
108,公立,一般大學,0016,國立陽明大學,博士班,墨西哥合眾國,中南美洲,1,0,1,1,0,1,0,0,0,0,0,0,0,0,0
108,公立,一般大學,0016,國立陽明大學,博士班,澳門,港澳,1,0,1,0,0,0,0,0,0,1,0,1,0,0,0
108,公立,一般大學,0016,國立陽明大學,博士班,巴基斯坦,南亞,1,1,0,1,1,0,0,0,0,0,0,0,0,0,0
108,公立,一般大學,0016,國立陽明大學,博士班,尼泊爾聯邦民主共和國,南亞,1,1,0,1,1,0,0,0,0,0,0,0,0,0,0
108,公立,一般大學,0016,國立陽明大學,博士班,布吉納法索,非洲,1,1,0,1,1,0,0,0,0,0,0,0,0,0,0
108,公立,一般大學,0016,國立陽明大學,博士班,甘比亞共和國,非洲,1,1,0,1,1,0,0,0,0,0,0,0,0,0,0
108,公立,一般大學,0016,國立陽明大學,博士班,印度,南亞,21,15,6,21,15,6,0,0,0,0,0,0,0,0,0
108,公立,一般大學,0016,國立陽明大學,博士班,西班牙王國,歐洲,1,1,0,1,1,0,0,0,0,0,0,0,0,0,0
108,公立,一般大學,0016,國立陽明大學,博士班,汶萊和平之國,東協,1,1,0,1,1,0,0,0,0,0,0,0,0,0,0
108,公立,一般大學,0016,國立陽明大學,博士班,奈及利亞聯邦共和國,非洲,8,7,1,8,7,1,0,0,0,0,0,0,0,0,0
108,公立,一般大學,0016,國立陽明大學,博士班,美國,北美洲,2,2,0,1,1,0,1,1,0,0,0,0,0,0,0
108,公立,一般大學,0016,國立陽明大學,博士班,馬來西亞,東協,11,5,6,8,4,4,3,1,2,0,0,0,0,0,0
108,公立,一般大學,0016,國立陽明大學,博士班,菲律賓共和國,東協,4,2,2,4,2,2,0,0,0,0,0,0,0,0,0
108,公立,一般大學,0016,國立陽明大學,博士班,新加坡共和國,東協,1,0,1,0,0,0,1,0,1,0,0,0,0,0,0
108,公立,一般大學,0016,國立陽明大學,博士班,蒙古國,其他亞洲地區,1,1,0,1,1,0,0,0,0,0,0,0,0,0,0
108,公立,一般大學,0017,國立臺北大學,學士班(日間),大陸地區,大陸地區,19,8,11,0,0,0,0,0,0,0,0,0,19,8,11
108,公立,一般大學,0017,國立臺北大學,學士班(日間),大韓民國(南韓),其他亞洲地區,1,1,0,0,0,0,1,1,0,0,0,0,0,0,0
108,公立,一般大學,0017,國立臺北大學,學士班(日間),日本,其他亞洲地區,11,5,6,9,5,4,2,0,2,0,0,0,0,0,0
108,公立,一般大學,0017,國立臺北大學,學士班(日間),印度尼西亞共和國,東協,22,9,13,1,1,0,21,8,13,0,0,0,0,0,0
108,公立,一般大學,0017,國立臺北大學,學士班(日間),泰國,東協,2,2,0,0,0,0,2,2,0,0,0,0,0,0,0
108,公立,一般大學,0017,國立臺北大學,學士班(日間),烏克蘭,其他亞洲地區,1,0,1,1,0,1,0,0,0,0,0,0,0,0,0
108,公立,一般大學,0017,國立臺北大學,學士班(日間),秘魯共和國,中南美洲,2,0,2,0,0,0,2,0,2,0,0,0,0,0,0
108,公立,一般大學,0017,國立臺北大學,學士班(日間),馬來西亞,東協,107,61,46,6,4,2,101,57,44,0,0,0,0,0,0
108,公立,一般大學,0017,國立臺北大學,學士班(日間),蒙古國,其他亞洲地區,1,0,1,1,0,1,0,0,0,0,0,0,0,0,0
108,公立,一般大學,0017,國立臺北大學,學士班(日間),厄瓜多共和國,中南美洲,1,0,1,0,0,0,1,0,1,0,0,0,0,0,0
108,公立,一般大學,0017,國立臺北大學,學士班(日間),巴拉圭,中南美洲,3,1,2,2,0,2,1,1,0,0,0,0,0,0,0
108,公立,一般大學,0017,國立臺北大學,學士班(日間),阿根廷,中南美洲,1,0,1,0,0,0,1,0,1,0,0,0,0,0,0
108,公立,一般大學,0017,國立臺北大學,學士班(日間),香港,港澳,69,40,29,0,0,0,0,0,0,69,40,29,0,0,0
108,公立,一般大學,0017,國立臺北大學,學士班(日間),越南社會主義共和國,東協,10,3,7,4,1,3,6,2,4,0,0,0,0,0,0
108,公立,一般大學,0017,國立臺北大學,學士班(日間),德意志聯邦共和國,歐洲,1,0,1,1,0,1,0,0,0,0,0,0,0,0,0
108,公立,一般大學,0017,國立臺北大學,學士班(日間),緬甸,東協,48,6,42,0,0,0,48,6,42,0,0,0,0,0,0
108,公立,一般大學,0017,國立臺北大學,學士班(日間),澳門,港澳,48,26,22,0,0,0,0,0,0,48,26,22,0,0,0
108,公立,一般大學,0017,國立臺北大學,碩士班(日間),印度尼西亞共和國,東協,5,2,3,4,2,2,1,0,1,0,0,0,0,0,0
108,公立,一般大學,0017,國立臺北大學,碩士班(日間),坦尚尼亞聯合共和國,非洲,1,1,0,1,1,0,0,0,0,0,0,0,0,0,0
108,公立,一般大學,0017,國立臺北大學,碩士班(日間),泰國,東協,4,0,4,4,0,4,0,0,0,0,0,0,0,0,0
108,公立,一般大學,0017,國立臺北大學,碩士班(日間),馬來西亞,東協,6,3,3,0,0,0,6,3,3,0,0,0,0,0,0
108,公立,一般大學,0017,國立臺北大學,碩士班(日間),菲律賓共和國,東協,2,2,0,2,2,0,0,0,0,0,0,0,0,0,0
108,公立,一般大學,0017,國立臺北大學,碩士班(日間),越南社會主義共和國,東協,5,1,4,5,1,4,0,0,0,0,0,0,0,0,0
108,公立,一般大學,0017,國立臺北大學,碩士班(日間),蒙古國,其他亞洲地區,1,1,0,1,1,0,0,0,0,0,0,0,0,0,0
108,公立,一般大學,0017,國立臺北大學,碩士班(日間),大陸地區,大陸地區,27,18,9,0,0,0,0,0,0,0,0,0,27,18,9
108,公立,一般大學,0017,國立臺北大學,碩士班(日間),美國,北美洲,1,1,0,1,1,0,0,0,0,0,0,0,0,0,0
108,公立,一般大學,0017,國立臺北大學,碩士班(日間),香港,港澳,13,10,3,0,0,0,0,0,0,13,10,3,0,0,0
108,公立,一般大學,0017,國立臺北大學,碩士班(日間),莫三比克共和國,非洲,1,0,1,1,0,1,0,0,0,0,0,0,0,0,0
108,公立,一般大學,0017,國立臺北大學,碩士班(日間),斯里蘭卡民主社會主義共和國,南亞,2,1,1,2,1,1,0,0,0,0,0,0,0,0,0
108,公立,一般大學,0017,國立臺北大學,碩士班(日間),緬甸,東協,4,0,4,0,0,0,4,0,4,0,0,0,0,0,0
108,公立,一般大學,0017,國立臺北大學,碩士班(日間),墨西哥合眾國,中南美洲,1,1,0,1,1,0,0,0,0,0,0,0,0,0,0
108,公立,一般大學,0017,國立臺北大學,碩士班(日間),澳門,港澳,2,1,1,0,0,0,0,0,0,2,1,1,0,0,0
108,公立,一般大學,0017,國立臺北大學,博士班,俄羅斯聯邦,其他亞洲地區,1,1,0,1,1,0,0,0,0,0,0,0,0,0,0
108,公立,一般大學,0017,國立臺北大學,博士班,菲律賓共和國,東協,2,0,2,2,0,2,0,0,0,0,0,0,0,0,0
108,公立,一般大學,0017,國立臺北大學,博士班,越南社會主義共和國,東協,1,1,0,1,1,0,0,0,0,0,0,0,0,0,0
108,公立,一般大學,0017,國立臺北大學,博士班,德意志聯邦共和國,歐洲,1,1,0,1,1,0,0,0,0,0,0,0,0,0,0
108,公立,一般大學,0017,國立臺北大學,博士班,大陸地區,大陸地區,21,11,10,0,0,0,0,0,0,0,0,0,21,11,10
108,公立,一般大學,0017,國立臺北大學,博士班,馬來西亞,東協,1,1,0,0,0,0,1,1,0,0,0,0,0,0,0
108,公立,一般大學,0017,國立臺北大學,博士班,澳門,港澳,1,1,0,0,0,0,0,0,0,1,1,0,0,0,0
108,公立,一般大學,0018,國立嘉義大學,學士班(日間),日本,其他亞洲地區,5,3,2,4,2,2,1,1,0,0,0,0,0,0,0
108,公立,一般大學,0018,國立嘉義大學,學士班(日間),印度尼西亞共和國,東協,31,10,21,5,2,3,26,8,18,0,0,0,0,0,0
108,公立,一般大學,0018,國立嘉義大學,學士班(日間),南非共和國,非洲,2,1,1,0,0,0,2,1,1,0,0,0,0,0,0
108,公立,一般大學,0018,國立嘉義大學,學士班(日間),香港,港澳,66,32,34,0,0,0,0,0,0,66,32,34,0,0,0
108,公立,一般大學,0018,國立嘉義大學,學士班(日間),大陸地區,大陸地區,4,2,2,0,0,0,0,0,0,0,0,0,4,2,2
108,公立,一般大學,0018,國立嘉義大學,學士班(日間),大韓民國(南韓),其他亞洲地區,2,2,0,2,2,0,0,0,0,0,0,0,0,0,0
108,公立,一般大學,0018,國立嘉義大學,學士班(日間),美國,北美洲,1,0,1,0,0,0,1,0,1,0,0,0,0,0,0
108,公立,一般大學,0018,國立嘉義大學,學士班(日間),馬來西亞,東協,152,68,84,13,5,8,139,63,76,0,0,0,0,0,0
108,公立,一般大學,0018,國立嘉義大學,學士班(日間),斐濟群島共和國,其他亞洲地區,1,0,1,0,0,0,1,0,1,0,0,0,0,0,0
108,公立,一般大學,0018,國立嘉義大學,學士班(日間),越南社會主義共和國,東協,7,2,5,5,0,5,2,2,0,0,0,0,0,0,0
108,公立,一般大學,0018,國立嘉義大學,學士班(日間),新加坡共和國,東協,1,0,1,1,0,1,0,0,0,0,0,0,0,0,0
108,公立,一般大學,0018,國立嘉義大學,學士班(日間),聖露西亞,中南美洲,1,1,0,1,1,0,0,0,0,0,0,0,0,0,0
108,公立,一般大學,0018,國立嘉義大學,學士班(日間),澳門,港澳,40,27,13,0,0,0,0,0,0,40,27,13,0,0,0
108,公立,一般大學,0018,國立嘉義大學,學士班(日間),緬甸,東協,1,1,0,0,0,0,1,1,0,0,0,0,0,0,0
108,公立,一般大學,0018,國立嘉義大學,學士班(日間),諾魯共和國,其他亞洲地區,1,0,1,1,0,1,0,0,0,0,0,0,0,0,0
108,公立,一般大學,0018,國立嘉義大學,碩士班(日間),大韓民國(南韓),其他亞洲地區,1,0,1,1,0,1,0,0,0,0,0,0,0,0,0
108,公立,一般大學,0018,國立嘉義大學,碩士班(日間),香港,港澳,5,3,2,0,0,0,0,0,0,5,3,2,0,0,0
108,公立,一般大學,0018,國立嘉義大學,碩士班(日間),越南社會主義共和國,東協,4,1,3,4,1,3,0,0,0,0,0,0,0,0,0
108,公立,一般大學,0018,國立嘉義大學,碩士班(日間),蒙古國,其他亞洲地區,1,0,1,1,0,1,0,0,0,0,0,0,0,0,0
108,公立,一般大學,0018,國立嘉義大學,碩士班(日間),澳門,港澳,2,1,1,0,0,0,0,0,0,2,1,1,0,0,0
108,公立,一般大學,0018,國立嘉義大學,碩士班(日間),大陸地區,大陸地區,1,1,0,0,0,0,0,0,0,0,0,0,1,1,0
108,公立,一般大學,0018,國立嘉義大學,碩士班(日間),印度尼西亞共和國,東協,20,5,15,20,5,15,0,0,0,0,0,0,0,0,0
108,公立,一般大學,0018,國立嘉義大學,碩士班(日間),約旦哈什米王國,其他亞洲地區,1,0,1,1,0,1,0,0,0,0,0,0,0,0,0
108,公立,一般大學,0018,國立嘉義大學,碩士班(日間),泰國,東協,5,2,3,5,2,3,0,0,0,0,0,0,0,0,0
108,公立,一般大學,0018,國立嘉義大學,碩士班(日間),馬來西亞,東協,9,4,5,1,1,0,8,3,5,0,0,0,0,0,0
108,公立,一般大學,0018,國立嘉義大學,博士班,菲律賓共和國,東協,1,0,1,1,0,1,0,0,0,0,0,0,0,0,0
108,公立,一般大學,0018,國立嘉義大學,博士班,大陸地區,大陸地區,2,1,1,0,0,0,0,0,0,0,0,0,2,1,1
108,公立,一般大學,0018,國立嘉義大學,博士班,印度尼西亞共和國,東協,4,1,3,4,1,3,0,0,0,0,0,0,0,0,0
108,公立,一般大學,0018,國立嘉義大學,博士班,泰國,東協,4,2,2,4,2,2,0,0,0,0,0,0,0,0,0
108,公立,一般大學,0018,國立嘉義大學,博士班,秘魯共和國,中南美洲,1,0,1,1,0,1,0,0,0,0,0,0,0,0,0
108,公立,一般大學,0018,國立嘉義大學,博士班,越南社會主義共和國,東協,1,1,0,1,1,0,0,0,0,0,0,0,0,0,0
108,公立,一般大學,0018,國立嘉義大學,博士班,澳門,港澳,1,1,0,0,0,0,0,0,0,1,1,0,0,0,0
108,公立,一般大學,0018,國立嘉義大學,博士班,蒙古國,其他亞洲地區,2,1,1,2,1,1,0,0,0,0,0,0,0,0,0
108,公立,一般大學,0019,國立高雄大學,學士班(日間),大陸地區,大陸地區,7,3,4,0,0,0,0,0,0,0,0,0,7,3,4
108,公立,一般大學,0019,國立高雄大學,學士班(日間),巴拉圭,中南美洲,1,1,0,1,1,0,0,0,0,0,0,0,0,0,0
108,公立,一般大學,0019,國立高雄大學,學士班(日間),日本,其他亞洲地區,12,6,6,12,6,6,0,0,0,0,0,0,0,0,0
108,公立,一般大學,0019,國立高雄大學,學士班(日間),瓜地馬拉共和國,中南美洲,1,0,1,1,0,1,0,0,0,0,0,0,0,0,0
108,公立,一般大學,0019,國立高雄大學,學士班(日間),印度尼西亞共和國,東協,50,33,17,8,6,2,42,27,15,0,0,0,0,0,0
108,公立,一般大學,0019,國立高雄大學,學士班(日間),美國,北美洲,2,2,0,1,1,0,1,1,0,0,0,0,0,0,0
108,公立,一般大學,0019,國立高雄大學,學士班(日間),索羅門群島,其他亞洲地區,1,0,1,1,0,1,0,0,0,0,0,0,0,0,0
108,公立,一般大學,0019,國立高雄大學,學士班(日間),馬來西亞,東協,43,25,18,1,0,1,42,25,17,0,0,0,0,0,0
108,公立,一般大學,0019,國立高雄大學,學士班(日間),蒙古國,其他亞洲地區,1,1,0,1,1,0,0,0,0,0,0,0,0,0,0
108,公立,一般大學,0019,國立高雄大學,學士班(日間),緬甸,東協,3,0,3,0,0,0,3,0,3,0,0,0,0,0,0
108,公立,一般大學,0019,國立高雄大學,學士班(日間),香港,港澳,12,7,5,0,0,0,0,0,0,12,7,5,0,0,0
108,公立,一般大學,0019,國立高雄大學,學士班(日間),泰國,東協,1,0,1,0,0,0,1,0,1,0,0,0,0,0,0
108,公立,一般大學,0019,國立高雄大學,學士班(日間),越南社會主義共和國,東協,6,3,3,5,2,3,1,1,0,0,0,0,0,0,0
108,公立,一般大學,0019,國立高雄大學,學士班(日間),澳門,港澳,17,10,7,0,0,0,0,0,0,17,10,7,0,0,0
108,公立,一般大學,0019,國立高雄大學,碩士班(日間),俄羅斯聯邦,其他亞洲地區,1,1,0,1,1,0,0,0,0,0,0,0,0,0,0
108,公立,一般大學,0019,國立高雄大學,碩士班(日間),蒙古國,其他亞洲地區,3,1,2,3,1,2,0,0,0,0,0,0,0,0,0
108,公立,一般大學,0019,國立高雄大學,碩士班(日間),土耳其共和國,其他亞洲地區,1,0,1,1,0,1,0,0,0,0,0,0,0,0,0
108,公立,一般大學,0019,國立高雄大學,碩士班(日間),大陸地區,大陸地區,2,2,0,0,0,0,0,0,0,0,0,0,2,2,0
108,公立,一般大學,0019,國立高雄大學,碩士班(日間),巴拉圭,中南美洲,1,1,0,1,1,0,0,0,0,0,0,0,0,0,0
108,公立,一般大學,0019,國立高雄大學,碩士班(日間),印度尼西亞共和國,東協,3,3,0,3,3,0,0,0,0,0,0,0,0,0,0
108,公立,一般大學,0019,國立高雄大學,碩士班(日間),香港,港澳,2,2,0,0,0,0,0,0,0,2,2,0,0,0,0
108,公立,一般大學,0019,國立高雄大學,碩士班(日間),哥倫比亞共和國,中南美洲,5,2,3,5,2,3,0,0,0,0,0,0,0,0,0
108,公立,一般大學,0019,國立高雄大學,碩士班(日間),泰國,東協,4,1,3,4,1,3,0,0,0,0,0,0,0,0,0
108,公立,一般大學,0019,國立高雄大學,碩士班(日間),馬來西亞,東協,1,0,1,0,0,0,1,0,1,0,0,0,0,0,0
108,公立,一般大學,0019,國立高雄大學,碩士班(日間),菲律賓共和國,東協,2,1,1,2,1,1,0,0,0,0,0,0,0,0,0
108,公立,一般大學,0019,國立高雄大學,碩士班(日間),越南社會主義共和國,東協,9,3,6,9,3,6,0,0,0,0,0,0,0,0,0
108,公立,一般大學,0019,國立高雄大學,碩士班(日間),澳門,港澳,1,1,0,0,0,0,0,0,0,1,1,0,0,0,0
108,公立,一般大學,0019,國立高雄大學,博士班,大陸地區,大陸地區,2,1,1,0,0,0,0,0,0,0,0,0,2,1,1
108,公立,一般大學,0020,國立東華大學,學士班(日間),大陸地區,大陸地區,19,11,8,0,0,0,0,0,0,0,0,0,19,11,8
108,公立,一般大學,0020,國立東華大學,學士班(日間),史瓦帝尼王國,非洲,9,6,3,9,6,3,0,0,0,0,0,0,0,0,0
108,公立,一般大學,0020,國立東華大學,學士班(日間),尼加拉瓜,中南美洲,1,1,0,1,1,0,0,0,0,0,0,0,0,0,0
108,公立,一般大學,0020,國立東華大學,學士班(日間),甘比亞共和國,非洲,1,1,0,1,1,0,0,0,0,0,0,0,0,0,0
108,公立,一般大學,0020,國立東華大學,學士班(日間),印度尼西亞共和國,東協,55,23,32,24,11,13,31,12,19,0,0,0,0,0,0
108,公立,一般大學,0020,國立東華大學,學士班(日間),多明尼加共和國,中南美洲,1,1,0,1,1,0,0,0,0,0,0,0,0,0,0
108,公立,一般大學,0020,國立東華大學,學士班(日間),大韓民國(南韓),其他亞洲地區,1,1,0,0,0,0,1,1,0,0,0,0,0,0,0
108,公立,一般大學,0020,國立東華大學,學士班(日間),日本,其他亞洲地區,6,2,4,5,2,3,1,0,1,0,0,0,0,0,0
108,公立,一般大學,0020,國立東華大學,學士班(日間),印度,南亞,1,1,0,1,1,0,0,0,0,0,0,0,0,0,0
108,公立,一般大學,0020,國立東華大學,學士班(日間),吉里巴斯共和國,其他亞洲地區,3,1,2,3,1,2,0,0,0,0,0,0,0,0,0
108,公立,一般大學,0020,國立東華大學,學士班(日間),吉爾吉斯,其他亞洲地區,20,18,2,20,18,2,0,0,0,0,0,0,0,0,0
108,公立,一般大學,0020,國立東華大學,學士班(日間),吐瓦魯,其他亞洲地區,3,3,0,3,3,0,0,0,0,0,0,0,0,0,0
108,公立,一般大學,0020,國立東華大學,學士班(日間),查德共和國,非洲,1,1,0,1,1,0,0,0,0,0,0,0,0,0,0
108,公立,一般大學,0020,國立東華大學,學士班(日間),美國,北美洲,3,3,0,1,1,0,2,2,0,0,0,0,0,0,0
108,公立,一般大學,0020,國立東華大學,學士班(日間),烏克蘭,其他亞洲地區,1,1,0,1,1,0,0,0,0,0,0,0,0,0,0
108,公立,一般大學,0020,國立東華大學,學士班(日間),索羅門群島,其他亞洲地區,2,1,1,2,1,1,0,0,0,0,0,0,0,0,0
108,公立,一般大學,0020,國立東華大學,學士班(日間),馬拉威共和國,非洲,1,0,1,0,0,0,1,0,1,0,0,0,0,0,0
108,公立,一般大學,0020,國立東華大學,學士班(日間),聖文森(及格瑞那丁),中南美洲,6,3,3,6,3,3,0,0,0,0,0,0,0,0,0
108,公立,一般大學,0020,國立東華大學,學士班(日間),聖克里斯多福及尼維斯,中南美洲,9,5,4,9,5,4,0,0,0,0,0,0,0,0,0
108,公立,一般大學,0020,國立東華大學,學士班(日間),聖露西亞,中南美洲,1,0,1,1,0,1,0,0,0,0,0,0,0,0,0
108,公立,一般大學,0020,國立東華大學,學士班(日間),蒙古國,其他亞洲地區,15,7,8,15,7,8,0,0,0,0,0,0,0,0,0
108,公立,一般大學,0020,國立東華大學,學士班(日間),澳大利亞,其他亞洲地區,1,1,0,1,1,0,0,0,0,0,0,0,0,0,0
108,公立,一般大學,0020,國立東華大學,學士班(日間),薩爾瓦多,中南美洲,1,1,0,1,1,0,0,0,0,0,0,0,0,0,0
108,公立,一般大學,0020,國立東華大學,學士班(日間),宏都拉斯共和國,中南美洲,3,2,1,3,2,1,0,0,0,0,0,0,0,0,0
108,公立,一般大學,0020,國立東華大學,學士班(日間),貝里斯,中南美洲,6,5,1,6,5,1,0,0,0,0,0,0,0,0,0
108,公立,一般大學,0020,國立東華大學,學士班(日間),香港,港澳,97,53,44,0,0,0,0,0,0,97,53,44,0,0,0
108,公立,一般大學,0020,國立東華大學,學士班(日間),哥斯大黎加共和國,中南美洲,1,0,1,0,0,0,1,0,1,0,0,0,0,0,0
108,公立,一般大學,0020,國立東華大學,學士班(日間),泰國,東協,8,3,5,6,3,3,2,0,2,0,0,0,0,0,0
108,公立,一般大學,0020,國立東華大學,學士班(日間),秘魯共和國,中南美洲,1,0,1,1,0,1,0,0,0,0,0,0,0,0,0
108,公立,一般大學,0020,國立東華大學,學士班(日間),馬來西亞,東協,176,86,90,6,1,5,170,85,85,0,0,0,0,0,0
108,公立,一般大學,0020,國立東華大學,學士班(日間),象牙海岸共和國,非洲,1,1,0,1,1,0,0,0,0,0,0,0,0,0,0
108,公立,一般大學,0020,國立東華大學,學士班(日間),越南社會主義共和國,東協,16,5,11,13,2,11,3,3,0,0,0,0,0,0,0
108,公立,一般大學,0020,國立東華大學,學士班(日間),摩洛哥王國,非洲,1,1,0,1,1,0,0,0,0,0,0,0,0,0,0
108,公立,一般大學,0020,國立東華大學,學士班(日間),緬甸,東協,2,1,1,0,0,0,2,1,1,0,0,0,0,0,0
108,公立,一般大學,0020,國立東華大學,學士班(日間),澳門,港澳,57,25,32,0,0,0,0,0,0,57,25,32,0,0,0
108,公立,一般大學,0020,國立東華大學,碩士班(日間),土耳其共和國,其他亞洲地區,1,1,0,1,1,0,0,0,0,0,0,0,0,0,0
108,公立,一般大學,0020,國立東華大學,碩士班(日間),土庫曼,其他亞洲地區,1,1,0,1,1,0,0,0,0,0,0,0,0,0,0
108,公立,一般大學,0020,國立東華大學,碩士班(日間),大陸地區,大陸地區,3,1,2,0,0,0,0,0,0,0,0,0,3,1,2
108,公立,一般大學,0020,國立東華大學,碩士班(日間),大韓民國(南韓),其他亞洲地區,1,1,0,1,1,0,0,0,0,0,0,0,0,0,0
108,公立,一般大學,0020,國立東華大學,碩士班(日間),加拿大,北美洲,1,1,0,1,1,0,0,0,0,0,0,0,0,0,0
108,公立,一般大學,0020,國立東華大學,碩士班(日間),瓜地馬拉共和國,中南美洲,1,1,0,1,1,0,0,0,0,0,0,0,0,0,0
108,公立,一般大學,0020,國立東華大學,碩士班(日間),白俄羅斯共和國,其他亞洲地區,1,0,1,1,0,1,0,0,0,0,0,0,0,0,0
108,公立,一般大學,0020,國立東華大學,碩士班(日間),匈牙利共和國,歐洲,1,0,1,1,0,1,0,0,0,0,0,0,0,0,0
108,公立,一般大學,0020,國立東華大學,碩士班(日間),印度,南亞,7,4,3,7,4,3,0,0,0,0,0,0,0,0,0
108,公立,一般大學,0020,國立東華大學,碩士班(日間),印度尼西亞共和國,東協,41,17,24,40,17,23,1,0,1,0,0,0,0,0,0
108,公立,一般大學,0020,國立東華大學,碩士班(日間),史瓦帝尼王國,非洲,3,2,1,3,2,1,0,0,0,0,0,0,0,0,0
108,公立,一般大學,0020,國立東華大學,碩士班(日間),尼泊爾聯邦民主共和國,南亞,1,1,0,1,1,0,0,0,0,0,0,0,0,0,0
108,公立,一般大學,0020,國立東華大學,碩士班(日間),甘比亞共和國,非洲,1,0,1,1,0,1,0,0,0,0,0,0,0,0,0
108,公立,一般大學,0020,國立東華大學,碩士班(日間),吉爾吉斯,其他亞洲地區,1,0,1,1,0,1,0,0,0,0,0,0,0,0,0
108,公立,一般大學,0020,國立東華大學,碩士班(日間),俄羅斯聯邦,其他亞洲地區,1,0,1,1,0,1,0,0,0,0,0,0,0,0,0
108,公立,一般大學,0020,國立東華大學,碩士班(日間),美國,北美洲,6,5,1,6,5,1,0,0,0,0,0,0,0,0,0
108,公立,一般大學,0020,國立東華大學,碩士班(日間),馬拉威共和國,非洲,14,10,4,14,10,4,0,0,0,0,0,0,0,0,0
108,公立,一般大學,0020,國立東華大學,碩士班(日間),捷克共和國,歐洲,1,0,1,1,0,1,0,0,0,0,0,0,0,0,0
108,公立,一般大學,0020,國立東華大學,碩士班(日間),斯里蘭卡民主社會主義共和國,南亞,1,0,1,1,0,1,0,0,0,0,0,0,0,0,0
108,公立,一般大學,0020,國立東華大學,碩士班(日間),斯洛伐克共和國,歐洲,1,0,1,1,0,1,0,0,0,0,0,0,0,0,0
108,公立,一般大學,0020,國立東華大學,碩士班(日間),菲律賓共和國,東協,4,3,1,4,3,1,0,0,0,0,0,0,0,0,0
108,公立,一般大學,0020,國立東華大學,碩士班(日間),聖克里斯多福及尼維斯,中南美洲,3,2,1,3,2,1,0,0,0,0,0,0,0,0,0
108,公立,一般大學,0020,國立東華大學,碩士班(日間),葡萄牙共和國,歐洲,1,1,0,1,1,0,0,0,0,0,0,0,0,0,0
108,公立,一般大學,0020,國立東華大學,碩士班(日間),蒙古國,其他亞洲地區,18,7,11,18,7,11,0,0,0,0,0,0,0,0,0
108,公立,一般大學,0020,國立東華大學,碩士班(日間),吉里巴斯共和國,其他亞洲地區,1,1,0,1,1,0,0,0,0,0,0,0,0,0,0
108,公立,一般大學,0020,國立東華大學,碩士班(日間),貝里斯,中南美洲,2,1,1,2,1,1,0,0,0,0,0,0,0,0,0
108,公立,一般大學,0020,國立東華大學,碩士班(日間),法國,歐洲,2,1,1,2,1,1,0,0,0,0,0,0,0,0,0
108,公立,一般大學,0020,國立東華大學,碩士班(日間),英國,歐洲,1,1,0,1,1,0,0,0,0,0,0,0,0,0,0
108,公立,一般大學,0020,國立東華大學,碩士班(日間),香港,港澳,7,5,2,0,0,0,0,0,0,7,5,2,0,0,0
108,公立,一般大學,0020,國立東華大學,碩士班(日間),泰國,東協,6,2,4,6,2,4,0,0,0,0,0,0,0,0,0
108,公立,一般大學,0020,國立東華大學,碩士班(日間),馬來西亞,東協,21,10,11,7,2,5,14,8,6,0,0,0,0,0,0
108,公立,一般大學,0020,國立東華大學,碩士班(日間),越南社會主義共和國,東協,24,4,20,24,4,20,0,0,0,0,0,0,0,0,0
108,公立,一般大學,0020,國立東華大學,碩士班(日間),墨西哥合眾國,中南美洲,1,0,1,1,0,1,0,0,0,0,0,0,0,0,0
108,公立,一般大學,0020,國立東華大學,碩士班(日間),澳門,港澳,4,3,1,0,0,0,0,0,0,4,3,1,0,0,0
108,公立,一般大學,0020,國立東華大學,博士班,土耳其共和國,其他亞洲地區,1,1,0,1,1,0,0,0,0,0,0,0,0,0,0
108,公立,一般大學,0020,國立東華大學,博士班,大陸地區,大陸地區,13,5,8,0,0,0,0,0,0,0,0,0,13,5,8
108,公立,一般大學,0020,國立東華大學,博士班,印度,南亞,32,24,8,32,24,8,0,0,0,0,0,0,0,0,0
108,公立,一般大學,0020,國立東華大學,博士班,法國,歐洲,1,0,1,1,0,1,0,0,0,0,0,0,0,0,0
108,公立,一般大學,0020,國立東華大學,博士班,馬拉威共和國,非洲,1,1,0,1,1,0,0,0,0,0,0,0,0,0,0
108,公立,一般大學,0020,國立東華大學,博士班,加拿大,北美洲,2,0,2,2,0,2,0,0,0,0,0,0,0,0,0
108,公立,一般大學,0020,國立東華大學,博士班,印度尼西亞共和國,東協,28,20,8,28,20,8,0,0,0,0,0,0,0,0,0
108,公立,一般大學,0020,國立東華大學,博士班,俄羅斯聯邦,其他亞洲地區,1,0,1,1,0,1,0,0,0,0,0,0,0,0,0
108,公立,一般大學,0020,國立東華大學,博士班,英國,歐洲,1,1,0,1,1,0,0,0,0,0,0,0,0,0,0
108,公立,一般大學,0020,國立東華大學,博士班,泰國,東協,7,3,4,7,3,4,0,0,0,0,0,0,0,0,0
108,公立,一般大學,0020,國立東華大學,博士班,馬來西亞,東協,2,2,0,1,1,0,1,1,0,0,0,0,0,0,0
108,公立,一般大學,0020,國立東華大學,博士班,菲律賓共和國,東協,1,1,0,1,1,0,0,0,0,0,0,0,0,0,0
108,公立,一般大學,0020,國立東華大學,博士班,新加坡共和國,東協,1,0,1,1,0,1,0,0,0,0,0,0,0,0,0
108,公立,一般大學,0020,國立東華大學,博士班,聖文森(及格瑞那丁),中南美洲,1,1,0,1,1,0,0,0,0,0,0,0,0,0,0
108,公立,一般大學,0020,國立東華大學,博士班,捷克共和國,歐洲,1,1,0,1,1,0,0,0,0,0,0,0,0,0,0
108,公立,一般大學,0020,國立東華大學,博士班,越南社會主義共和國,東協,10,6,4,10,6,4,0,0,0,0,0,0,0,0,0
108,公立,一般大學,0020,國立東華大學,博士班,蒙古國,其他亞洲地區,2,2,0,2,2,0,0,0,0,0,0,0,0,0,0
108,公立,一般大學,0021,國立暨南國際大學,學士班(日間),巴西聯邦共和國,中南美洲,1,0,1,0,0,0,1,0,1,0,0,0,0,0,0
108,公立,一般大學,0021,國立暨南國際大學,學士班(日間),日本,其他亞洲地區,7,1,6,4,0,4,3,1,2,0,0,0,0,0,0
108,公立,一般大學,0021,國立暨南國際大學,學士班(日間),泰國,東協,6,2,4,1,0,1,5,2,3,0,0,0,0,0,0
108,公立,一般大學,0021,國立暨南國際大學,學士班(日間),大陸地區,大陸地區,4,3,1,0,0,0,0,0,0,0,0,0,4,3,1
108,公立,一般大學,0021,國立暨南國際大學,學士班(日間),印度尼西亞共和國,東協,42,22,20,0,0,0,42,22,20,0,0,0,0,0,0
108,公立,一般大學,0021,國立暨南國際大學,學士班(日間),貝里斯,中南美洲,1,0,1,0,0,0,1,0,1,0,0,0,0,0,0
108,公立,一般大學,0021,國立暨南國際大學,學士班(日間),南非共和國,非洲,3,1,2,0,0,0,3,1,2,0,0,0,0,0,0
108,公立,一般大學,0021,國立暨南國際大學,學士班(日間),香港,港澳,152,85,67,0,0,0,0,0,0,152,85,67,0,0,0
108,公立,一般大學,0021,國立暨南國際大學,學士班(日間),馬來西亞,東協,221,103,118,4,0,4,217,103,114,0,0,0,0,0,0
108,公立,一般大學,0021,國立暨南國際大學,學士班(日間),越南社會主義共和國,東協,13,8,5,2,0,2,11,8,3,0,0,0,0,0,0
108,公立,一般大學,0021,國立暨南國際大學,學士班(日間),葡萄牙共和國,歐洲,1,0,1,1,0,1,0,0,0,0,0,0,0,0,0
108,公立,一般大學,0021,國立暨南國際大學,學士班(日間),緬甸,東協,10,4,6,0,0,0,10,4,6,0,0,0,0,0,0
108,公立,一般大學,0021,國立暨南國際大學,學士班(日間),澳門,港澳,71,50,21,0,0,0,0,0,0,71,50,21,0,0,0
108,公立,一般大學,0021,國立暨南國際大學,碩士班(日間),大陸地區,大陸地區,3,2,1,0,0,0,0,0,0,0,0,0,3,2,1
108,公立,一般大學,0021,國立暨南國際大學,碩士班(日間),大韓民國(南韓),其他亞洲地區,1,0,1,1,0,1,0,0,0,0,0,0,0,0,0
108,公立,一般大學,0021,國立暨南國際大學,碩士班(日間),厄瓜多共和國,中南美洲,1,0,1,0,0,0,1,0,1,0,0,0,0,0,0
108,公立,一般大學,0021,國立暨南國際大學,碩士班(日間),日本,其他亞洲地區,1,1,0,1,1,0,0,0,0,0,0,0,0,0,0
108,公立,一般大學,0021,國立暨南國際大學,碩士班(日間),印度尼西亞共和國,東協,1,1,0,0,0,0,1,1,0,0,0,0,0,0,0
108,公立,一般大學,0021,國立暨南國際大學,碩士班(日間),香港,港澳,10,6,4,0,0,0,0,0,0,10,6,4,0,0,0
108,公立,一般大學,0021,國立暨南國際大學,碩士班(日間),烏克蘭,其他亞洲地區,1,1,0,1,1,0,0,0,0,0,0,0,0,0,0
108,公立,一般大學,0021,國立暨南國際大學,碩士班(日間),馬來西亞,東協,13,9,4,1,0,1,12,9,3,0,0,0,0,0,0
108,公立,一般大學,0021,國立暨南國際大學,碩士班(日間),蒙古國,其他亞洲地區,1,0,1,1,0,1,0,0,0,0,0,0,0,0,0
108,公立,一般大學,0021,國立暨南國際大學,碩士班(日間),緬甸,東協,12,3,9,12,3,9,0,0,0,0,0,0,0,0,0
108,公立,一般大學,0021,國立暨南國際大學,碩士班(日間),澳門,港澳,1,1,0,0,0,0,0,0,0,1,1,0,0,0,0
108,公立,一般大學,0021,國立暨南國際大學,碩士班(日間),俄羅斯聯邦,其他亞洲地區,1,0,1,1,0,1,0,0,0,0,0,0,0,0,0
108,公立,一般大學,0021,國立暨南國際大學,碩士班(日間),越南社會主義共和國,東協,4,1,3,4,1,3,0,0,0,0,0,0,0,0,0
108,公立,一般大學,0021,國立暨南國際大學,博士班,大陸地區,大陸地區,12,6,6,0,0,0,0,0,0,0,0,0,12,6,6
108,公立,一般大學,0021,國立暨南國際大學,博士班,大韓民國(南韓),其他亞洲地區,2,1,1,2,1,1,0,0,0,0,0,0,0,0,0
108,公立,一般大學,0021,國立暨南國際大學,博士班,馬來西亞,東協,5,5,0,4,4,0,1,1,0,0,0,0,0,0,0
108,公立,一般大學,0021,國立暨南國際大學,博士班,越南社會主義共和國,東協,23,8,15,23,8,15,0,0,0,0,0,0,0,0,0
108,公立,一般大學,0021,國立暨南國際大學,博士班,印度,南亞,2,2,0,2,2,0,0,0,0,0,0,0,0,0,0
108,公立,一般大學,0021,國立暨南國際大學,博士班,美國,北美洲,2,2,0,2,2,0,0,0,0,0,0,0,0,0,0
108,公立,一般大學,0021,國立暨南國際大學,博士班,香港,港澳,4,4,0,0,0,0,0,0,0,4,4,0,0,0,0
108,公立,一般大學,0021,國立暨南國際大學,博士班,泰國,東協,1,0,1,1,0,1,0,0,0,0,0,0,0,0,0
108,公立,一般大學,0021,國立暨南國際大學,博士班,緬甸,東協,3,0,3,2,0,2,1,0,1,0,0,0,0,0,0
108,公立,一般大學,0021,國立暨南國際大學,博士班,澳門,港澳,1,0,1,0,0,0,0,0,0,1,0,1,0,0,0
108,公立,技專校院,0022,國立臺灣科技大學,學士班(日間),土耳其共和國,其他亞洲地區,2,2,0,2,2,0,0,0,0,0,0,0,0,0,0
108,公立,技專校院,0022,國立臺灣科技大學,學士班(日間),大陸地區,大陸地區,97,54,43,0,0,0,0,0,0,0,0,0,97,54,43
108,公立,技專校院,0022,國立臺灣科技大學,學士班(日間),巴西聯邦共和國,中南美洲,1,1,0,1,1,0,0,0,0,0,0,0,0,0,0
108,公立,技專校院,0022,國立臺灣科技大學,學士班(日間),巴拉圭,中南美洲,5,3,2,4,2,2,1,1,0,0,0,0,0,0,0
108,公立,技專校院,0022,國立臺灣科技大學,學士班(日間),加拿大,北美洲,2,2,0,0,0,0,2,2,0,0,0,0,0,0,0
108,公立,技專校院,0022,國立臺灣科技大學,學士班(日間),尼加拉瓜,中南美洲,4,2,2,4,2,2,0,0,0,0,0,0,0,0,0
108,公立,技專校院,0022,國立臺灣科技大學,學士班(日間),印度尼西亞共和國,東協,187,122,65,98,63,35,89,59,30,0,0,0,0,0,0
108,公立,技專校院,0022,國立臺灣科技大學,學士班(日間),南非共和國,非洲,1,1,0,0,0,0,1,1,0,0,0,0,0,0,0
108,公立,技專校院,0022,國立臺灣科技大學,學士班(日間),香港,港澳,42,25,17,0,0,0,0,0,0,42,25,17,0,0,0
108,公立,技專校院,0022,國立臺灣科技大學,學士班(日間),泰國,東協,4,2,2,2,1,1,2,1,1,0,0,0,0,0,0
108,公立,技專校院,0022,國立臺灣科技大學,學士班(日間),索羅門群島,其他亞洲地區,1,1,0,1,1,0,0,0,0,0,0,0,0,0,0
108,公立,技專校院,0022,國立臺灣科技大學,學士班(日間),菲律賓共和國,東協,3,2,1,1,1,0,2,1,1,0,0,0,0,0,0
108,公立,技專校院,0022,國立臺灣科技大學,學士班(日間),越南社會主義共和國,東協,32,19,13,16,12,4,16,7,9,0,0,0,0,0,0
108,公立,技專校院,0022,國立臺灣科技大學,學士班(日間),澳門,港澳,41,34,7,0,0,0,0,0,0,41,34,7,0,0,0
108,公立,技專校院,0022,國立臺灣科技大學,學士班(日間),大韓民國(南韓),其他亞洲地區,2,1,1,1,1,0,1,0,1,0,0,0,0,0,0
108,公立,技專校院,0022,國立臺灣科技大學,學士班(日間),厄瓜多共和國,中南美洲,1,1,0,0,0,0,1,1,0,0,0,0,0,0,0
108,公立,技專校院,0022,國立臺灣科技大學,學士班(日間),日本,其他亞洲地區,7,3,4,5,2,3,2,1,1,0,0,0,0,0,0
108,公立,技專校院,0022,國立臺灣科技大學,學士班(日間),西班牙王國,歐洲,1,1,0,1,1,0,0,0,0,0,0,0,0,0,0
108,公立,技專校院,0022,國立臺灣科技大學,學士班(日間),宏都拉斯共和國,中南美洲,2,2,0,2,2,0,0,0,0,0,0,0,0,0,0
108,公立,技專校院,0022,國立臺灣科技大學,學士班(日間),約旦哈什米王國,其他亞洲地區,1,1,0,0,0,0,1,1,0,0,0,0,0,0,0
108,公立,技專校院,0022,國立臺灣科技大學,學士班(日間),美國,北美洲,4,4,0,0,0,0,4,4,0,0,0,0,0,0,0
108,公立,技專校院,0022,國立臺灣科技大學,學士班(日間),哥斯大黎加共和國,中南美洲,1,1,0,0,0,0,1,1,0,0,0,0,0,0,0
108,公立,技專校院,0022,國立臺灣科技大學,學士班(日間),海地共和國,中南美洲,1,1,0,1,1,0,0,0,0,0,0,0,0,0,0
108,公立,技專校院,0022,國立臺灣科技大學,學士班(日間),馬來西亞,東協,104,76,28,4,3,1,100,73,27,0,0,0,0,0,0
108,公立,技專校院,0022,國立臺灣科技大學,學士班(日間),馬拉威共和國,非洲,1,1,0,1,1,0,0,0,0,0,0,0,0,0,0
108,公立,技專校院,0022,國立臺灣科技大學,學士班(日間),新加坡共和國,東協,3,1,2,0,0,0,3,1,2,0,0,0,0,0,0
108,公立,技專校院,0022,國立臺灣科技大學,學士班(日間),聖文森(及格瑞那丁),中南美洲,2,1,1,2,1,1,0,0,0,0,0,0,0,0,0
108,公立,技專校院,0022,國立臺灣科技大學,學士班(日間),聖多美普林西比民主共和國,非洲,1,1,0,1,1,0,0,0,0,0,0,0,0,0,0
108,公立,技專校院,0022,國立臺灣科技大學,學士班(日間),聖露西亞,中南美洲,2,1,1,2,1,1,0,0,0,0,0,0,0,0,0
108,公立,技專校院,0022,國立臺灣科技大學,學士班(日間),蒙古國,其他亞洲地區,3,1,2,3,1,2,0,0,0,0,0,0,0,0,0
108,公立,技專校院,0022,國立臺灣科技大學,學士班(日間),緬甸,東協,24,14,10,0,0,0,24,14,10,0,0,0,0,0,0
108,公立,技專校院,0022,國立臺灣科技大學,學士班(日間),薩爾瓦多,中南美洲,1,1,0,1,1,0,0,0,0,0,0,0,0,0,0
108,公立,技專校院,0022,國立臺灣科技大學,碩士班(日間),大韓民國(南韓),其他亞洲地區,2,1,1,2,1,1,0,0,0,0,0,0,0,0,0
108,公立,技專校院,0022,國立臺灣科技大學,碩士班(日間),巴基斯坦,南亞,7,7,0,7,7,0,0,0,0,0,0,0,0,0,0
108,公立,技專校院,0022,國立臺灣科技大學,碩士班(日間),日本,其他亞洲地區,1,1,0,1,1,0,0,0,0,0,0,0,0,0,0
108,公立,技專校院,0022,國立臺灣科技大學,碩士班(日間),布吉納法索,非洲,1,1,0,1,1,0,0,0,0,0,0,0,0,0,0
108,公立,技專校院,0022,國立臺灣科技大學,碩士班(日間),甘比亞共和國,非洲,1,1,0,1,1,0,0,0,0,0,0,0,0,0,0
108,公立,技專校院,0022,國立臺灣科技大學,碩士班(日間),印度,南亞,14,11,3,14,11,3,0,0,0,0,0,0,0,0,0
108,公立,技專校院,0022,國立臺灣科技大學,碩士班(日間),汶萊和平之國,東協,1,1,0,1,1,0,0,0,0,0,0,0,0,0,0
108,公立,技專校院,0022,國立臺灣科技大學,碩士班(日間),俄羅斯聯邦,其他亞洲地區,3,1,2,3,1,2,0,0,0,0,0,0,0,0,0
108,公立,技專校院,0022,國立臺灣科技大學,碩士班(日間),哈薩克共和國,其他亞洲地區,1,0,1,1,0,1,0,0,0,0,0,0,0,0,0
108,公立,技專校院,0022,國立臺灣科技大學,碩士班(日間),美國,北美洲,5,5,0,4,4,0,1,1,0,0,0,0,0,0,0
108,公立,技專校院,0022,國立臺灣科技大學,碩士班(日間),捷克共和國,歐洲,1,1,0,1,1,0,0,0,0,0,0,0,0,0,0
108,公立,技專校院,0022,國立臺灣科技大學,碩士班(日間),斯洛伐克共和國,歐洲,2,2,0,2,2,0,0,0,0,0,0,0,0,0,0
108,公立,技專校院,0022,國立臺灣科技大學,碩士班(日間),菲律賓共和國,東協,10,8,2,10,8,2,0,0,0,0,0,0,0,0,0
108,公立,技專校院,0022,國立臺灣科技大學,碩士班(日間),聖克里斯多福及尼維斯,中南美洲,1,1,0,1,1,0,0,0,0,0,0,0,0,0,0
108,公立,技專校院,0022,國立臺灣科技大學,碩士班(日間),蒙古國,其他亞洲地區,7,3,4,7,3,4,0,0,0,0,0,0,0,0,0
108,公立,技專校院,0022,國立臺灣科技大學,碩士班(日間),德意志聯邦共和國,歐洲,4,2,2,4,2,2,0,0,0,0,0,0,0,0,0
108,公立,技專校院,0022,國立臺灣科技大學,碩士班(日間),薩爾瓦多,中南美洲,1,1,0,1,1,0,0,0,0,0,0,0,0,0,0
108,公立,技專校院,0022,國立臺灣科技大學,碩士班(日間),土耳其共和國,其他亞洲地區,2,1,1,2,1,1,0,0,0,0,0,0,0,0,0
108,公立,技專校院,0022,國立臺灣科技大學,碩士班(日間),大陸地區,大陸地區,85,51,34,0,0,0,0,0,0,0,0,0,85,51,34
108,公立,技專校院,0022,國立臺灣科技大學,碩士班(日間),比利時王國,歐洲,1,1,0,1,1,0,0,0,0,0,0,0,0,0,0
108,公立,技專校院,0022,國立臺灣科技大學,碩士班(日間),加拿大,北美洲,1,1,0,0,0,0,1,1,0,0,0,0,0,0,0
108,公立,技專校院,0022,國立臺灣科技大學,碩士班(日間),史瓦帝尼王國,非洲,1,1,0,1,1,0,0,0,0,0,0,0,0,0,0
108,公立,技專校院,0022,國立臺灣科技大學,碩士班(日間),尼加拉瓜,中南美洲,3,2,1,2,2,0,1,0,1,0,0,0,0,0,0
108,公立,技專校院,0022,國立臺灣科技大學,碩士班(日間),伊拉克共和國,其他亞洲地區,1,1,0,1,1,0,0,0,0,0,0,0,0,0,0
108,公立,技專校院,0022,國立臺灣科技大學,碩士班(日間),伊朗伊斯蘭共和國,其他亞洲地區,2,1,1,2,1,1,0,0,0,0,0,0,0,0,0
108,公立,技專校院,0022,國立臺灣科技大學,碩士班(日間),匈牙利共和國,歐洲,1,1,0,1,1,0,0,0,0,0,0,0,0,0,0
108,公立,技專校院,0022,國立臺灣科技大學,碩士班(日間),印度尼西亞共和國,東協,231,126,105,227,124,103,4,2,2,0,0,0,0,0,0
108,公立,技專校院,0022,國立臺灣科技大學,碩士班(日間),衣索比亞聯邦民主共和國,非洲,8,7,1,8,7,1,0,0,0,0,0,0,0,0,0
108,公立,技專校院,0022,國立臺灣科技大學,碩士班(日間),宏都拉斯共和國,中南美洲,1,1,0,1,1,0,0,0,0,0,0,0,0,0,0
108,公立,技專校院,0022,國立臺灣科技大學,碩士班(日間),委內瑞拉共和國,中南美洲,1,1,0,1,1,0,0,0,0,0,0,0,0,0,0
108,公立,技專校院,0022,國立臺灣科技大學,碩士班(日間),孟加拉人民共和國,南亞,1,1,0,1,1,0,0,0,0,0,0,0,0,0,0
108,公立,技專校院,0022,國立臺灣科技大學,碩士班(日間),波蘭共和國,歐洲,1,1,0,1,1,0,0,0,0,0,0,0,0,0,0
108,公立,技專校院,0022,國立臺灣科技大學,碩士班(日間),法國,歐洲,3,3,0,3,3,0,0,0,0,0,0,0,0,0,0
108,公立,技專校院,0022,國立臺灣科技大學,碩士班(日間),肯亞共和國,非洲,3,3,0,3,3,0,0,0,0,0,0,0,0,0,0
108,公立,技專校院,0022,國立臺灣科技大學,碩士班(日間),柬埔寨王國,東協,1,0,1,1,0,1,0,0,0,0,0,0,0,0,0
108,公立,技專校院,0022,國立臺灣科技大學,碩士班(日間),香港,港澳,7,2,5,0,0,0,0,0,0,7,2,5,0,0,0
108,公立,技專校院,0022,國立臺灣科技大學,碩士班(日間),泰國,東協,28,7,21,28,7,21,0,0,0,0,0,0,0,0,0
108,公立,技專校院,0022,國立臺灣科技大學,碩士班(日間),烏干達共和國,非洲,1,1,0,1,1,0,0,0,0,0,0,0,0,0,0
108,公立,技專校院,0022,國立臺灣科技大學,碩士班(日間),馬來西亞,東協,12,9,3,3,2,1,9,7,2,0,0,0,0,0,0
108,公立,技專校院,0022,國立臺灣科技大學,碩士班(日間),荷蘭王國,歐洲,1,1,0,1,1,0,0,0,0,0,0,0,0,0,0
108,公立,技專校院,0022,國立臺灣科技大學,碩士班(日間),越南社會主義共和國,東協,50,24,26,50,24,26,0,0,0,0,0,0,0,0,0
108,公立,技專校院,0022,國立臺灣科技大學,碩士班(日間),聖文森(及格瑞那丁),中南美洲,1,0,1,1,0,1,0,0,0,0,0,0,0,0,0
108,公立,技專校院,0022,國立臺灣科技大學,碩士班(日間),墨西哥合眾國,中南美洲,7,4,3,7,4,3,0,0,0,0,0,0,0,0,0
108,公立,技專校院,0022,國立臺灣科技大學,碩士班(日間),澳門,港澳,1,0,1,0,0,0,0,0,0,1,0,1,0,0,0
108,公立,技專校院,0022,國立臺灣科技大學,博士班,厄瓜多共和國,中南美洲,1,0,1,1,0,1,0,0,0,0,0,0,0,0,0
108,公立,技專校院,0022,國立臺灣科技大學,博士班,巴基斯坦,南亞,11,11,0,11,11,0,0,0,0,0,0,0,0,0,0
108,公立,技專校院,0022,國立臺灣科技大學,博士班,史瓦帝尼王國,非洲,1,1,0,1,1,0,0,0,0,0,0,0,0,0,0
108,公立,技專校院,0022,國立臺灣科技大學,博士班,甘比亞共和國,非洲,1,1,0,1,1,0,0,0,0,0,0,0,0,0,0
108,公立,技專校院,0022,國立臺灣科技大學,博士班,印度,南亞,47,34,13,47,34,13,0,0,0,0,0,0,0,0,0
108,公立,技專校院,0022,國立臺灣科技大學,博士班,衣索比亞聯邦民主共和國,非洲,107,104,3,107,104,3,0,0,0,0,0,0,0,0,0
108,公立,技專校院,0022,國立臺灣科技大學,博士班,美國,北美洲,2,1,1,2,1,1,0,0,0,0,0,0,0,0,0
108,公立,技專校院,0022,國立臺灣科技大學,博士班,泰國,東協,9,6,3,9,6,3,0,0,0,0,0,0,0,0,0
108,公立,技專校院,0022,國立臺灣科技大學,博士班,海地共和國,中南美洲,1,1,0,1,1,0,0,0,0,0,0,0,0,0,0
108,公立,技專校院,0022,國立臺灣科技大學,博士班,越南社會主義共和國,東協,38,24,14,38,24,14,0,0,0,0,0,0,0,0,0
108,公立,技專校院,0022,國立臺灣科技大學,博士班,義大利共和國,歐洲,1,1,0,1,1,0,0,0,0,0,0,0,0,0,0
108,公立,技專校院,0022,國立臺灣科技大學,博士班,聖露西亞,中南美洲,1,0,1,1,0,1,0,0,0,0,0,0,0,0,0
108,公立,技專校院,0022,國立臺灣科技大學,博士班,蒙古國,其他亞洲地區,2,0,2,2,0,2,0,0,0,0,0,0,0,0,0
108,公立,技專校院,0022,國立臺灣科技大學,博士班,德意志聯邦共和國,歐洲,2,2,0,2,2,0,0,0,0,0,0,0,0,0,0
108,公立,技專校院,0022,國立臺灣科技大學,博士班,大陸地區,大陸地區,42,19,23,0,0,0,0,0,0,0,0,0,42,19,23
108,公立,技專校院,0022,國立臺灣科技大學,博士班,巴西聯邦共和國,中南美洲,1,1,0,0,0,0,1,1,0,0,0,0,0,0,0
108,公立,技專校院,0022,國立臺灣科技大學,博士班,巴拿馬共和國,中南美洲,1,1,0,1,1,0,0,0,0,0,0,0,0,0,0
108,公立,技專校院,0022,國立臺灣科技大學,博士班,日本,其他亞洲地區,1,1,0,1,1,0,0,0,0,0,0,0,0,0,0
108,公立,技專校院,0022,國立臺灣科技大學,博士班,伊拉克共和國,其他亞洲地區,1,1,0,1,1,0,0,0,0,0,0,0,0,0,0
108,公立,技專校院,0022,國立臺灣科技大學,博士班,伊朗伊斯蘭共和國,其他亞洲地區,3,3,0,3,3,0,0,0,0,0,0,0,0,0,0
108,公立,技專校院,0022,國立臺灣科技大學,博士班,印度尼西亞共和國,東協,118,79,39,118,79,39,0,0,0,0,0,0,0,0,0
108,公立,技專校院,0022,國立臺灣科技大學,博士班,西班牙王國,歐洲,1,1,0,1,1,0,0,0,0,0,0,0,0,0,0
108,公立,技專校院,0022,國立臺灣科技大學,博士班,辛巴威共和國,非洲,1,1,0,1,1,0,0,0,0,0,0,0,0,0,0
108,公立,技專校院,0022,國立臺灣科技大學,博士班,委內瑞拉共和國,中南美洲,1,1,0,1,1,0,0,0,0,0,0,0,0,0,0
108,公立,技專校院,0022,國立臺灣科技大學,博士班,肯亞共和國,非洲,8,7,1,8,7,1,0,0,0,0,0,0,0,0,0
108,公立,技專校院,0022,國立臺灣科技大學,博士班,俄羅斯聯邦,其他亞洲地區,3,0,3,3,0,3,0,0,0,0,0,0,0,0,0
108,公立,技專校院,0022,國立臺灣科技大學,博士班,約旦哈什米王國,其他亞洲地區,1,1,0,1,1,0,0,0,0,0,0,0,0,0,0
108,公立,技專校院,0022,國立臺灣科技大學,博士班,荷蘭王國,歐洲,1,1,0,1,1,0,0,0,0,0,0,0,0,0,0
108,公立,技專校院,0022,國立臺灣科技大學,博士班,菲律賓共和國,東協,7,5,2,7,5,2,0,0,0,0,0,0,0,0,0
108,公立,技專校院,0022,國立臺灣科技大學,博士班,墨西哥合眾國,中南美洲,1,1,0,1,1,0,0,0,0,0,0,0,0,0,0
108,公立,技專校院,0023,國立雲林科技大學,學士班(日間),大陸地區,大陸地區,101,42,59,0,0,0,0,0,0,0,0,0,101,42,59
108,公立,技專校院,0023,國立雲林科技大學,學士班(日間),大韓民國(南韓),其他亞洲地區,1,1,0,0,0,0,1,1,0,0,0,0,0,0,0
108,公立,技專校院,0023,國立雲林科技大學,學士班(日間),日本,其他亞洲地區,7,4,3,7,4,3,0,0,0,0,0,0,0,0,0
108,公立,技專校院,0023,國立雲林科技大學,學士班(日間),印度尼西亞共和國,東協,38,17,21,6,1,5,32,16,16,0,0,0,0,0,0
108,公立,技專校院,0023,國立雲林科技大學,學士班(日間),阿根廷,中南美洲,1,1,0,0,0,0,1,1,0,0,0,0,0,0,0
108,公立,技專校院,0023,國立雲林科技大學,學士班(日間),馬來西亞,東協,139,75,64,23,9,14,116,66,50,0,0,0,0,0,0
108,公立,技專校院,0023,國立雲林科技大學,學士班(日間),厄瓜多共和國,中南美洲,1,1,0,0,0,0,1,1,0,0,0,0,0,0,0
108,公立,技專校院,0023,國立雲林科技大學,學士班(日間),美國,北美洲,1,0,1,0,0,0,1,0,1,0,0,0,0,0,0
108,公立,技專校院,0023,國立雲林科技大學,學士班(日間),香港,港澳,50,22,28,0,0,0,0,0,0,50,22,28,0,0,0
108,公立,技專校院,0023,國立雲林科技大學,學士班(日間),越南社會主義共和國,東協,14,8,6,3,0,3,11,8,3,0,0,0,0,0,0
108,公立,技專校院,0023,國立雲林科技大學,學士班(日間),緬甸,東協,5,2,3,0,0,0,5,2,3,0,0,0,0,0,0
108,公立,技專校院,0023,國立雲林科技大學,學士班(日間),澳門,港澳,21,7,14,0,0,0,0,0,0,21,7,14,0,0,0
108,公立,技專校院,0023,國立雲林科技大學,碩士班(日間),巴基斯坦,南亞,1,1,0,1,1,0,0,0,0,0,0,0,0,0,0
108,公立,技專校院,0023,國立雲林科技大學,碩士班(日間),白俄羅斯共和國,其他亞洲地區,1,0,1,1,0,1,0,0,0,0,0,0,0,0,0
108,公立,技專校院,0023,國立雲林科技大學,碩士班(日間),印度,南亞,3,3,0,3,3,0,0,0,0,0,0,0,0,0,0
108,公立,技專校院,0023,國立雲林科技大學,碩士班(日間),香港,港澳,7,3,4,0,0,0,0,0,0,7,3,4,0,0,0
108,公立,技專校院,0023,國立雲林科技大學,碩士班(日間),泰國,東協,2,1,1,2,1,1,0,0,0,0,0,0,0,0,0
108,公立,技專校院,0023,國立雲林科技大學,碩士班(日間),越南社會主義共和國,東協,11,1,10,11,1,10,0,0,0,0,0,0,0,0,0
108,公立,技專校院,0023,國立雲林科技大學,碩士班(日間),大陸地區,大陸地區,24,17,7,0,0,0,0,0,0,0,0,0,24,17,7
108,公立,技專校院,0023,國立雲林科技大學,碩士班(日間),印度尼西亞共和國,東協,27,11,16,27,11,16,0,0,0,0,0,0,0,0,0
108,公立,技專校院,0023,國立雲林科技大學,碩士班(日間),多明尼加共和國,中南美洲,1,1,0,1,1,0,0,0,0,0,0,0,0,0,0
108,公立,技專校院,0023,國立雲林科技大學,碩士班(日間),南非共和國,非洲,1,1,0,1,1,0,0,0,0,0,0,0,0,0,0
108,公立,技專校院,0023,國立雲林科技大學,碩士班(日間),烏干達共和國,非洲,1,0,1,1,0,1,0,0,0,0,0,0,0,0,0
108,公立,技專校院,0023,國立雲林科技大學,碩士班(日間),馬來西亞,東協,6,6,0,5,5,0,1,1,0,0,0,0,0,0,0
108,公立,技專校院,0023,國立雲林科技大學,博士班,大陸地區,大陸地區,30,15,15,0,0,0,0,0,0,0,0,0,30,15,15
108,公立,技專校院,0023,國立雲林科技大學,博士班,印度尼西亞共和國,東協,19,11,8,19,11,8,0,0,0,0,0,0,0,0,0
108,公立,技專校院,0023,國立雲林科技大學,博士班,烏干達共和國,非洲,1,1,0,1,1,0,0,0,0,0,0,0,0,0,0
108,公立,技專校院,0023,國立雲林科技大學,博士班,越南社會主義共和國,東協,4,1,3,4,1,3,0,0,0,0,0,0,0,0,0
108,公立,技專校院,0023,國立雲林科技大學,博士班,馬來西亞,東協,1,1,0,1,1,0,0,0,0,0,0,0,0,0,0
108,公立,技專校院,0023,國立雲林科技大學,博士班,德意志聯邦共和國,歐洲,1,0,1,1,0,1,0,0,0,0,0,0,0,0,0
108,公立,技專校院,0023,國立雲林科技大學,博士班,澳大利亞,其他亞洲地區,1,1,0,1,1,0,0,0,0,0,0,0,0,0,0
108,公立,技專校院,0024,國立屏東科技大學,學士班(日間),大陸地區,大陸地區,5,3,2,0,0,0,0,0,0,0,0,0,5,3,2
108,公立,技專校院,0024,國立屏東科技大學,學士班(日間),大韓民國(南韓),其他亞洲地區,3,3,0,0,0,0,3,3,0,0,0,0,0,0,0
108,公立,技專校院,0024,國立屏東科技大學,學士班(日間),巴布亞紐幾內亞獨立國,其他亞洲地區,1,0,1,1,0,1,0,0,0,0,0,0,0,0,0
108,公立,技專校院,0024,國立屏東科技大學,學士班(日間),日本,其他亞洲地區,3,1,2,2,1,1,1,0,1,0,0,0,0,0,0
108,公立,技專校院,0024,國立屏東科技大學,學士班(日間),加拿大,北美洲,1,0,1,0,0,0,1,0,1,0,0,0,0,0,0
108,公立,技專校院,0024,國立屏東科技大學,學士班(日間),印度,南亞,5,5,0,5,5,0,0,0,0,0,0,0,0,0,0
108,公立,技專校院,0024,國立屏東科技大學,學士班(日間),印度尼西亞共和國,東協,17,4,13,10,3,7,7,1,6,0,0,0,0,0,0
108,公立,技專校院,0024,國立屏東科技大學,學士班(日間),吉里巴斯共和國,其他亞洲地區,1,1,0,1,1,0,0,0,0,0,0,0,0,0,0
108,公立,技專校院,0024,國立屏東科技大學,學士班(日間),宏都拉斯共和國,中南美洲,5,1,4,5,1,4,0,0,0,0,0,0,0,0,0
108,公立,技專校院,0024,國立屏東科技大學,學士班(日間),貝里斯,中南美洲,7,4,3,7,4,3,0,0,0,0,0,0,0,0,0
108,公立,技專校院,0024,國立屏東科技大學,學士班(日間),英國,歐洲,1,1,0,1,1,0,0,0,0,0,0,0,0,0,0
108,公立,技專校院,0024,國立屏東科技大學,學士班(日間),香港,港澳,43,22,21,0,0,0,0,0,0,43,22,21,0,0,0
108,公立,技專校院,0024,國立屏東科技大學,學士班(日間),馬來西亞,東協,157,96,61,23,22,1,134,74,60,0,0,0,0,0,0
108,公立,技專校院,0024,國立屏東科技大學,學士班(日間),越南社會主義共和國,東協,5,1,4,4,0,4,1,1,0,0,0,0,0,0,0
108,公立,技專校院,0024,國立屏東科技大學,學士班(日間),聖文森(及格瑞那丁),中南美洲,1,0,1,1,0,1,0,0,0,0,0,0,0,0,0
108,公立,技專校院,0024,國立屏東科技大學,學士班(日間),緬甸,東協,3,1,2,0,0,0,3,1,2,0,0,0,0,0,0
108,公立,技專校院,0024,國立屏東科技大學,學士班(日間),澳門,港澳,30,14,16,0,0,0,0,0,0,30,14,16,0,0,0
108,公立,技專校院,0024,國立屏東科技大學,學士班(日間),薩爾瓦多,中南美洲,1,1,0,1,1,0,0,0,0,0,0,0,0,0,0
108,公立,技專校院,0024,國立屏東科技大學,學士班(日間),巴拿馬共和國,中南美洲,1,0,1,1,0,1,0,0,0,0,0,0,0,0,0
108,公立,技專校院,0024,國立屏東科技大學,學士班(日間),史瓦帝尼王國,非洲,4,1,3,4,1,3,0,0,0,0,0,0,0,0,0
108,公立,技專校院,0024,國立屏東科技大學,學士班(日間),尼泊爾聯邦民主共和國,南亞,26,8,18,26,8,18,0,0,0,0,0,0,0,0,0
108,公立,技專校院,0024,國立屏東科技大學,學士班(日間),瓜地馬拉共和國,中南美洲,3,3,0,3,3,0,0,0,0,0,0,0,0,0,0
108,公立,技專校院,0024,國立屏東科技大學,學士班(日間),甘比亞共和國,非洲,3,1,2,3,1,2,0,0,0,0,0,0,0,0,0
108,公立,技專校院,0024,國立屏東科技大學,學士班(日間),吐瓦魯,其他亞洲地區,2,1,1,2,1,1,0,0,0,0,0,0,0,0,0
108,公立,技專校院,0024,國立屏東科技大學,學士班(日間),汶萊和平之國,東協,1,1,0,0,0,0,1,1,0,0,0,0,0,0,0
108,公立,技專校院,0024,國立屏東科技大學,學士班(日間),帛琉共和國,其他亞洲地區,3,0,3,3,0,3,0,0,0,0,0,0,0,0,0
108,公立,技專校院,0024,國立屏東科技大學,學士班(日間),美國,北美洲,1,0,1,0,0,0,1,0,1,0,0,0,0,0,0
108,公立,技專校院,0024,國立屏東科技大學,學士班(日間),泰國,東協,2,1,1,0,0,0,2,1,1,0,0,0,0,0,0
108,公立,技專校院,0024,國立屏東科技大學,學士班(日間),海地共和國,中南美洲,3,2,1,3,2,1,0,0,0,0,0,0,0,0,0
108,公立,技專校院,0024,國立屏東科技大學,學士班(日間),索羅門群島,其他亞洲地區,2,2,0,2,2,0,0,0,0,0,0,0,0,0,0
108,公立,技專校院,0024,國立屏東科技大學,學士班(日間),馬拉威共和國,非洲,2,2,0,2,2,0,0,0,0,0,0,0,0,0,0
108,公立,技專校院,0024,國立屏東科技大學,學士班(日間),馬紹爾群島共和國,其他亞洲地區,1,1,0,1,1,0,0,0,0,0,0,0,0,0,0
108,公立,技專校院,0024,國立屏東科技大學,學士班(日間),聖克里斯多福及尼維斯,中南美洲,1,0,1,1,0,1,0,0,0,0,0,0,0,0,0
108,公立,技專校院,0024,國立屏東科技大學,學士班(日間),聖露西亞,中南美洲,1,0,1,1,0,1,0,0,0,0,0,0,0,0,0
108,公立,技專校院,0024,國立屏東科技大學,學士班(日間),蒙古國,其他亞洲地區,1,0,1,1,0,1,0,0,0,0,0,0,0,0,0
108,公立,技專校院,0024,國立屏東科技大學,學士班(日間),諾魯共和國,其他亞洲地區,1,0,1,1,0,1,0,0,0,0,0,0,0,0,0
108,公立,技專校院,0024,國立屏東科技大學,碩士班(日間),巴基斯坦,南亞,2,2,0,2,2,0,0,0,0,0,0,0,0,0,0
108,公立,技專校院,0024,國立屏東科技大學,碩士班(日間),史瓦帝尼王國,非洲,10,4,6,10,4,6,0,0,0,0,0,0,0,0,0
108,公立,技專校院,0024,國立屏東科技大學,碩士班(日間),尼泊爾聯邦民主共和國,南亞,4,1,3,4,1,3,0,0,0,0,0,0,0,0,0
108,公立,技專校院,0024,國立屏東科技大學,碩士班(日間),孟加拉人民共和國,南亞,1,1,0,1,1,0,0,0,0,0,0,0,0,0,0
108,公立,技專校院,0024,國立屏東科技大學,碩士班(日間),泰國,東協,7,2,5,7,2,5,0,0,0,0,0,0,0,0,0
108,公立,技專校院,0024,國立屏東科技大學,碩士班(日間),海地共和國,中南美洲,1,0,1,1,0,1,0,0,0,0,0,0,0,0,0
108,公立,技專校院,0024,國立屏東科技大學,碩士班(日間),捷克共和國,歐洲,1,1,0,1,1,0,0,0,0,0,0,0,0,0,0
108,公立,技專校院,0024,國立屏東科技大學,碩士班(日間),聖露西亞,中南美洲,1,0,1,1,0,1,0,0,0,0,0,0,0,0,0
108,公立,技專校院,0024,國立屏東科技大學,碩士班(日間),蒙古國,其他亞洲地區,4,0,4,4,0,4,0,0,0,0,0,0,0,0,0
108,公立,技專校院,0024,國立屏東科技大學,碩士班(日間),巴布亞紐幾內亞獨立國,其他亞洲地區,2,1,1,2,1,1,0,0,0,0,0,0,0,0,0
108,公立,技專校院,0024,國立屏東科技大學,碩士班(日間),日本,其他亞洲地區,2,0,2,2,0,2,0,0,0,0,0,0,0,0,0
108,公立,技專校院,0024,國立屏東科技大學,碩士班(日間),印度,南亞,1,1,0,1,1,0,0,0,0,0,0,0,0,0,0
108,公立,技專校院,0024,國立屏東科技大學,碩士班(日間),印度尼西亞共和國,東協,32,10,22,31,10,21,1,0,1,0,0,0,0,0,0
108,公立,技專校院,0024,國立屏東科技大學,碩士班(日間),宏都拉斯共和國,中南美洲,1,1,0,1,1,0,0,0,0,0,0,0,0,0,0
108,公立,技專校院,0024,國立屏東科技大學,碩士班(日間),貝里斯,中南美洲,3,2,1,3,2,1,0,0,0,0,0,0,0,0,0
108,公立,技專校院,0024,國立屏東科技大學,碩士班(日間),香港,港澳,8,4,4,0,0,0,0,0,0,8,4,4,0,0,0
108,公立,技專校院,0024,國立屏東科技大學,碩士班(日間),馬來西亞,東協,12,9,3,4,3,1,8,6,2,0,0,0,0,0,0
108,公立,技專校院,0024,國立屏東科技大學,碩士班(日間),斐濟群島共和國,其他亞洲地區,1,1,0,1,1,0,0,0,0,0,0,0,0,0,0
108,公立,技專校院,0024,國立屏東科技大學,碩士班(日間),菲律賓共和國,東協,1,1,0,1,1,0,0,0,0,0,0,0,0,0,0
108,公立,技專校院,0024,國立屏東科技大學,碩士班(日間),越南社會主義共和國,東協,21,6,15,21,6,15,0,0,0,0,0,0,0,0,0
108,公立,技專校院,0024,國立屏東科技大學,碩士班(日間),聖文森(及格瑞那丁),中南美洲,3,1,2,3,1,2,0,0,0,0,0,0,0,0,0
108,公立,技專校院,0024,國立屏東科技大學,碩士班(日間),聖克里斯多福及尼維斯,中南美洲,1,1,0,1,1,0,0,0,0,0,0,0,0,0,0
108,公立,技專校院,0024,國立屏東科技大學,碩士班(日間),澳門,港澳,2,1,1,0,0,0,0,0,0,2,1,1,0,0,0
108,公立,技專校院,0024,國立屏東科技大學,碩士班(日間),薩爾瓦多,中南美洲,1,0,1,1,0,1,0,0,0,0,0,0,0,0,0
108,公立,技專校院,0024,國立屏東科技大學,博士班,巴布亞紐幾內亞獨立國,其他亞洲地區,2,2,0,2,2,0,0,0,0,0,0,0,0,0,0
108,公立,技專校院,0024,國立屏東科技大學,博士班,史瓦帝尼王國,非洲,2,2,0,2,2,0,0,0,0,0,0,0,0,0,0
108,公立,技專校院,0024,國立屏東科技大學,博士班,瓜地馬拉共和國,中南美洲,1,1,0,1,1,0,0,0,0,0,0,0,0,0,0
108,公立,技專校院,0024,國立屏東科技大學,博士班,甘比亞共和國,非洲,2,2,0,2,2,0,0,0,0,0,0,0,0,0,0
108,公立,技專校院,0024,國立屏東科技大學,博士班,印度,南亞,11,8,3,11,8,3,0,0,0,0,0,0,0,0,0
108,公立,技專校院,0024,國立屏東科技大學,博士班,辛巴威共和國,非洲,1,1,0,1,1,0,0,0,0,0,0,0,0,0,0
108,公立,技專校院,0024,國立屏東科技大學,博士班,南非共和國,非洲,1,0,1,1,0,1,0,0,0,0,0,0,0,0,0
108,公立,技專校院,0024,國立屏東科技大學,博士班,香港,港澳,1,1,0,0,0,0,0,0,0,1,1,0,0,0,0
108,公立,技專校院,0024,國立屏東科技大學,博士班,海地共和國,中南美洲,1,1,0,1,1,0,0,0,0,0,0,0,0,0,0
108,公立,技專校院,0024,國立屏東科技大學,博士班,索羅門群島,其他亞洲地區,3,2,1,3,2,1,0,0,0,0,0,0,0,0,0
108,公立,技專校院,0024,國立屏東科技大學,博士班,越南社會主義共和國,東協,20,11,9,20,11,9,0,0,0,0,0,0,0,0,0
108,公立,技專校院,0024,國立屏東科技大學,博士班,尼泊爾聯邦民主共和國,南亞,5,4,1,5,4,1,0,0,0,0,0,0,0,0,0
108,公立,技專校院,0024,國立屏東科技大學,博士班,印度尼西亞共和國,東協,18,10,8,18,10,8,0,0,0,0,0,0,0,0,0
108,公立,技專校院,0024,國立屏東科技大學,博士班,柬埔寨王國,東協,1,1,0,1,1,0,0,0,0,0,0,0,0,0,0
108,公立,技專校院,0024,國立屏東科技大學,博士班,泰國,東協,32,11,21,32,11,21,0,0,0,0,0,0,0,0,0
108,公立,技專校院,0024,國立屏東科技大學,博士班,馬來西亞,東協,1,0,1,0,0,0,1,0,1,0,0,0,0,0,0
108,公立,技專校院,0024,國立屏東科技大學,博士班,蒙古國,其他亞洲地區,4,0,4,4,0,4,0,0,0,0,0,0,0,0,0
108,公立,技專校院,0024,國立屏東科技大學,博士班,寮人民民主共和國(寮國),東協,1,0,1,1,0,1,0,0,0,0,0,0,0,0,0
108,公立,技專校院,0025,國立臺北科技大學,五專,印度尼西亞共和國,東協,1,1,0,0,0,0,1,1,0,0,0,0,0,0,0
108,公立,技專校院,0025,國立臺北科技大學,學士班(日間),大韓民國(南韓),其他亞洲地區,5,1,4,2,1,1,3,0,3,0,0,0,0,0,0
108,公立,技專校院,0025,國立臺北科技大學,學士班(日間),巴西聯邦共和國,中南美洲,2,1,1,0,0,0,2,1,1,0,0,0,0,0,0
108,公立,技專校院,0025,國立臺北科技大學,學士班(日間),巴拿馬共和國,中南美洲,6,2,4,6,2,4,0,0,0,0,0,0,0,0,0
108,公立,技專校院,0025,國立臺北科技大學,學士班(日間),日本,其他亞洲地區,10,4,6,6,2,4,4,2,2,0,0,0,0,0,0
108,公立,技專校院,0025,國立臺北科技大學,學士班(日間),加拿大,北美洲,5,4,1,2,1,1,3,3,0,0,0,0,0,0,0
108,公立,技專校院,0025,國立臺北科技大學,學士班(日間),布吉納法索,非洲,1,1,0,1,1,0,0,0,0,0,0,0,0,0,0
108,公立,技專校院,0025,國立臺北科技大學,學士班(日間),印度尼西亞共和國,東協,63,32,31,16,9,7,47,23,24,0,0,0,0,0,0
108,公立,技專校院,0025,國立臺北科技大學,學士班(日間),西班牙王國,歐洲,1,1,0,1,1,0,0,0,0,0,0,0,0,0,0
108,公立,技專校院,0025,國立臺北科技大學,學士班(日間),委內瑞拉共和國,中南美洲,1,0,1,0,0,0,1,0,1,0,0,0,0,0,0
108,公立,技專校院,0025,國立臺北科技大學,學士班(日間),哥斯大黎加共和國,中南美洲,1,1,0,1,1,0,0,0,0,0,0,0,0,0,0
108,公立,技專校院,0025,國立臺北科技大學,學士班(日間),馬來西亞,東協,131,90,41,25,15,10,106,75,31,0,0,0,0,0,0
108,公立,技專校院,0025,國立臺北科技大學,學士班(日間),荷蘭王國,歐洲,1,0,1,1,0,1,0,0,0,0,0,0,0,0,0
108,公立,技專校院,0025,國立臺北科技大學,學士班(日間),新加坡共和國,東協,1,0,1,1,0,1,0,0,0,0,0,0,0,0,0
108,公立,技專校院,0025,國立臺北科技大學,學士班(日間),土耳其共和國,其他亞洲地區,1,0,1,1,0,1,0,0,0,0,0,0,0,0,0
108,公立,技專校院,0025,國立臺北科技大學,學士班(日間),聖文森(及格瑞那丁),中南美洲,6,4,2,6,4,2,0,0,0,0,0,0,0,0,0
108,公立,技專校院,0025,國立臺北科技大學,學士班(日間),大陸地區,大陸地區,151,68,83,0,0,0,0,0,0,0,0,0,151,68,83
108,公立,技專校院,0025,國立臺北科技大學,學士班(日間),巴拉圭,中南美洲,21,10,11,21,10,11,0,0,0,0,0,0,0,0,0
108,公立,技專校院,0025,國立臺北科技大學,學士班(日間),尼加拉瓜,中南美洲,4,3,1,4,3,1,0,0,0,0,0,0,0,0,0
108,公立,技專校院,0025,國立臺北科技大學,學士班(日間),瓜地馬拉共和國,中南美洲,3,0,3,2,0,2,1,0,1,0,0,0,0,0,0
108,公立,技專校院,0025,國立臺北科技大學,學士班(日間),伊朗伊斯蘭共和國,其他亞洲地區,1,0,1,0,0,0,1,0,1,0,0,0,0,0,0
108,公立,技專校院,0025,國立臺北科技大學,學士班(日間),宏都拉斯共和國,中南美洲,5,5,0,5,5,0,0,0,0,0,0,0,0,0,0
108,公立,技專校院,0025,國立臺北科技大學,學士班(日間),貝里斯,中南美洲,1,0,1,1,0,1,0,0,0,0,0,0,0,0,0
108,公立,技專校院,0025,國立臺北科技大學,學士班(日間),帛琉共和國,其他亞洲地區,2,2,0,2,2,0,0,0,0,0,0,0,0,0,0
108,公立,技專校院,0025,國立臺北科技大學,學士班(日間),阿根廷,中南美洲,1,0,1,0,0,0,1,0,1,0,0,0,0,0,0
108,公立,技專校院,0025,國立臺北科技大學,學士班(日間),美國,北美洲,3,2,1,2,2,0,1,0,1,0,0,0,0,0,0
108,公立,技專校院,0025,國立臺北科技大學,學士班(日間),香港,港澳,91,60,31,0,0,0,0,0,0,91,60,31,0,0,0
108,公立,技專校院,0025,國立臺北科技大學,學士班(日間),泰國,東協,16,9,7,11,6,5,5,3,2,0,0,0,0,0,0
108,公立,技專校院,0025,國立臺北科技大學,學士班(日間),海地共和國,中南美洲,3,3,0,3,3,0,0,0,0,0,0,0,0,0,0
108,公立,技專校院,0025,國立臺北科技大學,學士班(日間),索羅門群島,其他亞洲地區,1,1,0,1,1,0,0,0,0,0,0,0,0,0,0
108,公立,技專校院,0025,國立臺北科技大學,學士班(日間),馬拉威共和國,非洲,1,1,0,1,1,0,0,0,0,0,0,0,0,0,0
108,公立,技專校院,0025,國立臺北科技大學,學士班(日間),馬紹爾群島共和國,其他亞洲地區,2,2,0,2,2,0,0,0,0,0,0,0,0,0,0
108,公立,技專校院,0025,國立臺北科技大學,學士班(日間),越南社會主義共和國,東協,29,13,16,14,5,9,15,8,7,0,0,0,0,0,0
108,公立,技專校院,0025,國立臺北科技大學,學士班(日間),聖克里斯多福及尼維斯,中南美洲,1,1,0,1,1,0,0,0,0,0,0,0,0,0,0
108,公立,技專校院,0025,國立臺北科技大學,學士班(日間),聖露西亞,中南美洲,3,1,2,3,1,2,0,0,0,0,0,0,0,0,0
108,公立,技專校院,0025,國立臺北科技大學,學士班(日間),葉門共和國,其他亞洲地區,1,1,0,1,1,0,0,0,0,0,0,0,0,0,0
108,公立,技專校院,0025,國立臺北科技大學,學士班(日間),緬甸,東協,30,18,12,0,0,0,30,18,12,0,0,0,0,0,0
108,公立,技專校院,0025,國立臺北科技大學,學士班(日間),澳大利亞,其他亞洲地區,1,0,1,0,0,0,1,0,1,0,0,0,0,0,0
108,公立,技專校院,0025,國立臺北科技大學,學士班(日間),澳門,港澳,40,24,16,0,0,0,0,0,0,40,24,16,0,0,0
108,公立,技專校院,0025,國立臺北科技大學,碩士班(日間),土耳其共和國,其他亞洲地區,2,2,0,2,2,0,0,0,0,0,0,0,0,0,0
108,公立,技專校院,0025,國立臺北科技大學,碩士班(日間),大陸地區,大陸地區,39,22,17,0,0,0,0,0,0,0,0,0,39,22,17
108,公立,技專校院,0025,國立臺北科技大學,碩士班(日間),巴拉圭,中南美洲,3,3,0,3,3,0,0,0,0,0,0,0,0,0,0
108,公立,技專校院,0025,國立臺北科技大學,碩士班(日間),史瓦帝尼王國,非洲,6,6,0,6,6,0,0,0,0,0,0,0,0,0,0
108,公立,技專校院,0025,國立臺北科技大學,碩士班(日間),尼加拉瓜,中南美洲,2,2,0,2,2,0,0,0,0,0,0,0,0,0,0
108,公立,技專校院,0025,國立臺北科技大學,碩士班(日間),瓜地馬拉共和國,中南美洲,1,1,0,1,1,0,0,0,0,0,0,0,0,0,0
108,公立,技專校院,0025,國立臺北科技大學,碩士班(日間),甘比亞共和國,非洲,1,1,0,1,1,0,0,0,0,0,0,0,0,0,0
108,公立,技專校院,0025,國立臺北科技大學,碩士班(日間),伊朗伊斯蘭共和國,其他亞洲地區,1,0,1,1,0,1,0,0,0,0,0,0,0,0,0
108,公立,技專校院,0025,國立臺北科技大學,碩士班(日間),印度,南亞,32,22,10,32,22,10,0,0,0,0,0,0,0,0,0
108,公立,技專校院,0025,國立臺北科技大學,碩士班(日間),衣索比亞聯邦民主共和國,非洲,1,1,0,1,1,0,0,0,0,0,0,0,0,0,0
108,公立,技專校院,0025,國立臺北科技大學,碩士班(日間),宏都拉斯共和國,中南美洲,1,1,0,1,1,0,0,0,0,0,0,0,0,0,0
108,公立,技專校院,0025,國立臺北科技大學,碩士班(日間),貝里斯,中南美洲,1,1,0,1,1,0,0,0,0,0,0,0,0,0,0
108,公立,技專校院,0025,國立臺北科技大學,碩士班(日間),法國,歐洲,1,0,1,1,0,1,0,0,0,0,0,0,0,0,0
108,公立,技專校院,0025,國立臺北科技大學,碩士班(日間),美國,北美洲,2,1,1,1,1,0,1,0,1,0,0,0,0,0,0
108,公立,技專校院,0025,國立臺北科技大學,碩士班(日間),香港,港澳,8,5,3,0,0,0,0,0,0,8,5,3,0,0,0
108,公立,技專校院,0025,國立臺北科技大學,碩士班(日間),越南社會主義共和國,東協,40,17,23,40,17,23,0,0,0,0,0,0,0,0,0
108,公立,技專校院,0025,國立臺北科技大學,碩士班(日間),新加坡共和國,東協,1,1,0,0,0,0,1,1,0,0,0,0,0,0,0
108,公立,技專校院,0025,國立臺北科技大學,碩士班(日間),義大利共和國,歐洲,1,0,1,1,0,1,0,0,0,0,0,0,0,0,0
108,公立,技專校院,0025,國立臺北科技大學,碩士班(日間),蒙古國,其他亞洲地區,7,3,4,7,3,4,0,0,0,0,0,0,0,0,0
108,公立,技專校院,0025,國立臺北科技大學,碩士班(日間),德意志聯邦共和國,歐洲,3,2,1,3,2,1,0,0,0,0,0,0,0,0,0
108,公立,技專校院,0025,國立臺北科技大學,碩士班(日間),墨西哥合眾國,中南美洲,1,1,0,1,1,0,0,0,0,0,0,0,0,0,0
108,公立,技專校院,0025,國立臺北科技大學,碩士班(日間),澳門,港澳,2,1,1,0,0,0,0,0,0,2,1,1,0,0,0
108,公立,技專校院,0025,國立臺北科技大學,碩士班(日間),大韓民國(南韓),其他亞洲地區,1,0,1,1,0,1,0,0,0,0,0,0,0,0,0
108,公立,技專校院,0025,國立臺北科技大學,碩士班(日間),伊拉克共和國,其他亞洲地區,1,1,0,1,1,0,0,0,0,0,0,0,0,0,0
108,公立,技專校院,0025,國立臺北科技大學,碩士班(日間),印度尼西亞共和國,東協,27,17,10,25,16,9,2,1,1,0,0,0,0,0,0
108,公立,技專校院,0025,國立臺北科技大學,碩士班(日間),西班牙王國,歐洲,1,1,0,1,1,0,0,0,0,0,0,0,0,0,0
108,公立,技專校院,0025,國立臺北科技大學,碩士班(日間),波蘭共和國,歐洲,1,1,0,1,1,0,0,0,0,0,0,0,0,0,0
108,公立,技專校院,0025,國立臺北科技大學,碩士班(日間),俄羅斯聯邦,其他亞洲地區,5,2,3,5,2,3,0,0,0,0,0,0,0,0,0
108,公立,技專校院,0025,國立臺北科技大學,碩士班(日間),泰國,東協,33,10,23,32,9,23,1,1,0,0,0,0,0,0,0
108,公立,技專校院,0025,國立臺北科技大學,碩士班(日間),秘魯共和國,中南美洲,2,0,2,2,0,2,0,0,0,0,0,0,0,0,0
108,公立,技專校院,0025,國立臺北科技大學,碩士班(日間),馬來西亞,東協,8,6,2,3,3,0,5,3,2,0,0,0,0,0,0
108,公立,技專校院,0025,國立臺北科技大學,碩士班(日間),菲律賓共和國,東協,4,2,2,4,2,2,0,0,0,0,0,0,0,0,0
108,公立,技專校院,0025,國立臺北科技大學,碩士班(日間),奧地利共和國,歐洲,1,1,0,1,1,0,0,0,0,0,0,0,0,0,0
108,公立,技專校院,0025,國立臺北科技大學,碩士班(日間),聖文森(及格瑞那丁),中南美洲,1,1,0,1,1,0,0,0,0,0,0,0,0,0,0
108,公立,技專校院,0025,國立臺北科技大學,碩士班(日間),羅馬尼亞,歐洲,1,1,0,1,1,0,0,0,0,0,0,0,0,0,0
108,公立,技專校院,0025,國立臺北科技大學,博士班,大陸地區,大陸地區,30,23,7,0,0,0,0,0,0,0,0,0,30,23,7
108,公立,技專校院,0025,國立臺北科技大學,博士班,厄瓜多共和國,中南美洲,3,3,0,3,3,0,0,0,0,0,0,0,0,0,0
108,公立,技專校院,0025,國立臺北科技大學,博士班,尼加拉瓜,中南美洲,1,1,0,1,1,0,0,0,0,0,0,0,0,0,0
108,公立,技專校院,0025,國立臺北科技大學,博士班,印度,南亞,68,48,20,68,48,20,0,0,0,0,0,0,0,0,0
108,公立,技專校院,0025,國立臺北科技大學,博士班,印度尼西亞共和國,東協,4,3,1,4,3,1,0,0,0,0,0,0,0,0,0
108,公立,技專校院,0025,國立臺北科技大學,博士班,衣索比亞聯邦民主共和國,非洲,9,9,0,9,9,0,0,0,0,0,0,0,0,0,0
108,公立,技專校院,0025,國立臺北科技大學,博士班,貝里斯,中南美洲,1,1,0,1,1,0,0,0,0,0,0,0,0,0,0
108,公立,技專校院,0025,國立臺北科技大學,博士班,馬來西亞,東協,1,1,0,1,1,0,0,0,0,0,0,0,0,0,0
108,公立,技專校院,0025,國立臺北科技大學,博士班,越南社會主義共和國,東協,25,17,8,25,17,8,0,0,0,0,0,0,0,0,0
108,公立,技專校院,0025,國立臺北科技大學,博士班,新加坡共和國,東協,1,1,0,1,1,0,0,0,0,0,0,0,0,0,0
108,公立,技專校院,0025,國立臺北科技大學,博士班,聖文森(及格瑞那丁),中南美洲,1,1,0,1,1,0,0,0,0,0,0,0,0,0,0
108,公立,技專校院,0025,國立臺北科技大學,博士班,蒙古國,其他亞洲地區,1,0,1,1,0,1,0,0,0,0,0,0,0,0,0
108,公立,技專校院,0025,國立臺北科技大學,博士班,澳大利亞,其他亞洲地區,1,0,1,1,0,1,0,0,0,0,0,0,0,0,0
108,公立,技專校院,0025,國立臺北科技大學,博士班,日本,其他亞洲地區,1,1,0,1,1,0,0,0,0,0,0,0,0,0,0
108,公立,技專校院,0025,國立臺北科技大學,博士班,布吉納法索,非洲,1,1,0,1,1,0,0,0,0,0,0,0,0,0,0
108,公立,技專校院,0025,國立臺北科技大學,博士班,甘比亞共和國,非洲,2,2,0,2,2,0,0,0,0,0,0,0,0,0,0
108,公立,技專校院,0025,國立臺北科技大學,博士班,約旦哈什米王國,其他亞洲地區,1,1,0,1,1,0,0,0,0,0,0,0,0,0,0
108,公立,技專校院,0025,國立臺北科技大學,博士班,埃及阿拉伯共和國,非洲,1,1,0,1,1,0,0,0,0,0,0,0,0,0,0
108,公立,技專校院,0025,國立臺北科技大學,博士班,泰國,東協,3,0,3,3,0,3,0,0,0,0,0,0,0,0,0
108,公立,技專校院,0025,國立臺北科技大學,博士班,菲律賓共和國,東協,1,1,0,1,1,0,0,0,0,0,0,0,0,0,0
108,公立,一般大學,0028,國立臺北藝術大學,學士班(日間),大陸地區,大陸地區,16,1,15,0,0,0,0,0,0,0,0,0,16,1,15
108,公立,一般大學,0028,國立臺北藝術大學,學士班(日間),加拿大,北美洲,1,1,0,1,1,0,0,0,0,0,0,0,0,0,0
108,公立,一般大學,0028,國立臺北藝術大學,學士班(日間),瓜地馬拉共和國,中南美洲,1,0,1,1,0,1,0,0,0,0,0,0,0,0,0
108,公立,一般大學,0028,國立臺北藝術大學,學士班(日間),法國,歐洲,1,0,1,1,0,1,0,0,0,0,0,0,0,0,0
108,公立,一般大學,0028,國立臺北藝術大學,學士班(日間),南非共和國,非洲,1,1,0,1,1,0,0,0,0,0,0,0,0,0,0
108,公立,一般大學,0028,國立臺北藝術大學,學士班(日間),香港,港澳,40,11,29,0,0,0,0,0,0,40,11,29,0,0,0
108,公立,一般大學,0028,國立臺北藝術大學,學士班(日間),秘魯共和國,中南美洲,1,0,1,1,0,1,0,0,0,0,0,0,0,0,0
108,公立,一般大學,0028,國立臺北藝術大學,學士班(日間),愛沙尼亞共和國,歐洲,1,0,1,1,0,1,0,0,0,0,0,0,0,0,0
108,公立,一般大學,0028,國立臺北藝術大學,學士班(日間),瑞士聯邦,歐洲,1,1,0,1,1,0,0,0,0,0,0,0,0,0,0
108,公立,一般大學,0028,國立臺北藝術大學,學士班(日間),澳門,港澳,10,6,4,0,0,0,0,0,0,10,6,4,0,0,0
108,公立,一般大學,0028,國立臺北藝術大學,學士班(日間),巴西聯邦共和國,中南美洲,1,0,1,1,0,1,0,0,0,0,0,0,0,0,0
108,公立,一般大學,0028,國立臺北藝術大學,學士班(日間),巴拿馬共和國,中南美洲,1,0,1,1,0,1,0,0,0,0,0,0,0,0,0
108,公立,一般大學,0028,國立臺北藝術大學,學士班(日間),日本,其他亞洲地區,2,1,1,1,1,0,1,0,1,0,0,0,0,0,0
108,公立,一般大學,0028,國立臺北藝術大學,學士班(日間),美國,北美洲,3,3,0,3,3,0,0,0,0,0,0,0,0,0,0
108,公立,一般大學,0028,國立臺北藝術大學,學士班(日間),馬來西亞,東協,36,17,19,17,8,9,19,9,10,0,0,0,0,0,0
108,公立,一般大學,0028,國立臺北藝術大學,學士班(日間),新加坡共和國,東協,4,2,2,4,2,2,0,0,0,0,0,0,0,0,0
108,公立,一般大學,0028,國立臺北藝術大學,碩士班(日間),巴西聯邦共和國,中南美洲,1,0,1,1,0,1,0,0,0,0,0,0,0,0,0
108,公立,一般大學,0028,國立臺北藝術大學,碩士班(日間),日本,其他亞洲地區,7,1,6,7,1,6,0,0,0,0,0,0,0,0,0
108,公立,一般大學,0028,國立臺北藝術大學,碩士班(日間),以色列,其他亞洲地區,1,0,1,1,0,1,0,0,0,0,0,0,0,0,0
108,公立,一般大學,0028,國立臺北藝術大學,碩士班(日間),俄羅斯聯邦,其他亞洲地區,1,0,1,1,0,1,0,0,0,0,0,0,0,0,0
108,公立,一般大學,0028,國立臺北藝術大學,碩士班(日間),美國,北美洲,4,3,1,3,2,1,1,1,0,0,0,0,0,0,0
108,公立,一般大學,0028,國立臺北藝術大學,碩士班(日間),泰國,東協,3,0,3,3,0,3,0,0,0,0,0,0,0,0,0
108,公立,一般大學,0028,國立臺北藝術大學,碩士班(日間),馬來西亞,東協,22,14,8,11,9,2,11,5,6,0,0,0,0,0,0
108,公立,一般大學,0028,國立臺北藝術大學,碩士班(日間),菲律賓共和國,東協,2,1,1,2,1,1,0,0,0,0,0,0,0,0,0
108,公立,一般大學,0028,國立臺北藝術大學,碩士班(日間),大陸地區,大陸地區,34,18,16,0,0,0,0,0,0,0,0,0,34,18,16
108,公立,一般大學,0028,國立臺北藝術大學,碩士班(日間),大韓民國(南韓),其他亞洲地區,2,0,2,2,0,2,0,0,0,0,0,0,0,0,0
108,公立,一般大學,0028,國立臺北藝術大學,碩士班(日間),巴布亞紐幾內亞獨立國,其他亞洲地區,1,1,0,1,1,0,0,0,0,0,0,0,0,0,0
108,公立,一般大學,0028,國立臺北藝術大學,碩士班(日間),比利時王國,歐洲,1,0,1,1,0,1,0,0,0,0,0,0,0,0,0
108,公立,一般大學,0028,國立臺北藝術大學,碩士班(日間),加拿大,北美洲,5,2,3,5,2,3,0,0,0,0,0,0,0,0,0
108,公立,一般大學,0028,國立臺北藝術大學,碩士班(日間),尼加拉瓜,中南美洲,2,0,2,2,0,2,0,0,0,0,0,0,0,0,0
108,公立,一般大學,0028,國立臺北藝術大學,碩士班(日間),瓜地馬拉共和國,中南美洲,2,0,2,2,0,2,0,0,0,0,0,0,0,0,0
108,公立,一般大學,0028,國立臺北藝術大學,碩士班(日間),宏都拉斯共和國,中南美洲,3,1,2,3,1,2,0,0,0,0,0,0,0,0,0
108,公立,一般大學,0028,國立臺北藝術大學,碩士班(日間),貝里斯,中南美洲,1,0,1,1,0,1,0,0,0,0,0,0,0,0,0
108,公立,一般大學,0028,國立臺北藝術大學,碩士班(日間),香港,港澳,13,5,8,0,0,0,0,0,0,13,5,8,0,0,0
108,公立,一般大學,0028,國立臺北藝術大學,碩士班(日間),秘魯共和國,中南美洲,1,0,1,1,0,1,0,0,0,0,0,0,0,0,0
108,公立,一般大學,0028,國立臺北藝術大學,碩士班(日間),新加坡共和國,東協,3,2,1,3,2,1,0,0,0,0,0,0,0,0,0
108,公立,一般大學,0028,國立臺北藝術大學,碩士班(日間),緬甸,東協,1,1,0,0,0,0,1,1,0,0,0,0,0,0,0
108,公立,一般大學,0028,國立臺北藝術大學,碩士班(日間),澳門,港澳,10,7,3,0,0,0,0,0,0,10,7,3,0,0,0
108,公立,一般大學,0028,國立臺北藝術大學,博士班,大陸地區,大陸地區,8,3,5,0,0,0,0,0,0,0,0,0,8,3,5
108,公立,一般大學,0028,國立臺北藝術大學,博士班,印度尼西亞共和國,東協,1,0,1,1,0,1,0,0,0,0,0,0,0,0,0
108,公立,一般大學,0028,國立臺北藝術大學,博士班,香港,港澳,1,0,1,0,0,0,0,0,0,1,0,1,0,0,0
108,公立,一般大學,0028,國立臺北藝術大學,博士班,馬來西亞,東協,1,1,0,0,0,0,1,1,0,0,0,0,0,0,0
108,公立,一般大學,0028,國立臺北藝術大學,博士班,新加坡共和國,東協,1,0,1,1,0,1,0,0,0,0,0,0,0,0,0
108,公立,一般大學,0029,國立臺灣藝術大學,學士班(日間),日本,其他亞洲地區,9,1,8,9,1,8,0,0,0,0,0,0,0,0,0
108,公立,一般大學,0029,國立臺灣藝術大學,學士班(日間),阿根廷,中南美洲,1,1,0,0,0,0,1,1,0,0,0,0,0,0,0
108,公立,一般大學,0029,國立臺灣藝術大學,學士班(日間),美國,北美洲,1,0,1,0,0,0,1,0,1,0,0,0,0,0,0
108,公立,一般大學,0029,國立臺灣藝術大學,學士班(日間),越南社會主義共和國,東協,2,0,2,1,0,1,1,0,1,0,0,0,0,0,0
108,公立,一般大學,0029,國立臺灣藝術大學,學士班(日間),大陸地區,大陸地區,19,7,12,0,0,0,0,0,0,0,0,0,19,7,12
108,公立,一般大學,0029,國立臺灣藝術大學,學士班(日間),大韓民國(南韓),其他亞洲地區,2,1,1,1,1,0,1,0,1,0,0,0,0,0,0
108,公立,一般大學,0029,國立臺灣藝術大學,學士班(日間),瓜地馬拉共和國,中南美洲,1,0,1,1,0,1,0,0,0,0,0,0,0,0,0
108,公立,一般大學,0029,國立臺灣藝術大學,學士班(日間),印度尼西亞共和國,東協,4,2,2,0,0,0,4,2,2,0,0,0,0,0,0
108,公立,一般大學,0029,國立臺灣藝術大學,學士班(日間),西班牙王國,歐洲,1,0,1,1,0,1,0,0,0,0,0,0,0,0,0
108,公立,一般大學,0029,國立臺灣藝術大學,學士班(日間),宏都拉斯共和國,中南美洲,1,0,1,1,0,1,0,0,0,0,0,0,0,0,0
108,公立,一般大學,0029,國立臺灣藝術大學,學士班(日間),玻利維亞共和國,中南美洲,1,0,1,1,0,1,0,0,0,0,0,0,0,0,0
108,公立,一般大學,0029,國立臺灣藝術大學,學士班(日間),香港,港澳,39,12,27,0,0,0,0,0,0,39,12,27,0,0,0
108,公立,一般大學,0029,國立臺灣藝術大學,學士班(日間),馬來西亞,東協,66,26,40,35,14,21,31,12,19,0,0,0,0,0,0
108,公立,一般大學,0029,國立臺灣藝術大學,學士班(日間),新加坡共和國,東協,2,0,2,2,0,2,0,0,0,0,0,0,0,0,0
108,公立,一般大學,0029,國立臺灣藝術大學,學士班(日間),澳門,港澳,22,12,10,0,0,0,0,0,0,22,12,10,0,0,0
108,公立,一般大學,0029,國立臺灣藝術大學,碩士班(日間),大陸地區,大陸地區,30,17,13,0,0,0,0,0,0,0,0,0,30,17,13
108,公立,一般大學,0029,國立臺灣藝術大學,碩士班(日間),大韓民國(南韓),其他亞洲地區,1,0,1,1,0,1,0,0,0,0,0,0,0,0,0
108,公立,一般大學,0029,國立臺灣藝術大學,碩士班(日間),印度尼西亞共和國,東協,2,1,1,1,0,1,1,1,0,0,0,0,0,0,0
108,公立,一般大學,0029,國立臺灣藝術大學,碩士班(日間),香港,港澳,17,6,11,0,0,0,0,0,0,17,6,11,0,0,0
108,公立,一般大學,0029,國立臺灣藝術大學,碩士班(日間),馬來西亞,東協,11,4,7,1,0,1,10,4,6,0,0,0,0,0,0
108,公立,一般大學,0029,國立臺灣藝術大學,碩士班(日間),新加坡共和國,東協,2,0,2,2,0,2,0,0,0,0,0,0,0,0,0
108,公立,一般大學,0029,國立臺灣藝術大學,碩士班(日間),義大利共和國,歐洲,1,1,0,1,1,0,0,0,0,0,0,0,0,0,0
108,公立,一般大學,0029,國立臺灣藝術大學,碩士班(日間),澳門,港澳,8,3,5,0,0,0,0,0,0,8,3,5,0,0,0
108,公立,一般大學,0029,國立臺灣藝術大學,碩士班(日間),日本,其他亞洲地區,3,0,3,3,0,3,0,0,0,0,0,0,0,0,0
108,公立,一般大學,0029,國立臺灣藝術大學,碩士班(日間),美國,北美洲,1,1,0,0,0,0,1,1,0,0,0,0,0,0,0
108,公立,一般大學,0029,國立臺灣藝術大學,碩士班(日間),泰國,東協,1,0,1,0,0,0,1,0,1,0,0,0,0,0,0
108,公立,一般大學,0029,國立臺灣藝術大學,博士班,法國,歐洲,1,0,1,1,0,1,0,0,0,0,0,0,0,0,0
108,公立,一般大學,0029,國立臺灣藝術大學,博士班,俄羅斯聯邦,其他亞洲地區,1,0,1,1,0,1,0,0,0,0,0,0,0,0,0
108,公立,一般大學,0029,國立臺灣藝術大學,博士班,泰國,東協,1,1,0,0,0,0,1,1,0,0,0,0,0,0,0
108,公立,一般大學,0029,國立臺灣藝術大學,博士班,馬來西亞,東協,2,1,1,1,0,1,1,1,0,0,0,0,0,0,0
108,公立,一般大學,0029,國立臺灣藝術大學,博士班,澳門,港澳,2,2,0,0,0,0,0,0,0,2,2,0,0,0,0
108,公立,一般大學,0029,國立臺灣藝術大學,博士班,大陸地區,大陸地區,32,16,16,0,0,0,0,0,0,0,0,0,32,16,16
108,公立,一般大學,0029,國立臺灣藝術大學,博士班,日本,其他亞洲地區,1,1,0,1,1,0,0,0,0,0,0,0,0,0,0
108,公立,一般大學,0029,國立臺灣藝術大學,博士班,新加坡共和國,東協,1,0,1,1,0,1,0,0,0,0,0,0,0,0,0
108,公立,一般大學,0030,國立臺東大學,學士班(日間),大陸地區,大陸地區,3,1,2,0,0,0,0,0,0,0,0,0,3,1,2
108,公立,一般大學,0030,國立臺東大學,學士班(日間),大韓民國(南韓),其他亞洲地區,3,2,1,3,2,1,0,0,0,0,0,0,0,0,0
108,公立,一般大學,0030,國立臺東大學,學士班(日間),日本,其他亞洲地區,2,1,1,2,1,1,0,0,0,0,0,0,0,0,0
108,公立,一般大學,0030,國立臺東大學,學士班(日間),印度尼西亞共和國,東協,3,1,2,0,0,0,3,1,2,0,0,0,0,0,0
108,公立,一般大學,0030,國立臺東大學,學士班(日間),香港,港澳,4,3,1,0,0,0,0,0,0,4,3,1,0,0,0
108,公立,一般大學,0030,國立臺東大學,學士班(日間),馬來西亞,東協,23,11,12,1,1,0,22,10,12,0,0,0,0,0,0
108,公立,一般大學,0030,國立臺東大學,學士班(日間),緬甸,東協,2,1,1,0,0,0,2,1,1,0,0,0,0,0,0
108,公立,一般大學,0030,國立臺東大學,學士班(日間),澳門,港澳,8,4,4,0,0,0,0,0,0,8,4,4,0,0,0
108,公立,一般大學,0030,國立臺東大學,學士班(日間),越南社會主義共和國,東協,1,1,0,1,1,0,0,0,0,0,0,0,0,0,0
108,公立,一般大學,0030,國立臺東大學,碩士班(日間),美國,北美洲,1,1,0,1,1,0,0,0,0,0,0,0,0,0,0
108,公立,一般大學,0030,國立臺東大學,碩士班(日間),越南社會主義共和國,東協,2,0,2,2,0,2,0,0,0,0,0,0,0,0,0
108,公立,一般大學,0030,國立臺東大學,碩士班(日間),澳門,港澳,1,1,0,0,0,0,0,0,0,1,1,0,0,0,0
108,公立,一般大學,0030,國立臺東大學,碩士班(日間),香港,港澳,2,1,1,0,0,0,0,0,0,2,1,1,0,0,0
108,公立,一般大學,0030,國立臺東大學,碩士班(日間),馬來西亞,東協,3,2,1,1,0,1,2,2,0,0,0,0,0,0,0
108,公立,一般大學,0030,國立臺東大學,博士班,大陸地區,大陸地區,4,2,2,0,0,0,0,0,0,0,0,0,4,2,2
108,公立,一般大學,0030,國立臺東大學,博士班,美國,北美洲,1,1,0,1,1,0,0,0,0,0,0,0,0,0,0
108,公立,一般大學,0031,國立宜蘭大學,學士班(日間),巴拉圭,中南美洲,2,1,1,2,1,1,0,0,0,0,0,0,0,0,0
108,公立,一般大學,0031,國立宜蘭大學,學士班(日間),印度尼西亞共和國,東協,3,1,2,0,0,0,3,1,2,0,0,0,0,0,0
108,公立,一般大學,0031,國立宜蘭大學,學士班(日間),多明尼加共和國,中南美洲,1,0,1,0,0,0,1,0,1,0,0,0,0,0,0
108,公立,一般大學,0031,國立宜蘭大學,學士班(日間),阿根廷,中南美洲,1,1,0,0,0,0,1,1,0,0,0,0,0,0,0
108,公立,一般大學,0031,國立宜蘭大學,學士班(日間),馬來西亞,東協,53,32,21,1,1,0,52,31,21,0,0,0,0,0,0
108,公立,一般大學,0031,國立宜蘭大學,學士班(日間),越南社會主義共和國,東協,2,0,2,1,0,1,1,0,1,0,0,0,0,0,0
108,公立,一般大學,0031,國立宜蘭大學,學士班(日間),聖克里斯多福及尼維斯,中南美洲,1,1,0,1,1,0,0,0,0,0,0,0,0,0,0
108,公立,一般大學,0031,國立宜蘭大學,學士班(日間),蒙古國,其他亞洲地區,1,0,1,1,0,1,0,0,0,0,0,0,0,0,0
108,公立,一般大學,0031,國立宜蘭大學,學士班(日間),大陸地區,大陸地區,3,1,2,0,0,0,0,0,0,0,0,0,3,1,2
108,公立,一般大學,0031,國立宜蘭大學,學士班(日間),日本,其他亞洲地區,2,0,2,1,0,1,1,0,1,0,0,0,0,0,0
108,公立,一般大學,0031,國立宜蘭大學,學士班(日間),印度,南亞,1,1,0,1,1,0,0,0,0,0,0,0,0,0,0
108,公立,一般大學,0031,國立宜蘭大學,學士班(日間),美國,北美洲,2,2,0,1,1,0,1,1,0,0,0,0,0,0,0
108,公立,一般大學,0031,國立宜蘭大學,學士班(日間),香港,港澳,43,31,12,0,0,0,0,0,0,43,31,12,0,0,0
108,公立,一般大學,0031,國立宜蘭大學,學士班(日間),緬甸,東協,3,1,2,0,0,0,3,1,2,0,0,0,0,0,0
108,公立,一般大學,0031,國立宜蘭大學,學士班(日間),澳門,港澳,12,8,4,0,0,0,0,0,0,12,8,4,0,0,0
108,公立,一般大學,0031,國立宜蘭大學,碩士班(日間),大陸地區,大陸地區,3,1,2,0,0,0,0,0,0,0,0,0,3,1,2
108,公立,一般大學,0031,國立宜蘭大學,碩士班(日間),史瓦帝尼王國,非洲,1,0,1,1,0,1,0,0,0,0,0,0,0,0,0
108,公立,一般大學,0031,國立宜蘭大學,碩士班(日間),印度,南亞,3,2,1,3,2,1,0,0,0,0,0,0,0,0,0
108,公立,一般大學,0031,國立宜蘭大學,碩士班(日間),香港,港澳,1,1,0,0,0,0,0,0,0,1,1,0,0,0,0
108,公立,一般大學,0031,國立宜蘭大學,碩士班(日間),法國,歐洲,1,0,1,1,0,1,0,0,0,0,0,0,0,0,0
108,公立,一般大學,0031,國立宜蘭大學,碩士班(日間),南非共和國,非洲,1,0,1,1,0,1,0,0,0,0,0,0,0,0,0
108,公立,一般大學,0031,國立宜蘭大學,碩士班(日間),馬來西亞,東協,5,4,1,0,0,0,5,4,1,0,0,0,0,0,0
108,公立,一般大學,0031,國立宜蘭大學,博士班,印度,南亞,1,0,1,1,0,1,0,0,0,0,0,0,0,0,0
108,公立,一般大學,0032,國立聯合大學,學士班(日間),大陸地區,大陸地區,14,7,7,0,0,0,0,0,0,0,0,0,14,7,7
108,公立,一般大學,0032,國立聯合大學,學士班(日間),印度尼西亞共和國,東協,10,9,1,2,2,0,8,7,1,0,0,0,0,0,0
108,公立,一般大學,0032,國立聯合大學,學士班(日間),馬來西亞,東協,32,15,17,0,0,0,32,15,17,0,0,0,0,0,0
108,公立,一般大學,0032,國立聯合大學,學士班(日間),香港,港澳,6,4,2,0,0,0,0,0,0,6,4,2,0,0,0
108,公立,一般大學,0032,國立聯合大學,學士班(日間),泰國,東協,1,0,1,0,0,0,1,0,1,0,0,0,0,0,0
108,公立,一般大學,0032,國立聯合大學,學士班(日間),緬甸,東協,3,0,3,0,0,0,3,0,3,0,0,0,0,0,0
108,公立,一般大學,0032,國立聯合大學,學士班(日間),澳門,港澳,5,5,0,0,0,0,0,0,0,5,5,0,0,0,0
108,公立,一般大學,0032,國立聯合大學,碩士班(日間),印度,南亞,3,3,0,3,3,0,0,0,0,0,0,0,0,0,0
108,公立,技專校院,0033,國立虎尾科技大學,學士班(日間),日本,其他亞洲地區,4,4,0,2,2,0,2,2,0,0,0,0,0,0,0
108,公立,技專校院,0033,國立虎尾科技大學,學士班(日間),貝里斯,中南美洲,1,1,0,0,0,0,1,1,0,0,0,0,0,0,0
108,公立,技專校院,0033,國立虎尾科技大學,學士班(日間),香港,港澳,6,5,1,0,0,0,0,0,0,6,5,1,0,0,0
108,公立,技專校院,0033,國立虎尾科技大學,學士班(日間),越南社會主義共和國,東協,3,2,1,0,0,0,3,2,1,0,0,0,0,0,0
108,公立,技專校院,0033,國立虎尾科技大學,學士班(日間),緬甸,東協,1,1,0,0,0,0,1,1,0,0,0,0,0,0,0
108,公立,技專校院,0033,國立虎尾科技大學,學士班(日間),澳門,港澳,1,0,1,0,0,0,0,0,0,1,0,1,0,0,0
108,公立,技專校院,0033,國立虎尾科技大學,學士班(日間),大陸地區,大陸地區,18,17,1,0,0,0,0,0,0,0,0,0,18,17,1
108,公立,技專校院,0033,國立虎尾科技大學,學士班(日間),印度尼西亞共和國,東協,3,2,1,1,1,0,2,1,1,0,0,0,0,0,0
108,公立,技專校院,0033,國立虎尾科技大學,學士班(日間),馬來西亞,東協,39,32,7,19,16,3,20,16,4,0,0,0,0,0,0
108,公立,技專校院,0033,國立虎尾科技大學,碩士班(日間),印度,南亞,13,12,1,13,12,1,0,0,0,0,0,0,0,0,0
108,公立,技專校院,0033,國立虎尾科技大學,碩士班(日間),印度尼西亞共和國,東協,11,8,3,11,8,3,0,0,0,0,0,0,0,0,0
108,公立,技專校院,0033,國立虎尾科技大學,碩士班(日間),俄羅斯聯邦,其他亞洲地區,1,0,1,1,0,1,0,0,0,0,0,0,0,0,0
108,公立,技專校院,0033,國立虎尾科技大學,碩士班(日間),馬來西亞,東協,1,1,0,1,1,0,0,0,0,0,0,0,0,0,0
108,公立,技專校院,0033,國立虎尾科技大學,碩士班(日間),越南社會主義共和國,東協,24,9,15,24,9,15,0,0,0,0,0,0,0,0,0
108,公立,技專校院,0033,國立虎尾科技大學,碩士班(日間),蒙古國,其他亞洲地區,14,4,10,14,4,10,0,0,0,0,0,0,0,0,0
108,公立,技專校院,0033,國立虎尾科技大學,碩士班(日間),孟加拉人民共和國,南亞,1,1,0,1,1,0,0,0,0,0,0,0,0,0,0
108,公立,技專校院,0033,國立虎尾科技大學,碩士班(日間),泰國,東協,19,3,16,19,3,16,0,0,0,0,0,0,0,0,0
108,公立,技專校院,0033,國立虎尾科技大學,博士班,印度尼西亞共和國,東協,2,2,0,2,2,0,0,0,0,0,0,0,0,0,0
108,公立,技專校院,0033,國立虎尾科技大學,博士班,泰國,東協,1,1,0,1,1,0,0,0,0,0,0,0,0,0,0
108,公立,技專校院,0033,國立虎尾科技大學,博士班,越南社會主義共和國,東協,3,3,0,3,3,0,0,0,0,0,0,0,0,0,0
108,公立,技專校院,0033,國立虎尾科技大學,博士班,印度,南亞,1,1,0,1,1,0,0,0,0,0,0,0,0,0,0
108,公立,一般大學,0035,國立臺南藝術大學,學士班(日間),大陸地區,大陸地區,9,3,6,0,0,0,0,0,0,0,0,0,9,3,6
108,公立,一般大學,0035,國立臺南藝術大學,學士班(日間),香港,港澳,7,2,5,0,0,0,0,0,0,7,2,5,0,0,0
108,公立,一般大學,0035,國立臺南藝術大學,學士班(日間),澳門,港澳,1,1,0,0,0,0,0,0,0,1,1,0,0,0,0
108,公立,一般大學,0035,國立臺南藝術大學,學士班(日間),印度尼西亞共和國,東協,1,0,1,0,0,0,1,0,1,0,0,0,0,0,0
108,公立,一般大學,0035,國立臺南藝術大學,學士班(日間),馬來西亞,東協,14,8,6,6,3,3,8,5,3,0,0,0,0,0,0
108,公立,一般大學,0035,國立臺南藝術大學,碩士班(日間),大韓民國(南韓),其他亞洲地區,1,0,1,1,0,1,0,0,0,0,0,0,0,0,0
108,公立,一般大學,0035,國立臺南藝術大學,碩士班(日間),馬來西亞,東協,5,3,2,3,1,2,2,2,0,0,0,0,0,0,0
108,公立,一般大學,0035,國立臺南藝術大學,碩士班(日間),澳門,港澳,2,0,2,0,0,0,0,0,0,2,0,2,0,0,0
108,公立,一般大學,0035,國立臺南藝術大學,碩士班(日間),大陸地區,大陸地區,4,1,3,0,0,0,0,0,0,0,0,0,4,1,3
108,公立,一般大學,0035,國立臺南藝術大學,碩士班(日間),日本,其他亞洲地區,1,0,1,1,0,1,0,0,0,0,0,0,0,0,0
108,公立,一般大學,0035,國立臺南藝術大學,碩士班(日間),美國,北美洲,1,0,1,1,0,1,0,0,0,0,0,0,0,0,0
108,公立,一般大學,0035,國立臺南藝術大學,碩士班(日間),香港,港澳,6,2,4,0,0,0,0,0,0,6,2,4,0,0,0
108,公立,一般大學,0035,國立臺南藝術大學,碩士班(日間),新加坡共和國,東協,1,1,0,1,1,0,0,0,0,0,0,0,0,0,0
108,公立,一般大學,0035,國立臺南藝術大學,博士班,大陸地區,大陸地區,1,0,1,0,0,0,0,0,0,0,0,0,1,0,1
108,公立,一般大學,0035,國立臺南藝術大學,博士班,大韓民國(南韓),其他亞洲地區,1,0,1,1,0,1,0,0,0,0,0,0,0,0,0
108,公立,一般大學,0035,國立臺南藝術大學,博士班,日本,其他亞洲地區,2,0,2,2,0,2,0,0,0,0,0,0,0,0,0
108,公立,一般大學,0036,國立臺南大學,學士班(日間),大陸地區,大陸地區,14,8,6,0,0,0,0,0,0,0,0,0,14,8,6
108,公立,一般大學,0036,國立臺南大學,學士班(日間),大韓民國(南韓),其他亞洲地區,2,1,1,2,1,1,0,0,0,0,0,0,0,0,0
108,公立,一般大學,0036,國立臺南大學,學士班(日間),日本,其他亞洲地區,7,2,5,6,2,4,1,0,1,0,0,0,0,0,0
108,公立,一般大學,0036,國立臺南大學,學士班(日間),印度尼西亞共和國,東協,5,1,4,5,1,4,0,0,0,0,0,0,0,0,0
108,公立,一般大學,0036,國立臺南大學,學士班(日間),南非共和國,非洲,1,0,1,1,0,1,0,0,0,0,0,0,0,0,0
108,公立,一般大學,0036,國立臺南大學,學士班(日間),香港,港澳,20,7,13,0,0,0,0,0,0,20,7,13,0,0,0
108,公立,一般大學,0036,國立臺南大學,學士班(日間),緬甸,東協,1,0,1,0,0,0,1,0,1,0,0,0,0,0,0
108,公立,一般大學,0036,國立臺南大學,學士班(日間),澳門,港澳,15,4,11,0,0,0,0,0,0,15,4,11,0,0,0
108,公立,一般大學,0036,國立臺南大學,學士班(日間),俄羅斯聯邦,其他亞洲地區,1,0,1,1,0,1,0,0,0,0,0,0,0,0,0
108,公立,一般大學,0036,國立臺南大學,學士班(日間),馬來西亞,東協,23,12,11,2,1,1,21,11,10,0,0,0,0,0,0
108,公立,一般大學,0036,國立臺南大學,學士班(日間),越南社會主義共和國,東協,6,0,6,6,0,6,0,0,0,0,0,0,0,0,0
108,公立,一般大學,0036,國立臺南大學,學士班(日間),蒙古國,其他亞洲地區,3,1,2,3,1,2,0,0,0,0,0,0,0,0,0
108,公立,一般大學,0036,國立臺南大學,碩士班(日間),巴西聯邦共和國,中南美洲,1,0,1,1,0,1,0,0,0,0,0,0,0,0,0
108,公立,一般大學,0036,國立臺南大學,碩士班(日間),伊拉克共和國,其他亞洲地區,1,1,0,1,1,0,0,0,0,0,0,0,0,0,0
108,公立,一般大學,0036,國立臺南大學,碩士班(日間),法國,歐洲,1,1,0,1,1,0,0,0,0,0,0,0,0,0,0
108,公立,一般大學,0036,國立臺南大學,碩士班(日間),美國,北美洲,1,1,0,1,1,0,0,0,0,0,0,0,0,0,0
108,公立,一般大學,0036,國立臺南大學,碩士班(日間),泰國,東協,2,2,0,2,2,0,0,0,0,0,0,0,0,0,0
108,公立,一般大學,0036,國立臺南大學,碩士班(日間),馬來西亞,東協,3,2,1,0,0,0,3,2,1,0,0,0,0,0,0
108,公立,一般大學,0036,國立臺南大學,碩士班(日間),越南社會主義共和國,東協,2,0,2,2,0,2,0,0,0,0,0,0,0,0,0
108,公立,一般大學,0036,國立臺南大學,碩士班(日間),澳門,港澳,4,1,3,0,0,0,0,0,0,4,1,3,0,0,0
108,公立,一般大學,0036,國立臺南大學,碩士班(日間),大陸地區,大陸地區,1,0,1,0,0,0,0,0,0,0,0,0,1,0,1
108,公立,一般大學,0036,國立臺南大學,碩士班(日間),香港,港澳,5,2,3,0,0,0,0,0,0,5,2,3,0,0,0
108,公立,一般大學,0036,國立臺南大學,博士班,印度尼西亞共和國,東協,1,0,1,1,0,1,0,0,0,0,0,0,0,0,0
108,公立,一般大學,0036,國立臺南大學,博士班,越南社會主義共和國,東協,1,0,1,1,0,1,0,0,0,0,0,0,0,0,0
108,公立,一般大學,0036,國立臺南大學,博士班,大陸地區,大陸地區,9,1,8,0,0,0,0,0,0,0,0,0,9,1,8
108,公立,一般大學,0036,國立臺南大學,博士班,大韓民國(南韓),其他亞洲地區,1,1,0,1,1,0,0,0,0,0,0,0,0,0,0
108,公立,一般大學,0036,國立臺南大學,博士班,菲律賓共和國,東協,1,1,0,1,1,0,0,0,0,0,0,0,0,0,0
108,公立,一般大學,0037,國立臺北教育大學,學士班(日間),日本,其他亞洲地區,7,4,3,5,2,3,2,2,0,0,0,0,0,0,0
108,公立,一般大學,0037,國立臺北教育大學,學士班(日間),俄羅斯聯邦,其他亞洲地區,1,1,0,1,1,0,0,0,0,0,0,0,0,0,0
108,公立,一般大學,0037,國立臺北教育大學,學士班(日間),菲律賓共和國,東協,1,0,1,0,0,0,1,0,1,0,0,0,0,0,0
108,公立,一般大學,0037,國立臺北教育大學,學士班(日間),大陸地區,大陸地區,5,0,5,0,0,0,0,0,0,0,0,0,5,0,5
108,公立,一般大學,0037,國立臺北教育大學,學士班(日間),大韓民國(南韓),其他亞洲地區,1,0,1,0,0,0,1,0,1,0,0,0,0,0,0
108,公立,一般大學,0037,國立臺北教育大學,學士班(日間),瓜地馬拉共和國,中南美洲,1,0,1,1,0,1,0,0,0,0,0,0,0,0,0
108,公立,一般大學,0037,國立臺北教育大學,學士班(日間),印度尼西亞共和國,東協,3,2,1,1,1,0,2,1,1,0,0,0,0,0,0
108,公立,一般大學,0037,國立臺北教育大學,學士班(日間),香港,港澳,26,11,15,0,0,0,0,0,0,26,11,15,0,0,0
108,公立,一般大學,0037,國立臺北教育大學,學士班(日間),馬來西亞,東協,37,12,25,4,2,2,33,10,23,0,0,0,0,0,0
108,公立,一般大學,0037,國立臺北教育大學,學士班(日間),越南社會主義共和國,東協,11,2,9,7,1,6,4,1,3,0,0,0,0,0,0
108,公立,一般大學,0037,國立臺北教育大學,學士班(日間),緬甸,東協,20,5,15,0,0,0,20,5,15,0,0,0,0,0,0
108,公立,一般大學,0037,國立臺北教育大學,學士班(日間),澳門,港澳,27,9,18,0,0,0,0,0,0,27,9,18,0,0,0
108,公立,一般大學,0037,國立臺北教育大學,碩士班(日間),大陸地區,大陸地區,3,1,2,0,0,0,0,0,0,0,0,0,3,1,2
108,公立,一般大學,0037,國立臺北教育大學,碩士班(日間),大韓民國(南韓),其他亞洲地區,3,0,3,3,0,3,0,0,0,0,0,0,0,0,0
108,公立,一般大學,0037,國立臺北教育大學,碩士班(日間),巴拉圭,中南美洲,1,1,0,1,1,0,0,0,0,0,0,0,0,0,0
108,公立,一般大學,0037,國立臺北教育大學,碩士班(日間),印度,南亞,1,0,1,1,0,1,0,0,0,0,0,0,0,0,0
108,公立,一般大學,0037,國立臺北教育大學,碩士班(日間),印度尼西亞共和國,東協,1,0,1,0,0,0,1,0,1,0,0,0,0,0,0
108,公立,一般大學,0037,國立臺北教育大學,碩士班(日間),南非共和國,非洲,3,1,2,3,1,2,0,0,0,0,0,0,0,0,0
108,公立,一般大學,0037,國立臺北教育大學,碩士班(日間),英國,歐洲,3,2,1,3,2,1,0,0,0,0,0,0,0,0,0
108,公立,一般大學,0037,國立臺北教育大學,碩士班(日間),香港,港澳,2,0,2,0,0,0,0,0,0,2,0,2,0,0,0
108,公立,一般大學,0037,國立臺北教育大學,碩士班(日間),馬來西亞,東協,15,4,11,5,1,4,10,3,7,0,0,0,0,0,0
108,公立,一般大學,0037,國立臺北教育大學,碩士班(日間),越南社會主義共和國,東協,11,0,11,11,0,11,0,0,0,0,0,0,0,0,0
108,公立,一般大學,0037,國立臺北教育大學,碩士班(日間),聖文森(及格瑞那丁),中南美洲,1,0,1,1,0,1,0,0,0,0,0,0,0,0,0
108,公立,一般大學,0037,國立臺北教育大學,碩士班(日間),緬甸,東協,1,0,1,0,0,0,1,0,1,0,0,0,0,0,0
108,公立,一般大學,0037,國立臺北教育大學,碩士班(日間),澳門,港澳,11,5,6,0,0,0,0,0,0,11,5,6,0,0,0
108,公立,一般大學,0037,國立臺北教育大學,碩士班(日間),日本,其他亞洲地區,2,0,2,2,0,2,0,0,0,0,0,0,0,0,0
108,公立,一般大學,0037,國立臺北教育大學,碩士班(日間),孟加拉人民共和國,南亞,1,0,1,1,0,1,0,0,0,0,0,0,0,0,0
108,公立,一般大學,0037,國立臺北教育大學,碩士班(日間),俄羅斯聯邦,其他亞洲地區,5,1,4,5,1,4,0,0,0,0,0,0,0,0,0
108,公立,一般大學,0037,國立臺北教育大學,碩士班(日間),美國,北美洲,7,4,3,6,4,2,1,0,1,0,0,0,0,0,0
108,公立,一般大學,0037,國立臺北教育大學,碩士班(日間),泰國,東協,3,0,3,2,0,2,1,0,1,0,0,0,0,0,0
108,公立,一般大學,0037,國立臺北教育大學,碩士班(日間),義大利共和國,歐洲,1,0,1,1,0,1,0,0,0,0,0,0,0,0,0
108,公立,一般大學,0037,國立臺北教育大學,博士班,大陸地區,大陸地區,4,4,0,0,0,0,0,0,0,0,0,0,4,4,0
108,公立,一般大學,0037,國立臺北教育大學,博士班,越南社會主義共和國,東協,2,0,2,2,0,2,0,0,0,0,0,0,0,0,0
108,公立,一般大學,0039,國立臺中教育大學,學士班(日間),厄瓜多共和國,中南美洲,1,1,0,0,0,0,1,1,0,0,0,0,0,0,0
108,公立,一般大學,0039,國立臺中教育大學,學士班(日間),日本,其他亞洲地區,6,3,3,6,3,3,0,0,0,0,0,0,0,0,0
108,公立,一般大學,0039,國立臺中教育大學,學士班(日間),馬來西亞,東協,69,26,43,11,3,8,58,23,35,0,0,0,0,0,0
108,公立,一般大學,0039,國立臺中教育大學,學士班(日間),新加坡共和國,東協,1,1,0,0,0,0,1,1,0,0,0,0,0,0,0
108,公立,一般大學,0039,國立臺中教育大學,學士班(日間),大陸地區,大陸地區,10,1,9,0,0,0,0,0,0,0,0,0,10,1,9
108,公立,一般大學,0039,國立臺中教育大學,學士班(日間),加拿大,北美洲,1,0,1,0,0,0,1,0,1,0,0,0,0,0,0
108,公立,一般大學,0039,國立臺中教育大學,學士班(日間),印度尼西亞共和國,東協,30,12,18,1,0,1,29,12,17,0,0,0,0,0,0
108,公立,一般大學,0039,國立臺中教育大學,學士班(日間),阿根廷,中南美洲,1,1,0,0,0,0,1,1,0,0,0,0,0,0,0
108,公立,一般大學,0039,國立臺中教育大學,學士班(日間),香港,港澳,24,10,14,0,0,0,0,0,0,24,10,14,0,0,0
108,公立,一般大學,0039,國立臺中教育大學,學士班(日間),泰國,東協,2,0,2,1,0,1,1,0,1,0,0,0,0,0,0
108,公立,一般大學,0039,國立臺中教育大學,學士班(日間),越南社會主義共和國,東協,8,1,7,8,1,7,0,0,0,0,0,0,0,0,0
108,公立,一般大學,0039,國立臺中教育大學,學士班(日間),蒙古國,其他亞洲地區,1,0,1,1,0,1,0,0,0,0,0,0,0,0,0
108,公立,一般大學,0039,國立臺中教育大學,學士班(日間),緬甸,東協,9,2,7,0,0,0,9,2,7,0,0,0,0,0,0
108,公立,一般大學,0039,國立臺中教育大學,學士班(日間),澳門,港澳,28,10,18,0,0,0,0,0,0,28,10,18,0,0,0
108,公立,一般大學,0039,國立臺中教育大學,碩士班(日間),大陸地區,大陸地區,1,0,1,0,0,0,0,0,0,0,0,0,1,0,1
108,公立,一般大學,0039,國立臺中教育大學,碩士班(日間),大韓民國(南韓),其他亞洲地區,1,0,1,1,0,1,0,0,0,0,0,0,0,0,0
108,公立,一般大學,0039,國立臺中教育大學,碩士班(日間),甘比亞共和國,非洲,1,1,0,1,1,0,0,0,0,0,0,0,0,0,0
108,公立,一般大學,0039,國立臺中教育大學,碩士班(日間),印度尼西亞共和國,東協,1,0,1,1,0,1,0,0,0,0,0,0,0,0,0
108,公立,一般大學,0039,國立臺中教育大學,碩士班(日間),香港,港澳,3,1,2,0,0,0,0,0,0,3,1,2,0,0,0
108,公立,一般大學,0039,國立臺中教育大學,碩士班(日間),泰國,東協,2,2,0,2,2,0,0,0,0,0,0,0,0,0,0
108,公立,一般大學,0039,國立臺中教育大學,碩士班(日間),越南社會主義共和國,東協,12,0,12,12,0,12,0,0,0,0,0,0,0,0,0
108,公立,一般大學,0039,國立臺中教育大學,碩士班(日間),蒙古國,其他亞洲地區,7,4,3,7,4,3,0,0,0,0,0,0,0,0,0
108,公立,一般大學,0039,國立臺中教育大學,碩士班(日間),日本,其他亞洲地區,1,0,1,1,0,1,0,0,0,0,0,0,0,0,0
108,公立,一般大學,0039,國立臺中教育大學,碩士班(日間),印度,南亞,1,0,1,1,0,1,0,0,0,0,0,0,0,0,0
108,公立,一般大學,0039,國立臺中教育大學,碩士班(日間),俄羅斯聯邦,其他亞洲地區,5,2,3,5,2,3,0,0,0,0,0,0,0,0,0
108,公立,一般大學,0039,國立臺中教育大學,碩士班(日間),馬來西亞,東協,7,4,3,3,1,2,4,3,1,0,0,0,0,0,0
108,公立,一般大學,0039,國立臺中教育大學,博士班,大陸地區,大陸地區,2,2,0,0,0,0,0,0,0,0,0,0,2,2,0
108,公立,一般大學,0039,國立臺中教育大學,博士班,大韓民國(南韓),其他亞洲地區,1,0,1,1,0,1,0,0,0,0,0,0,0,0,0
108,公立,一般大學,0039,國立臺中教育大學,博士班,香港,港澳,1,0,1,0,0,0,0,0,0,1,0,1,0,0,0
108,公立,一般大學,0039,國立臺中教育大學,博士班,越南社會主義共和國,東協,2,1,1,2,1,1,0,0,0,0,0,0,0,0,0
108,公立,一般大學,0039,國立臺中教育大學,博士班,泰國,東協,1,0,1,1,0,1,0,0,0,0,0,0,0,0,0
108,公立,技專校院,0042,國立澎湖科技大學,五專,印度尼西亞共和國,東協,1,1,0,0,0,0,1,1,0,0,0,0,0,0,0
108,公立,技專校院,0042,國立澎湖科技大學,學士班(日間),大韓民國(南韓),其他亞洲地區,1,1,0,1,1,0,0,0,0,0,0,0,0,0,0
108,公立,技專校院,0042,國立澎湖科技大學,學士班(日間),馬來西亞,東協,13,5,8,2,1,1,11,4,7,0,0,0,0,0,0
108,公立,技專校院,0042,國立澎湖科技大學,學士班(日間),香港,港澳,3,3,0,0,0,0,0,0,0,3,3,0,0,0,0
108,公立,技專校院,0042,國立澎湖科技大學,學士班(日間),越南社會主義共和國,東協,13,8,5,13,8,5,0,0,0,0,0,0,0,0,0
108,公立,技專校院,0042,國立澎湖科技大學,學士班(日間),葡萄牙共和國,歐洲,1,1,0,1,1,0,0,0,0,0,0,0,0,0,0
108,公立,技專校院,0042,國立澎湖科技大學,學士班(日間),緬甸,東協,1,1,0,0,0,0,1,1,0,0,0,0,0,0,0
108,公立,技專校院,0042,國立澎湖科技大學,學士班(日間),澳門,港澳,1,1,0,0,0,0,0,0,0,1,1,0,0,0,0
108,公立,技專校院,0042,國立澎湖科技大學,碩士班(日間),越南社會主義共和國,東協,2,1,1,2,1,1,0,0,0,0,0,0,0,0,0
108,公立,技專校院,0043,國立勤益科技大學,學士班(日間),大陸地區,大陸地區,15,12,3,0,0,0,0,0,0,0,0,0,15,12,3
108,公立,技專校院,0043,國立勤益科技大學,學士班(日間),尼泊爾聯邦民主共和國,南亞,10,8,2,10,8,2,0,0,0,0,0,0,0,0,0
108,公立,技專校院,0043,國立勤益科技大學,學士班(日間),印度尼西亞共和國,東協,78,56,22,78,56,22,0,0,0,0,0,0,0,0,0
108,公立,技專校院,0043,國立勤益科技大學,學士班(日間),香港,港澳,17,17,0,0,0,0,0,0,0,17,17,0,0,0,0
108,公立,技專校院,0043,國立勤益科技大學,學士班(日間),馬來西亞,東協,39,36,3,17,16,1,22,20,2,0,0,0,0,0,0
108,公立,技專校院,0043,國立勤益科技大學,學士班(日間),越南社會主義共和國,東協,115,60,55,112,58,54,3,2,1,0,0,0,0,0,0
108,公立,技專校院,0043,國立勤益科技大學,學士班(日間),蒙古國,其他亞洲地區,3,0,3,3,0,3,0,0,0,0,0,0,0,0,0
108,公立,技專校院,0043,國立勤益科技大學,學士班(日間),寮人民民主共和國(寮國),東協,3,2,1,3,2,1,0,0,0,0,0,0,0,0,0
108,公立,技專校院,0043,國立勤益科技大學,學士班(日間),澳門,港澳,3,2,1,0,0,0,0,0,0,3,2,1,0,0,0
108,公立,技專校院,0043,國立勤益科技大學,學士班(日間),日本,其他亞洲地區,1,1,0,0,0,0,1,1,0,0,0,0,0,0,0
108,公立,技專校院,0043,國立勤益科技大學,學士班(日間),柬埔寨王國,東協,1,0,1,1,0,1,0,0,0,0,0,0,0,0,0
108,公立,技專校院,0043,國立勤益科技大學,學士班(日間),泰國,東協,3,1,2,3,1,2,0,0,0,0,0,0,0,0,0
108,公立,技專校院,0043,國立勤益科技大學,學士班(日間),墨西哥合眾國,中南美洲,1,0,1,0,0,0,1,0,1,0,0,0,0,0,0
108,公立,技專校院,0043,國立勤益科技大學,碩士班(日間),印度尼西亞共和國,東協,30,18,12,30,18,12,0,0,0,0,0,0,0,0,0
108,公立,技專校院,0043,國立勤益科技大學,碩士班(日間),美國,北美洲,1,1,0,1,1,0,0,0,0,0,0,0,0,0,0
108,公立,技專校院,0043,國立勤益科技大學,碩士班(日間),泰國,東協,12,7,5,12,7,5,0,0,0,0,0,0,0,0,0
108,公立,技專校院,0043,國立勤益科技大學,碩士班(日間),印度,南亞,3,2,1,3,2,1,0,0,0,0,0,0,0,0,0
108,公立,技專校院,0043,國立勤益科技大學,碩士班(日間),香港,港澳,1,1,0,0,0,0,0,0,0,1,1,0,0,0,0
108,公立,技專校院,0043,國立勤益科技大學,碩士班(日間),馬來西亞,東協,2,2,0,2,2,0,0,0,0,0,0,0,0,0,0
108,公立,技專校院,0043,國立勤益科技大學,碩士班(日間),越南社會主義共和國,東協,3,1,2,3,1,2,0,0,0,0,0,0,0,0,0
108,公立,技專校院,0043,國立勤益科技大學,碩士班(日間),蒙古國,其他亞洲地區,11,4,7,11,4,7,0,0,0,0,0,0,0,0,0
108,公立,技專校院,0043,國立勤益科技大學,博士班,印度,南亞,1,1,0,1,1,0,0,0,0,0,0,0,0,0,0
108,公立,技專校院,0043,國立勤益科技大學,博士班,印度尼西亞共和國,東協,3,2,1,3,2,1,0,0,0,0,0,0,0,0,0
108,公立,一般大學,0044,國立體育大學,學士班(日間),大陸地區,大陸地區,10,7,3,0,0,0,0,0,0,0,0,0,10,7,3
108,公立,一般大學,0044,國立體育大學,學士班(日間),香港,港澳,12,7,5,0,0,0,0,0,0,12,7,5,0,0,0
108,公立,一般大學,0044,國立體育大學,學士班(日間),澳門,港澳,9,6,3,0,0,0,0,0,0,9,6,3,0,0,0
108,公立,一般大學,0044,國立體育大學,學士班(日間),大韓民國(南韓),其他亞洲地區,5,2,3,5,2,3,0,0,0,0,0,0,0,0,0
108,公立,一般大學,0044,國立體育大學,學士班(日間),日本,其他亞洲地區,2,2,0,2,2,0,0,0,0,0,0,0,0,0,0
108,公立,一般大學,0044,國立體育大學,學士班(日間),馬來西亞,東協,11,8,3,0,0,0,11,8,3,0,0,0,0,0,0
108,公立,一般大學,0044,國立體育大學,學士班(日間),馬拉威共和國,非洲,3,3,0,3,3,0,0,0,0,0,0,0,0,0,0
108,公立,一般大學,0044,國立體育大學,碩士班(日間),馬來西亞,東協,6,4,2,3,3,0,3,1,2,0,0,0,0,0,0
108,公立,一般大學,0044,國立體育大學,碩士班(日間),大陸地區,大陸地區,5,2,3,0,0,0,0,0,0,0,0,0,5,2,3
108,公立,一般大學,0044,國立體育大學,碩士班(日間),香港,港澳,7,3,4,0,0,0,0,0,0,7,3,4,0,0,0
108,公立,一般大學,0044,國立體育大學,碩士班(日間),澳大利亞,其他亞洲地區,1,1,0,1,1,0,0,0,0,0,0,0,0,0,0
108,公立,一般大學,0044,國立體育大學,碩士班(日間),澳門,港澳,3,2,1,0,0,0,0,0,0,3,2,1,0,0,0
108,公立,一般大學,0044,國立體育大學,博士班,蒙古國,其他亞洲地區,1,0,1,1,0,1,0,0,0,0,0,0,0,0,0
108,公立,一般大學,0044,國立體育大學,博士班,德意志聯邦共和國,歐洲,1,0,1,1,0,1,0,0,0,0,0,0,0,0,0
108,公立,一般大學,0044,國立體育大學,博士班,大陸地區,大陸地區,23,17,6,0,0,0,0,0,0,0,0,0,23,17,6
108,公立,一般大學,0044,國立體育大學,博士班,大韓民國(南韓),其他亞洲地區,1,1,0,1,1,0,0,0,0,0,0,0,0,0,0
108,公立,一般大學,0044,國立體育大學,博士班,香港,港澳,1,0,1,0,0,0,0,0,0,1,0,1,0,0,0
108,公立,一般大學,0044,國立體育大學,博士班,馬來西亞,東協,1,1,0,0,0,0,1,1,0,0,0,0,0,0,0
108,公立,技專校院,0046,國立臺北護理健康大學,學士班(日間),阿根廷,中南美洲,1,1,0,0,0,0,1,1,0,0,0,0,0,0,0
108,公立,技專校院,0046,國立臺北護理健康大學,學士班(日間),美國,北美洲,1,1,0,0,0,0,1,1,0,0,0,0,0,0,0
108,公立,技專校院,0046,國立臺北護理健康大學,學士班(日間),香港,港澳,16,10,6,0,0,0,0,0,0,16,10,6,0,0,0
108,公立,技專校院,0046,國立臺北護理健康大學,學士班(日間),越南社會主義共和國,東協,4,1,3,0,0,0,4,1,3,0,0,0,0,0,0
108,公立,技專校院,0046,國立臺北護理健康大學,學士班(日間),緬甸,東協,3,0,3,0,0,0,3,0,3,0,0,0,0,0,0
108,公立,技專校院,0046,國立臺北護理健康大學,學士班(日間),澳門,港澳,24,5,19,0,0,0,0,0,0,24,5,19,0,0,0
108,公立,技專校院,0046,國立臺北護理健康大學,學士班(日間),馬來西亞,東協,42,6,36,1,0,1,41,6,35,0,0,0,0,0,0
108,公立,技專校院,0046,國立臺北護理健康大學,學士班(日間),菲律賓共和國,東協,1,0,1,0,0,0,1,0,1,0,0,0,0,0,0
108,公立,技專校院,0046,國立臺北護理健康大學,碩士班(日間),加拿大,北美洲,1,1,0,1,1,0,0,0,0,0,0,0,0,0,0
108,公立,技專校院,0046,國立臺北護理健康大學,碩士班(日間),印度尼西亞共和國,東協,9,2,7,9,2,7,0,0,0,0,0,0,0,0,0
108,公立,技專校院,0046,國立臺北護理健康大學,碩士班(日間),吉爾吉斯,其他亞洲地區,1,0,1,1,0,1,0,0,0,0,0,0,0,0,0
108,公立,技專校院,0046,國立臺北護理健康大學,碩士班(日間),俄羅斯聯邦,其他亞洲地區,1,1,0,1,1,0,0,0,0,0,0,0,0,0,0
108,公立,技專校院,0046,國立臺北護理健康大學,碩士班(日間),馬來西亞,東協,3,0,3,2,0,2,1,0,1,0,0,0,0,0,0
108,公立,技專校院,0046,國立臺北護理健康大學,碩士班(日間),馬拉威共和國,非洲,3,1,2,3,1,2,0,0,0,0,0,0,0,0,0
108,公立,技專校院,0046,國立臺北護理健康大學,碩士班(日間),菲律賓共和國,東協,1,1,0,1,1,0,0,0,0,0,0,0,0,0,0
108,公立,技專校院,0046,國立臺北護理健康大學,碩士班(日間),聖克里斯多福及尼維斯,中南美洲,2,0,2,2,0,2,0,0,0,0,0,0,0,0,0
108,公立,技專校院,0046,國立臺北護理健康大學,碩士班(日間),巴布亞紐幾內亞獨立國,其他亞洲地區,2,0,2,2,0,2,0,0,0,0,0,0,0,0,0
108,公立,技專校院,0046,國立臺北護理健康大學,碩士班(日間),史瓦帝尼王國,非洲,1,0,1,1,0,1,0,0,0,0,0,0,0,0,0
108,公立,技專校院,0046,國立臺北護理健康大學,碩士班(日間),貝里斯,中南美洲,1,0,1,1,0,1,0,0,0,0,0,0,0,0,0
108,公立,技專校院,0046,國立臺北護理健康大學,碩士班(日間),美國,北美洲,2,1,1,1,0,1,1,1,0,0,0,0,0,0,0
108,公立,技專校院,0046,國立臺北護理健康大學,碩士班(日間),香港,港澳,13,4,9,0,0,0,0,0,0,13,4,9,0,0,0
108,公立,技專校院,0046,國立臺北護理健康大學,碩士班(日間),越南社會主義共和國,東協,5,0,5,5,0,5,0,0,0,0,0,0,0,0,0
108,公立,技專校院,0046,國立臺北護理健康大學,碩士班(日間),緬甸,東協,2,1,1,0,0,0,2,1,1,0,0,0,0,0,0
108,公立,技專校院,0046,國立臺北護理健康大學,碩士班(日間),澳門,港澳,1,1,0,0,0,0,0,0,0,1,1,0,0,0,0
108,公立,技專校院,0046,國立臺北護理健康大學,博士班,印度尼西亞共和國,東協,11,6,5,11,6,5,0,0,0,0,0,0,0,0,0
108,公立,技專校院,0046,國立臺北護理健康大學,博士班,衣索比亞聯邦民主共和國,非洲,1,1,0,1,1,0,0,0,0,0,0,0,0,0,0
108,公立,技專校院,0046,國立臺北護理健康大學,博士班,越南社會主義共和國,東協,1,0,1,1,0,1,0,0,0,0,0,0,0,0,0
108,公立,技專校院,0047,國立高雄餐旅大學,學士班(日間),大陸地區,大陸地區,4,1,3,0,0,0,0,0,0,0,0,0,4,1,3
108,公立,技專校院,0047,國立高雄餐旅大學,學士班(日間),大韓民國(南韓),其他亞洲地區,4,3,1,4,3,1,0,0,0,0,0,0,0,0,0
108,公立,技專校院,0047,國立高雄餐旅大學,學士班(日間),巴西聯邦共和國,中南美洲,3,0,3,0,0,0,3,0,3,0,0,0,0,0,0
108,公立,技專校院,0047,國立高雄餐旅大學,學士班(日間),巴拉圭,中南美洲,3,2,1,3,2,1,0,0,0,0,0,0,0,0,0
108,公立,技專校院,0047,國立高雄餐旅大學,學士班(日間),印度尼西亞共和國,東協,97,23,74,52,12,40,45,11,34,0,0,0,0,0,0
108,公立,技專校院,0047,國立高雄餐旅大學,學士班(日間),吉里巴斯共和國,其他亞洲地區,1,1,0,1,1,0,0,0,0,0,0,0,0,0,0
108,公立,技專校院,0047,國立高雄餐旅大學,學士班(日間),多明尼加共和國,中南美洲,2,2,0,0,0,0,2,2,0,0,0,0,0,0,0
108,公立,技專校院,0047,國立高雄餐旅大學,學士班(日間),南非共和國,非洲,1,0,1,0,0,0,1,0,1,0,0,0,0,0,0
108,公立,技專校院,0047,國立高雄餐旅大學,學士班(日間),馬來西亞,東協,100,39,61,35,16,19,65,23,42,0,0,0,0,0,0
108,公立,技專校院,0047,國立高雄餐旅大學,學士班(日間),菲律賓共和國,東協,1,0,1,0,0,0,1,0,1,0,0,0,0,0,0
108,公立,技專校院,0047,國立高雄餐旅大學,學士班(日間),越南社會主義共和國,東協,10,3,7,5,1,4,5,2,3,0,0,0,0,0,0
108,公立,技專校院,0047,國立高雄餐旅大學,學士班(日間),新加坡共和國,東協,1,0,1,1,0,1,0,0,0,0,0,0,0,0,0
108,公立,技專校院,0047,國立高雄餐旅大學,學士班(日間),聖文森(及格瑞那丁),中南美洲,3,0,3,3,0,3,0,0,0,0,0,0,0,0,0
108,公立,技專校院,0047,國立高雄餐旅大學,學士班(日間),聖克里斯多福及尼維斯,中南美洲,1,0,1,1,0,1,0,0,0,0,0,0,0,0,0
108,公立,技專校院,0047,國立高雄餐旅大學,學士班(日間),日本,其他亞洲地區,12,5,7,11,4,7,1,1,0,0,0,0,0,0,0
108,公立,技專校院,0047,國立高雄餐旅大學,學士班(日間),史瓦帝尼王國,非洲,2,0,2,2,0,2,0,0,0,0,0,0,0,0,0
108,公立,技專校院,0047,國立高雄餐旅大學,學士班(日間),匈牙利共和國,歐洲,1,1,0,0,0,0,1,1,0,0,0,0,0,0,0
108,公立,技專校院,0047,國立高雄餐旅大學,學士班(日間),法國,歐洲,1,1,0,1,1,0,0,0,0,0,0,0,0,0,0
108,公立,技專校院,0047,國立高雄餐旅大學,學士班(日間),美國,北美洲,1,1,0,1,1,0,0,0,0,0,0,0,0,0,0
108,公立,技專校院,0047,國立高雄餐旅大學,學士班(日間),香港,港澳,12,7,5,0,0,0,0,0,0,12,7,5,0,0,0
108,公立,技專校院,0047,國立高雄餐旅大學,學士班(日間),泰國,東協,4,2,2,2,0,2,2,2,0,0,0,0,0,0,0
108,公立,技專校院,0047,國立高雄餐旅大學,學士班(日間),緬甸,東協,3,1,2,0,0,0,3,1,2,0,0,0,0,0,0
108,公立,技專校院,0047,國立高雄餐旅大學,學士班(日間),澳門,港澳,29,17,12,0,0,0,0,0,0,29,17,12,0,0,0
108,公立,技專校院,0047,國立高雄餐旅大學,碩士班(日間),迦納共和國,非洲,1,1,0,1,1,0,0,0,0,0,0,0,0,0,0
108,公立,技專校院,0047,國立高雄餐旅大學,碩士班(日間),香港,港澳,1,0,1,0,0,0,0,0,0,1,0,1,0,0,0
108,公立,技專校院,0047,國立高雄餐旅大學,碩士班(日間),泰國,東協,1,0,1,1,0,1,0,0,0,0,0,0,0,0,0
108,公立,技專校院,0047,國立高雄餐旅大學,碩士班(日間),緬甸,東協,2,0,2,1,0,1,1,0,1,0,0,0,0,0,0
108,公立,技專校院,0047,國立高雄餐旅大學,碩士班(日間),大陸地區,大陸地區,1,0,1,0,0,0,0,0,0,0,0,0,1,0,1
108,公立,技專校院,0047,國立高雄餐旅大學,碩士班(日間),巴西聯邦共和國,中南美洲,1,0,1,0,0,0,1,0,1,0,0,0,0,0,0
108,公立,技專校院,0047,國立高雄餐旅大學,碩士班(日間),印度尼西亞共和國,東協,4,1,3,4,1,3,0,0,0,0,0,0,0,0,0
108,公立,技專校院,0047,國立高雄餐旅大學,碩士班(日間),菲律賓共和國,東協,1,1,0,1,1,0,0,0,0,0,0,0,0,0,0
108,公立,技專校院,0047,國立高雄餐旅大學,碩士班(日間),越南社會主義共和國,東協,4,1,3,4,1,3,0,0,0,0,0,0,0,0,0
108,公立,技專校院,0047,國立高雄餐旅大學,碩士班(日間),新加坡共和國,東協,1,0,1,1,0,1,0,0,0,0,0,0,0,0,0
108,公立,技專校院,0047,國立高雄餐旅大學,博士班,大陸地區,大陸地區,3,1,2,0,0,0,0,0,0,0,0,0,3,1,2
108,公立,技專校院,0047,國立高雄餐旅大學,博士班,捷克共和國,歐洲,1,1,0,1,1,0,0,0,0,0,0,0,0,0,0
108,公立,技專校院,0047,國立高雄餐旅大學,博士班,澳大利亞,其他亞洲地區,1,0,1,1,0,1,0,0,0,0,0,0,0,0,0
108,公立,技專校院,0047,國立高雄餐旅大學,博士班,印度尼西亞共和國,東協,3,2,1,3,2,1,0,0,0,0,0,0,0,0,0
108,公立,技專校院,0047,國立高雄餐旅大學,博士班,泰國,東協,1,1,0,1,1,0,0,0,0,0,0,0,0,0,0
108,公立,技專校院,0047,國立高雄餐旅大學,博士班,菲律賓共和國,東協,1,0,1,1,0,1,0,0,0,0,0,0,0,0,0
108,公立,技專校院,0047,國立高雄餐旅大學,博士班,越南社會主義共和國,東協,4,2,2,4,2,2,0,0,0,0,0,0,0,0,0
108,公立,一般大學,0048,國立金門大學,學士班(日間),大陸地區,大陸地區,93,57,36,0,0,0,0,0,0,0,0,0,93,57,36
108,公立,一般大學,0048,國立金門大學,學士班(日間),香港,港澳,11,5,6,0,0,0,0,0,0,11,5,6,0,0,0
108,公立,一般大學,0048,國立金門大學,學士班(日間),馬來西亞,東協,18,10,8,0,0,0,18,10,8,0,0,0,0,0,0
108,公立,一般大學,0048,國立金門大學,學士班(日間),加拿大,北美洲,1,1,0,0,0,0,1,1,0,0,0,0,0,0,0
108,公立,一般大學,0048,國立金門大學,學士班(日間),印度尼西亞共和國,東協,15,7,8,12,7,5,3,0,3,0,0,0,0,0,0
108,公立,一般大學,0048,國立金門大學,學士班(日間),阿根廷,中南美洲,2,2,0,1,1,0,1,1,0,0,0,0,0,0,0
108,公立,一般大學,0048,國立金門大學,學士班(日間),澳門,港澳,4,2,2,0,0,0,0,0,0,4,2,2,0,0,0
108,公立,一般大學,0048,國立金門大學,碩士班(日間),大陸地區,大陸地區,12,6,6,0,0,0,0,0,0,0,0,0,12,6,6
108,公立,一般大學,0048,國立金門大學,碩士班(日間),印度尼西亞共和國,東協,7,3,4,7,3,4,0,0,0,0,0,0,0,0,0
108,公立,一般大學,0048,國立金門大學,碩士班(日間),越南社會主義共和國,東協,2,1,1,1,0,1,1,1,0,0,0,0,0,0,0
108,公立,一般大學,0048,國立金門大學,碩士班(日間),馬來西亞,東協,1,1,0,0,0,0,1,1,0,0,0,0,0,0,0
108,公立,一般大學,0049,國立臺灣體育運動大學,學士班(日間),日本,其他亞洲地區,3,2,1,2,1,1,1,1,0,0,0,0,0,0,0
108,公立,一般大學,0049,國立臺灣體育運動大學,學士班(日間),貝里斯,中南美洲,1,1,0,0,0,0,1,1,0,0,0,0,0,0,0
108,公立,一般大學,0049,國立臺灣體育運動大學,學士班(日間),香港,港澳,23,12,11,0,0,0,0,0,0,23,12,11,0,0,0
108,公立,一般大學,0049,國立臺灣體育運動大學,學士班(日間),緬甸,東協,1,1,0,0,0,0,1,1,0,0,0,0,0,0,0
108,公立,一般大學,0049,國立臺灣體育運動大學,學士班(日間),澳門,港澳,16,12,4,0,0,0,0,0,0,16,12,4,0,0,0
108,公立,一般大學,0049,國立臺灣體育運動大學,學士班(日間),大陸地區,大陸地區,2,1,1,0,0,0,0,0,0,0,0,0,2,1,1
108,公立,一般大學,0049,國立臺灣體育運動大學,學士班(日間),大韓民國(南韓),其他亞洲地區,8,4,4,8,4,4,0,0,0,0,0,0,0,0,0
108,公立,一般大學,0049,國立臺灣體育運動大學,學士班(日間),阿根廷,中南美洲,1,1,0,0,0,0,1,1,0,0,0,0,0,0,0
108,公立,一般大學,0049,國立臺灣體育運動大學,學士班(日間),南非共和國,非洲,1,0,1,0,0,0,1,0,1,0,0,0,0,0,0
108,公立,一般大學,0049,國立臺灣體育運動大學,學士班(日間),馬來西亞,東協,24,12,12,0,0,0,24,12,12,0,0,0,0,0,0
108,公立,一般大學,0049,國立臺灣體育運動大學,學士班(日間),葡萄牙共和國,歐洲,1,1,0,0,0,0,1,1,0,0,0,0,0,0,0
108,公立,一般大學,0049,國立臺灣體育運動大學,碩士班(日間),大陸地區,大陸地區,3,2,1,0,0,0,0,0,0,0,0,0,3,2,1
108,公立,一般大學,0049,國立臺灣體育運動大學,碩士班(日間),印度尼西亞共和國,東協,1,0,1,0,0,0,1,0,1,0,0,0,0,0,0
108,公立,一般大學,0049,國立臺灣體育運動大學,碩士班(日間),馬來西亞,東協,2,1,1,0,0,0,2,1,1,0,0,0,0,0,0
108,公立,一般大學,0049,國立臺灣體育運動大學,碩士班(日間),香港,港澳,2,0,2,0,0,0,0,0,0,2,0,2,0,0,0
108,公立,一般大學,0049,國立臺灣體育運動大學,碩士班(日間),澳門,港澳,1,1,0,0,0,0,0,0,0,1,1,0,0,0,0
108,公立,技專校院,0050,國立臺中科技大學,五專,印度尼西亞共和國,東協,1,0,1,0,0,0,1,0,1,0,0,0,0,0,0
108,公立,技專校院,0050,國立臺中科技大學,五專,貝里斯,中南美洲,1,1,0,0,0,0,1,1,0,0,0,0,0,0,0
108,公立,技專校院,0050,國立臺中科技大學,五專,泰國,東協,4,2,2,0,0,0,4,2,2,0,0,0,0,0,0
108,公立,技專校院,0050,國立臺中科技大學,五專,越南社會主義共和國,東協,1,0,1,0,0,0,1,0,1,0,0,0,0,0,0
108,公立,技專校院,0050,國立臺中科技大學,學士班(日間),大陸地區,大陸地區,26,13,13,0,0,0,0,0,0,0,0,0,26,13,13
108,公立,技專校院,0050,國立臺中科技大學,學士班(日間),日本,其他亞洲地區,7,4,3,3,2,1,4,2,2,0,0,0,0,0,0
108,公立,技專校院,0050,國立臺中科技大學,學士班(日間),香港,港澳,15,12,3,0,0,0,0,0,0,15,12,3,0,0,0
108,公立,技專校院,0050,國立臺中科技大學,學士班(日間),德意志聯邦共和國,歐洲,1,0,1,0,0,0,1,0,1,0,0,0,0,0,0
108,公立,技專校院,0050,國立臺中科技大學,學士班(日間),緬甸,東協,5,1,4,0,0,0,5,1,4,0,0,0,0,0,0
108,公立,技專校院,0050,國立臺中科技大學,學士班(日間),印度尼西亞共和國,東協,39,19,20,0,0,0,39,19,20,0,0,0,0,0,0
108,公立,技專校院,0050,國立臺中科技大學,學士班(日間),美國,北美洲,1,1,0,0,0,0,1,1,0,0,0,0,0,0,0
108,公立,技專校院,0050,國立臺中科技大學,學士班(日間),泰國,東協,2,1,1,0,0,0,2,1,1,0,0,0,0,0,0
108,公立,技專校院,0050,國立臺中科技大學,學士班(日間),馬來西亞,東協,38,26,12,2,1,1,36,25,11,0,0,0,0,0,0
108,公立,技專校院,0050,國立臺中科技大學,學士班(日間),越南社會主義共和國,東協,8,2,6,1,0,1,7,2,5,0,0,0,0,0,0
108,公立,技專校院,0050,國立臺中科技大學,學士班(日間),澳門,港澳,5,2,3,0,0,0,0,0,0,5,2,3,0,0,0
108,公立,技專校院,0050,國立臺中科技大學,碩士班(日間),大陸地區,大陸地區,8,6,2,0,0,0,0,0,0,0,0,0,8,6,2
108,公立,技專校院,0050,國立臺中科技大學,碩士班(日間),香港,港澳,1,1,0,0,0,0,0,0,0,1,1,0,0,0,0
108,公立,技專校院,0050,國立臺中科技大學,碩士班(日間),日本,其他亞洲地區,1,1,0,1,1,0,0,0,0,0,0,0,0,0,0
108,公立,技專校院,0051,國立臺北商業大學,五專,加拿大,北美洲,1,0,1,0,0,0,1,0,1,0,0,0,0,0,0
108,公立,技專校院,0051,國立臺北商業大學,五專,印度尼西亞共和國,東協,5,0,5,0,0,0,5,0,5,0,0,0,0,0,0
108,公立,技專校院,0051,國立臺北商業大學,五專,約旦哈什米王國,其他亞洲地區,1,0,1,0,0,0,1,0,1,0,0,0,0,0,0
108,公立,技專校院,0051,國立臺北商業大學,五專,泰國,東協,1,0,1,0,0,0,1,0,1,0,0,0,0,0,0
108,公立,技專校院,0051,國立臺北商業大學,五專,阿根廷,中南美洲,2,1,1,0,0,0,2,1,1,0,0,0,0,0,0
108,公立,技專校院,0051,國立臺北商業大學,五專,越南社會主義共和國,東協,1,0,1,1,0,1,0,0,0,0,0,0,0,0,0
108,公立,技專校院,0051,國立臺北商業大學,五專,緬甸,東協,1,0,1,0,0,0,1,0,1,0,0,0,0,0,0
108,公立,技專校院,0051,國立臺北商業大學,學士班(日間),大陸地區,大陸地區,74,34,40,0,0,0,0,0,0,0,0,0,74,34,40
108,公立,技專校院,0051,國立臺北商業大學,學士班(日間),日本,其他亞洲地區,2,1,1,2,1,1,0,0,0,0,0,0,0,0,0
108,公立,技專校院,0051,國立臺北商業大學,學士班(日間),印度尼西亞共和國,東協,35,11,24,2,0,2,33,11,22,0,0,0,0,0,0
108,公立,技專校院,0051,國立臺北商業大學,學士班(日間),西班牙王國,歐洲,1,1,0,1,1,0,0,0,0,0,0,0,0,0,0
108,公立,技專校院,0051,國立臺北商業大學,學士班(日間),阿根廷,中南美洲,1,1,0,0,0,0,1,1,0,0,0,0,0,0,0
108,公立,技專校院,0051,國立臺北商業大學,學士班(日間),南非共和國,非洲,1,1,0,1,1,0,0,0,0,0,0,0,0,0,0
108,公立,技專校院,0051,國立臺北商業大學,學士班(日間),泰國,東協,1,0,1,1,0,1,0,0,0,0,0,0,0,0,0
108,公立,技專校院,0051,國立臺北商業大學,學士班(日間),緬甸,東協,41,13,28,0,0,0,41,13,28,0,0,0,0,0,0
108,公立,技專校院,0051,國立臺北商業大學,學士班(日間),巴西聯邦共和國,中南美洲,2,2,0,1,1,0,1,1,0,0,0,0,0,0,0
108,公立,技專校院,0051,國立臺北商業大學,學士班(日間),俄羅斯聯邦,其他亞洲地區,1,1,0,1,1,0,0,0,0,0,0,0,0,0,0
108,公立,技專校院,0051,國立臺北商業大學,學士班(日間),美國,北美洲,1,1,0,0,0,0,1,1,0,0,0,0,0,0,0
108,公立,技專校院,0051,國立臺北商業大學,學士班(日間),香港,港澳,7,3,4,0,0,0,0,0,0,7,3,4,0,0,0
108,公立,技專校院,0051,國立臺北商業大學,學士班(日間),馬來西亞,東協,45,23,22,2,0,2,43,23,20,0,0,0,0,0,0
108,公立,技專校院,0051,國立臺北商業大學,學士班(日間),馬拉威共和國,非洲,2,2,0,2,2,0,0,0,0,0,0,0,0,0,0
108,公立,技專校院,0051,國立臺北商業大學,學士班(日間),菲律賓共和國,東協,1,1,0,0,0,0,1,1,0,0,0,0,0,0,0
108,公立,技專校院,0051,國立臺北商業大學,學士班(日間),越南社會主義共和國,東協,42,11,31,10,1,9,32,10,22,0,0,0,0,0,0
108,公立,技專校院,0051,國立臺北商業大學,學士班(日間),澳門,港澳,2,1,1,0,0,0,0,0,0,2,1,1,0,0,0
108,公立,技專校院,0051,國立臺北商業大學,碩士班(日間),大陸地區,大陸地區,8,5,3,0,0,0,0,0,0,0,0,0,8,5,3
108,公立,技專校院,0051,國立臺北商業大學,碩士班(日間),阿根廷,中南美洲,1,1,0,1,1,0,0,0,0,0,0,0,0,0,0
108,公立,一般大學,0052,國立屏東大學,學士班(日間),大陸地區,大陸地區,18,15,3,0,0,0,0,0,0,0,0,0,18,15,3
108,公立,一般大學,0052,國立屏東大學,學士班(日間),史瓦帝尼王國,非洲,1,1,0,1,1,0,0,0,0,0,0,0,0,0,0
108,公立,一般大學,0052,國立屏東大學,學士班(日間),印度尼西亞共和國,東協,4,1,3,0,0,0,4,1,3,0,0,0,0,0,0
108,公立,一般大學,0052,國立屏東大學,學士班(日間),香港,港澳,17,10,7,0,0,0,0,0,0,17,10,7,0,0,0
108,公立,一般大學,0052,國立屏東大學,學士班(日間),緬甸,東協,3,0,3,0,0,0,3,0,3,0,0,0,0,0,0
108,公立,一般大學,0052,國立屏東大學,學士班(日間),馬來西亞,東協,72,33,39,9,2,7,63,31,32,0,0,0,0,0,0
108,公立,一般大學,0052,國立屏東大學,學士班(日間),越南社會主義共和國,東協,6,2,4,5,1,4,1,1,0,0,0,0,0,0,0
108,公立,一般大學,0052,國立屏東大學,學士班(日間),奧地利共和國,歐洲,1,1,0,1,1,0,0,0,0,0,0,0,0,0,0
108,公立,一般大學,0052,國立屏東大學,學士班(日間),聖克里斯多福及尼維斯,中南美洲,1,0,1,1,0,1,0,0,0,0,0,0,0,0,0
108,公立,一般大學,0052,國立屏東大學,學士班(日間),澳門,港澳,34,18,16,0,0,0,0,0,0,34,18,16,0,0,0
108,公立,一般大學,0052,國立屏東大學,碩士班(日間),美國,北美洲,1,1,0,1,1,0,0,0,0,0,0,0,0,0,0
108,公立,一般大學,0052,國立屏東大學,碩士班(日間),泰國,東協,3,1,2,3,1,2,0,0,0,0,0,0,0,0,0
108,公立,一般大學,0052,國立屏東大學,碩士班(日間),馬來西亞,東協,4,2,2,1,0,1,3,2,1,0,0,0,0,0,0
108,公立,一般大學,0052,國立屏東大學,碩士班(日間),澳門,港澳,1,1,0,0,0,0,0,0,0,1,1,0,0,0,0
108,公立,一般大學,0052,國立屏東大學,碩士班(日間),大陸地區,大陸地區,1,0,1,0,0,0,0,0,0,0,0,0,1,0,1
108,公立,一般大學,0052,國立屏東大學,碩士班(日間),印度尼西亞共和國,東協,1,1,0,0,0,0,1,1,0,0,0,0,0,0,0
108,公立,一般大學,0052,國立屏東大學,碩士班(日間),香港,港澳,1,1,0,0,0,0,0,0,0,1,1,0,0,0,0
108,公立,一般大學,0052,國立屏東大學,碩士班(日間),新加坡共和國,東協,1,0,1,1,0,1,0,0,0,0,0,0,0,0,0
108,公立,一般大學,0052,國立屏東大學,博士班,越南社會主義共和國,東協,1,1,0,1,1,0,0,0,0,0,0,0,0,0,0
108,公立,技專校院,0053,國立高雄科技大學,學士班(日間),大韓民國(南韓),其他亞洲地區,1,1,0,0,0,0,1,1,0,0,0,0,0,0,0
108,公立,技專校院,0053,國立高雄科技大學,學士班(日間),巴西聯邦共和國,中南美洲,1,0,1,0,0,0,1,0,1,0,0,0,0,0,0
108,公立,技專校院,0053,國立高雄科技大學,學士班(日間),印度尼西亞共和國,東協,18,7,11,2,0,2,16,7,9,0,0,0,0,0,0
108,公立,技專校院,0053,國立高雄科技大學,學士班(日間),阿根廷,中南美洲,1,0,1,0,0,0,1,0,1,0,0,0,0,0,0
108,公立,技專校院,0053,國立高雄科技大學,學士班(日間),玻利維亞共和國,中南美洲,1,0,1,0,0,0,1,0,1,0,0,0,0,0,0
108,公立,技專校院,0053,國立高雄科技大學,學士班(日間),馬來西亞,東協,75,48,27,15,11,4,60,37,23,0,0,0,0,0,0
108,公立,技專校院,0053,國立高雄科技大學,學士班(日間),菲律賓共和國,東協,1,0,1,0,0,0,1,0,1,0,0,0,0,0,0
108,公立,技專校院,0053,國立高雄科技大學,學士班(日間),越南社會主義共和國,東協,29,7,22,22,7,15,7,0,7,0,0,0,0,0,0
108,公立,技專校院,0053,國立高雄科技大學,學士班(日間),大陸地區,大陸地區,60,41,19,0,0,0,0,0,0,0,0,0,60,41,19
108,公立,技專校院,0053,國立高雄科技大學,學士班(日間),厄瓜多共和國,中南美洲,1,0,1,0,0,0,1,0,1,0,0,0,0,0,0
108,公立,技專校院,0053,國立高雄科技大學,學士班(日間),日本,其他亞洲地區,17,3,14,17,3,14,0,0,0,0,0,0,0,0,0
108,公立,技專校院,0053,國立高雄科技大學,學士班(日間),尼加拉瓜,中南美洲,1,0,1,1,0,1,0,0,0,0,0,0,0,0,0
108,公立,技專校院,0053,國立高雄科技大學,學士班(日間),香港,港澳,43,27,16,0,0,0,0,0,0,43,27,16,0,0,0
108,公立,技專校院,0053,國立高雄科技大學,學士班(日間),紐西蘭,其他亞洲地區,1,0,1,1,0,1,0,0,0,0,0,0,0,0,0
108,公立,技專校院,0053,國立高雄科技大學,學士班(日間),新加坡共和國,東協,1,1,0,0,0,0,1,1,0,0,0,0,0,0,0
108,公立,技專校院,0053,國立高雄科技大學,學士班(日間),緬甸,東協,6,3,3,0,0,0,6,3,3,0,0,0,0,0,0
108,公立,技專校院,0053,國立高雄科技大學,學士班(日間),澳門,港澳,13,9,4,0,0,0,0,0,0,13,9,4,0,0,0
108,公立,技專校院,0053,國立高雄科技大學,碩士班(日間),大陸地區,大陸地區,8,6,2,0,0,0,0,0,0,0,0,0,8,6,2
108,公立,技專校院,0053,國立高雄科技大學,碩士班(日間),日本,其他亞洲地區,2,0,2,2,0,2,0,0,0,0,0,0,0,0,0
108,公立,技專校院,0053,國立高雄科技大學,碩士班(日間),印度,南亞,3,3,0,3,3,0,0,0,0,0,0,0,0,0,0
108,公立,技專校院,0053,國立高雄科技大學,碩士班(日間),貝里斯,中南美洲,1,1,0,1,1,0,0,0,0,0,0,0,0,0,0
108,公立,技專校院,0053,國立高雄科技大學,碩士班(日間),柬埔寨王國,東協,15,6,9,15,6,9,0,0,0,0,0,0,0,0,0
108,公立,技專校院,0053,國立高雄科技大學,碩士班(日間),美國,北美洲,1,0,1,1,0,1,0,0,0,0,0,0,0,0,0
108,公立,技專校院,0053,國立高雄科技大學,碩士班(日間),香港,港澳,3,3,0,0,0,0,0,0,0,3,3,0,0,0,0
108,公立,技專校院,0053,國立高雄科技大學,碩士班(日間),墨西哥合眾國,中南美洲,1,0,1,1,0,1,0,0,0,0,0,0,0,0,0
108,公立,技專校院,0053,國立高雄科技大學,碩士班(日間),印度尼西亞共和國,東協,6,4,2,5,3,2,1,1,0,0,0,0,0,0,0
108,公立,技專校院,0053,國立高雄科技大學,碩士班(日間),法國,歐洲,2,1,1,2,1,1,0,0,0,0,0,0,0,0,0
108,公立,技專校院,0053,國立高雄科技大學,碩士班(日間),泰國,東協,2,0,2,2,0,2,0,0,0,0,0,0,0,0,0
108,公立,技專校院,0053,國立高雄科技大學,碩士班(日間),馬來西亞,東協,6,5,1,3,2,1,3,3,0,0,0,0,0,0,0
108,公立,技專校院,0053,國立高雄科技大學,碩士班(日間),菲律賓共和國,東協,3,3,0,3,3,0,0,0,0,0,0,0,0,0,0
108,公立,技專校院,0053,國立高雄科技大學,碩士班(日間),越南社會主義共和國,東協,48,17,31,47,17,30,1,0,1,0,0,0,0,0,0
108,公立,技專校院,0053,國立高雄科技大學,碩士班(日間),奧地利共和國,歐洲,1,0,1,1,0,1,0,0,0,0,0,0,0,0,0
108,公立,技專校院,0053,國立高雄科技大學,碩士班(日間),寮人民民主共和國(寮國),東協,3,0,3,3,0,3,0,0,0,0,0,0,0,0,0
108,公立,技專校院,0053,國立高雄科技大學,博士班,大陸地區,大陸地區,3,1,2,0,0,0,0,0,0,0,0,0,3,1,2
108,公立,技專校院,0053,國立高雄科技大學,博士班,巴基斯坦,南亞,1,1,0,1,1,0,0,0,0,0,0,0,0,0,0
108,公立,技專校院,0053,國立高雄科技大學,博士班,伊朗伊斯蘭共和國,其他亞洲地區,2,2,0,2,2,0,0,0,0,0,0,0,0,0,0
108,公立,技專校院,0053,國立高雄科技大學,博士班,印度,南亞,1,1,0,1,1,0,0,0,0,0,0,0,0,0,0
108,公立,技專校院,0053,國立高雄科技大學,博士班,馬來西亞,東協,2,1,1,2,1,1,0,0,0,0,0,0,0,0,0
108,公立,技專校院,0053,國立高雄科技大學,博士班,蒙古國,其他亞洲地區,1,0,1,1,0,1,0,0,0,0,0,0,0,0,0
108,公立,技專校院,0053,國立高雄科技大學,博士班,印度尼西亞共和國,東協,3,2,1,3,2,1,0,0,0,0,0,0,0,0,0
108,公立,技專校院,0053,國立高雄科技大學,博士班,波蘭共和國,歐洲,1,1,0,1,1,0,0,0,0,0,0,0,0,0,0
108,公立,技專校院,0053,國立高雄科技大學,博士班,玻利維亞共和國,中南美洲,1,1,0,1,1,0,0,0,0,0,0,0,0,0,0
108,公立,技專校院,0053,國立高雄科技大學,博士班,美國,北美洲,1,1,0,1,1,0,0,0,0,0,0,0,0,0,0
108,公立,技專校院,0053,國立高雄科技大學,博士班,泰國,東協,1,1,0,1,1,0,0,0,0,0,0,0,0,0,0
108,公立,技專校院,0053,國立高雄科技大學,博士班,菲律賓共和國,東協,3,3,0,3,3,0,0,0,0,0,0,0,0,0,0
108,公立,技專校院,0053,國立高雄科技大學,博士班,越南社會主義共和國,東協,47,33,14,47,33,14,0,0,0,0,0,0,0,0,0
108,公立,技專校院,0144,國立臺灣戲曲學院,學士班(日間),大陸地區,大陸地區,14,0,14,0,0,0,0,0,0,0,0,0,14,0,14
108,公立,技專校院,0144,國立臺灣戲曲學院,學士班(日間),香港,港澳,2,0,2,0,0,0,0,0,0,2,0,2,0,0,0
108,公立,技專校院,0144,國立臺灣戲曲學院,學士班(日間),澳門,港澳,2,1,1,0,0,0,0,0,0,2,1,1,0,0,0
108,公立,技專校院,0144,國立臺灣戲曲學院,學士班(日間),澳大利亞,其他亞洲地區,1,1,0,1,1,0,0,0,0,0,0,0,0,0,0
108,公立,技專校院,0221,國立臺南護理專科學校,五專,泰國,東協,1,0,1,0,0,0,1,0,1,0,0,0,0,0,0
108,私立,一般大學,1001,東海大學,學士班(日間),巴西聯邦共和國,中南美洲,1,1,0,1,1,0,0,0,0,0,0,0,0,0,0
108,私立,一般大學,1001,東海大學,學士班(日間),加拿大,北美洲,3,3,0,3,3,0,0,0,0,0,0,0,0,0,0
108,私立,一般大學,1001,東海大學,學士班(日間),史瓦帝尼王國,非洲,3,1,2,3,1,2,0,0,0,0,0,0,0,0,0
108,私立,一般大學,1001,東海大學,學士班(日間),尼加拉瓜,中南美洲,1,1,0,1,1,0,0,0,0,0,0,0,0,0,0
108,私立,一般大學,1001,東海大學,學士班(日間),印度尼西亞共和國,東協,151,74,77,143,69,74,8,5,3,0,0,0,0,0,0
108,私立,一般大學,1001,東海大學,學士班(日間),吉里巴斯共和國,其他亞洲地區,1,0,1,1,0,1,0,0,0,0,0,0,0,0,0
108,私立,一般大學,1001,東海大學,學士班(日間),吉爾吉斯,其他亞洲地區,5,5,0,5,5,0,0,0,0,0,0,0,0,0,0
108,私立,一般大學,1001,東海大學,學士班(日間),尚比亞共和國,非洲,1,1,0,1,1,0,0,0,0,0,0,0,0,0,0
108,私立,一般大學,1001,東海大學,學士班(日間),俄羅斯聯邦,其他亞洲地區,1,0,1,1,0,1,0,0,0,0,0,0,0,0,0
108,私立,一般大學,1001,東海大學,學士班(日間),美國,北美洲,2,2,0,2,2,0,0,0,0,0,0,0,0,0,0
108,私立,一般大學,1001,東海大學,學士班(日間),英國,歐洲,1,0,1,1,0,1,0,0,0,0,0,0,0,0,0
108,私立,一般大學,1001,東海大學,學士班(日間),泰國,東協,1,0,1,0,0,0,1,0,1,0,0,0,0,0,0
108,私立,一般大學,1001,東海大學,學士班(日間),馬來西亞,東協,119,58,61,63,33,30,56,25,31,0,0,0,0,0,0
108,私立,一般大學,1001,東海大學,學士班(日間),菲律賓共和國,東協,2,1,1,2,1,1,0,0,0,0,0,0,0,0,0
108,私立,一般大學,1001,東海大學,學士班(日間),越南社會主義共和國,東協,14,5,9,14,5,9,0,0,0,0,0,0,0,0,0
108,私立,一般大學,1001,東海大學,學士班(日間),聖露西亞,中南美洲,1,1,0,1,1,0,0,0,0,0,0,0,0,0,0
108,私立,一般大學,1001,東海大學,學士班(日間),蒙古國,其他亞洲地區,10,4,6,10,4,6,0,0,0,0,0,0,0,0,0
108,私立,一般大學,1001,東海大學,學士班(日間),澳門,港澳,58,37,21,0,0,0,0,0,0,58,37,21,0,0,0
108,私立,一般大學,1001,東海大學,學士班(日間),薩爾瓦多,中南美洲,2,0,2,2,0,2,0,0,0,0,0,0,0,0,0
108,私立,一般大學,1001,東海大學,學士班(日間),大陸地區,大陸地區,239,99,140,0,0,0,0,0,0,0,0,0,239,99,140
108,私立,一般大學,1001,東海大學,學士班(日間),大韓民國(南韓),其他亞洲地區,7,2,5,6,2,4,1,0,1,0,0,0,0,0,0
108,私立,一般大學,1001,東海大學,學士班(日間),日本,其他亞洲地區,52,13,39,52,13,39,0,0,0,0,0,0,0,0,0
108,私立,一般大學,1001,東海大學,學士班(日間),印度,南亞,1,1,0,1,1,0,0,0,0,0,0,0,0,0,0
108,私立,一般大學,1001,東海大學,學士班(日間),委內瑞拉共和國,中南美洲,1,1,0,0,0,0,1,1,0,0,0,0,0,0,0
108,私立,一般大學,1001,東海大學,學士班(日間),香港,港澳,113,62,51,0,0,0,0,0,0,113,62,51,0,0,0
108,私立,一般大學,1001,東海大學,學士班(日間),新加坡共和國,東協,1,0,1,1,0,1,0,0,0,0,0,0,0,0,0
108,私立,一般大學,1001,東海大學,學士班(日間),聖克里斯多福及尼維斯,中南美洲,2,2,0,2,2,0,0,0,0,0,0,0,0,0,0
108,私立,一般大學,1001,東海大學,學士班(日間),葉門共和國,其他亞洲地區,1,1,0,1,1,0,0,0,0,0,0,0,0,0,0
108,私立,一般大學,1001,東海大學,學士班(日間),葡萄牙共和國,歐洲,1,1,0,0,0,0,1,1,0,0,0,0,0,0,0
108,私立,一般大學,1001,東海大學,學士班(日間),緬甸,東協,1,1,0,0,0,0,1,1,0,0,0,0,0,0,0
108,私立,一般大學,1001,東海大學,學士班(日間),諾魯共和國,其他亞洲地區,1,0,1,1,0,1,0,0,0,0,0,0,0,0,0
108,私立,一般大學,1001,東海大學,碩士班(日間),大陸地區,大陸地區,45,21,24,0,0,0,0,0,0,0,0,0,45,21,24
108,私立,一般大學,1001,東海大學,碩士班(日間),大韓民國(南韓),其他亞洲地區,1,0,1,1,0,1,0,0,0,0,0,0,0,0,0
108,私立,一般大學,1001,東海大學,碩士班(日間),厄瓜多共和國,中南美洲,1,1,0,0,0,0,1,1,0,0,0,0,0,0,0
108,私立,一般大學,1001,東海大學,碩士班(日間),日本,其他亞洲地區,4,1,3,4,1,3,0,0,0,0,0,0,0,0,0
108,私立,一般大學,1001,東海大學,碩士班(日間),印度,南亞,2,2,0,2,2,0,0,0,0,0,0,0,0,0,0
108,私立,一般大學,1001,東海大學,碩士班(日間),美國,北美洲,1,1,0,1,1,0,0,0,0,0,0,0,0,0,0
108,私立,一般大學,1001,東海大學,碩士班(日間),香港,港澳,14,9,5,0,0,0,0,0,0,14,9,5,0,0,0
108,私立,一般大學,1001,東海大學,碩士班(日間),新加坡共和國,東協,1,0,1,1,0,1,0,0,0,0,0,0,0,0,0
108,私立,一般大學,1001,東海大學,碩士班(日間),聖克里斯多福及尼維斯,中南美洲,1,0,1,1,0,1,0,0,0,0,0,0,0,0,0
108,私立,一般大學,1001,東海大學,碩士班(日間),巴西聯邦共和國,中南美洲,1,0,1,1,0,1,0,0,0,0,0,0,0,0,0
108,私立,一般大學,1001,東海大學,碩士班(日間),巴基斯坦,南亞,1,0,1,1,0,1,0,0,0,0,0,0,0,0,0
108,私立,一般大學,1001,東海大學,碩士班(日間),印度尼西亞共和國,東協,15,7,8,14,7,7,1,0,1,0,0,0,0,0,0
108,私立,一般大學,1001,東海大學,碩士班(日間),吉爾吉斯,其他亞洲地區,2,1,1,2,1,1,0,0,0,0,0,0,0,0,0
108,私立,一般大學,1001,東海大學,碩士班(日間),法國,歐洲,1,1,0,1,1,0,0,0,0,0,0,0,0,0,0
108,私立,一般大學,1001,東海大學,碩士班(日間),泰國,東協,2,0,2,2,0,2,0,0,0,0,0,0,0,0,0
108,私立,一般大學,1001,東海大學,碩士班(日間),馬來西亞,東協,22,6,16,16,4,12,6,2,4,0,0,0,0,0,0
108,私立,一般大學,1001,東海大學,碩士班(日間),越南社會主義共和國,東協,5,0,5,5,0,5,0,0,0,0,0,0,0,0,0
108,私立,一般大學,1001,東海大學,碩士班(日間),瑞士聯邦,歐洲,1,0,1,1,0,1,0,0,0,0,0,0,0,0,0
108,私立,一般大學,1001,東海大學,碩士班(日間),蒙古國,其他亞洲地區,3,2,1,3,2,1,0,0,0,0,0,0,0,0,0
108,私立,一般大學,1001,東海大學,碩士班(日間),澳門,港澳,4,3,1,0,0,0,0,0,0,4,3,1,0,0,0
108,私立,一般大學,1001,東海大學,博士班,巴基斯坦,南亞,1,1,0,1,1,0,0,0,0,0,0,0,0,0,0
108,私立,一般大學,1001,東海大學,博士班,印度,南亞,9,6,3,9,6,3,0,0,0,0,0,0,0,0,0
108,私立,一般大學,1001,東海大學,博士班,新加坡共和國,東協,1,0,1,1,0,1,0,0,0,0,0,0,0,0,0
108,私立,一般大學,1001,東海大學,博士班,義大利共和國,歐洲,1,1,0,1,1,0,0,0,0,0,0,0,0,0,0
108,私立,一般大學,1001,東海大學,博士班,大陸地區,大陸地區,27,10,17,0,0,0,0,0,0,0,0,0,27,10,17
108,私立,一般大學,1001,東海大學,博士班,巴布亞紐幾內亞獨立國,其他亞洲地區,1,1,0,1,1,0,0,0,0,0,0,0,0,0,0
108,私立,一般大學,1001,東海大學,博士班,日本,其他亞洲地區,1,0,1,1,0,1,0,0,0,0,0,0,0,0,0
108,私立,一般大學,1001,東海大學,博士班,白俄羅斯共和國,其他亞洲地區,1,0,1,1,0,1,0,0,0,0,0,0,0,0,0
108,私立,一般大學,1001,東海大學,博士班,印度尼西亞共和國,東協,13,5,8,13,5,8,0,0,0,0,0,0,0,0,0
108,私立,一般大學,1001,東海大學,博士班,馬來西亞,東協,2,1,1,1,0,1,1,1,0,0,0,0,0,0,0
108,私立,一般大學,1001,東海大學,博士班,越南社會主義共和國,東協,2,1,1,2,1,1,0,0,0,0,0,0,0,0,0
108,私立,一般大學,1002,輔仁大學,學士班(日間),大陸地區,大陸地區,249,87,162,0,0,0,0,0,0,0,0,0,249,87,162
108,私立,一般大學,1002,輔仁大學,學士班(日間),大韓民國(南韓),其他亞洲地區,29,15,14,27,13,14,2,2,0,0,0,0,0,0,0
108,私立,一般大學,1002,輔仁大學,學士班(日間),巴西聯邦共和國,中南美洲,1,1,0,1,1,0,0,0,0,0,0,0,0,0,0
108,私立,一般大學,1002,輔仁大學,學士班(日間),日本,其他亞洲地區,38,12,26,36,11,25,2,1,1,0,0,0,0,0,0
108,私立,一般大學,1002,輔仁大學,學士班(日間),加拿大,北美洲,3,3,0,1,1,0,2,2,0,0,0,0,0,0,0
108,私立,一般大學,1002,輔仁大學,學士班(日間),布吉納法索,非洲,1,0,1,1,0,1,0,0,0,0,0,0,0,0,0
108,私立,一般大學,1002,輔仁大學,學士班(日間),印度尼西亞共和國,東協,37,11,26,23,6,17,14,5,9,0,0,0,0,0,0
108,私立,一般大學,1002,輔仁大學,學士班(日間),俄羅斯聯邦,其他亞洲地區,1,1,0,1,1,0,0,0,0,0,0,0,0,0,0
108,私立,一般大學,1002,輔仁大學,學士班(日間),玻利維亞共和國,中南美洲,1,1,0,0,0,0,1,1,0,0,0,0,0,0,0
108,私立,一般大學,1002,輔仁大學,學士班(日間),香港,港澳,156,82,74,0,0,0,0,0,0,156,82,74,0,0,0
108,私立,一般大學,1002,輔仁大學,學士班(日間),哥斯大黎加共和國,中南美洲,1,0,1,0,0,0,1,0,1,0,0,0,0,0,0
108,私立,一般大學,1002,輔仁大學,學士班(日間),馬來西亞,東協,151,57,94,36,12,24,115,45,70,0,0,0,0,0,0
108,私立,一般大學,1002,輔仁大學,學士班(日間),新加坡共和國,東協,2,1,1,0,0,0,2,1,1,0,0,0,0,0,0
108,私立,一般大學,1002,輔仁大學,學士班(日間),葡萄牙共和國,歐洲,1,1,0,1,1,0,0,0,0,0,0,0,0,0,0
108,私立,一般大學,1002,輔仁大學,學士班(日間),巴拉圭,中南美洲,1,1,0,0,0,0,1,1,0,0,0,0,0,0,0
108,私立,一般大學,1002,輔仁大學,學士班(日間),巴林,其他亞洲地區,1,0,1,0,0,0,1,0,1,0,0,0,0,0,0
108,私立,一般大學,1002,輔仁大學,學士班(日間),巴拿馬共和國,中南美洲,1,0,1,0,0,0,1,0,1,0,0,0,0,0,0
108,私立,一般大學,1002,輔仁大學,學士班(日間),史瓦帝尼王國,非洲,2,0,2,1,0,1,1,0,1,0,0,0,0,0,0
108,私立,一般大學,1002,輔仁大學,學士班(日間),美國,北美洲,9,5,4,4,4,0,5,1,4,0,0,0,0,0,0
108,私立,一般大學,1002,輔仁大學,學士班(日間),泰國,東協,7,2,5,5,1,4,2,1,1,0,0,0,0,0,0
108,私立,一般大學,1002,輔仁大學,學士班(日間),紐西蘭,其他亞洲地區,1,0,1,0,0,0,1,0,1,0,0,0,0,0,0
108,私立,一般大學,1002,輔仁大學,學士班(日間),越南社會主義共和國,東協,24,3,21,18,3,15,6,0,6,0,0,0,0,0,0
108,私立,一般大學,1002,輔仁大學,學士班(日間),塞爾維亞共和國,歐洲,1,0,1,1,0,1,0,0,0,0,0,0,0,0,0
108,私立,一般大學,1002,輔仁大學,學士班(日間),義大利共和國,歐洲,2,1,1,2,1,1,0,0,0,0,0,0,0,0,0
108,私立,一般大學,1002,輔仁大學,學士班(日間),蒙古國,其他亞洲地區,1,1,0,1,1,0,0,0,0,0,0,0,0,0,0
108,私立,一般大學,1002,輔仁大學,學士班(日間),緬甸,東協,1,1,0,0,0,0,1,1,0,0,0,0,0,0,0
108,私立,一般大學,1002,輔仁大學,學士班(日間),墨西哥合眾國,中南美洲,1,0,1,0,0,0,1,0,1,0,0,0,0,0,0
108,私立,一般大學,1002,輔仁大學,學士班(日間),澳大利亞,其他亞洲地區,1,0,1,1,0,1,0,0,0,0,0,0,0,0,0
108,私立,一般大學,1002,輔仁大學,學士班(日間),澳門,港澳,155,113,42,0,0,0,0,0,0,155,113,42,0,0,0
108,私立,一般大學,1002,輔仁大學,碩士班(日間),日本,其他亞洲地區,14,4,10,12,4,8,2,0,2,0,0,0,0,0,0
108,私立,一般大學,1002,輔仁大學,碩士班(日間),比利時王國,歐洲,1,0,1,1,0,1,0,0,0,0,0,0,0,0,0
108,私立,一般大學,1002,輔仁大學,碩士班(日間),法國,歐洲,7,2,5,7,2,5,0,0,0,0,0,0,0,0,0
108,私立,一般大學,1002,輔仁大學,碩士班(日間),美國,北美洲,2,1,1,2,1,1,0,0,0,0,0,0,0,0,0
108,私立,一般大學,1002,輔仁大學,碩士班(日間),泰國,東協,4,1,3,4,1,3,0,0,0,0,0,0,0,0,0
108,私立,一般大學,1002,輔仁大學,碩士班(日間),海地共和國,中南美洲,1,1,0,1,1,0,0,0,0,0,0,0,0,0,0
108,私立,一般大學,1002,輔仁大學,碩士班(日間),紐西蘭,其他亞洲地區,1,1,0,1,1,0,0,0,0,0,0,0,0,0,0
108,私立,一般大學,1002,輔仁大學,碩士班(日間),越南社會主義共和國,東協,9,2,7,9,2,7,0,0,0,0,0,0,0,0,0
108,私立,一般大學,1002,輔仁大學,碩士班(日間),義大利共和國,歐洲,2,2,0,2,2,0,0,0,0,0,0,0,0,0,0
108,私立,一般大學,1002,輔仁大學,碩士班(日間),德意志聯邦共和國,歐洲,1,1,0,1,1,0,0,0,0,0,0,0,0,0,0
108,私立,一般大學,1002,輔仁大學,碩士班(日間),澳門,港澳,7,3,4,0,0,0,0,0,0,7,3,4,0,0,0
108,私立,一般大學,1002,輔仁大學,碩士班(日間),大陸地區,大陸地區,216,94,122,0,0,0,0,0,0,0,0,0,216,94,122
108,私立,一般大學,1002,輔仁大學,碩士班(日間),大韓民國(南韓),其他亞洲地區,5,3,2,5,3,2,0,0,0,0,0,0,0,0,0
108,私立,一般大學,1002,輔仁大學,碩士班(日間),巴西聯邦共和國,中南美洲,1,0,1,0,0,0,1,0,1,0,0,0,0,0,0
108,私立,一般大學,1002,輔仁大學,碩士班(日間),加拿大,北美洲,3,1,2,2,1,1,1,0,1,0,0,0,0,0,0
108,私立,一般大學,1002,輔仁大學,碩士班(日間),印度,南亞,4,2,2,4,2,2,0,0,0,0,0,0,0,0,0
108,私立,一般大學,1002,輔仁大學,碩士班(日間),印度尼西亞共和國,東協,7,5,2,5,3,2,2,2,0,0,0,0,0,0,0
108,私立,一般大學,1002,輔仁大學,碩士班(日間),西班牙王國,歐洲,1,0,1,1,0,1,0,0,0,0,0,0,0,0,0
108,私立,一般大學,1002,輔仁大學,碩士班(日間),宏都拉斯共和國,中南美洲,1,0,1,1,0,1,0,0,0,0,0,0,0,0,0
108,私立,一般大學,1002,輔仁大學,碩士班(日間),波蘭共和國,歐洲,1,1,0,1,1,0,0,0,0,0,0,0,0,0,0
108,私立,一般大學,1002,輔仁大學,碩士班(日間),俄羅斯聯邦,其他亞洲地區,2,0,2,2,0,2,0,0,0,0,0,0,0,0,0
108,私立,一般大學,1002,輔仁大學,碩士班(日間),香港,港澳,14,4,10,0,0,0,0,0,0,14,4,10,0,0,0
108,私立,一般大學,1002,輔仁大學,碩士班(日間),剛果民主共和國,非洲,1,1,0,1,1,0,0,0,0,0,0,0,0,0,0
108,私立,一般大學,1002,輔仁大學,碩士班(日間),馬來西亞,東協,20,9,11,11,4,7,9,5,4,0,0,0,0,0,0
108,私立,一般大學,1002,輔仁大學,碩士班(日間),荷蘭王國,歐洲,1,1,0,1,1,0,0,0,0,0,0,0,0,0,0
108,私立,一般大學,1002,輔仁大學,碩士班(日間),菲律賓共和國,東協,1,0,1,1,0,1,0,0,0,0,0,0,0,0,0
108,私立,一般大學,1002,輔仁大學,碩士班(日間),瑞士聯邦,歐洲,1,0,1,1,0,1,0,0,0,0,0,0,0,0,0
108,私立,一般大學,1002,輔仁大學,碩士班(日間),蒙古國,其他亞洲地區,1,1,0,1,1,0,0,0,0,0,0,0,0,0,0
108,私立,一般大學,1002,輔仁大學,博士班,大陸地區,大陸地區,58,33,25,0,0,0,0,0,0,0,0,0,58,33,25
108,私立,一般大學,1002,輔仁大學,博士班,大韓民國(南韓),其他亞洲地區,1,1,0,1,1,0,0,0,0,0,0,0,0,0,0
108,私立,一般大學,1002,輔仁大學,博士班,日本,其他亞洲地區,3,2,1,3,2,1,0,0,0,0,0,0,0,0,0
108,私立,一般大學,1002,輔仁大學,博士班,加拿大,北美洲,1,1,0,0,0,0,1,1,0,0,0,0,0,0,0
108,私立,一般大學,1002,輔仁大學,博士班,印度,南亞,3,2,1,3,2,1,0,0,0,0,0,0,0,0,0
108,私立,一般大學,1002,輔仁大學,博士班,印度尼西亞共和國,東協,1,0,1,1,0,1,0,0,0,0,0,0,0,0,0
108,私立,一般大學,1002,輔仁大學,博士班,多明尼加共和國,中南美洲,1,1,0,1,1,0,0,0,0,0,0,0,0,0,0
108,私立,一般大學,1002,輔仁大學,博士班,香港,港澳,2,1,1,0,0,0,0,0,0,2,1,1,0,0,0
108,私立,一般大學,1002,輔仁大學,博士班,比利時王國,歐洲,1,1,0,1,1,0,0,0,0,0,0,0,0,0,0
108,私立,一般大學,1002,輔仁大學,博士班,吉里巴斯共和國,其他亞洲地區,1,0,1,1,0,1,0,0,0,0,0,0,0,0,0
108,私立,一般大學,1002,輔仁大學,博士班,奈及利亞聯邦共和國,非洲,1,1,0,1,1,0,0,0,0,0,0,0,0,0,0
108,私立,一般大學,1002,輔仁大學,博士班,波蘭共和國,歐洲,2,1,1,2,1,1,0,0,0,0,0,0,0,0,0
108,私立,一般大學,1002,輔仁大學,博士班,阿根廷,中南美洲,1,0,1,1,0,1,0,0,0,0,0,0,0,0,0
108,私立,一般大學,1002,輔仁大學,博士班,俄羅斯聯邦,其他亞洲地區,1,0,1,1,0,1,0,0,0,0,0,0,0,0,0
108,私立,一般大學,1002,輔仁大學,博士班,美國,北美洲,2,2,0,2,2,0,0,0,0,0,0,0,0,0,0
108,私立,一般大學,1002,輔仁大學,博士班,馬來西亞,東協,6,3,3,2,0,2,4,3,1,0,0,0,0,0,0
108,私立,一般大學,1002,輔仁大學,博士班,菲律賓共和國,東協,2,1,1,2,1,1,0,0,0,0,0,0,0,0,0
108,私立,一般大學,1002,輔仁大學,博士班,越南社會主義共和國,東協,3,2,1,3,2,1,0,0,0,0,0,0,0,0,0
108,私立,一般大學,1002,輔仁大學,博士班,義大利共和國,歐洲,2,1,1,2,1,1,0,0,0,0,0,0,0,0,0
108,私立,一般大學,1003,東吳大學,學士班(日間),大韓民國(南韓),其他亞洲地區,21,10,11,16,8,8,5,2,3,0,0,0,0,0,0
108,私立,一般大學,1003,東吳大學,學士班(日間),日本,其他亞洲地區,33,12,21,32,11,21,1,1,0,0,0,0,0,0,0
108,私立,一般大學,1003,東吳大學,學士班(日間),印度尼西亞共和國,東協,6,2,4,1,1,0,5,1,4,0,0,0,0,0,0
108,私立,一般大學,1003,東吳大學,學士班(日間),汶萊和平之國,東協,1,0,1,0,0,0,1,0,1,0,0,0,0,0,0
108,私立,一般大學,1003,東吳大學,學士班(日間),南非共和國,非洲,1,1,0,0,0,0,1,1,0,0,0,0,0,0,0
108,私立,一般大學,1003,東吳大學,學士班(日間),泰國,東協,3,2,1,0,0,0,3,2,1,0,0,0,0,0,0
108,私立,一般大學,1003,東吳大學,學士班(日間),馬來西亞,東協,76,36,40,20,9,11,56,27,29,0,0,0,0,0,0
108,私立,一般大學,1003,東吳大學,學士班(日間),菲律賓共和國,東協,1,0,1,0,0,0,1,0,1,0,0,0,0,0,0
108,私立,一般大學,1003,東吳大學,學士班(日間),澳大利亞,其他亞洲地區,1,1,0,0,0,0,1,1,0,0,0,0,0,0,0
108,私立,一般大學,1003,東吳大學,學士班(日間),土耳其共和國,其他亞洲地區,1,1,0,1,1,0,0,0,0,0,0,0,0,0,0
108,私立,一般大學,1003,東吳大學,學士班(日間),大陸地區,大陸地區,131,54,77,0,0,0,0,0,0,0,0,0,131,54,77
108,私立,一般大學,1003,東吳大學,學士班(日間),奈及利亞聯邦共和國,非洲,1,0,1,0,0,0,1,0,1,0,0,0,0,0,0
108,私立,一般大學,1003,東吳大學,學士班(日間),帛琉共和國,其他亞洲地區,1,0,1,1,0,1,0,0,0,0,0,0,0,0,0
108,私立,一般大學,1003,東吳大學,學士班(日間),美國,北美洲,1,1,0,0,0,0,1,1,0,0,0,0,0,0,0
108,私立,一般大學,1003,東吳大學,學士班(日間),香港,港澳,148,80,68,0,0,0,0,0,0,148,80,68,0,0,0
108,私立,一般大學,1003,東吳大學,學士班(日間),越南社會主義共和國,東協,10,5,5,7,3,4,3,2,1,0,0,0,0,0,0
108,私立,一般大學,1003,東吳大學,學士班(日間),新加坡共和國,東協,3,1,2,2,0,2,1,1,0,0,0,0,0,0,0
108,私立,一般大學,1003,東吳大學,學士班(日間),德意志聯邦共和國,歐洲,1,1,0,1,1,0,0,0,0,0,0,0,0,0,0
108,私立,一般大學,1003,東吳大學,學士班(日間),澳門,港澳,104,53,51,0,0,0,0,0,0,104,53,51,0,0,0
108,私立,一般大學,1003,東吳大學,碩士班(日間),大陸地區,大陸地區,63,25,38,0,0,0,0,0,0,0,0,0,63,25,38
108,私立,一般大學,1003,東吳大學,碩士班(日間),日本,其他亞洲地區,6,3,3,6,3,3,0,0,0,0,0,0,0,0,0
108,私立,一般大學,1003,東吳大學,碩士班(日間),奈及利亞聯邦共和國,非洲,1,1,0,1,1,0,0,0,0,0,0,0,0,0,0
108,私立,一般大學,1003,東吳大學,碩士班(日間),波蘭共和國,歐洲,1,1,0,1,1,0,0,0,0,0,0,0,0,0,0
108,私立,一般大學,1003,東吳大學,碩士班(日間),香港,港澳,11,5,6,0,0,0,0,0,0,11,5,6,0,0,0
108,私立,一般大學,1003,東吳大學,碩士班(日間),德意志聯邦共和國,歐洲,1,1,0,1,1,0,0,0,0,0,0,0,0,0,0
108,私立,一般大學,1003,東吳大學,碩士班(日間),澳門,港澳,3,2,1,0,0,0,0,0,0,3,2,1,0,0,0
108,私立,一般大學,1003,東吳大學,碩士班(日間),印度尼西亞共和國,東協,1,0,1,1,0,1,0,0,0,0,0,0,0,0,0
108,私立,一般大學,1003,東吳大學,碩士班(日間),馬來西亞,東協,11,9,2,7,5,2,4,4,0,0,0,0,0,0,0
108,私立,一般大學,1003,東吳大學,碩士班(日間),捷克共和國,歐洲,1,1,0,1,1,0,0,0,0,0,0,0,0,0,0
108,私立,一般大學,1003,東吳大學,博士班,大陸地區,大陸地區,17,11,6,0,0,0,0,0,0,0,0,0,17,11,6
108,私立,一般大學,1003,東吳大學,博士班,日本,其他亞洲地區,14,3,11,14,3,11,0,0,0,0,0,0,0,0,0
108,私立,一般大學,1003,東吳大學,博士班,香港,港澳,1,0,1,0,0,0,0,0,0,1,0,1,0,0,0
108,私立,一般大學,1004,中原大學,學士班(日間),日本,其他亞洲地區,38,15,23,38,15,23,0,0,0,0,0,0,0,0,0
108,私立,一般大學,1004,中原大學,學士班(日間),印度尼西亞共和國,東協,93,42,51,39,17,22,54,25,29,0,0,0,0,0,0
108,私立,一般大學,1004,中原大學,學士班(日間),俄羅斯聯邦,其他亞洲地區,1,1,0,1,1,0,0,0,0,0,0,0,0,0,0
108,私立,一般大學,1004,中原大學,學士班(日間),美國,北美洲,2,1,1,2,1,1,0,0,0,0,0,0,0,0,0
108,私立,一般大學,1004,中原大學,學士班(日間),泰國,東協,2,2,0,1,1,0,1,1,0,0,0,0,0,0,0
108,私立,一般大學,1004,中原大學,學士班(日間),越南社會主義共和國,東協,38,9,29,35,7,28,3,2,1,0,0,0,0,0,0
108,私立,一般大學,1004,中原大學,學士班(日間),寮人民民主共和國(寮國),東協,1,1,0,1,1,0,0,0,0,0,0,0,0,0,0
108,私立,一般大學,1004,中原大學,學士班(日間),澳門,港澳,105,57,48,0,0,0,0,0,0,105,57,48,0,0,0
108,私立,一般大學,1004,中原大學,學士班(日間),大陸地區,大陸地區,226,116,110,0,0,0,0,0,0,0,0,0,226,116,110
108,私立,一般大學,1004,中原大學,學士班(日間),大韓民國(南韓),其他亞洲地區,17,5,12,15,3,12,2,2,0,0,0,0,0,0,0
108,私立,一般大學,1004,中原大學,學士班(日間),巴拿馬共和國,中南美洲,2,1,1,2,1,1,0,0,0,0,0,0,0,0,0
108,私立,一般大學,1004,中原大學,學士班(日間),吉爾吉斯,其他亞洲地區,1,1,0,1,1,0,0,0,0,0,0,0,0,0,0
108,私立,一般大學,1004,中原大學,學士班(日間),汶萊和平之國,東協,1,1,0,0,0,0,1,1,0,0,0,0,0,0,0
108,私立,一般大學,1004,中原大學,學士班(日間),芬蘭共和國,歐洲,1,0,1,1,0,1,0,0,0,0,0,0,0,0,0
108,私立,一般大學,1004,中原大學,學士班(日間),香港,港澳,212,131,81,0,0,0,0,0,0,212,131,81,0,0,0
108,私立,一般大學,1004,中原大學,學士班(日間),馬來西亞,東協,191,96,95,67,34,33,124,62,62,0,0,0,0,0,0
108,私立,一般大學,1004,中原大學,學士班(日間),菲律賓共和國,東協,2,0,2,2,0,2,0,0,0,0,0,0,0,0,0
108,私立,一般大學,1004,中原大學,學士班(日間),聖克里斯多福及尼維斯,中南美洲,2,1,1,2,1,1,0,0,0,0,0,0,0,0,0
108,私立,一般大學,1004,中原大學,學士班(日間),澳大利亞,其他亞洲地區,1,1,0,1,1,0,0,0,0,0,0,0,0,0,0
108,私立,一般大學,1004,中原大學,學士班(日間),薩爾瓦多,中南美洲,1,1,0,1,1,0,0,0,0,0,0,0,0,0,0
108,私立,一般大學,1004,中原大學,碩士班(日間),巴基斯坦,南亞,8,7,1,8,7,1,0,0,0,0,0,0,0,0,0
108,私立,一般大學,1004,中原大學,碩士班(日間),印度,南亞,1,0,1,1,0,1,0,0,0,0,0,0,0,0,0
108,私立,一般大學,1004,中原大學,碩士班(日間),吉爾吉斯,其他亞洲地區,1,1,0,1,1,0,0,0,0,0,0,0,0,0,0
108,私立,一般大學,1004,中原大學,碩士班(日間),辛巴威共和國,非洲,1,0,1,1,0,1,0,0,0,0,0,0,0,0,0
108,私立,一般大學,1004,中原大學,碩士班(日間),美國,北美洲,3,3,0,3,3,0,0,0,0,0,0,0,0,0,0
108,私立,一般大學,1004,中原大學,碩士班(日間),香港,港澳,4,1,3,0,0,0,0,0,0,4,1,3,0,0,0
108,私立,一般大學,1004,中原大學,碩士班(日間),海地共和國,中南美洲,1,1,0,1,1,0,0,0,0,0,0,0,0,0,0
108,私立,一般大學,1004,中原大學,碩士班(日間),馬來西亞,東協,9,3,6,4,2,2,5,1,4,0,0,0,0,0,0
108,私立,一般大學,1004,中原大學,碩士班(日間),菲律賓共和國,東協,6,4,2,6,4,2,0,0,0,0,0,0,0,0,0
108,私立,一般大學,1004,中原大學,碩士班(日間),義大利共和國,歐洲,1,0,1,1,0,1,0,0,0,0,0,0,0,0,0
108,私立,一般大學,1004,中原大學,碩士班(日間),蒙古國,其他亞洲地區,3,0,3,3,0,3,0,0,0,0,0,0,0,0,0
108,私立,一般大學,1004,中原大學,碩士班(日間),大陸地區,大陸地區,25,14,11,0,0,0,0,0,0,0,0,0,25,14,11
108,私立,一般大學,1004,中原大學,碩士班(日間),日本,其他亞洲地區,1,0,1,1,0,1,0,0,0,0,0,0,0,0,0
108,私立,一般大學,1004,中原大學,碩士班(日間),布吉納法索,非洲,1,1,0,1,1,0,0,0,0,0,0,0,0,0,0
108,私立,一般大學,1004,中原大學,碩士班(日間),甘比亞共和國,非洲,2,2,0,2,2,0,0,0,0,0,0,0,0,0,0
108,私立,一般大學,1004,中原大學,碩士班(日間),印度尼西亞共和國,東協,62,27,35,62,27,35,0,0,0,0,0,0,0,0,0
108,私立,一般大學,1004,中原大學,碩士班(日間),法國,歐洲,1,1,0,1,1,0,0,0,0,0,0,0,0,0,0
108,私立,一般大學,1004,中原大學,碩士班(日間),南非共和國,非洲,1,0,1,1,0,1,0,0,0,0,0,0,0,0,0
108,私立,一般大學,1004,中原大學,碩士班(日間),泰國,東協,5,1,4,5,1,4,0,0,0,0,0,0,0,0,0
108,私立,一般大學,1004,中原大學,碩士班(日間),越南社會主義共和國,東協,22,8,14,20,7,13,2,1,1,0,0,0,0,0,0
108,私立,一般大學,1004,中原大學,碩士班(日間),寮人民民主共和國(寮國),東協,1,0,1,1,0,1,0,0,0,0,0,0,0,0,0
108,私立,一般大學,1004,中原大學,碩士班(日間),澳門,港澳,1,1,0,0,0,0,0,0,0,1,1,0,0,0,0
108,私立,一般大學,1004,中原大學,博士班,大陸地區,大陸地區,30,15,15,0,0,0,0,0,0,0,0,0,30,15,15
108,私立,一般大學,1004,中原大學,博士班,巴基斯坦,南亞,9,8,1,9,8,1,0,0,0,0,0,0,0,0,0
108,私立,一般大學,1004,中原大學,博士班,伊朗伊斯蘭共和國,其他亞洲地區,1,1,0,1,1,0,0,0,0,0,0,0,0,0,0
108,私立,一般大學,1004,中原大學,博士班,泰國,東協,1,0,1,1,0,1,0,0,0,0,0,0,0,0,0
108,私立,一般大學,1004,中原大學,博士班,海地共和國,中南美洲,2,2,0,2,2,0,0,0,0,0,0,0,0,0,0
108,私立,一般大學,1004,中原大學,博士班,秘魯共和國,中南美洲,1,0,1,1,0,1,0,0,0,0,0,0,0,0,0
108,私立,一般大學,1004,中原大學,博士班,菲律賓共和國,東協,16,11,5,16,11,5,0,0,0,0,0,0,0,0,0
108,私立,一般大學,1004,中原大學,博士班,越南社會主義共和國,東協,13,10,3,13,10,3,0,0,0,0,0,0,0,0,0
108,私立,一般大學,1004,中原大學,博士班,蒙古國,其他亞洲地區,2,1,1,2,1,1,0,0,0,0,0,0,0,0,0
108,私立,一般大學,1004,中原大學,博士班,印度,南亞,18,10,8,18,10,8,0,0,0,0,0,0,0,0,0
108,私立,一般大學,1004,中原大學,博士班,印度尼西亞共和國,東協,23,20,3,23,20,3,0,0,0,0,0,0,0,0,0
108,私立,一般大學,1004,中原大學,博士班,突尼西亞共和國,非洲,1,1,0,1,1,0,0,0,0,0,0,0,0,0,0
108,私立,一般大學,1004,中原大學,博士班,約旦哈什米王國,其他亞洲地區,1,1,0,1,1,0,0,0,0,0,0,0,0,0,0
108,私立,一般大學,1005,淡江大學學校財團法人淡江大學,學士班(日間),土耳其共和國,其他亞洲地區,4,1,3,4,1,3,0,0,0,0,0,0,0,0,0
108,私立,一般大學,1005,淡江大學學校財團法人淡江大學,學士班(日間),巴拿馬共和國,中南美洲,7,3,4,7,3,4,0,0,0,0,0,0,0,0,0
108,私立,一般大學,1005,淡江大學學校財團法人淡江大學,學士班(日間),史瓦帝尼王國,非洲,11,8,3,11,8,3,0,0,0,0,0,0,0,0,0
108,私立,一般大學,1005,淡江大學學校財團法人淡江大學,學士班(日間),尼加拉瓜,中南美洲,5,2,3,5,2,3,0,0,0,0,0,0,0,0,0
108,私立,一般大學,1005,淡江大學學校財團法人淡江大學,學士班(日間),瓜地馬拉共和國,中南美洲,4,1,3,4,1,3,0,0,0,0,0,0,0,0,0
108,私立,一般大學,1005,淡江大學學校財團法人淡江大學,學士班(日間),吐瓦魯,其他亞洲地區,10,3,7,10,3,7,0,0,0,0,0,0,0,0,0
108,私立,一般大學,1005,淡江大學學校財團法人淡江大學,學士班(日間),西班牙王國,歐洲,1,1,0,1,1,0,0,0,0,0,0,0,0,0,0
108,私立,一般大學,1005,淡江大學學校財團法人淡江大學,學士班(日間),利比亞,非洲,1,0,1,1,0,1,0,0,0,0,0,0,0,0,0
108,私立,一般大學,1005,淡江大學學校財團法人淡江大學,學士班(日間),貝里斯,中南美洲,3,1,2,3,1,2,0,0,0,0,0,0,0,0,0
108,私立,一般大學,1005,淡江大學學校財團法人淡江大學,學士班(日間),亞塞拜然共和國,其他亞洲地區,1,1,0,1,1,0,0,0,0,0,0,0,0,0,0
108,私立,一般大學,1005,淡江大學學校財團法人淡江大學,學士班(日間),帛琉共和國,其他亞洲地區,9,2,7,9,2,7,0,0,0,0,0,0,0,0,0
108,私立,一般大學,1005,淡江大學學校財團法人淡江大學,學士班(日間),芬蘭共和國,歐洲,1,0,1,1,0,1,0,0,0,0,0,0,0,0,0
108,私立,一般大學,1005,淡江大學學校財團法人淡江大學,學士班(日間),俄羅斯聯邦,其他亞洲地區,5,1,4,5,1,4,0,0,0,0,0,0,0,0,0
108,私立,一般大學,1005,淡江大學學校財團法人淡江大學,學士班(日間),美國,北美洲,15,13,2,11,10,1,4,3,1,0,0,0,0,0,0
108,私立,一般大學,1005,淡江大學學校財團法人淡江大學,學士班(日間),泰國,東協,13,5,8,11,4,7,2,1,1,0,0,0,0,0,0
108,私立,一般大學,1005,淡江大學學校財團法人淡江大學,學士班(日間),海地共和國,中南美洲,9,8,1,9,8,1,0,0,0,0,0,0,0,0,0
108,私立,一般大學,1005,淡江大學學校財團法人淡江大學,學士班(日間),烏克蘭,其他亞洲地區,1,0,1,1,0,1,0,0,0,0,0,0,0,0,0
108,私立,一般大學,1005,淡江大學學校財團法人淡江大學,學士班(日間),索羅門群島,其他亞洲地區,19,10,9,19,10,9,0,0,0,0,0,0,0,0,0
108,私立,一般大學,1005,淡江大學學校財團法人淡江大學,學士班(日間),馬拉威共和國,非洲,2,2,0,2,2,0,0,0,0,0,0,0,0,0,0
108,私立,一般大學,1005,淡江大學學校財團法人淡江大學,學士班(日間),馬紹爾群島共和國,其他亞洲地區,15,4,11,15,4,11,0,0,0,0,0,0,0,0,0
108,私立,一般大學,1005,淡江大學學校財團法人淡江大學,學士班(日間),幾內亞共和國,非洲,1,1,0,1,1,0,0,0,0,0,0,0,0,0,0
108,私立,一般大學,1005,淡江大學學校財團法人淡江大學,學士班(日間),斯里蘭卡民主社會主義共和國,南亞,1,0,1,0,0,0,1,0,1,0,0,0,0,0,0
108,私立,一般大學,1005,淡江大學學校財團法人淡江大學,學士班(日間),智利,中南美洲,1,0,1,0,0,0,1,0,1,0,0,0,0,0,0
108,私立,一般大學,1005,淡江大學學校財團法人淡江大學,學士班(日間),新加坡共和國,東協,2,1,1,2,1,1,0,0,0,0,0,0,0,0,0
108,私立,一般大學,1005,淡江大學學校財團法人淡江大學,學士班(日間),義大利共和國,歐洲,2,2,0,2,2,0,0,0,0,0,0,0,0,0,0
108,私立,一般大學,1005,淡江大學學校財團法人淡江大學,學士班(日間),聖多美普林西比民主共和國,非洲,1,1,0,1,1,0,0,0,0,0,0,0,0,0,0
108,私立,一般大學,1005,淡江大學學校財團法人淡江大學,學士班(日間),聖克里斯多福及尼維斯,中南美洲,3,1,2,3,1,2,0,0,0,0,0,0,0,0,0
108,私立,一般大學,1005,淡江大學學校財團法人淡江大學,學士班(日間),聖露西亞,中南美洲,2,2,0,2,2,0,0,0,0,0,0,0,0,0,0
108,私立,一般大學,1005,淡江大學學校財團法人淡江大學,學士班(日間),蒙古國,其他亞洲地區,11,4,7,11,4,7,0,0,0,0,0,0,0,0,0
108,私立,一般大學,1005,淡江大學學校財團法人淡江大學,學士班(日間),德意志聯邦共和國,歐洲,2,1,1,2,1,1,0,0,0,0,0,0,0,0,0
108,私立,一般大學,1005,淡江大學學校財團法人淡江大學,學士班(日間),緬甸,東協,9,5,4,1,0,1,8,5,3,0,0,0,0,0,0
108,私立,一般大學,1005,淡江大學學校財團法人淡江大學,學士班(日間),澳大利亞,其他亞洲地區,1,1,0,1,1,0,0,0,0,0,0,0,0,0,0
108,私立,一般大學,1005,淡江大學學校財團法人淡江大學,學士班(日間),諾魯共和國,其他亞洲地區,8,3,5,8,3,5,0,0,0,0,0,0,0,0,0
108,私立,一般大學,1005,淡江大學學校財團法人淡江大學,學士班(日間),大陸地區,大陸地區,318,145,173,0,0,0,0,0,0,0,0,0,318,145,173
108,私立,一般大學,1005,淡江大學學校財團法人淡江大學,學士班(日間),大韓民國(南韓),其他亞洲地區,37,16,21,29,10,19,8,6,2,0,0,0,0,0,0
108,私立,一般大學,1005,淡江大學學校財團法人淡江大學,學士班(日間),厄瓜多共和國,中南美洲,1,0,1,1,0,1,0,0,0,0,0,0,0,0,0
108,私立,一般大學,1005,淡江大學學校財團法人淡江大學,學士班(日間),巴布亞紐幾內亞獨立國,其他亞洲地區,1,0,1,1,0,1,0,0,0,0,0,0,0,0,0
108,私立,一般大學,1005,淡江大學學校財團法人淡江大學,學士班(日間),巴西聯邦共和國,中南美洲,5,2,3,3,2,1,2,0,2,0,0,0,0,0,0
108,私立,一般大學,1005,淡江大學學校財團法人淡江大學,學士班(日間),巴拉圭,中南美洲,17,7,10,16,7,9,1,0,1,0,0,0,0,0,0
108,私立,一般大學,1005,淡江大學學校財團法人淡江大學,學士班(日間),日本,其他亞洲地區,88,40,48,75,37,38,13,3,10,0,0,0,0,0,0
108,私立,一般大學,1005,淡江大學學校財團法人淡江大學,學士班(日間),加拿大,北美洲,5,5,0,3,3,0,2,2,0,0,0,0,0,0,0
108,私立,一般大學,1005,淡江大學學校財團法人淡江大學,學士班(日間),布吉納法索,非洲,3,3,0,3,3,0,0,0,0,0,0,0,0,0,0
108,私立,一般大學,1005,淡江大學學校財團法人淡江大學,學士班(日間),白俄羅斯共和國,其他亞洲地區,1,1,0,1,1,0,0,0,0,0,0,0,0,0,0
108,私立,一般大學,1005,淡江大學學校財團法人淡江大學,學士班(日間),匈牙利共和國,歐洲,1,1,0,1,1,0,0,0,0,0,0,0,0,0,0
108,私立,一般大學,1005,淡江大學學校財團法人淡江大學,學士班(日間),印度,南亞,7,3,4,7,3,4,0,0,0,0,0,0,0,0,0
108,私立,一般大學,1005,淡江大學學校財團法人淡江大學,學士班(日間),印度尼西亞共和國,東協,245,110,135,154,60,94,91,50,41,0,0,0,0,0,0
108,私立,一般大學,1005,淡江大學學校財團法人淡江大學,學士班(日間),吉里巴斯共和國,其他亞洲地區,19,4,15,19,4,15,0,0,0,0,0,0,0,0,0
108,私立,一般大學,1005,淡江大學學校財團法人淡江大學,學士班(日間),多明尼加共和國,中南美洲,1,1,0,1,1,0,0,0,0,0,0,0,0,0,0
108,私立,一般大學,1005,淡江大學學校財團法人淡江大學,學士班(日間),宏都拉斯共和國,中南美洲,9,7,2,9,7,2,0,0,0,0,0,0,0,0,0
108,私立,一般大學,1005,淡江大學學校財團法人淡江大學,學士班(日間),波蘭共和國,歐洲,1,0,1,1,0,1,0,0,0,0,0,0,0,0,0
108,私立,一般大學,1005,淡江大學學校財團法人淡江大學,學士班(日間),法國,歐洲,4,3,1,4,3,1,0,0,0,0,0,0,0,0,0
108,私立,一般大學,1005,淡江大學學校財團法人淡江大學,學士班(日間),阿根廷,中南美洲,1,0,1,0,0,0,1,0,1,0,0,0,0,0,0
108,私立,一般大學,1005,淡江大學學校財團法人淡江大學,學士班(日間),南非共和國,非洲,2,1,1,2,1,1,0,0,0,0,0,0,0,0,0
108,私立,一般大學,1005,淡江大學學校財團法人淡江大學,學士班(日間),柬埔寨王國,東協,1,1,0,1,1,0,0,0,0,0,0,0,0,0,0
108,私立,一般大學,1005,淡江大學學校財團法人淡江大學,學士班(日間),英國,歐洲,1,0,1,1,0,1,0,0,0,0,0,0,0,0,0
108,私立,一般大學,1005,淡江大學學校財團法人淡江大學,學士班(日間),香港,港澳,300,160,140,0,0,0,0,0,0,300,160,140,0,0,0
108,私立,一般大學,1005,淡江大學學校財團法人淡江大學,學士班(日間),哥斯大黎加共和國,中南美洲,1,0,1,0,0,0,1,0,1,0,0,0,0,0,0
108,私立,一般大學,1005,淡江大學學校財團法人淡江大學,學士班(日間),秘魯共和國,中南美洲,7,5,2,7,5,2,0,0,0,0,0,0,0,0,0
108,私立,一般大學,1005,淡江大學學校財團法人淡江大學,學士班(日間),馬來西亞,東協,165,69,96,35,8,27,130,61,69,0,0,0,0,0,0
108,私立,一般大學,1005,淡江大學學校財團法人淡江大學,學士班(日間),菲律賓共和國,東協,2,0,2,0,0,0,2,0,2,0,0,0,0,0,0
108,私立,一般大學,1005,淡江大學學校財團法人淡江大學,學士班(日間),越南社會主義共和國,東協,51,19,32,41,14,27,10,5,5,0,0,0,0,0,0
108,私立,一般大學,1005,淡江大學學校財團法人淡江大學,學士班(日間),聖文森(及格瑞那丁),中南美洲,7,2,5,7,2,5,0,0,0,0,0,0,0,0,0
108,私立,一般大學,1005,淡江大學學校財團法人淡江大學,學士班(日間),墨西哥合眾國,中南美洲,5,3,2,4,2,2,1,1,0,0,0,0,0,0,0
108,私立,一般大學,1005,淡江大學學校財團法人淡江大學,學士班(日間),澳門,港澳,174,118,56,0,0,0,0,0,0,174,118,56,0,0,0
108,私立,一般大學,1005,淡江大學學校財團法人淡江大學,學士班(日間),薩爾瓦多,中南美洲,2,1,1,2,1,1,0,0,0,0,0,0,0,0,0
108,私立,一般大學,1005,淡江大學學校財團法人淡江大學,碩士班(日間),大陸地區,大陸地區,51,33,18,0,0,0,0,0,0,0,0,0,51,33,18
108,私立,一般大學,1005,淡江大學學校財團法人淡江大學,碩士班(日間),大韓民國(南韓),其他亞洲地區,4,1,3,4,1,3,0,0,0,0,0,0,0,0,0
108,私立,一般大學,1005,淡江大學學校財團法人淡江大學,碩士班(日間),厄瓜多共和國,中南美洲,1,1,0,1,1,0,0,0,0,0,0,0,0,0,0
108,私立,一般大學,1005,淡江大學學校財團法人淡江大學,碩士班(日間),巴西聯邦共和國,中南美洲,1,0,1,1,0,1,0,0,0,0,0,0,0,0,0
108,私立,一般大學,1005,淡江大學學校財團法人淡江大學,碩士班(日間),巴拉圭,中南美洲,1,0,1,1,0,1,0,0,0,0,0,0,0,0,0
108,私立,一般大學,1005,淡江大學學校財團法人淡江大學,碩士班(日間),日本,其他亞洲地區,8,7,1,7,6,1,1,1,0,0,0,0,0,0,0
108,私立,一般大學,1005,淡江大學學校財團法人淡江大學,碩士班(日間),以色列,其他亞洲地區,1,0,1,1,0,1,0,0,0,0,0,0,0,0,0
108,私立,一般大學,1005,淡江大學學校財團法人淡江大學,碩士班(日間),布吉納法索,非洲,3,2,1,3,2,1,0,0,0,0,0,0,0,0,0
108,私立,一般大學,1005,淡江大學學校財團法人淡江大學,碩士班(日間),伊朗伊斯蘭共和國,其他亞洲地區,1,1,0,1,1,0,0,0,0,0,0,0,0,0,0
108,私立,一般大學,1005,淡江大學學校財團法人淡江大學,碩士班(日間),匈牙利共和國,歐洲,1,1,0,1,1,0,0,0,0,0,0,0,0,0,0
108,私立,一般大學,1005,淡江大學學校財團法人淡江大學,碩士班(日間),印度,南亞,4,3,1,4,3,1,0,0,0,0,0,0,0,0,0
108,私立,一般大學,1005,淡江大學學校財團法人淡江大學,碩士班(日間),印度尼西亞共和國,東協,5,2,3,5,2,3,0,0,0,0,0,0,0,0,0
108,私立,一般大學,1005,淡江大學學校財團法人淡江大學,碩士班(日間),宏都拉斯共和國,中南美洲,1,1,0,1,1,0,0,0,0,0,0,0,0,0,0
108,私立,一般大學,1005,淡江大學學校財團法人淡江大學,碩士班(日間),沙烏地阿拉伯王國,其他亞洲地區,2,2,0,2,2,0,0,0,0,0,0,0,0,0,0
108,私立,一般大學,1005,淡江大學學校財團法人淡江大學,碩士班(日間),南非共和國,非洲,1,0,1,1,0,1,0,0,0,0,0,0,0,0,0
108,私立,一般大學,1005,淡江大學學校財團法人淡江大學,碩士班(日間),科威特,其他亞洲地區,1,1,0,0,0,0,1,1,0,0,0,0,0,0,0
108,私立,一般大學,1005,淡江大學學校財團法人淡江大學,碩士班(日間),英國,歐洲,1,1,0,1,1,0,0,0,0,0,0,0,0,0,0
108,私立,一般大學,1005,淡江大學學校財團法人淡江大學,碩士班(日間),香港,港澳,12,6,6,0,0,0,0,0,0,12,6,6,0,0,0
108,私立,一般大學,1005,淡江大學學校財團法人淡江大學,碩士班(日間),烏茲別克共和國,其他亞洲地區,1,1,0,1,1,0,0,0,0,0,0,0,0,0,0
108,私立,一般大學,1005,淡江大學學校財團法人淡江大學,碩士班(日間),馬來西亞,東協,7,3,4,2,1,1,5,2,3,0,0,0,0,0,0
108,私立,一般大學,1005,淡江大學學校財團法人淡江大學,碩士班(日間),菲律賓共和國,東協,1,1,0,1,1,0,0,0,0,0,0,0,0,0,0
108,私立,一般大學,1005,淡江大學學校財團法人淡江大學,碩士班(日間),越南社會主義共和國,東協,8,1,7,8,1,7,0,0,0,0,0,0,0,0,0
108,私立,一般大學,1005,淡江大學學校財團法人淡江大學,碩士班(日間),聖克里斯多福及尼維斯,中南美洲,1,0,1,1,0,1,0,0,0,0,0,0,0,0,0
108,私立,一般大學,1005,淡江大學學校財團法人淡江大學,碩士班(日間),澳門,港澳,4,2,2,0,0,0,0,0,0,4,2,2,0,0,0
108,私立,一般大學,1005,淡江大學學校財團法人淡江大學,碩士班(日間),史瓦帝尼王國,非洲,1,0,1,1,0,1,0,0,0,0,0,0,0,0,0
108,私立,一般大學,1005,淡江大學學校財團法人淡江大學,碩士班(日間),尼加拉瓜,中南美洲,2,0,2,2,0,2,0,0,0,0,0,0,0,0,0
108,私立,一般大學,1005,淡江大學學校財團法人淡江大學,碩士班(日間),瓜地馬拉共和國,中南美洲,1,0,1,1,0,1,0,0,0,0,0,0,0,0,0
108,私立,一般大學,1005,淡江大學學校財團法人淡江大學,碩士班(日間),西班牙王國,歐洲,2,2,0,2,2,0,0,0,0,0,0,0,0,0,0
108,私立,一般大學,1005,淡江大學學校財團法人淡江大學,碩士班(日間),法國,歐洲,2,0,2,2,0,2,0,0,0,0,0,0,0,0,0
108,私立,一般大學,1005,淡江大學學校財團法人淡江大學,碩士班(日間),俄羅斯聯邦,其他亞洲地區,2,1,1,2,1,1,0,0,0,0,0,0,0,0,0
108,私立,一般大學,1005,淡江大學學校財團法人淡江大學,碩士班(日間),美國,北美洲,7,5,2,5,4,1,2,1,1,0,0,0,0,0,0
108,私立,一般大學,1005,淡江大學學校財團法人淡江大學,碩士班(日間),泰國,東協,12,2,10,12,2,10,0,0,0,0,0,0,0,0,0
108,私立,一般大學,1005,淡江大學學校財團法人淡江大學,碩士班(日間),海地共和國,中南美洲,1,0,1,1,0,1,0,0,0,0,0,0,0,0,0
108,私立,一般大學,1005,淡江大學學校財團法人淡江大學,碩士班(日間),瑞典王國,歐洲,1,1,0,1,1,0,0,0,0,0,0,0,0,0,0
108,私立,一般大學,1005,淡江大學學校財團法人淡江大學,碩士班(日間),義大利共和國,歐洲,1,1,0,1,1,0,0,0,0,0,0,0,0,0,0
108,私立,一般大學,1005,淡江大學學校財團法人淡江大學,碩士班(日間),蒙古國,其他亞洲地區,1,1,0,1,1,0,0,0,0,0,0,0,0,0,0
108,私立,一般大學,1005,淡江大學學校財團法人淡江大學,碩士班(日間),德意志聯邦共和國,歐洲,1,1,0,1,1,0,0,0,0,0,0,0,0,0,0
108,私立,一般大學,1005,淡江大學學校財團法人淡江大學,碩士班(日間),墨西哥合眾國,中南美洲,1,0,1,1,0,1,0,0,0,0,0,0,0,0,0
108,私立,一般大學,1005,淡江大學學校財團法人淡江大學,博士班,土耳其共和國,其他亞洲地區,1,0,1,1,0,1,0,0,0,0,0,0,0,0,0
108,私立,一般大學,1005,淡江大學學校財團法人淡江大學,博士班,布吉納法索,非洲,1,1,0,1,1,0,0,0,0,0,0,0,0,0,0
108,私立,一般大學,1005,淡江大學學校財團法人淡江大學,博士班,伊拉克共和國,其他亞洲地區,1,1,0,1,1,0,0,0,0,0,0,0,0,0,0
108,私立,一般大學,1005,淡江大學學校財團法人淡江大學,博士班,匈牙利共和國,歐洲,1,0,1,1,0,1,0,0,0,0,0,0,0,0,0
108,私立,一般大學,1005,淡江大學學校財團法人淡江大學,博士班,法國,歐洲,1,0,1,1,0,1,0,0,0,0,0,0,0,0,0
108,私立,一般大學,1005,淡江大學學校財團法人淡江大學,博士班,肯亞共和國,非洲,1,1,0,1,1,0,0,0,0,0,0,0,0,0,0
108,私立,一般大學,1005,淡江大學學校財團法人淡江大學,博士班,美國,北美洲,1,0,1,1,0,1,0,0,0,0,0,0,0,0,0
108,私立,一般大學,1005,淡江大學學校財團法人淡江大學,博士班,英國,歐洲,1,1,0,1,1,0,0,0,0,0,0,0,0,0,0
108,私立,一般大學,1005,淡江大學學校財團法人淡江大學,博士班,馬來西亞,東協,5,5,0,5,5,0,0,0,0,0,0,0,0,0,0
108,私立,一般大學,1005,淡江大學學校財團法人淡江大學,博士班,菲律賓共和國,東協,1,1,0,1,1,0,0,0,0,0,0,0,0,0,0
108,私立,一般大學,1005,淡江大學學校財團法人淡江大學,博士班,義大利共和國,歐洲,1,1,0,1,1,0,0,0,0,0,0,0,0,0,0
108,私立,一般大學,1005,淡江大學學校財團法人淡江大學,博士班,墨西哥合眾國,中南美洲,1,1,0,1,1,0,0,0,0,0,0,0,0,0,0
108,私立,一般大學,1005,淡江大學學校財團法人淡江大學,博士班,大陸地區,大陸地區,19,7,12,0,0,0,0,0,0,0,0,0,19,7,12
108,私立,一般大學,1005,淡江大學學校財團法人淡江大學,博士班,日本,其他亞洲地區,3,2,1,3,2,1,0,0,0,0,0,0,0,0,0
108,私立,一般大學,1005,淡江大學學校財團法人淡江大學,博士班,瓜地馬拉共和國,中南美洲,1,1,0,1,1,0,0,0,0,0,0,0,0,0,0
108,私立,一般大學,1005,淡江大學學校財團法人淡江大學,博士班,印度,南亞,5,3,2,5,3,2,0,0,0,0,0,0,0,0,0
108,私立,一般大學,1005,淡江大學學校財團法人淡江大學,博士班,越南社會主義共和國,東協,6,2,4,6,2,4,0,0,0,0,0,0,0,0,0
108,私立,一般大學,1006,中國文化大學,學士班(日間),大陸地區,大陸地區,298,119,179,0,0,0,0,0,0,0,0,0,298,119,179
108,私立,一般大學,1006,中國文化大學,學士班(日間),日本,其他亞洲地區,69,31,38,66,29,37,3,2,1,0,0,0,0,0,0
108,私立,一般大學,1006,中國文化大學,學士班(日間),印度,南亞,1,0,1,1,0,1,0,0,0,0,0,0,0,0,0
108,私立,一般大學,1006,中國文化大學,學士班(日間),南非共和國,非洲,1,1,0,0,0,0,1,1,0,0,0,0,0,0,0
108,私立,一般大學,1006,中國文化大學,學士班(日間),查德共和國,非洲,1,1,0,1,1,0,0,0,0,0,0,0,0,0,0
108,私立,一般大學,1006,中國文化大學,學士班(日間),香港,港澳,274,136,138,0,0,0,0,0,0,274,136,138,0,0,0
108,私立,一般大學,1006,中國文化大學,學士班(日間),馬拉威共和國,非洲,1,1,0,1,1,0,0,0,0,0,0,0,0,0,0
108,私立,一般大學,1006,中國文化大學,學士班(日間),新加坡共和國,東協,5,1,4,5,1,4,0,0,0,0,0,0,0,0,0
108,私立,一般大學,1006,中國文化大學,學士班(日間),德意志聯邦共和國,歐洲,1,0,1,1,0,1,0,0,0,0,0,0,0,0,0
108,私立,一般大學,1006,中國文化大學,學士班(日間),緬甸,東協,2,0,2,1,0,1,1,0,1,0,0,0,0,0,0
108,私立,一般大學,1006,中國文化大學,學士班(日間),澳門,港澳,81,46,35,0,0,0,0,0,0,81,46,35,0,0,0
108,私立,一般大學,1006,中國文化大學,學士班(日間),諾魯共和國,其他亞洲地區,1,1,0,1,1,0,0,0,0,0,0,0,0,0,0
108,私立,一般大學,1006,中國文化大學,學士班(日間),土耳其共和國,其他亞洲地區,1,1,0,1,1,0,0,0,0,0,0,0,0,0,0
108,私立,一般大學,1006,中國文化大學,學士班(日間),大韓民國(南韓),其他亞洲地區,32,14,18,27,11,16,5,3,2,0,0,0,0,0,0
108,私立,一般大學,1006,中國文化大學,學士班(日間),巴西聯邦共和國,中南美洲,1,0,1,0,0,0,1,0,1,0,0,0,0,0,0
108,私立,一般大學,1006,中國文化大學,學士班(日間),加拿大,北美洲,3,2,1,0,0,0,3,2,1,0,0,0,0,0,0
108,私立,一般大學,1006,中國文化大學,學士班(日間),布吉納法索,非洲,1,1,0,1,1,0,0,0,0,0,0,0,0,0,0
108,私立,一般大學,1006,中國文化大學,學士班(日間),印度尼西亞共和國,東協,58,32,26,39,22,17,19,10,9,0,0,0,0,0,0
108,私立,一般大學,1006,中國文化大學,學士班(日間),拉脫維亞共和國,歐洲,1,0,1,1,0,1,0,0,0,0,0,0,0,0,0
108,私立,一般大學,1006,中國文化大學,學士班(日間),法國,歐洲,1,0,1,1,0,1,0,0,0,0,0,0,0,0,0
108,私立,一般大學,1006,中國文化大學,學士班(日間),俄羅斯聯邦,其他亞洲地區,1,0,1,1,0,1,0,0,0,0,0,0,0,0,0
108,私立,一般大學,1006,中國文化大學,學士班(日間),美國,北美洲,11,7,4,9,6,3,2,1,1,0,0,0,0,0,0
108,私立,一般大學,1006,中國文化大學,學士班(日間),剛果共和國,非洲,2,2,0,2,2,0,0,0,0,0,0,0,0,0,0
108,私立,一般大學,1006,中國文化大學,學士班(日間),泰國,東協,3,1,2,1,1,0,2,0,2,0,0,0,0,0,0
108,私立,一般大學,1006,中國文化大學,學士班(日間),烏茲別克共和國,其他亞洲地區,1,1,0,1,1,0,0,0,0,0,0,0,0,0,0
108,私立,一般大學,1006,中國文化大學,學士班(日間),秘魯共和國,中南美洲,1,1,0,1,1,0,0,0,0,0,0,0,0,0,0
108,私立,一般大學,1006,中國文化大學,學士班(日間),馬來西亞,東協,266,120,146,136,62,74,130,58,72,0,0,0,0,0,0
108,私立,一般大學,1006,中國文化大學,學士班(日間),菲律賓共和國,東協,1,1,0,1,1,0,0,0,0,0,0,0,0,0,0
108,私立,一般大學,1006,中國文化大學,學士班(日間),越南社會主義共和國,東協,13,2,11,11,2,9,2,0,2,0,0,0,0,0,0
108,私立,一般大學,1006,中國文化大學,學士班(日間),義大利共和國,歐洲,1,0,1,0,0,0,1,0,1,0,0,0,0,0,0
108,私立,一般大學,1006,中國文化大學,學士班(日間),蒙古國,其他亞洲地區,16,6,10,16,6,10,0,0,0,0,0,0,0,0,0
108,私立,一般大學,1006,中國文化大學,學士班(日間),黎巴嫩共和國,其他亞洲地區,1,0,1,1,0,1,0,0,0,0,0,0,0,0,0
108,私立,一般大學,1006,中國文化大學,學士班(日間),澳大利亞,其他亞洲地區,1,0,1,0,0,0,1,0,1,0,0,0,0,0,0
108,私立,一般大學,1006,中國文化大學,碩士班(日間),大韓民國(南韓),其他亞洲地區,17,2,15,16,2,14,1,0,1,0,0,0,0,0,0
108,私立,一般大學,1006,中國文化大學,碩士班(日間),印度尼西亞共和國,東協,11,6,5,11,6,5,0,0,0,0,0,0,0,0,0
108,私立,一般大學,1006,中國文化大學,碩士班(日間),波蘭共和國,歐洲,1,0,1,1,0,1,0,0,0,0,0,0,0,0,0
108,私立,一般大學,1006,中國文化大學,碩士班(日間),法國,歐洲,1,1,0,1,1,0,0,0,0,0,0,0,0,0,0
108,私立,一般大學,1006,中國文化大學,碩士班(日間),俄羅斯聯邦,其他亞洲地區,3,1,2,3,1,2,0,0,0,0,0,0,0,0,0
108,私立,一般大學,1006,中國文化大學,碩士班(日間),美國,北美洲,3,1,2,3,1,2,0,0,0,0,0,0,0,0,0
108,私立,一般大學,1006,中國文化大學,碩士班(日間),泰國,東協,6,2,4,6,2,4,0,0,0,0,0,0,0,0,0
108,私立,一般大學,1006,中國文化大學,碩士班(日間),馬來西亞,東協,5,4,1,3,2,1,2,2,0,0,0,0,0,0,0
108,私立,一般大學,1006,中國文化大學,碩士班(日間),菲律賓共和國,東協,1,0,1,0,0,0,1,0,1,0,0,0,0,0,0
108,私立,一般大學,1006,中國文化大學,碩士班(日間),越南社會主義共和國,東協,18,6,12,18,6,12,0,0,0,0,0,0,0,0,0
108,私立,一般大學,1006,中國文化大學,碩士班(日間),蒙古國,其他亞洲地區,9,3,6,9,3,6,0,0,0,0,0,0,0,0,0
108,私立,一般大學,1006,中國文化大學,碩士班(日間),薩爾瓦多,中南美洲,1,0,1,1,0,1,0,0,0,0,0,0,0,0,0
108,私立,一般大學,1006,中國文化大學,碩士班(日間),大陸地區,大陸地區,40,26,14,0,0,0,0,0,0,0,0,0,40,26,14
108,私立,一般大學,1006,中國文化大學,碩士班(日間),厄瓜多共和國,中南美洲,1,1,0,1,1,0,0,0,0,0,0,0,0,0,0
108,私立,一般大學,1006,中國文化大學,碩士班(日間),日本,其他亞洲地區,2,1,1,2,1,1,0,0,0,0,0,0,0,0,0
108,私立,一般大學,1006,中國文化大學,碩士班(日間),印度,南亞,1,1,0,1,1,0,0,0,0,0,0,0,0,0,0
108,私立,一般大學,1006,中國文化大學,碩士班(日間),宏都拉斯共和國,中南美洲,1,1,0,1,1,0,0,0,0,0,0,0,0,0,0
108,私立,一般大學,1006,中國文化大學,碩士班(日間),奈及利亞聯邦共和國,非洲,1,1,0,1,1,0,0,0,0,0,0,0,0,0,0
108,私立,一般大學,1006,中國文化大學,碩士班(日間),香港,港澳,16,9,7,0,0,0,0,0,0,16,9,7,0,0,0
108,私立,一般大學,1006,中國文化大學,碩士班(日間),澳門,港澳,5,4,1,0,0,0,0,0,0,5,4,1,0,0,0
108,私立,一般大學,1006,中國文化大學,博士班,土庫曼,其他亞洲地區,1,1,0,1,1,0,0,0,0,0,0,0,0,0,0
108,私立,一般大學,1006,中國文化大學,博士班,波蘭共和國,歐洲,1,1,0,1,1,0,0,0,0,0,0,0,0,0,0
108,私立,一般大學,1006,中國文化大學,博士班,俄羅斯聯邦,其他亞洲地區,1,0,1,1,0,1,0,0,0,0,0,0,0,0,0
108,私立,一般大學,1006,中國文化大學,博士班,美國,北美洲,2,1,1,2,1,1,0,0,0,0,0,0,0,0,0
108,私立,一般大學,1006,中國文化大學,博士班,越南社會主義共和國,東協,7,4,3,7,4,3,0,0,0,0,0,0,0,0,0
108,私立,一般大學,1006,中國文化大學,博士班,大陸地區,大陸地區,14,9,5,0,0,0,0,0,0,0,0,0,14,9,5
108,私立,一般大學,1006,中國文化大學,博士班,大韓民國(南韓),其他亞洲地區,1,0,1,1,0,1,0,0,0,0,0,0,0,0,0
108,私立,一般大學,1006,中國文化大學,博士班,香港,港澳,2,2,0,0,0,0,0,0,0,2,2,0,0,0,0
108,私立,一般大學,1006,中國文化大學,博士班,蒙古國,其他亞洲地區,3,0,3,3,0,3,0,0,0,0,0,0,0,0,0
108,私立,一般大學,1007,逢甲大學,學士班(日間),土耳其共和國,其他亞洲地區,1,1,0,1,1,0,0,0,0,0,0,0,0,0,0
108,私立,一般大學,1007,逢甲大學,學士班(日間),大陸地區,大陸地區,271,147,124,0,0,0,0,0,0,0,0,0,271,147,124
108,私立,一般大學,1007,逢甲大學,學士班(日間),大韓民國(南韓),其他亞洲地區,12,6,6,11,5,6,1,1,0,0,0,0,0,0,0
108,私立,一般大學,1007,逢甲大學,學士班(日間),巴布亞紐幾內亞獨立國,其他亞洲地區,2,2,0,2,2,0,0,0,0,0,0,0,0,0,0
108,私立,一般大學,1007,逢甲大學,學士班(日間),巴拉圭,中南美洲,1,0,1,1,0,1,0,0,0,0,0,0,0,0,0
108,私立,一般大學,1007,逢甲大學,學士班(日間),比利時王國,歐洲,1,1,0,1,1,0,0,0,0,0,0,0,0,0,0
108,私立,一般大學,1007,逢甲大學,學士班(日間),加拿大,北美洲,1,1,0,0,0,0,1,1,0,0,0,0,0,0,0
108,私立,一般大學,1007,逢甲大學,學士班(日間),印度尼西亞共和國,東協,127,60,67,113,54,59,14,6,8,0,0,0,0,0,0
108,私立,一般大學,1007,逢甲大學,學士班(日間),吉爾吉斯,其他亞洲地區,1,1,0,1,1,0,0,0,0,0,0,0,0,0,0
108,私立,一般大學,1007,逢甲大學,學士班(日間),貝里斯,中南美洲,1,0,1,1,0,1,0,0,0,0,0,0,0,0,0
108,私立,一般大學,1007,逢甲大學,學士班(日間),帛琉共和國,其他亞洲地區,1,1,0,1,1,0,0,0,0,0,0,0,0,0,0
108,私立,一般大學,1007,逢甲大學,學士班(日間),波蘭共和國,歐洲,1,1,0,1,1,0,0,0,0,0,0,0,0,0,0
108,私立,一般大學,1007,逢甲大學,學士班(日間),法國,歐洲,2,1,1,2,1,1,0,0,0,0,0,0,0,0,0
108,私立,一般大學,1007,逢甲大學,學士班(日間),阿根廷,中南美洲,1,1,0,1,1,0,0,0,0,0,0,0,0,0,0
108,私立,一般大學,1007,逢甲大學,學士班(日間),南非共和國,非洲,7,5,2,4,4,0,3,1,2,0,0,0,0,0,0
108,私立,一般大學,1007,逢甲大學,學士班(日間),香港,港澳,298,219,79,0,0,0,0,0,0,298,219,79,0,0,0
108,私立,一般大學,1007,逢甲大學,學士班(日間),泰國,東協,33,14,19,32,14,18,1,0,1,0,0,0,0,0,0
108,私立,一般大學,1007,逢甲大學,學士班(日間),索羅門群島,其他亞洲地區,1,1,0,1,1,0,0,0,0,0,0,0,0,0,0
108,私立,一般大學,1007,逢甲大學,學士班(日間),智利,中南美洲,1,1,0,0,0,0,1,1,0,0,0,0,0,0,0
108,私立,一般大學,1007,逢甲大學,學士班(日間),越南社會主義共和國,東協,34,8,26,33,8,25,1,0,1,0,0,0,0,0,0
108,私立,一般大學,1007,逢甲大學,學士班(日間),聖露西亞,中南美洲,3,1,2,3,1,2,0,0,0,0,0,0,0,0,0
108,私立,一般大學,1007,逢甲大學,學士班(日間),蒙古國,其他亞洲地區,17,8,9,17,8,9,0,0,0,0,0,0,0,0,0
108,私立,一般大學,1007,逢甲大學,學士班(日間),墨西哥合眾國,中南美洲,2,1,1,2,1,1,0,0,0,0,0,0,0,0,0
108,私立,一般大學,1007,逢甲大學,學士班(日間),澳門,港澳,63,52,11,0,0,0,0,0,0,63,52,11,0,0,0
108,私立,一般大學,1007,逢甲大學,學士班(日間),巴西聯邦共和國,中南美洲,2,2,0,2,2,0,0,0,0,0,0,0,0,0,0
108,私立,一般大學,1007,逢甲大學,學士班(日間),日本,其他亞洲地區,56,26,30,56,26,30,0,0,0,0,0,0,0,0,0
108,私立,一般大學,1007,逢甲大學,學士班(日間),布吉納法索,非洲,1,1,0,1,1,0,0,0,0,0,0,0,0,0,0
108,私立,一般大學,1007,逢甲大學,學士班(日間),克羅埃西亞共和國,歐洲,1,1,0,1,1,0,0,0,0,0,0,0,0,0,0
108,私立,一般大學,1007,逢甲大學,學士班(日間),奈及利亞聯邦共和國,非洲,1,1,0,1,1,0,0,0,0,0,0,0,0,0,0
108,私立,一般大學,1007,逢甲大學,學士班(日間),俄羅斯聯邦,其他亞洲地區,2,0,2,2,0,2,0,0,0,0,0,0,0,0,0
108,私立,一般大學,1007,逢甲大學,學士班(日間),美國,北美洲,3,3,0,0,0,0,3,3,0,0,0,0,0,0,0
108,私立,一般大學,1007,逢甲大學,學士班(日間),英國,歐洲,2,2,0,1,1,0,1,1,0,0,0,0,0,0,0
108,私立,一般大學,1007,逢甲大學,學士班(日間),馬來西亞,東協,273,200,73,133,97,36,140,103,37,0,0,0,0,0,0
108,私立,一般大學,1007,逢甲大學,學士班(日間),荷蘭王國,歐洲,1,1,0,1,1,0,0,0,0,0,0,0,0,0,0
108,私立,一般大學,1007,逢甲大學,學士班(日間),聖克里斯多福及尼維斯,中南美洲,2,1,1,2,1,1,0,0,0,0,0,0,0,0,0
108,私立,一般大學,1007,逢甲大學,碩士班(日間),日本,其他亞洲地區,1,0,1,1,0,1,0,0,0,0,0,0,0,0,0
108,私立,一般大學,1007,逢甲大學,碩士班(日間),奈及利亞聯邦共和國,非洲,1,0,1,1,0,1,0,0,0,0,0,0,0,0,0
108,私立,一般大學,1007,逢甲大學,碩士班(日間),俄羅斯聯邦,其他亞洲地區,1,0,1,1,0,1,0,0,0,0,0,0,0,0,0
108,私立,一般大學,1007,逢甲大學,碩士班(日間),美國,北美洲,4,3,1,4,3,1,0,0,0,0,0,0,0,0,0
108,私立,一般大學,1007,逢甲大學,碩士班(日間),泰國,東協,11,2,9,11,2,9,0,0,0,0,0,0,0,0,0
108,私立,一般大學,1007,逢甲大學,碩士班(日間),馬來西亞,東協,13,6,7,7,5,2,6,1,5,0,0,0,0,0,0
108,私立,一般大學,1007,逢甲大學,碩士班(日間),土耳其共和國,其他亞洲地區,1,1,0,1,1,0,0,0,0,0,0,0,0,0,0
108,私立,一般大學,1007,逢甲大學,碩士班(日間),大陸地區,大陸地區,23,14,9,0,0,0,0,0,0,0,0,0,23,14,9
108,私立,一般大學,1007,逢甲大學,碩士班(日間),巴布亞紐幾內亞獨立國,其他亞洲地區,1,1,0,1,1,0,0,0,0,0,0,0,0,0,0
108,私立,一般大學,1007,逢甲大學,碩士班(日間),巴拉圭,中南美洲,1,1,0,1,1,0,0,0,0,0,0,0,0,0,0
108,私立,一般大學,1007,逢甲大學,碩士班(日間),印度,南亞,3,3,0,3,3,0,0,0,0,0,0,0,0,0,0
108,私立,一般大學,1007,逢甲大學,碩士班(日間),印度尼西亞共和國,東協,11,5,6,11,5,6,0,0,0,0,0,0,0,0,0
108,私立,一般大學,1007,逢甲大學,碩士班(日間),吉爾吉斯,其他亞洲地區,1,0,1,1,0,1,0,0,0,0,0,0,0,0,0
108,私立,一般大學,1007,逢甲大學,碩士班(日間),法國,歐洲,2,0,2,2,0,2,0,0,0,0,0,0,0,0,0
108,私立,一般大學,1007,逢甲大學,碩士班(日間),香港,港澳,12,12,0,0,0,0,0,0,0,12,12,0,0,0,0
108,私立,一般大學,1007,逢甲大學,碩士班(日間),烏干達共和國,非洲,1,1,0,1,1,0,0,0,0,0,0,0,0,0,0
108,私立,一般大學,1007,逢甲大學,碩士班(日間),烏克蘭,其他亞洲地區,1,1,0,1,1,0,0,0,0,0,0,0,0,0,0
108,私立,一般大學,1007,逢甲大學,碩士班(日間),越南社會主義共和國,東協,22,8,14,22,8,14,0,0,0,0,0,0,0,0,0
108,私立,一般大學,1007,逢甲大學,碩士班(日間),蒙古國,其他亞洲地區,3,2,1,3,2,1,0,0,0,0,0,0,0,0,0
108,私立,一般大學,1007,逢甲大學,碩士班(日間),德意志聯邦共和國,歐洲,1,0,1,1,0,1,0,0,0,0,0,0,0,0,0
108,私立,一般大學,1007,逢甲大學,碩士班(日間),澳門,港澳,3,3,0,0,0,0,0,0,0,3,3,0,0,0,0
108,私立,一般大學,1007,逢甲大學,碩士班(日間),羅馬尼亞,歐洲,1,1,0,1,1,0,0,0,0,0,0,0,0,0,0
108,私立,一般大學,1007,逢甲大學,博士班,泰國,東協,6,2,4,6,2,4,0,0,0,0,0,0,0,0,0
108,私立,一般大學,1007,逢甲大學,博士班,蒙古國,其他亞洲地區,1,0,1,1,0,1,0,0,0,0,0,0,0,0,0
108,私立,一般大學,1007,逢甲大學,博士班,土耳其共和國,其他亞洲地區,1,1,0,1,1,0,0,0,0,0,0,0,0,0,0
108,私立,一般大學,1007,逢甲大學,博士班,大陸地區,大陸地區,15,10,5,0,0,0,0,0,0,0,0,0,15,10,5
108,私立,一般大學,1007,逢甲大學,博士班,布吉納法索,非洲,2,2,0,2,2,0,0,0,0,0,0,0,0,0,0
108,私立,一般大學,1007,逢甲大學,博士班,印度,南亞,3,3,0,3,3,0,0,0,0,0,0,0,0,0,0
108,私立,一般大學,1007,逢甲大學,博士班,印度尼西亞共和國,東協,1,0,1,1,0,1,0,0,0,0,0,0,0,0,0
108,私立,一般大學,1007,逢甲大學,博士班,英國,歐洲,1,1,0,1,1,0,0,0,0,0,0,0,0,0,0
108,私立,一般大學,1007,逢甲大學,博士班,剛果共和國,非洲,1,1,0,1,1,0,0,0,0,0,0,0,0,0,0
108,私立,一般大學,1007,逢甲大學,博士班,秘魯共和國,中南美洲,1,1,0,1,1,0,0,0,0,0,0,0,0,0,0
108,私立,一般大學,1007,逢甲大學,博士班,馬來西亞,東協,5,4,1,5,4,1,0,0,0,0,0,0,0,0,0
108,私立,一般大學,1007,逢甲大學,博士班,菲律賓共和國,東協,1,1,0,1,1,0,0,0,0,0,0,0,0,0,0
108,私立,一般大學,1007,逢甲大學,博士班,越南社會主義共和國,東協,43,33,10,43,33,10,0,0,0,0,0,0,0,0,0
108,私立,一般大學,1008,靜宜大學,學士班(日間),大陸地區,大陸地區,182,91,91,0,0,0,0,0,0,0,0,0,182,91,91
108,私立,一般大學,1008,靜宜大學,學士班(日間),巴拉圭,中南美洲,1,0,1,0,0,0,1,0,1,0,0,0,0,0,0
108,私立,一般大學,1008,靜宜大學,學士班(日間),印度,南亞,1,1,0,1,1,0,0,0,0,0,0,0,0,0,0
108,私立,一般大學,1008,靜宜大學,學士班(日間),法國,歐洲,1,1,0,1,1,0,0,0,0,0,0,0,0,0,0
108,私立,一般大學,1008,靜宜大學,學士班(日間),香港,港澳,75,34,41,0,0,0,0,0,0,75,34,41,0,0,0
108,私立,一般大學,1008,靜宜大學,學士班(日間),秘魯共和國,中南美洲,1,1,0,1,1,0,0,0,0,0,0,0,0,0,0
108,私立,一般大學,1008,靜宜大學,學士班(日間),智利,中南美洲,1,0,1,1,0,1,0,0,0,0,0,0,0,0,0
108,私立,一般大學,1008,靜宜大學,學士班(日間),越南社會主義共和國,東協,33,7,26,31,7,24,2,0,2,0,0,0,0,0,0
108,私立,一般大學,1008,靜宜大學,學士班(日間),葡萄牙共和國,歐洲,1,1,0,1,1,0,0,0,0,0,0,0,0,0,0
108,私立,一般大學,1008,靜宜大學,學士班(日間),蒙古國,其他亞洲地區,5,0,5,5,0,5,0,0,0,0,0,0,0,0,0
108,私立,一般大學,1008,靜宜大學,學士班(日間),德意志聯邦共和國,歐洲,1,1,0,1,1,0,0,0,0,0,0,0,0,0,0
108,私立,一般大學,1008,靜宜大學,學士班(日間),澳門,港澳,29,11,18,0,0,0,0,0,0,29,11,18,0,0,0
108,私立,一般大學,1008,靜宜大學,學士班(日間),大韓民國(南韓),其他亞洲地區,4,1,3,4,1,3,0,0,0,0,0,0,0,0,0
108,私立,一般大學,1008,靜宜大學,學士班(日間),日本,其他亞洲地區,54,18,36,54,18,36,0,0,0,0,0,0,0,0,0
108,私立,一般大學,1008,靜宜大學,學士班(日間),史瓦帝尼王國,非洲,4,0,4,4,0,4,0,0,0,0,0,0,0,0,0
108,私立,一般大學,1008,靜宜大學,學士班(日間),印度尼西亞共和國,東協,15,2,13,8,1,7,7,1,6,0,0,0,0,0,0
108,私立,一般大學,1008,靜宜大學,學士班(日間),吉里巴斯共和國,其他亞洲地區,1,1,0,1,1,0,0,0,0,0,0,0,0,0,0
108,私立,一般大學,1008,靜宜大學,學士班(日間),肯亞共和國,非洲,1,0,1,1,0,1,0,0,0,0,0,0,0,0,0
108,私立,一般大學,1008,靜宜大學,學士班(日間),保加利亞共和國,歐洲,1,0,1,1,0,1,0,0,0,0,0,0,0,0,0
108,私立,一般大學,1008,靜宜大學,學士班(日間),俄羅斯聯邦,其他亞洲地區,3,2,1,3,2,1,0,0,0,0,0,0,0,0,0
108,私立,一般大學,1008,靜宜大學,學士班(日間),美國,北美洲,2,1,1,2,1,1,0,0,0,0,0,0,0,0,0
108,私立,一般大學,1008,靜宜大學,學士班(日間),泰國,東協,5,2,3,4,2,2,1,0,1,0,0,0,0,0,0
108,私立,一般大學,1008,靜宜大學,學士班(日間),馬來西亞,東協,128,66,62,92,51,41,36,15,21,0,0,0,0,0,0
108,私立,一般大學,1008,靜宜大學,學士班(日間),菲律賓共和國,東協,1,0,1,0,0,0,1,0,1,0,0,0,0,0,0
108,私立,一般大學,1008,靜宜大學,學士班(日間),墨西哥合眾國,中南美洲,1,1,0,1,1,0,0,0,0,0,0,0,0,0,0
108,私立,一般大學,1008,靜宜大學,碩士班(日間),大韓民國(南韓),其他亞洲地區,2,0,2,2,0,2,0,0,0,0,0,0,0,0,0
108,私立,一般大學,1008,靜宜大學,碩士班(日間),日本,其他亞洲地區,5,2,3,5,2,3,0,0,0,0,0,0,0,0,0
108,私立,一般大學,1008,靜宜大學,碩士班(日間),布吉納法索,非洲,1,0,1,1,0,1,0,0,0,0,0,0,0,0,0
108,私立,一般大學,1008,靜宜大學,碩士班(日間),印度尼西亞共和國,東協,15,8,7,15,8,7,0,0,0,0,0,0,0,0,0
108,私立,一般大學,1008,靜宜大學,碩士班(日間),西班牙王國,歐洲,2,1,1,2,1,1,0,0,0,0,0,0,0,0,0
108,私立,一般大學,1008,靜宜大學,碩士班(日間),法國,歐洲,5,2,3,5,2,3,0,0,0,0,0,0,0,0,0
108,私立,一般大學,1008,靜宜大學,碩士班(日間),俄羅斯聯邦,其他亞洲地區,2,1,1,2,1,1,0,0,0,0,0,0,0,0,0
108,私立,一般大學,1008,靜宜大學,碩士班(日間),美國,北美洲,1,1,0,1,1,0,0,0,0,0,0,0,0,0,0
108,私立,一般大學,1008,靜宜大學,碩士班(日間),埃及阿拉伯共和國,非洲,1,1,0,1,1,0,0,0,0,0,0,0,0,0,0
108,私立,一般大學,1008,靜宜大學,碩士班(日間),泰國,東協,4,1,3,4,1,3,0,0,0,0,0,0,0,0,0
108,私立,一般大學,1008,靜宜大學,碩士班(日間),馬來西亞,東協,2,1,1,1,1,0,1,0,1,0,0,0,0,0,0
108,私立,一般大學,1008,靜宜大學,碩士班(日間),菲律賓共和國,東協,3,1,2,3,1,2,0,0,0,0,0,0,0,0,0
108,私立,一般大學,1008,靜宜大學,碩士班(日間),奧地利共和國,歐洲,4,3,1,4,3,1,0,0,0,0,0,0,0,0,0
108,私立,一般大學,1008,靜宜大學,碩士班(日間),蒙古國,其他亞洲地區,3,1,2,3,1,2,0,0,0,0,0,0,0,0,0
108,私立,一般大學,1008,靜宜大學,碩士班(日間),墨西哥合眾國,中南美洲,4,1,3,4,1,3,0,0,0,0,0,0,0,0,0
108,私立,一般大學,1008,靜宜大學,碩士班(日間),土耳其共和國,其他亞洲地區,1,1,0,1,1,0,0,0,0,0,0,0,0,0,0
108,私立,一般大學,1008,靜宜大學,碩士班(日間),大陸地區,大陸地區,12,4,8,0,0,0,0,0,0,0,0,0,12,4,8
108,私立,一般大學,1008,靜宜大學,碩士班(日間),比利時王國,歐洲,1,1,0,1,1,0,0,0,0,0,0,0,0,0,0
108,私立,一般大學,1008,靜宜大學,碩士班(日間),立陶宛共和國,歐洲,1,0,1,1,0,1,0,0,0,0,0,0,0,0,0
108,私立,一般大學,1008,靜宜大學,碩士班(日間),匈牙利共和國,歐洲,1,1,0,1,1,0,0,0,0,0,0,0,0,0,0
108,私立,一般大學,1008,靜宜大學,碩士班(日間),印度,南亞,1,1,0,1,1,0,0,0,0,0,0,0,0,0,0
108,私立,一般大學,1008,靜宜大學,碩士班(日間),香港,港澳,2,1,1,0,0,0,0,0,0,2,1,1,0,0,0
108,私立,一般大學,1008,靜宜大學,碩士班(日間),智利,中南美洲,1,0,1,0,0,0,1,0,1,0,0,0,0,0,0
108,私立,一般大學,1008,靜宜大學,碩士班(日間),越南社會主義共和國,東協,15,3,12,15,3,12,0,0,0,0,0,0,0,0,0
108,私立,一般大學,1008,靜宜大學,碩士班(日間),德意志聯邦共和國,歐洲,2,1,1,2,1,1,0,0,0,0,0,0,0,0,0
108,私立,一般大學,1008,靜宜大學,碩士班(日間),澳門,港澳,1,0,1,0,0,0,0,0,0,1,0,1,0,0,0
108,私立,一般大學,1008,靜宜大學,博士班,日本,其他亞洲地區,1,0,1,1,0,1,0,0,0,0,0,0,0,0,0
108,私立,一般大學,1008,靜宜大學,博士班,印度尼西亞共和國,東協,2,1,1,2,1,1,0,0,0,0,0,0,0,0,0
108,私立,一般大學,1008,靜宜大學,博士班,馬來西亞,東協,1,0,1,1,0,1,0,0,0,0,0,0,0,0,0
108,私立,一般大學,1009,長庚大學,學士班(日間),美國,北美洲,4,4,0,0,0,0,4,4,0,0,0,0,0,0,0
108,私立,一般大學,1009,長庚大學,學士班(日間),越南社會主義共和國,東協,3,1,2,0,0,0,3,1,2,0,0,0,0,0,0
108,私立,一般大學,1009,長庚大學,學士班(日間),大陸地區,大陸地區,60,33,27,0,0,0,0,0,0,0,0,0,60,33,27
108,私立,一般大學,1009,長庚大學,學士班(日間),大韓民國(南韓),其他亞洲地區,7,5,2,3,3,0,4,2,2,0,0,0,0,0,0
108,私立,一般大學,1009,長庚大學,學士班(日間),日本,其他亞洲地區,3,2,1,0,0,0,3,2,1,0,0,0,0,0,0
108,私立,一般大學,1009,長庚大學,學士班(日間),加拿大,北美洲,2,2,0,0,0,0,2,2,0,0,0,0,0,0,0
108,私立,一般大學,1009,長庚大學,學士班(日間),印度尼西亞共和國,東協,1,0,1,0,0,0,1,0,1,0,0,0,0,0,0
108,私立,一般大學,1009,長庚大學,學士班(日間),香港,港澳,35,21,14,0,0,0,0,0,0,35,21,14,0,0,0
108,私立,一般大學,1009,長庚大學,學士班(日間),馬來西亞,東協,43,15,28,0,0,0,43,15,28,0,0,0,0,0,0
108,私立,一般大學,1009,長庚大學,學士班(日間),新加坡共和國,東協,3,1,2,0,0,0,3,1,2,0,0,0,0,0,0
108,私立,一般大學,1009,長庚大學,學士班(日間),葡萄牙共和國,歐洲,1,1,0,1,1,0,0,0,0,0,0,0,0,0,0
108,私立,一般大學,1009,長庚大學,學士班(日間),緬甸,東協,2,0,2,0,0,0,2,0,2,0,0,0,0,0,0
108,私立,一般大學,1009,長庚大學,學士班(日間),澳門,港澳,32,13,19,0,0,0,0,0,0,32,13,19,0,0,0
108,私立,一般大學,1009,長庚大學,碩士班(日間),大陸地區,大陸地區,5,5,0,0,0,0,0,0,0,0,0,0,5,5,0
108,私立,一般大學,1009,長庚大學,碩士班(日間),大韓民國(南韓),其他亞洲地區,1,1,0,1,1,0,0,0,0,0,0,0,0,0,0
108,私立,一般大學,1009,長庚大學,碩士班(日間),日本,其他亞洲地區,2,2,0,2,2,0,0,0,0,0,0,0,0,0,0
108,私立,一般大學,1009,長庚大學,碩士班(日間),以色列,其他亞洲地區,1,1,0,1,1,0,0,0,0,0,0,0,0,0,0
108,私立,一般大學,1009,長庚大學,碩士班(日間),印度,南亞,12,11,1,12,11,1,0,0,0,0,0,0,0,0,0
108,私立,一般大學,1009,長庚大學,碩士班(日間),沙烏地阿拉伯王國,其他亞洲地區,1,0,1,1,0,1,0,0,0,0,0,0,0,0,0
108,私立,一般大學,1009,長庚大學,碩士班(日間),英國,歐洲,1,1,0,1,1,0,0,0,0,0,0,0,0,0,0
108,私立,一般大學,1009,長庚大學,碩士班(日間),香港,港澳,1,1,0,0,0,0,0,0,0,1,1,0,0,0,0
108,私立,一般大學,1009,長庚大學,碩士班(日間),秘魯共和國,中南美洲,2,2,0,2,2,0,0,0,0,0,0,0,0,0,0
108,私立,一般大學,1009,長庚大學,碩士班(日間),馬來西亞,東協,5,2,3,1,0,1,4,2,2,0,0,0,0,0,0
108,私立,一般大學,1009,長庚大學,碩士班(日間),菲律賓共和國,東協,1,0,1,1,0,1,0,0,0,0,0,0,0,0,0
108,私立,一般大學,1009,長庚大學,碩士班(日間),新加坡共和國,東協,5,5,0,5,5,0,0,0,0,0,0,0,0,0,0
108,私立,一般大學,1009,長庚大學,碩士班(日間),義大利共和國,歐洲,1,1,0,1,1,0,0,0,0,0,0,0,0,0,0
108,私立,一般大學,1009,長庚大學,碩士班(日間),緬甸,東協,1,1,0,1,1,0,0,0,0,0,0,0,0,0,0
108,私立,一般大學,1009,長庚大學,碩士班(日間),土耳其共和國,其他亞洲地區,1,1,0,1,1,0,0,0,0,0,0,0,0,0,0
108,私立,一般大學,1009,長庚大學,碩士班(日間),甘比亞共和國,非洲,3,3,0,3,3,0,0,0,0,0,0,0,0,0,0
108,私立,一般大學,1009,長庚大學,碩士班(日間),印度尼西亞共和國,東協,5,3,2,5,3,2,0,0,0,0,0,0,0,0,0
108,私立,一般大學,1009,長庚大學,碩士班(日間),波蘭共和國,歐洲,1,0,1,1,0,1,0,0,0,0,0,0,0,0,0
108,私立,一般大學,1009,長庚大學,碩士班(日間),阿根廷,中南美洲,2,2,0,2,2,0,0,0,0,0,0,0,0,0,0
108,私立,一般大學,1009,長庚大學,碩士班(日間),美國,北美洲,2,2,0,2,2,0,0,0,0,0,0,0,0,0,0
108,私立,一般大學,1009,長庚大學,碩士班(日間),泰國,東協,16,5,11,15,4,11,1,1,0,0,0,0,0,0,0
108,私立,一般大學,1009,長庚大學,碩士班(日間),烏干達共和國,非洲,1,0,1,1,0,1,0,0,0,0,0,0,0,0,0
108,私立,一般大學,1009,長庚大學,碩士班(日間),越南社會主義共和國,東協,18,6,12,18,6,12,0,0,0,0,0,0,0,0,0
108,私立,一般大學,1009,長庚大學,碩士班(日間),德意志聯邦共和國,歐洲,1,1,0,1,1,0,0,0,0,0,0,0,0,0,0
108,私立,一般大學,1009,長庚大學,碩士班(日間),墨西哥合眾國,中南美洲,1,0,1,1,0,1,0,0,0,0,0,0,0,0,0
108,私立,一般大學,1009,長庚大學,碩士班(日間),澳門,港澳,3,3,0,0,0,0,0,0,0,3,3,0,0,0,0
108,私立,一般大學,1009,長庚大學,博士班,大韓民國(南韓),其他亞洲地區,1,0,1,1,0,1,0,0,0,0,0,0,0,0,0
108,私立,一般大學,1009,長庚大學,博士班,巴基斯坦,南亞,2,2,0,2,2,0,0,0,0,0,0,0,0,0,0
108,私立,一般大學,1009,長庚大學,博士班,奈及利亞聯邦共和國,非洲,1,1,0,1,1,0,0,0,0,0,0,0,0,0,0
108,私立,一般大學,1009,長庚大學,博士班,阿根廷,中南美洲,1,1,0,0,0,0,1,1,0,0,0,0,0,0,0
108,私立,一般大學,1009,長庚大學,博士班,馬來西亞,東協,4,1,3,1,0,1,3,1,2,0,0,0,0,0,0
108,私立,一般大學,1009,長庚大學,博士班,越南社會主義共和國,東協,16,5,11,16,5,11,0,0,0,0,0,0,0,0,0
108,私立,一般大學,1009,長庚大學,博士班,澳門,港澳,1,1,0,0,0,0,0,0,0,1,1,0,0,0,0
108,私立,一般大學,1009,長庚大學,博士班,大陸地區,大陸地區,7,6,1,0,0,0,0,0,0,0,0,0,7,6,1
108,私立,一般大學,1009,長庚大學,博士班,甘比亞共和國,非洲,1,1,0,1,1,0,0,0,0,0,0,0,0,0,0
108,私立,一般大學,1009,長庚大學,博士班,印度,南亞,37,27,10,37,27,10,0,0,0,0,0,0,0,0,0
108,私立,一般大學,1009,長庚大學,博士班,印度尼西亞共和國,東協,9,5,4,9,5,4,0,0,0,0,0,0,0,0,0
108,私立,一般大學,1009,長庚大學,博士班,沙烏地阿拉伯王國,其他亞洲地區,1,0,1,0,0,0,1,0,1,0,0,0,0,0,0
108,私立,一般大學,1009,長庚大學,博士班,美國,北美洲,1,1,0,1,1,0,0,0,0,0,0,0,0,0,0
108,私立,一般大學,1010,元智大學,學士班(日間),日本,其他亞洲地區,12,6,6,11,6,5,1,0,1,0,0,0,0,0,0
108,私立,一般大學,1010,元智大學,學士班(日間),史瓦帝尼王國,非洲,17,5,12,17,5,12,0,0,0,0,0,0,0,0,0
108,私立,一般大學,1010,元智大學,學士班(日間),甘比亞共和國,非洲,11,9,2,11,9,2,0,0,0,0,0,0,0,0,0
108,私立,一般大學,1010,元智大學,學士班(日間),印度尼西亞共和國,東協,9,4,5,7,3,4,2,1,1,0,0,0,0,0,0
108,私立,一般大學,1010,元智大學,學士班(日間),波蘭共和國,歐洲,1,1,0,1,1,0,0,0,0,0,0,0,0,0,0
108,私立,一般大學,1010,元智大學,學士班(日間),法國,歐洲,1,1,0,1,1,0,0,0,0,0,0,0,0,0,0
108,私立,一般大學,1010,元智大學,學士班(日間),突尼西亞共和國,非洲,1,1,0,1,1,0,0,0,0,0,0,0,0,0,0
108,私立,一般大學,1010,元智大學,學士班(日間),美國,北美洲,2,1,1,0,0,0,2,1,1,0,0,0,0,0,0
108,私立,一般大學,1010,元智大學,學士班(日間),香港,港澳,75,46,29,0,0,0,0,0,0,75,46,29,0,0,0
108,私立,一般大學,1010,元智大學,學士班(日間),泰國,東協,2,0,2,2,0,2,0,0,0,0,0,0,0,0,0
108,私立,一般大學,1010,元智大學,學士班(日間),塔吉克共和國,其他亞洲地區,3,3,0,3,3,0,0,0,0,0,0,0,0,0,0
108,私立,一般大學,1010,元智大學,學士班(日間),德意志聯邦共和國,歐洲,3,0,3,3,0,3,0,0,0,0,0,0,0,0,0
108,私立,一般大學,1010,元智大學,學士班(日間),墨西哥合眾國,中南美洲,1,0,1,1,0,1,0,0,0,0,0,0,0,0,0
108,私立,一般大學,1010,元智大學,學士班(日間),土耳其共和國,其他亞洲地區,1,1,0,1,1,0,0,0,0,0,0,0,0,0,0
108,私立,一般大學,1010,元智大學,學士班(日間),大陸地區,大陸地區,120,64,56,0,0,0,0,0,0,0,0,0,120,64,56
108,私立,一般大學,1010,元智大學,學士班(日間),大韓民國(南韓),其他亞洲地區,2,0,2,2,0,2,0,0,0,0,0,0,0,0,0
108,私立,一般大學,1010,元智大學,學士班(日間),瓜地馬拉共和國,中南美洲,1,1,0,1,1,0,0,0,0,0,0,0,0,0,0
108,私立,一般大學,1010,元智大學,學士班(日間),印度,南亞,1,1,0,1,1,0,0,0,0,0,0,0,0,0,0
108,私立,一般大學,1010,元智大學,學士班(日間),吉里巴斯共和國,其他亞洲地區,1,0,1,1,0,1,0,0,0,0,0,0,0,0,0
108,私立,一般大學,1010,元智大學,學士班(日間),吉爾吉斯,其他亞洲地區,4,3,1,4,3,1,0,0,0,0,0,0,0,0,0
108,私立,一般大學,1010,元智大學,學士班(日間),宏都拉斯共和國,中南美洲,1,0,1,1,0,1,0,0,0,0,0,0,0,0,0
108,私立,一般大學,1010,元智大學,學士班(日間),英國,歐洲,2,1,1,2,1,1,0,0,0,0,0,0,0,0,0
108,私立,一般大學,1010,元智大學,學士班(日間),海地共和國,中南美洲,4,2,2,4,2,2,0,0,0,0,0,0,0,0,0
108,私立,一般大學,1010,元智大學,學士班(日間),秘魯共和國,中南美洲,1,0,1,1,0,1,0,0,0,0,0,0,0,0,0
108,私立,一般大學,1010,元智大學,學士班(日間),索羅門群島,其他亞洲地區,12,6,6,12,6,6,0,0,0,0,0,0,0,0,0
108,私立,一般大學,1010,元智大學,學士班(日間),馬來西亞,東協,28,11,17,15,4,11,13,7,6,0,0,0,0,0,0
108,私立,一般大學,1010,元智大學,學士班(日間),菲律賓共和國,東協,1,0,1,1,0,1,0,0,0,0,0,0,0,0,0
108,私立,一般大學,1010,元智大學,學士班(日間),越南社會主義共和國,東協,28,6,22,28,6,22,0,0,0,0,0,0,0,0,0
108,私立,一般大學,1010,元智大學,學士班(日間),聖文森(及格瑞那丁),中南美洲,2,1,1,2,1,1,0,0,0,0,0,0,0,0,0
108,私立,一般大學,1010,元智大學,學士班(日間),聖露西亞,中南美洲,6,5,1,6,5,1,0,0,0,0,0,0,0,0,0
108,私立,一般大學,1010,元智大學,學士班(日間),蒙古國,其他亞洲地區,8,2,6,8,2,6,0,0,0,0,0,0,0,0,0
108,私立,一般大學,1010,元智大學,學士班(日間),澳門,港澳,8,5,3,0,0,0,0,0,0,8,5,3,0,0,0
108,私立,一般大學,1010,元智大學,碩士班(日間),土耳其共和國,其他亞洲地區,1,1,0,1,1,0,0,0,0,0,0,0,0,0,0
108,私立,一般大學,1010,元智大學,碩士班(日間),土庫曼,其他亞洲地區,1,1,0,1,1,0,0,0,0,0,0,0,0,0,0
108,私立,一般大學,1010,元智大學,碩士班(日間),大陸地區,大陸地區,8,6,2,0,0,0,0,0,0,0,0,0,8,6,2
108,私立,一般大學,1010,元智大學,碩士班(日間),巴拉圭,中南美洲,1,1,0,1,1,0,0,0,0,0,0,0,0,0,0
108,私立,一般大學,1010,元智大學,碩士班(日間),巴基斯坦,南亞,5,5,0,5,5,0,0,0,0,0,0,0,0,0,0
108,私立,一般大學,1010,元智大學,碩士班(日間),尼加拉瓜,中南美洲,2,2,0,2,2,0,0,0,0,0,0,0,0,0,0
108,私立,一般大學,1010,元智大學,碩士班(日間),尼泊爾聯邦民主共和國,南亞,1,1,0,1,1,0,0,0,0,0,0,0,0,0,0
108,私立,一般大學,1010,元智大學,碩士班(日間),瓜地馬拉共和國,中南美洲,2,2,0,2,2,0,0,0,0,0,0,0,0,0,0
108,私立,一般大學,1010,元智大學,碩士班(日間),印度,南亞,9,7,2,9,7,2,0,0,0,0,0,0,0,0,0
108,私立,一般大學,1010,元智大學,碩士班(日間),宏都拉斯共和國,中南美洲,7,6,1,7,6,1,0,0,0,0,0,0,0,0,0
108,私立,一般大學,1010,元智大學,碩士班(日間),俄羅斯聯邦,其他亞洲地區,2,1,1,2,1,1,0,0,0,0,0,0,0,0,0
108,私立,一般大學,1010,元智大學,碩士班(日間),美國,北美洲,2,2,0,2,2,0,0,0,0,0,0,0,0,0,0
108,私立,一般大學,1010,元智大學,碩士班(日間),哥倫比亞共和國,中南美洲,1,1,0,1,1,0,0,0,0,0,0,0,0,0,0
108,私立,一般大學,1010,元智大學,碩士班(日間),埃及阿拉伯共和國,非洲,1,0,1,1,0,1,0,0,0,0,0,0,0,0,0
108,私立,一般大學,1010,元智大學,碩士班(日間),海地共和國,中南美洲,3,2,1,3,2,1,0,0,0,0,0,0,0,0,0
108,私立,一般大學,1010,元智大學,碩士班(日間),秘魯共和國,中南美洲,1,0,1,1,0,1,0,0,0,0,0,0,0,0,0
108,私立,一般大學,1010,元智大學,碩士班(日間),索羅門群島,其他亞洲地區,1,1,0,1,1,0,0,0,0,0,0,0,0,0,0
108,私立,一般大學,1010,元智大學,碩士班(日間),馬來西亞,東協,15,5,10,13,5,8,2,0,2,0,0,0,0,0,0
108,私立,一般大學,1010,元智大學,碩士班(日間),菲律賓共和國,東協,1,0,1,1,0,1,0,0,0,0,0,0,0,0,0
108,私立,一般大學,1010,元智大學,碩士班(日間),越南社會主義共和國,東協,46,17,29,45,17,28,1,0,1,0,0,0,0,0,0
108,私立,一般大學,1010,元智大學,碩士班(日間),聖克里斯多福及尼維斯,中南美洲,1,1,0,1,1,0,0,0,0,0,0,0,0,0,0
108,私立,一般大學,1010,元智大學,碩士班(日間),聖露西亞,中南美洲,2,2,0,2,2,0,0,0,0,0,0,0,0,0,0
108,私立,一般大學,1010,元智大學,碩士班(日間),蒙古國,其他亞洲地區,5,1,4,5,1,4,0,0,0,0,0,0,0,0,0
108,私立,一般大學,1010,元智大學,碩士班(日間),德意志聯邦共和國,歐洲,1,0,1,1,0,1,0,0,0,0,0,0,0,0,0
108,私立,一般大學,1010,元智大學,碩士班(日間),薩爾瓦多,中南美洲,1,1,0,1,1,0,0,0,0,0,0,0,0,0,0
108,私立,一般大學,1010,元智大學,碩士班(日間),史瓦帝尼王國,非洲,4,2,2,4,2,2,0,0,0,0,0,0,0,0,0
108,私立,一般大學,1010,元智大學,碩士班(日間),甘比亞共和國,非洲,9,6,3,9,6,3,0,0,0,0,0,0,0,0,0
108,私立,一般大學,1010,元智大學,碩士班(日間),印度尼西亞共和國,東協,25,11,14,25,11,14,0,0,0,0,0,0,0,0,0
108,私立,一般大學,1010,元智大學,碩士班(日間),吉布地共和國,非洲,1,1,0,1,1,0,0,0,0,0,0,0,0,0,0
108,私立,一般大學,1010,元智大學,碩士班(日間),香港,港澳,7,6,1,0,0,0,0,0,0,7,6,1,0,0,0
108,私立,一般大學,1010,元智大學,碩士班(日間),泰國,東協,6,2,4,6,2,4,0,0,0,0,0,0,0,0,0
108,私立,一般大學,1010,元智大學,碩士班(日間),墨西哥合眾國,中南美洲,1,1,0,1,1,0,0,0,0,0,0,0,0,0,0
108,私立,一般大學,1010,元智大學,博士班,大陸地區,大陸地區,16,9,7,0,0,0,0,0,0,0,0,0,16,9,7
108,私立,一般大學,1010,元智大學,博士班,史瓦帝尼王國,非洲,5,4,1,5,4,1,0,0,0,0,0,0,0,0,0
108,私立,一般大學,1010,元智大學,博士班,瓜地馬拉共和國,中南美洲,2,2,0,2,2,0,0,0,0,0,0,0,0,0,0
108,私立,一般大學,1010,元智大學,博士班,印度尼西亞共和國,東協,16,12,4,16,12,4,0,0,0,0,0,0,0,0,0
108,私立,一般大學,1010,元智大學,博士班,貝里斯,中南美洲,1,1,0,1,1,0,0,0,0,0,0,0,0,0,0
108,私立,一般大學,1010,元智大學,博士班,孟加拉人民共和國,南亞,1,1,0,1,1,0,0,0,0,0,0,0,0,0,0
108,私立,一般大學,1010,元智大學,博士班,泰國,東協,3,0,3,3,0,3,0,0,0,0,0,0,0,0,0
108,私立,一般大學,1010,元智大學,博士班,海地共和國,中南美洲,3,3,0,3,3,0,0,0,0,0,0,0,0,0,0
108,私立,一般大學,1010,元智大學,博士班,索羅門群島,其他亞洲地區,1,1,0,1,1,0,0,0,0,0,0,0,0,0,0
108,私立,一般大學,1010,元智大學,博士班,菲律賓共和國,東協,1,0,1,1,0,1,0,0,0,0,0,0,0,0,0
108,私立,一般大學,1010,元智大學,博士班,越南社會主義共和國,東協,23,8,15,23,8,15,0,0,0,0,0,0,0,0,0
108,私立,一般大學,1010,元智大學,博士班,巴基斯坦,南亞,1,1,0,1,1,0,0,0,0,0,0,0,0,0,0
108,私立,一般大學,1010,元智大學,博士班,尼泊爾聯邦民主共和國,南亞,1,1,0,1,1,0,0,0,0,0,0,0,0,0,0
108,私立,一般大學,1010,元智大學,博士班,甘比亞共和國,非洲,2,2,0,2,2,0,0,0,0,0,0,0,0,0,0
108,私立,一般大學,1010,元智大學,博士班,印度,南亞,12,10,2,12,10,2,0,0,0,0,0,0,0,0,0
108,私立,一般大學,1010,元智大學,博士班,宏都拉斯共和國,中南美洲,4,2,2,4,2,2,0,0,0,0,0,0,0,0,0
108,私立,一般大學,1010,元智大學,博士班,俄羅斯聯邦,其他亞洲地區,2,1,1,2,1,1,0,0,0,0,0,0,0,0,0
108,私立,一般大學,1010,元智大學,博士班,美國,北美洲,1,1,0,1,1,0,0,0,0,0,0,0,0,0,0
108,私立,一般大學,1010,元智大學,博士班,蓋亞那共和國,中南美洲,1,0,1,1,0,1,0,0,0,0,0,0,0,0,0
108,私立,一般大學,1011,中華大學學校財團法人中華大學,學士班(日間),俄羅斯聯邦,其他亞洲地區,1,1,0,1,1,0,0,0,0,0,0,0,0,0,0
108,私立,一般大學,1011,中華大學學校財團法人中華大學,學士班(日間),馬來西亞,東協,79,43,36,71,37,34,8,6,2,0,0,0,0,0,0
108,私立,一般大學,1011,中華大學學校財團法人中華大學,學士班(日間),菲律賓共和國,東協,69,34,35,69,34,35,0,0,0,0,0,0,0,0,0
108,私立,一般大學,1011,中華大學學校財團法人中華大學,學士班(日間),越南社會主義共和國,東協,29,14,15,28,14,14,1,0,1,0,0,0,0,0,0
108,私立,一般大學,1011,中華大學學校財團法人中華大學,學士班(日間),聖露西亞,中南美洲,1,1,0,1,1,0,0,0,0,0,0,0,0,0,0
108,私立,一般大學,1011,中華大學學校財團法人中華大學,學士班(日間),蒙古國,其他亞洲地區,16,10,6,16,10,6,0,0,0,0,0,0,0,0,0
108,私立,一般大學,1011,中華大學學校財團法人中華大學,學士班(日間),墨西哥合眾國,中南美洲,1,1,0,1,1,0,0,0,0,0,0,0,0,0,0
108,私立,一般大學,1011,中華大學學校財團法人中華大學,學士班(日間),大陸地區,大陸地區,11,10,1,0,0,0,0,0,0,0,0,0,11,10,1
108,私立,一般大學,1011,中華大學學校財團法人中華大學,學士班(日間),大韓民國(南韓),其他亞洲地區,2,0,2,2,0,2,0,0,0,0,0,0,0,0,0
108,私立,一般大學,1011,中華大學學校財團法人中華大學,學士班(日間),日本,其他亞洲地區,14,12,2,14,12,2,0,0,0,0,0,0,0,0,0
108,私立,一般大學,1011,中華大學學校財團法人中華大學,學士班(日間),印度尼西亞共和國,東協,4,2,2,3,1,2,1,1,0,0,0,0,0,0,0
108,私立,一般大學,1011,中華大學學校財團法人中華大學,學士班(日間),宏都拉斯共和國,中南美洲,1,1,0,1,1,0,0,0,0,0,0,0,0,0,0
108,私立,一般大學,1011,中華大學學校財團法人中華大學,學士班(日間),貝里斯,中南美洲,1,0,1,0,0,0,1,0,1,0,0,0,0,0,0
108,私立,一般大學,1011,中華大學學校財團法人中華大學,學士班(日間),南非共和國,非洲,1,0,1,1,0,1,0,0,0,0,0,0,0,0,0
108,私立,一般大學,1011,中華大學學校財團法人中華大學,學士班(日間),香港,港澳,4,4,0,0,0,0,0,0,0,4,4,0,0,0,0
108,私立,一般大學,1011,中華大學學校財團法人中華大學,學士班(日間),海地共和國,中南美洲,2,2,0,2,2,0,0,0,0,0,0,0,0,0,0
108,私立,一般大學,1011,中華大學學校財團法人中華大學,學士班(日間),秘魯共和國,中南美洲,1,0,1,1,0,1,0,0,0,0,0,0,0,0,0
108,私立,一般大學,1011,中華大學學校財團法人中華大學,學士班(日間),馬拉威共和國,非洲,4,2,2,4,2,2,0,0,0,0,0,0,0,0,0
108,私立,一般大學,1011,中華大學學校財團法人中華大學,學士班(日間),聖克里斯多福及尼維斯,中南美洲,1,0,1,1,0,1,0,0,0,0,0,0,0,0,0
108,私立,一般大學,1011,中華大學學校財團法人中華大學,學士班(日間),德意志聯邦共和國,歐洲,1,0,1,1,0,1,0,0,0,0,0,0,0,0,0
108,私立,一般大學,1011,中華大學學校財團法人中華大學,學士班(日間),澳門,港澳,4,3,1,0,0,0,0,0,0,4,3,1,0,0,0
108,私立,一般大學,1011,中華大學學校財團法人中華大學,碩士班(日間),大陸地區,大陸地區,1,1,0,0,0,0,0,0,0,0,0,0,1,1,0
108,私立,一般大學,1011,中華大學學校財團法人中華大學,碩士班(日間),印度,南亞,2,1,1,2,1,1,0,0,0,0,0,0,0,0,0
108,私立,一般大學,1011,中華大學學校財團法人中華大學,碩士班(日間),約旦哈什米王國,其他亞洲地區,1,1,0,1,1,0,0,0,0,0,0,0,0,0,0
108,私立,一般大學,1011,中華大學學校財團法人中華大學,碩士班(日間),土耳其共和國,其他亞洲地區,2,1,1,2,1,1,0,0,0,0,0,0,0,0,0
108,私立,一般大學,1011,中華大學學校財團法人中華大學,碩士班(日間),巴基斯坦,南亞,1,1,0,1,1,0,0,0,0,0,0,0,0,0,0
108,私立,一般大學,1011,中華大學學校財團法人中華大學,碩士班(日間),印度尼西亞共和國,東協,1,1,0,1,1,0,0,0,0,0,0,0,0,0,0
108,私立,一般大學,1011,中華大學學校財團法人中華大學,碩士班(日間),俄羅斯聯邦,其他亞洲地區,1,1,0,1,1,0,0,0,0,0,0,0,0,0,0
108,私立,一般大學,1011,中華大學學校財團法人中華大學,碩士班(日間),泰國,東協,8,2,6,8,2,6,0,0,0,0,0,0,0,0,0
108,私立,一般大學,1011,中華大學學校財團法人中華大學,碩士班(日間),馬來西亞,東協,3,1,2,3,1,2,0,0,0,0,0,0,0,0,0
108,私立,一般大學,1011,中華大學學校財團法人中華大學,碩士班(日間),菲律賓共和國,東協,5,2,3,5,2,3,0,0,0,0,0,0,0,0,0
108,私立,一般大學,1011,中華大學學校財團法人中華大學,碩士班(日間),越南社會主義共和國,東協,7,1,6,7,1,6,0,0,0,0,0,0,0,0,0
108,私立,一般大學,1011,中華大學學校財團法人中華大學,碩士班(日間),蒙古國,其他亞洲地區,15,4,11,15,4,11,0,0,0,0,0,0,0,0,0
108,私立,一般大學,1011,中華大學學校財團法人中華大學,博士班,巴基斯坦,南亞,1,1,0,1,1,0,0,0,0,0,0,0,0,0,0
108,私立,一般大學,1011,中華大學學校財團法人中華大學,博士班,約旦哈什米王國,其他亞洲地區,1,1,0,1,1,0,0,0,0,0,0,0,0,0,0
108,私立,一般大學,1011,中華大學學校財團法人中華大學,博士班,蒙古國,其他亞洲地區,1,0,1,1,0,1,0,0,0,0,0,0,0,0,0
108,私立,一般大學,1011,中華大學學校財團法人中華大學,博士班,大陸地區,大陸地區,11,5,6,0,0,0,0,0,0,0,0,0,11,5,6
108,私立,一般大學,1011,中華大學學校財團法人中華大學,博士班,印度尼西亞共和國,東協,1,1,0,1,1,0,0,0,0,0,0,0,0,0,0
108,私立,一般大學,1011,中華大學學校財團法人中華大學,博士班,泰國,東協,2,1,1,2,1,1,0,0,0,0,0,0,0,0,0
108,私立,一般大學,1012,大葉大學,學士班(日間),大陸地區,大陸地區,30,18,12,0,0,0,0,0,0,0,0,0,30,18,12
108,私立,一般大學,1012,大葉大學,學士班(日間),印度尼西亞共和國,東協,13,4,9,10,3,7,3,1,2,0,0,0,0,0,0
108,私立,一般大學,1012,大葉大學,學士班(日間),香港,港澳,224,114,110,0,0,0,0,0,0,224,114,110,0,0,0
108,私立,一般大學,1012,大葉大學,學士班(日間),越南社會主義共和國,東協,15,8,7,15,8,7,0,0,0,0,0,0,0,0,0
108,私立,一般大學,1012,大葉大學,學士班(日間),澳門,港澳,12,8,4,0,0,0,0,0,0,12,8,4,0,0,0
108,私立,一般大學,1012,大葉大學,學士班(日間),日本,其他亞洲地區,13,5,8,13,5,8,0,0,0,0,0,0,0,0,0
108,私立,一般大學,1012,大葉大學,學士班(日間),玻利維亞共和國,中南美洲,1,1,0,1,1,0,0,0,0,0,0,0,0,0,0
108,私立,一般大學,1012,大葉大學,學士班(日間),泰國,東協,1,0,1,1,0,1,0,0,0,0,0,0,0,0,0
108,私立,一般大學,1012,大葉大學,學士班(日間),馬來西亞,東協,139,69,70,113,61,52,26,8,18,0,0,0,0,0,0
108,私立,一般大學,1012,大葉大學,學士班(日間),蒙古國,其他亞洲地區,36,16,20,36,16,20,0,0,0,0,0,0,0,0,0
108,私立,一般大學,1012,大葉大學,碩士班(日間),馬來西亞,東協,1,1,0,1,1,0,0,0,0,0,0,0,0,0,0
108,私立,一般大學,1012,大葉大學,碩士班(日間),蒙古國,其他亞洲地區,86,24,62,86,24,62,0,0,0,0,0,0,0,0,0
108,私立,一般大學,1012,大葉大學,碩士班(日間),印度尼西亞共和國,東協,10,4,6,10,4,6,0,0,0,0,0,0,0,0,0
108,私立,一般大學,1012,大葉大學,碩士班(日間),香港,港澳,4,2,2,0,0,0,0,0,0,4,2,2,0,0,0
108,私立,一般大學,1012,大葉大學,碩士班(日間),越南社會主義共和國,東協,6,2,4,6,2,4,0,0,0,0,0,0,0,0,0
108,私立,一般大學,1012,大葉大學,碩士班(日間),緬甸,東協,1,1,0,0,0,0,1,1,0,0,0,0,0,0,0
108,私立,一般大學,1012,大葉大學,碩士班(日間),澳門,港澳,1,0,1,0,0,0,0,0,0,1,0,1,0,0,0
108,私立,一般大學,1012,大葉大學,博士班,泰國,東協,1,1,0,1,1,0,0,0,0,0,0,0,0,0,0
108,私立,一般大學,1012,大葉大學,博士班,越南社會主義共和國,東協,9,3,6,9,3,6,0,0,0,0,0,0,0,0,0
108,私立,一般大學,1012,大葉大學,博士班,印度,南亞,2,1,1,2,1,1,0,0,0,0,0,0,0,0,0
108,私立,一般大學,1012,大葉大學,博士班,印度尼西亞共和國,東協,5,3,2,5,3,2,0,0,0,0,0,0,0,0,0
108,私立,一般大學,1012,大葉大學,博士班,馬來西亞,東協,1,0,1,1,0,1,0,0,0,0,0,0,0,0,0
108,私立,一般大學,1012,大葉大學,博士班,蒙古國,其他亞洲地區,5,3,2,5,3,2,0,0,0,0,0,0,0,0,0
108,私立,一般大學,1013,華梵大學,學士班(日間),大陸地區,大陸地區,8,3,5,0,0,0,0,0,0,0,0,0,8,3,5
108,私立,一般大學,1013,華梵大學,學士班(日間),香港,港澳,41,21,20,0,0,0,0,0,0,41,21,20,0,0,0
108,私立,一般大學,1013,華梵大學,學士班(日間),澳門,港澳,1,1,0,0,0,0,0,0,0,1,1,0,0,0,0
108,私立,一般大學,1013,華梵大學,學士班(日間),印度尼西亞共和國,東協,5,3,2,4,3,1,1,0,1,0,0,0,0,0,0
108,私立,一般大學,1013,華梵大學,學士班(日間),馬來西亞,東協,6,4,2,3,2,1,3,2,1,0,0,0,0,0,0
108,私立,一般大學,1013,華梵大學,學士班(日間),越南社會主義共和國,東協,3,1,2,3,1,2,0,0,0,0,0,0,0,0,0
108,私立,一般大學,1013,華梵大學,碩士班(日間),法國,歐洲,1,0,1,1,0,1,0,0,0,0,0,0,0,0,0
108,私立,一般大學,1013,華梵大學,碩士班(日間),泰國,東協,1,1,0,0,0,0,1,1,0,0,0,0,0,0,0
108,私立,一般大學,1013,華梵大學,碩士班(日間),馬來西亞,東協,1,0,1,1,0,1,0,0,0,0,0,0,0,0,0
108,私立,一般大學,1013,華梵大學,碩士班(日間),越南社會主義共和國,東協,7,1,6,7,1,6,0,0,0,0,0,0,0,0,0
108,私立,一般大學,1013,華梵大學,碩士班(日間),大陸地區,大陸地區,1,1,0,0,0,0,0,0,0,0,0,0,1,1,0
108,私立,一般大學,1013,華梵大學,碩士班(日間),香港,港澳,2,1,1,0,0,0,0,0,0,2,1,1,0,0,0
108,私立,一般大學,1013,華梵大學,博士班,加拿大,北美洲,1,1,0,1,1,0,0,0,0,0,0,0,0,0,0
108,私立,一般大學,1013,華梵大學,博士班,越南社會主義共和國,東協,3,2,1,3,2,1,0,0,0,0,0,0,0,0,0
108,私立,一般大學,1013,華梵大學,博士班,大陸地區,大陸地區,6,5,1,0,0,0,0,0,0,0,0,0,6,5,1
108,私立,一般大學,1013,華梵大學,博士班,斯里蘭卡民主社會主義共和國,南亞,2,2,0,2,2,0,0,0,0,0,0,0,0,0,0
108,私立,一般大學,1013,華梵大學,博士班,澳大利亞,其他亞洲地區,1,0,1,1,0,1,0,0,0,0,0,0,0,0,0
108,私立,一般大學,1014,義守大學,學士班(日間),大陸地區,大陸地區,61,31,30,0,0,0,0,0,0,0,0,0,61,31,30
108,私立,一般大學,1014,義守大學,學士班(日間),大韓民國(南韓),其他亞洲地區,4,2,2,0,0,0,4,2,2,0,0,0,0,0,0
108,私立,一般大學,1014,義守大學,學士班(日間),日本,其他亞洲地區,79,24,55,78,24,54,1,0,1,0,0,0,0,0,0
108,私立,一般大學,1014,義守大學,學士班(日間),加拿大,北美洲,1,1,0,1,1,0,0,0,0,0,0,0,0,0,0
108,私立,一般大學,1014,義守大學,學士班(日間),伊拉克共和國,其他亞洲地區,1,1,0,1,1,0,0,0,0,0,0,0,0,0,0
108,私立,一般大學,1014,義守大學,學士班(日間),印度尼西亞共和國,東協,174,77,97,164,74,90,10,3,7,0,0,0,0,0,0
108,私立,一般大學,1014,義守大學,學士班(日間),吉里巴斯共和國,其他亞洲地區,13,4,9,13,4,9,0,0,0,0,0,0,0,0,0
108,私立,一般大學,1014,義守大學,學士班(日間),宏都拉斯共和國,中南美洲,19,10,9,19,10,9,0,0,0,0,0,0,0,0,0
108,私立,一般大學,1014,義守大學,學士班(日間),俄羅斯聯邦,其他亞洲地區,1,1,0,1,1,0,0,0,0,0,0,0,0,0,0
108,私立,一般大學,1014,義守大學,學士班(日間),英國,歐洲,4,2,2,4,2,2,0,0,0,0,0,0,0,0,0
108,私立,一般大學,1014,義守大學,學士班(日間),香港,港澳,353,179,174,0,0,0,0,0,0,353,179,174,0,0,0
108,私立,一般大學,1014,義守大學,學士班(日間),秘魯共和國,中南美洲,1,0,1,1,0,1,0,0,0,0,0,0,0,0,0
108,私立,一般大學,1014,義守大學,學士班(日間),馬來西亞,東協,270,129,141,212,104,108,58,25,33,0,0,0,0,0,0
108,私立,一般大學,1014,義守大學,學士班(日間),馬拉威共和國,非洲,2,1,1,1,1,0,1,0,1,0,0,0,0,0,0
108,私立,一般大學,1014,義守大學,學士班(日間),菲律賓共和國,東協,4,4,0,4,4,0,0,0,0,0,0,0,0,0,0
108,私立,一般大學,1014,義守大學,學士班(日間),越南社會主義共和國,東協,81,32,49,78,31,47,3,1,2,0,0,0,0,0,0
108,私立,一般大學,1014,義守大學,學士班(日間),聖文森(及格瑞那丁),中南美洲,5,3,2,5,3,2,0,0,0,0,0,0,0,0,0
108,私立,一般大學,1014,義守大學,學士班(日間),聖克里斯多福及尼維斯,中南美洲,6,1,5,6,1,5,0,0,0,0,0,0,0,0,0
108,私立,一般大學,1014,義守大學,學士班(日間),葡萄牙共和國,歐洲,2,2,0,2,2,0,0,0,0,0,0,0,0,0,0
108,私立,一般大學,1014,義守大學,學士班(日間),澳門,港澳,110,55,55,0,0,0,0,0,0,110,55,55,0,0,0
108,私立,一般大學,1014,義守大學,學士班(日間),薩爾瓦多,中南美洲,1,1,0,1,1,0,0,0,0,0,0,0,0,0,0
108,私立,一般大學,1014,義守大學,學士班(日間),巴拉圭,中南美洲,3,1,2,3,1,2,0,0,0,0,0,0,0,0,0
108,私立,一般大學,1014,義守大學,學士班(日間),史瓦帝尼王國,非洲,54,15,39,54,15,39,0,0,0,0,0,0,0,0,0
108,私立,一般大學,1014,義守大學,學士班(日間),尼加拉瓜,中南美洲,1,0,1,1,0,1,0,0,0,0,0,0,0,0,0
108,私立,一般大學,1014,義守大學,學士班(日間),吉爾吉斯,其他亞洲地區,1,1,0,1,1,0,0,0,0,0,0,0,0,0,0
108,私立,一般大學,1014,義守大學,學士班(日間),吐瓦魯,其他亞洲地區,1,1,0,1,1,0,0,0,0,0,0,0,0,0,0
108,私立,一般大學,1014,義守大學,學士班(日間),貝里斯,中南美洲,14,7,7,14,7,7,0,0,0,0,0,0,0,0,0
108,私立,一般大學,1014,義守大學,學士班(日間),帛琉共和國,其他亞洲地區,2,2,0,2,2,0,0,0,0,0,0,0,0,0,0
108,私立,一般大學,1014,義守大學,學士班(日間),法國,歐洲,1,1,0,0,0,0,1,1,0,0,0,0,0,0,0
108,私立,一般大學,1014,義守大學,學士班(日間),美國,北美洲,6,5,1,5,4,1,1,1,0,0,0,0,0,0,0
108,私立,一般大學,1014,義守大學,學士班(日間),泰國,東協,13,6,7,13,6,7,0,0,0,0,0,0,0,0,0
108,私立,一般大學,1014,義守大學,學士班(日間),海地共和國,中南美洲,1,1,0,1,1,0,0,0,0,0,0,0,0,0,0
108,私立,一般大學,1014,義守大學,學士班(日間),烏茲別克共和國,其他亞洲地區,2,2,0,2,2,0,0,0,0,0,0,0,0,0,0
108,私立,一般大學,1014,義守大學,學士班(日間),索羅門群島,其他亞洲地區,16,10,6,16,10,6,0,0,0,0,0,0,0,0,0
108,私立,一般大學,1014,義守大學,學士班(日間),紐西蘭,其他亞洲地區,1,1,0,0,0,0,1,1,0,0,0,0,0,0,0
108,私立,一般大學,1014,義守大學,學士班(日間),馬紹爾群島共和國,其他亞洲地區,5,3,2,5,3,2,0,0,0,0,0,0,0,0,0
108,私立,一般大學,1014,義守大學,學士班(日間),聖露西亞,中南美洲,18,7,11,18,7,11,0,0,0,0,0,0,0,0,0
108,私立,一般大學,1014,義守大學,學士班(日間),蒙古國,其他亞洲地區,24,13,11,24,13,11,0,0,0,0,0,0,0,0,0
108,私立,一般大學,1014,義守大學,碩士班(日間),泰國,東協,5,0,5,5,0,5,0,0,0,0,0,0,0,0,0
108,私立,一般大學,1014,義守大學,碩士班(日間),烏茲別克共和國,其他亞洲地區,1,0,1,1,0,1,0,0,0,0,0,0,0,0,0
108,私立,一般大學,1014,義守大學,碩士班(日間),大陸地區,大陸地區,12,10,2,0,0,0,0,0,0,0,0,0,12,10,2
108,私立,一般大學,1014,義守大學,碩士班(日間),伊拉克共和國,其他亞洲地區,1,0,1,1,0,1,0,0,0,0,0,0,0,0,0
108,私立,一般大學,1014,義守大學,碩士班(日間),印度尼西亞共和國,東協,9,5,4,9,5,4,0,0,0,0,0,0,0,0,0
108,私立,一般大學,1014,義守大學,碩士班(日間),宏都拉斯共和國,中南美洲,2,1,1,2,1,1,0,0,0,0,0,0,0,0,0
108,私立,一般大學,1014,義守大學,碩士班(日間),香港,港澳,6,5,1,0,0,0,0,0,0,6,5,1,0,0,0
108,私立,一般大學,1014,義守大學,碩士班(日間),馬來西亞,東協,8,5,3,6,5,1,2,0,2,0,0,0,0,0,0
108,私立,一般大學,1014,義守大學,碩士班(日間),越南社會主義共和國,東協,62,19,43,62,19,43,0,0,0,0,0,0,0,0,0
108,私立,一般大學,1014,義守大學,碩士班(日間),蒙古國,其他亞洲地區,5,2,3,5,2,3,0,0,0,0,0,0,0,0,0
108,私立,一般大學,1014,義守大學,博士班,大陸地區,大陸地區,8,2,6,0,0,0,0,0,0,0,0,0,8,2,6
108,私立,一般大學,1014,義守大學,博士班,印度,南亞,1,1,0,1,1,0,0,0,0,0,0,0,0,0,0
108,私立,一般大學,1014,義守大學,博士班,印度尼西亞共和國,東協,2,1,1,2,1,1,0,0,0,0,0,0,0,0,0
108,私立,一般大學,1014,義守大學,博士班,越南社會主義共和國,東協,1,0,1,1,0,1,0,0,0,0,0,0,0,0,0
108,私立,一般大學,1014,義守大學,博士班,菲律賓共和國,東協,2,1,1,2,1,1,0,0,0,0,0,0,0,0,0
108,私立,一般大學,1015,世新大學,學士班(日間),大韓民國(南韓),其他亞洲地區,5,1,4,5,1,4,0,0,0,0,0,0,0,0,0
108,私立,一般大學,1015,世新大學,學士班(日間),奈及利亞聯邦共和國,非洲,3,2,1,3,2,1,0,0,0,0,0,0,0,0,0
108,私立,一般大學,1015,世新大學,學士班(日間),智利,中南美洲,1,1,0,1,1,0,0,0,0,0,0,0,0,0,0
108,私立,一般大學,1015,世新大學,學士班(日間),新加坡共和國,東協,7,1,6,7,1,6,0,0,0,0,0,0,0,0,0
108,私立,一般大學,1015,世新大學,學士班(日間),葡萄牙共和國,歐洲,1,1,0,1,1,0,0,0,0,0,0,0,0,0,0
108,私立,一般大學,1015,世新大學,學士班(日間),土耳其共和國,其他亞洲地區,1,1,0,1,1,0,0,0,0,0,0,0,0,0,0
108,私立,一般大學,1015,世新大學,學士班(日間),大陸地區,大陸地區,148,43,105,0,0,0,0,0,0,0,0,0,148,43,105
108,私立,一般大學,1015,世新大學,學士班(日間),巴拉圭,中南美洲,1,0,1,1,0,1,0,0,0,0,0,0,0,0,0
108,私立,一般大學,1015,世新大學,學士班(日間),日本,其他亞洲地區,29,11,18,26,8,18,3,3,0,0,0,0,0,0,0
108,私立,一般大學,1015,世新大學,學士班(日間),加拿大,北美洲,2,2,0,0,0,0,2,2,0,0,0,0,0,0,0
108,私立,一般大學,1015,世新大學,學士班(日間),印度尼西亞共和國,東協,17,7,10,1,0,1,16,7,9,0,0,0,0,0,0
108,私立,一般大學,1015,世新大學,學士班(日間),南非共和國,非洲,1,0,1,0,0,0,1,0,1,0,0,0,0,0,0
108,私立,一般大學,1015,世新大學,學士班(日間),香港,港澳,111,38,73,0,0,0,0,0,0,111,38,73,0,0,0
108,私立,一般大學,1015,世新大學,學士班(日間),馬來西亞,東協,244,78,166,107,36,71,137,42,95,0,0,0,0,0,0
108,私立,一般大學,1015,世新大學,學士班(日間),越南社會主義共和國,東協,11,4,7,4,3,1,7,1,6,0,0,0,0,0,0
108,私立,一般大學,1015,世新大學,學士班(日間),瑞士聯邦,歐洲,1,0,1,1,0,1,0,0,0,0,0,0,0,0,0
108,私立,一般大學,1015,世新大學,學士班(日間),緬甸,東協,2,0,2,1,0,1,1,0,1,0,0,0,0,0,0
108,私立,一般大學,1015,世新大學,學士班(日間),澳門,港澳,87,44,43,0,0,0,0,0,0,87,44,43,0,0,0
108,私立,一般大學,1015,世新大學,碩士班(日間),土耳其共和國,其他亞洲地區,1,1,0,1,1,0,0,0,0,0,0,0,0,0,0
108,私立,一般大學,1015,世新大學,碩士班(日間),大陸地區,大陸地區,58,17,41,0,0,0,0,0,0,0,0,0,58,17,41
108,私立,一般大學,1015,世新大學,碩士班(日間),大韓民國(南韓),其他亞洲地區,1,0,1,1,0,1,0,0,0,0,0,0,0,0,0
108,私立,一般大學,1015,世新大學,碩士班(日間),加拿大,北美洲,1,1,0,0,0,0,1,1,0,0,0,0,0,0,0
108,私立,一般大學,1015,世新大學,碩士班(日間),香港,港澳,6,4,2,0,0,0,0,0,0,6,4,2,0,0,0
108,私立,一般大學,1015,世新大學,碩士班(日間),馬來西亞,東協,10,5,5,6,4,2,4,1,3,0,0,0,0,0,0
108,私立,一般大學,1015,世新大學,碩士班(日間),菲律賓共和國,東協,1,1,0,1,1,0,0,0,0,0,0,0,0,0,0
108,私立,一般大學,1015,世新大學,碩士班(日間),越南社會主義共和國,東協,3,0,3,3,0,3,0,0,0,0,0,0,0,0,0
108,私立,一般大學,1015,世新大學,碩士班(日間),澳門,港澳,3,1,2,0,0,0,0,0,0,3,1,2,0,0,0
108,私立,一般大學,1015,世新大學,碩士班(日間),俄羅斯聯邦,其他亞洲地區,2,0,2,2,0,2,0,0,0,0,0,0,0,0,0
108,私立,一般大學,1015,世新大學,博士班,大陸地區,大陸地區,39,14,25,0,0,0,0,0,0,0,0,0,39,14,25
108,私立,一般大學,1016,銘傳大學,學士班(日間),巴拉圭,中南美洲,1,1,0,1,1,0,0,0,0,0,0,0,0,0,0
108,私立,一般大學,1016,銘傳大學,學士班(日間),巴勒斯坦,其他亞洲地區,1,1,0,1,1,0,0,0,0,0,0,0,0,0,0
108,私立,一般大學,1016,銘傳大學,學士班(日間),日本,其他亞洲地區,65,13,52,62,13,49,3,0,3,0,0,0,0,0,0
108,私立,一般大學,1016,銘傳大學,學士班(日間),史瓦帝尼王國,非洲,10,5,5,10,5,5,0,0,0,0,0,0,0,0,0
108,私立,一般大學,1016,銘傳大學,學士班(日間),尼加拉瓜,中南美洲,3,3,0,3,3,0,0,0,0,0,0,0,0,0,0
108,私立,一般大學,1016,銘傳大學,學士班(日間),吐瓦魯,其他亞洲地區,7,2,5,7,2,5,0,0,0,0,0,0,0,0,0
108,私立,一般大學,1016,銘傳大學,學士班(日間),貝里斯,中南美洲,9,4,5,9,4,5,0,0,0,0,0,0,0,0,0
108,私立,一般大學,1016,銘傳大學,學士班(日間),奈及利亞聯邦共和國,非洲,1,0,1,1,0,1,0,0,0,0,0,0,0,0,0
108,私立,一般大學,1016,銘傳大學,學士班(日間),法國,歐洲,4,3,1,4,3,1,0,0,0,0,0,0,0,0,0
108,私立,一般大學,1016,銘傳大學,學士班(日間),俄羅斯聯邦,其他亞洲地區,2,1,1,2,1,1,0,0,0,0,0,0,0,0,0
108,私立,一般大學,1016,銘傳大學,學士班(日間),美國,北美洲,15,14,1,14,13,1,1,1,0,0,0,0,0,0,0
108,私立,一般大學,1016,銘傳大學,學士班(日間),埃及阿拉伯共和國,非洲,1,1,0,1,1,0,0,0,0,0,0,0,0,0,0
108,私立,一般大學,1016,銘傳大學,學士班(日間),泰國,東協,40,19,21,34,16,18,6,3,3,0,0,0,0,0,0
108,私立,一般大學,1016,銘傳大學,學士班(日間),海地共和國,中南美洲,5,3,2,5,3,2,0,0,0,0,0,0,0,0,0
108,私立,一般大學,1016,銘傳大學,學士班(日間),索羅門群島,其他亞洲地區,2,2,0,2,2,0,0,0,0,0,0,0,0,0,0
108,私立,一般大學,1016,銘傳大學,學士班(日間),斯洛伐克共和國,歐洲,1,1,0,1,1,0,0,0,0,0,0,0,0,0,0
108,私立,一般大學,1016,銘傳大學,學士班(日間),越南社會主義共和國,東協,197,68,129,184,63,121,13,5,8,0,0,0,0,0,0
108,私立,一般大學,1016,銘傳大學,學士班(日間),瑞士聯邦,歐洲,1,1,0,1,1,0,0,0,0,0,0,0,0,0,0
108,私立,一般大學,1016,銘傳大學,學士班(日間),德意志聯邦共和國,歐洲,2,2,0,2,2,0,0,0,0,0,0,0,0,0,0
108,私立,一般大學,1016,銘傳大學,學士班(日間),緬甸,東協,4,3,1,1,0,1,3,3,0,0,0,0,0,0,0
108,私立,一般大學,1016,銘傳大學,學士班(日間),墨西哥合眾國,中南美洲,5,2,3,5,2,3,0,0,0,0,0,0,0,0,0
108,私立,一般大學,1016,銘傳大學,學士班(日間),土耳其共和國,其他亞洲地區,1,1,0,1,1,0,0,0,0,0,0,0,0,0,0
108,私立,一般大學,1016,銘傳大學,學士班(日間),大陸地區,大陸地區,311,123,188,0,0,0,0,0,0,0,0,0,311,123,188
108,私立,一般大學,1016,銘傳大學,學士班(日間),大韓民國(南韓),其他亞洲地區,14,7,7,12,5,7,2,2,0,0,0,0,0,0,0
108,私立,一般大學,1016,銘傳大學,學士班(日間),厄瓜多共和國,中南美洲,3,0,3,3,0,3,0,0,0,0,0,0,0,0,0
108,私立,一般大學,1016,銘傳大學,學士班(日間),巴布亞紐幾內亞獨立國,其他亞洲地區,11,5,6,11,5,6,0,0,0,0,0,0,0,0,0
108,私立,一般大學,1016,銘傳大學,學士班(日間),巴西聯邦共和國,中南美洲,3,2,1,3,2,1,0,0,0,0,0,0,0,0,0
108,私立,一般大學,1016,銘傳大學,學士班(日間),巴拿馬共和國,中南美洲,3,0,3,3,0,3,0,0,0,0,0,0,0,0,0
108,私立,一般大學,1016,銘傳大學,學士班(日間),加拿大,北美洲,3,1,2,1,1,0,2,0,2,0,0,0,0,0,0
108,私立,一般大學,1016,銘傳大學,學士班(日間),尼泊爾聯邦民主共和國,南亞,1,1,0,1,1,0,0,0,0,0,0,0,0,0,0
108,私立,一般大學,1016,銘傳大學,學士班(日間),布吉納法索,非洲,1,1,0,1,1,0,0,0,0,0,0,0,0,0,0
108,私立,一般大學,1016,銘傳大學,學士班(日間),瓜地馬拉共和國,中南美洲,8,4,4,8,4,4,0,0,0,0,0,0,0,0,0
108,私立,一般大學,1016,銘傳大學,學士班(日間),印度,南亞,6,3,3,6,3,3,0,0,0,0,0,0,0,0,0
108,私立,一般大學,1016,銘傳大學,學士班(日間),印度尼西亞共和國,東協,109,41,68,63,26,37,46,15,31,0,0,0,0,0,0
108,私立,一般大學,1016,銘傳大學,學士班(日間),多明尼加共和國,中南美洲,1,0,1,1,0,1,0,0,0,0,0,0,0,0,0
108,私立,一般大學,1016,銘傳大學,學士班(日間),宏都拉斯共和國,中南美洲,22,11,11,22,11,11,0,0,0,0,0,0,0,0,0
108,私立,一般大學,1016,銘傳大學,學士班(日間),帛琉共和國,其他亞洲地區,12,3,9,12,3,9,0,0,0,0,0,0,0,0,0
108,私立,一般大學,1016,銘傳大學,學士班(日間),拉脫維亞共和國,歐洲,1,0,1,1,0,1,0,0,0,0,0,0,0,0,0
108,私立,一般大學,1016,銘傳大學,學士班(日間),芬蘭共和國,歐洲,1,1,0,1,1,0,0,0,0,0,0,0,0,0,0
108,私立,一般大學,1016,銘傳大學,學士班(日間),南非共和國,非洲,5,2,3,5,2,3,0,0,0,0,0,0,0,0,0
108,私立,一般大學,1016,銘傳大學,學士班(日間),英國,歐洲,4,2,2,4,2,2,0,0,0,0,0,0,0,0,0
108,私立,一般大學,1016,銘傳大學,學士班(日間),香港,港澳,248,115,133,0,0,0,0,0,0,248,115,133,0,0,0
108,私立,一般大學,1016,銘傳大學,學士班(日間),秘魯共和國,中南美洲,2,0,2,2,0,2,0,0,0,0,0,0,0,0,0
108,私立,一般大學,1016,銘傳大學,學士班(日間),馬來西亞,東協,485,173,312,266,114,152,219,59,160,0,0,0,0,0,0
108,私立,一般大學,1016,銘傳大學,學士班(日間),馬紹爾群島共和國,其他亞洲地區,7,4,3,7,4,3,0,0,0,0,0,0,0,0,0
108,私立,一般大學,1016,銘傳大學,學士班(日間),馬達加斯加共和國,非洲,1,1,0,0,0,0,1,1,0,0,0,0,0,0,0
108,私立,一般大學,1016,銘傳大學,學士班(日間),荷蘭王國,歐洲,1,1,0,1,1,0,0,0,0,0,0,0,0,0,0
108,私立,一般大學,1016,銘傳大學,學士班(日間),菲律賓共和國,東協,5,2,3,4,1,3,1,1,0,0,0,0,0,0,0
108,私立,一般大學,1016,銘傳大學,學士班(日間),新加坡共和國,東協,1,0,1,1,0,1,0,0,0,0,0,0,0,0,0
108,私立,一般大學,1016,銘傳大學,學士班(日間),獅子山共和國,非洲,1,0,1,0,0,0,1,0,1,0,0,0,0,0,0
108,私立,一般大學,1016,銘傳大學,學士班(日間),聖文森(及格瑞那丁),中南美洲,7,2,5,7,2,5,0,0,0,0,0,0,0,0,0
108,私立,一般大學,1016,銘傳大學,學士班(日間),聖克里斯多福及尼維斯,中南美洲,6,4,2,6,4,2,0,0,0,0,0,0,0,0,0
108,私立,一般大學,1016,銘傳大學,學士班(日間),聖露西亞,中南美洲,4,0,4,4,0,4,0,0,0,0,0,0,0,0,0
108,私立,一般大學,1016,銘傳大學,學士班(日間),葡萄牙共和國,歐洲,2,2,0,0,0,0,2,2,0,0,0,0,0,0,0
108,私立,一般大學,1016,銘傳大學,學士班(日間),蒙古國,其他亞洲地區,14,7,7,14,7,7,0,0,0,0,0,0,0,0,0
108,私立,一般大學,1016,銘傳大學,學士班(日間),澳大利亞,其他亞洲地區,3,2,1,1,1,0,2,1,1,0,0,0,0,0,0
108,私立,一般大學,1016,銘傳大學,學士班(日間),澳門,港澳,124,52,72,0,0,0,0,0,0,124,52,72,0,0,0
108,私立,一般大學,1016,銘傳大學,學士班(日間),諾魯共和國,其他亞洲地區,3,2,1,3,2,1,0,0,0,0,0,0,0,0,0
108,私立,一般大學,1016,銘傳大學,學士班(日間),薩爾瓦多,中南美洲,11,5,6,11,5,6,0,0,0,0,0,0,0,0,0
108,私立,一般大學,1016,銘傳大學,碩士班(日間),大陸地區,大陸地區,34,17,17,0,0,0,0,0,0,0,0,0,34,17,17
108,私立,一般大學,1016,銘傳大學,碩士班(日間),尼加拉瓜,中南美洲,2,1,1,2,1,1,0,0,0,0,0,0,0,0,0
108,私立,一般大學,1016,銘傳大學,碩士班(日間),瓜地馬拉共和國,中南美洲,2,1,1,2,1,1,0,0,0,0,0,0,0,0,0
108,私立,一般大學,1016,銘傳大學,碩士班(日間),多明尼加共和國,中南美洲,2,1,1,2,1,1,0,0,0,0,0,0,0,0,0
108,私立,一般大學,1016,銘傳大學,碩士班(日間),宏都拉斯共和國,中南美洲,1,0,1,1,0,1,0,0,0,0,0,0,0,0,0
108,私立,一般大學,1016,銘傳大學,碩士班(日間),奈及利亞聯邦共和國,非洲,1,1,0,1,1,0,0,0,0,0,0,0,0,0,0
108,私立,一般大學,1016,銘傳大學,碩士班(日間),帛琉共和國,其他亞洲地區,2,0,2,2,0,2,0,0,0,0,0,0,0,0,0
108,私立,一般大學,1016,銘傳大學,碩士班(日間),香港,港澳,5,2,3,0,0,0,0,0,0,5,2,3,0,0,0
108,私立,一般大學,1016,銘傳大學,碩士班(日間),索羅門群島,其他亞洲地區,1,1,0,1,1,0,0,0,0,0,0,0,0,0,0
108,私立,一般大學,1016,銘傳大學,碩士班(日間),馬來西亞,東協,11,5,6,4,2,2,7,3,4,0,0,0,0,0,0
108,私立,一般大學,1016,銘傳大學,碩士班(日間),菲律賓共和國,東協,1,0,1,1,0,1,0,0,0,0,0,0,0,0,0
108,私立,一般大學,1016,銘傳大學,碩士班(日間),聖文森(及格瑞那丁),中南美洲,1,0,1,1,0,1,0,0,0,0,0,0,0,0,0
108,私立,一般大學,1016,銘傳大學,碩士班(日間),聖克里斯多福及尼維斯,中南美洲,1,1,0,1,1,0,0,0,0,0,0,0,0,0,0
108,私立,一般大學,1016,銘傳大學,碩士班(日間),蒙古國,其他亞洲地區,1,0,1,1,0,1,0,0,0,0,0,0,0,0,0
108,私立,一般大學,1016,銘傳大學,碩士班(日間),薩爾瓦多,中南美洲,3,2,1,3,2,1,0,0,0,0,0,0,0,0,0
108,私立,一般大學,1016,銘傳大學,碩士班(日間),巴拉圭,中南美洲,2,2,0,2,2,0,0,0,0,0,0,0,0,0,0
108,私立,一般大學,1016,銘傳大學,碩士班(日間),日本,其他亞洲地區,3,1,2,3,1,2,0,0,0,0,0,0,0,0,0
108,私立,一般大學,1016,銘傳大學,碩士班(日間),史瓦帝尼王國,非洲,4,1,3,4,1,3,0,0,0,0,0,0,0,0,0
108,私立,一般大學,1016,銘傳大學,碩士班(日間),印度尼西亞共和國,東協,3,3,0,3,3,0,0,0,0,0,0,0,0,0,0
108,私立,一般大學,1016,銘傳大學,碩士班(日間),貝里斯,中南美洲,3,2,1,3,2,1,0,0,0,0,0,0,0,0,0
108,私立,一般大學,1016,銘傳大學,碩士班(日間),波蘭共和國,歐洲,1,1,0,1,1,0,0,0,0,0,0,0,0,0,0
108,私立,一般大學,1016,銘傳大學,碩士班(日間),法國,歐洲,1,0,1,1,0,1,0,0,0,0,0,0,0,0,0
108,私立,一般大學,1016,銘傳大學,碩士班(日間),哈薩克共和國,其他亞洲地區,1,1,0,1,1,0,0,0,0,0,0,0,0,0,0
108,私立,一般大學,1016,銘傳大學,碩士班(日間),科威特,其他亞洲地區,1,0,1,1,0,1,0,0,0,0,0,0,0,0,0
108,私立,一般大學,1016,銘傳大學,碩士班(日間),美國,北美洲,2,2,0,2,2,0,0,0,0,0,0,0,0,0,0
108,私立,一般大學,1016,銘傳大學,碩士班(日間),泰國,東協,9,1,8,9,1,8,0,0,0,0,0,0,0,0,0
108,私立,一般大學,1016,銘傳大學,碩士班(日間),烏干達共和國,非洲,1,0,1,1,0,1,0,0,0,0,0,0,0,0,0
108,私立,一般大學,1016,銘傳大學,碩士班(日間),越南社會主義共和國,東協,7,1,6,7,1,6,0,0,0,0,0,0,0,0,0
108,私立,一般大學,1016,銘傳大學,碩士班(日間),墨西哥合眾國,中南美洲,1,0,1,1,0,1,0,0,0,0,0,0,0,0,0
108,私立,一般大學,1016,銘傳大學,博士班,越南社會主義共和國,東協,1,0,1,1,0,1,0,0,0,0,0,0,0,0,0
108,私立,一般大學,1016,銘傳大學,博士班,大陸地區,大陸地區,28,12,16,0,0,0,0,0,0,0,0,0,28,12,16
108,私立,一般大學,1017,實踐大學,學士班(日間),大韓民國(南韓),其他亞洲地區,4,1,3,3,1,2,1,0,1,0,0,0,0,0,0
108,私立,一般大學,1017,實踐大學,學士班(日間),巴拉圭,中南美洲,1,0,1,1,0,1,0,0,0,0,0,0,0,0,0
108,私立,一般大學,1017,實踐大學,學士班(日間),加拿大,北美洲,1,0,1,1,0,1,0,0,0,0,0,0,0,0,0
108,私立,一般大學,1017,實踐大學,學士班(日間),瓜地馬拉共和國,中南美洲,1,1,0,1,1,0,0,0,0,0,0,0,0,0,0
108,私立,一般大學,1017,實踐大學,學士班(日間),匈牙利共和國,歐洲,2,1,1,2,1,1,0,0,0,0,0,0,0,0,0
108,私立,一般大學,1017,實踐大學,學士班(日間),印度尼西亞共和國,東協,52,13,39,24,10,14,28,3,25,0,0,0,0,0,0
108,私立,一般大學,1017,實踐大學,學士班(日間),俄羅斯聯邦,其他亞洲地區,1,1,0,1,1,0,0,0,0,0,0,0,0,0,0
108,私立,一般大學,1017,實踐大學,學士班(日間),南非共和國,非洲,1,0,1,0,0,0,1,0,1,0,0,0,0,0,0
108,私立,一般大學,1017,實踐大學,學士班(日間),美國,北美洲,4,1,3,2,1,1,2,0,2,0,0,0,0,0,0
108,私立,一般大學,1017,實踐大學,學士班(日間),哥倫比亞共和國,中南美洲,2,1,1,2,1,1,0,0,0,0,0,0,0,0,0
108,私立,一般大學,1017,實踐大學,學士班(日間),泰國,東協,2,0,2,1,0,1,1,0,1,0,0,0,0,0,0
108,私立,一般大學,1017,實踐大學,學士班(日間),馬來西亞,東協,83,16,67,24,5,19,59,11,48,0,0,0,0,0,0
108,私立,一般大學,1017,實踐大學,學士班(日間),馬紹爾群島共和國,其他亞洲地區,1,0,1,1,0,1,0,0,0,0,0,0,0,0,0
108,私立,一般大學,1017,實踐大學,學士班(日間),斯洛伐克共和國,歐洲,1,0,1,1,0,1,0,0,0,0,0,0,0,0,0
108,私立,一般大學,1017,實踐大學,學士班(日間),菲律賓共和國,東協,2,1,1,2,1,1,0,0,0,0,0,0,0,0,0
108,私立,一般大學,1017,實踐大學,學士班(日間),越南社會主義共和國,東協,15,3,12,11,2,9,4,1,3,0,0,0,0,0,0
108,私立,一般大學,1017,實踐大學,學士班(日間),大陸地區,大陸地區,135,33,102,0,0,0,0,0,0,0,0,0,135,33,102
108,私立,一般大學,1017,實踐大學,學士班(日間),日本,其他亞洲地區,66,24,42,62,22,40,4,2,2,0,0,0,0,0,0
108,私立,一般大學,1017,實踐大學,學士班(日間),史瓦帝尼王國,非洲,1,1,0,1,1,0,0,0,0,0,0,0,0,0,0
108,私立,一般大學,1017,實踐大學,學士班(日間),香港,港澳,137,51,86,0,0,0,0,0,0,137,51,86,0,0,0
108,私立,一般大學,1017,實踐大學,學士班(日間),荷蘭王國,歐洲,1,0,1,1,0,1,0,0,0,0,0,0,0,0,0
108,私立,一般大學,1017,實踐大學,學士班(日間),新加坡共和國,東協,1,0,1,1,0,1,0,0,0,0,0,0,0,0,0
108,私立,一般大學,1017,實踐大學,學士班(日間),義大利共和國,歐洲,3,3,0,3,3,0,0,0,0,0,0,0,0,0,0
108,私立,一般大學,1017,實踐大學,學士班(日間),德意志聯邦共和國,歐洲,9,7,2,9,7,2,0,0,0,0,0,0,0,0,0
108,私立,一般大學,1017,實踐大學,學士班(日間),緬甸,東協,2,0,2,0,0,0,2,0,2,0,0,0,0,0,0
108,私立,一般大學,1017,實踐大學,學士班(日間),墨西哥合眾國,中南美洲,1,1,0,1,1,0,0,0,0,0,0,0,0,0,0
108,私立,一般大學,1017,實踐大學,學士班(日間),澳門,港澳,107,56,51,0,0,0,0,0,0,107,56,51,0,0,0
108,私立,一般大學,1017,實踐大學,碩士班(日間),大陸地區,大陸地區,31,16,15,0,0,0,0,0,0,0,0,0,31,16,15
108,私立,一般大學,1017,實踐大學,碩士班(日間),史瓦帝尼王國,非洲,2,1,1,2,1,1,0,0,0,0,0,0,0,0,0
108,私立,一般大學,1017,實踐大學,碩士班(日間),印度,南亞,1,0,1,1,0,1,0,0,0,0,0,0,0,0,0
108,私立,一般大學,1017,實踐大學,碩士班(日間),印度尼西亞共和國,東協,4,1,3,3,1,2,1,0,1,0,0,0,0,0,0
108,私立,一般大學,1017,實踐大學,碩士班(日間),美國,北美洲,2,1,1,1,0,1,1,1,0,0,0,0,0,0,0
108,私立,一般大學,1017,實踐大學,碩士班(日間),香港,港澳,5,2,3,0,0,0,0,0,0,5,2,3,0,0,0
108,私立,一般大學,1017,實踐大學,碩士班(日間),緬甸,東協,2,1,1,2,1,1,0,0,0,0,0,0,0,0,0
108,私立,一般大學,1017,實踐大學,碩士班(日間),大韓民國(南韓),其他亞洲地區,1,1,0,1,1,0,0,0,0,0,0,0,0,0,0
108,私立,一般大學,1017,實踐大學,碩士班(日間),泰國,東協,3,1,2,3,1,2,0,0,0,0,0,0,0,0,0
108,私立,一般大學,1017,實踐大學,碩士班(日間),馬來西亞,東協,3,2,1,2,1,1,1,1,0,0,0,0,0,0,0
108,私立,一般大學,1017,實踐大學,碩士班(日間),越南社會主義共和國,東協,1,1,0,1,1,0,0,0,0,0,0,0,0,0,0
108,私立,一般大學,1017,實踐大學,碩士班(日間),澳門,港澳,3,2,1,0,0,0,0,0,0,3,2,1,0,0,0
108,私立,一般大學,1017,實踐大學,博士班,美國,北美洲,1,1,0,1,1,0,0,0,0,0,0,0,0,0,0
108,私立,一般大學,1017,實踐大學,博士班,大陸地區,大陸地區,13,4,9,0,0,0,0,0,0,0,0,0,13,4,9
108,私立,技專校院,1018,朝陽科技大學,學士班(日間),大陸地區,大陸地區,140,66,74,0,0,0,0,0,0,0,0,0,140,66,74
108,私立,技專校院,1018,朝陽科技大學,學士班(日間),大韓民國(南韓),其他亞洲地區,1,1,0,1,1,0,0,0,0,0,0,0,0,0,0
108,私立,技專校院,1018,朝陽科技大學,學士班(日間),印度尼西亞共和國,東協,24,12,12,23,12,11,1,0,1,0,0,0,0,0,0
108,私立,技專校院,1018,朝陽科技大學,學士班(日間),馬來西亞,東協,74,36,38,58,30,28,16,6,10,0,0,0,0,0,0
108,私立,技專校院,1018,朝陽科技大學,學士班(日間),菲律賓共和國,東協,2,1,1,2,1,1,0,0,0,0,0,0,0,0,0
108,私立,技專校院,1018,朝陽科技大學,學士班(日間),蒙古國,其他亞洲地區,20,14,6,20,14,6,0,0,0,0,0,0,0,0,0
108,私立,技專校院,1018,朝陽科技大學,學士班(日間),寮人民民主共和國(寮國),東協,1,1,0,1,1,0,0,0,0,0,0,0,0,0,0
108,私立,技專校院,1018,朝陽科技大學,學士班(日間),日本,其他亞洲地區,1,0,1,1,0,1,0,0,0,0,0,0,0,0,0
108,私立,技專校院,1018,朝陽科技大學,學士班(日間),美國,北美洲,1,1,0,1,1,0,0,0,0,0,0,0,0,0,0
108,私立,技專校院,1018,朝陽科技大學,學士班(日間),香港,港澳,78,50,28,0,0,0,0,0,0,78,50,28,0,0,0
108,私立,技專校院,1018,朝陽科技大學,學士班(日間),越南社會主義共和國,東協,151,38,113,149,37,112,2,1,1,0,0,0,0,0,0
108,私立,技專校院,1018,朝陽科技大學,學士班(日間),緬甸,東協,1,1,0,0,0,0,1,1,0,0,0,0,0,0,0
108,私立,技專校院,1018,朝陽科技大學,學士班(日間),澳門,港澳,21,12,9,0,0,0,0,0,0,21,12,9,0,0,0
108,私立,技專校院,1018,朝陽科技大學,碩士班(日間),泰國,東協,1,0,1,1,0,1,0,0,0,0,0,0,0,0,0
108,私立,技專校院,1018,朝陽科技大學,碩士班(日間),緬甸,東協,3,1,2,3,1,2,0,0,0,0,0,0,0,0,0
108,私立,技專校院,1018,朝陽科技大學,碩士班(日間),大陸地區,大陸地區,10,5,5,0,0,0,0,0,0,0,0,0,10,5,5
108,私立,技專校院,1018,朝陽科技大學,碩士班(日間),大韓民國(南韓),其他亞洲地區,1,1,0,1,1,0,0,0,0,0,0,0,0,0,0
108,私立,技專校院,1018,朝陽科技大學,碩士班(日間),印度,南亞,1,0,1,1,0,1,0,0,0,0,0,0,0,0,0
108,私立,技專校院,1018,朝陽科技大學,碩士班(日間),印度尼西亞共和國,東協,1,1,0,1,1,0,0,0,0,0,0,0,0,0,0
108,私立,技專校院,1018,朝陽科技大學,碩士班(日間),香港,港澳,5,2,3,0,0,0,0,0,0,5,2,3,0,0,0
108,私立,技專校院,1018,朝陽科技大學,碩士班(日間),馬來西亞,東協,3,2,1,3,2,1,0,0,0,0,0,0,0,0,0
108,私立,技專校院,1018,朝陽科技大學,碩士班(日間),菲律賓共和國,東協,1,0,1,1,0,1,0,0,0,0,0,0,0,0,0
108,私立,技專校院,1018,朝陽科技大學,碩士班(日間),越南社會主義共和國,東協,20,7,13,20,7,13,0,0,0,0,0,0,0,0,0
108,私立,技專校院,1018,朝陽科技大學,博士班,大陸地區,大陸地區,8,4,4,0,0,0,0,0,0,0,0,0,8,4,4
108,私立,技專校院,1018,朝陽科技大學,博士班,尼泊爾聯邦民主共和國,南亞,4,3,1,4,3,1,0,0,0,0,0,0,0,0,0
108,私立,技專校院,1018,朝陽科技大學,博士班,印度,南亞,3,1,2,3,1,2,0,0,0,0,0,0,0,0,0
108,私立,技專校院,1018,朝陽科技大學,博士班,印度尼西亞共和國,東協,18,11,7,18,11,7,0,0,0,0,0,0,0,0,0
108,私立,技專校院,1018,朝陽科技大學,博士班,馬來西亞,東協,2,1,1,2,1,1,0,0,0,0,0,0,0,0,0
108,私立,技專校院,1018,朝陽科技大學,博士班,越南社會主義共和國,東協,3,3,0,3,3,0,0,0,0,0,0,0,0,0,0
108,私立,一般大學,1019,高雄醫學大學,學士班(日間),史瓦帝尼王國,非洲,3,1,2,3,1,2,0,0,0,0,0,0,0,0,0
108,私立,一般大學,1019,高雄醫學大學,學士班(日間),瓜地馬拉共和國,中南美洲,4,1,3,4,1,3,0,0,0,0,0,0,0,0,0
108,私立,一般大學,1019,高雄醫學大學,學士班(日間),貝里斯,中南美洲,7,3,4,6,2,4,1,1,0,0,0,0,0,0,0
108,私立,一般大學,1019,高雄醫學大學,學士班(日間),帛琉共和國,其他亞洲地區,7,3,4,7,3,4,0,0,0,0,0,0,0,0,0
108,私立,一般大學,1019,高雄醫學大學,學士班(日間),法國,歐洲,1,1,0,1,1,0,0,0,0,0,0,0,0,0,0
108,私立,一般大學,1019,高雄醫學大學,學士班(日間),美國,北美洲,19,11,8,12,7,5,7,4,3,0,0,0,0,0,0
108,私立,一般大學,1019,高雄醫學大學,學士班(日間),香港,港澳,38,16,22,0,0,0,0,0,0,38,16,22,0,0,0
108,私立,一般大學,1019,高雄醫學大學,學士班(日間),泰國,東協,1,1,0,0,0,0,1,1,0,0,0,0,0,0,0
108,私立,一般大學,1019,高雄醫學大學,學士班(日間),索羅門群島,其他亞洲地區,6,1,5,6,1,5,0,0,0,0,0,0,0,0,0
108,私立,一般大學,1019,高雄醫學大學,學士班(日間),馬紹爾群島共和國,其他亞洲地區,1,1,0,1,1,0,0,0,0,0,0,0,0,0,0
108,私立,一般大學,1019,高雄醫學大學,學士班(日間),越南社會主義共和國,東協,1,0,1,1,0,1,0,0,0,0,0,0,0,0,0
108,私立,一般大學,1019,高雄醫學大學,學士班(日間),聖露西亞,中南美洲,3,3,0,3,3,0,0,0,0,0,0,0,0,0,0
108,私立,一般大學,1019,高雄醫學大學,學士班(日間),蒙古國,其他亞洲地區,1,1,0,1,1,0,0,0,0,0,0,0,0,0,0
108,私立,一般大學,1019,高雄醫學大學,學士班(日間),德意志聯邦共和國,歐洲,1,1,0,1,1,0,0,0,0,0,0,0,0,0,0
108,私立,一般大學,1019,高雄醫學大學,學士班(日間),緬甸,東協,3,0,3,1,0,1,2,0,2,0,0,0,0,0,0
108,私立,一般大學,1019,高雄醫學大學,學士班(日間),澳門,港澳,45,24,21,0,0,0,0,0,0,45,24,21,0,0,0
108,私立,一般大學,1019,高雄醫學大學,學士班(日間),諾魯共和國,其他亞洲地區,2,0,2,2,0,2,0,0,0,0,0,0,0,0,0
108,私立,一般大學,1019,高雄醫學大學,學士班(日間),大陸地區,大陸地區,20,6,14,0,0,0,0,0,0,0,0,0,20,6,14
108,私立,一般大學,1019,高雄醫學大學,學士班(日間),大韓民國(南韓),其他亞洲地區,8,1,7,4,0,4,4,1,3,0,0,0,0,0,0
108,私立,一般大學,1019,高雄醫學大學,學士班(日間),厄瓜多共和國,中南美洲,1,0,1,1,0,1,0,0,0,0,0,0,0,0,0
108,私立,一般大學,1019,高雄醫學大學,學士班(日間),加拿大,北美洲,4,2,2,0,0,0,4,2,2,0,0,0,0,0,0
108,私立,一般大學,1019,高雄醫學大學,學士班(日間),印度尼西亞共和國,東協,12,2,10,2,0,2,10,2,8,0,0,0,0,0,0
108,私立,一般大學,1019,高雄醫學大學,學士班(日間),吉里巴斯共和國,其他亞洲地區,5,0,5,5,0,5,0,0,0,0,0,0,0,0,0
108,私立,一般大學,1019,高雄醫學大學,學士班(日間),宏都拉斯共和國,中南美洲,4,1,3,4,1,3,0,0,0,0,0,0,0,0,0
108,私立,一般大學,1019,高雄醫學大學,學士班(日間),約旦哈什米王國,其他亞洲地區,1,1,0,1,1,0,0,0,0,0,0,0,0,0,0
108,私立,一般大學,1019,高雄醫學大學,學士班(日間),馬來西亞,東協,118,38,80,21,7,14,97,31,66,0,0,0,0,0,0
108,私立,一般大學,1019,高雄醫學大學,學士班(日間),新加坡共和國,東協,7,3,4,1,0,1,6,3,3,0,0,0,0,0,0
108,私立,一般大學,1019,高雄醫學大學,學士班(日間),聖文森(及格瑞那丁),中南美洲,5,0,5,5,0,5,0,0,0,0,0,0,0,0,0
108,私立,一般大學,1019,高雄醫學大學,學士班(日間),聖克里斯多福及尼維斯,中南美洲,1,1,0,1,1,0,0,0,0,0,0,0,0,0,0
108,私立,一般大學,1019,高雄醫學大學,學士班(日間),葡萄牙共和國,歐洲,2,1,1,2,1,1,0,0,0,0,0,0,0,0,0
108,私立,一般大學,1019,高雄醫學大學,學士班(日間),薩爾瓦多,中南美洲,1,0,1,0,0,0,1,0,1,0,0,0,0,0,0
108,私立,一般大學,1019,高雄醫學大學,碩士班(日間),巴基斯坦,南亞,1,1,0,1,1,0,0,0,0,0,0,0,0,0,0
108,私立,一般大學,1019,高雄醫學大學,碩士班(日間),印度,南亞,2,0,2,2,0,2,0,0,0,0,0,0,0,0,0
108,私立,一般大學,1019,高雄醫學大學,碩士班(日間),印度尼西亞共和國,東協,3,1,2,3,1,2,0,0,0,0,0,0,0,0,0
108,私立,一般大學,1019,高雄醫學大學,碩士班(日間),宏都拉斯共和國,中南美洲,2,0,2,2,0,2,0,0,0,0,0,0,0,0,0
108,私立,一般大學,1019,高雄醫學大學,碩士班(日間),香港,港澳,2,1,1,0,0,0,0,0,0,2,1,1,0,0,0
108,私立,一般大學,1019,高雄醫學大學,碩士班(日間),馬來西亞,東協,5,1,4,1,0,1,4,1,3,0,0,0,0,0,0
108,私立,一般大學,1019,高雄醫學大學,碩士班(日間),馬拉威共和國,非洲,2,1,1,2,1,1,0,0,0,0,0,0,0,0,0
108,私立,一般大學,1019,高雄醫學大學,碩士班(日間),聖文森(及格瑞那丁),中南美洲,2,0,2,2,0,2,0,0,0,0,0,0,0,0,0
108,私立,一般大學,1019,高雄醫學大學,碩士班(日間),聖露西亞,中南美洲,2,0,2,2,0,2,0,0,0,0,0,0,0,0,0
108,私立,一般大學,1019,高雄醫學大學,碩士班(日間),蒙古國,其他亞洲地區,1,0,1,1,0,1,0,0,0,0,0,0,0,0,0
108,私立,一般大學,1019,高雄醫學大學,碩士班(日間),史瓦帝尼王國,非洲,5,3,2,5,3,2,0,0,0,0,0,0,0,0,0
108,私立,一般大學,1019,高雄醫學大學,碩士班(日間),貝里斯,中南美洲,2,0,2,2,0,2,0,0,0,0,0,0,0,0,0
108,私立,一般大學,1019,高雄醫學大學,碩士班(日間),孟加拉人民共和國,南亞,1,1,0,1,1,0,0,0,0,0,0,0,0,0,0
108,私立,一般大學,1019,高雄醫學大學,碩士班(日間),美國,北美洲,2,2,0,1,1,0,1,1,0,0,0,0,0,0,0
108,私立,一般大學,1019,高雄醫學大學,碩士班(日間),海地共和國,中南美洲,2,1,1,2,1,1,0,0,0,0,0,0,0,0,0
108,私立,一般大學,1019,高雄醫學大學,碩士班(日間),越南社會主義共和國,東協,6,1,5,6,1,5,0,0,0,0,0,0,0,0,0
108,私立,一般大學,1019,高雄醫學大學,碩士班(日間),緬甸,東協,1,0,1,1,0,1,0,0,0,0,0,0,0,0,0
108,私立,一般大學,1019,高雄醫學大學,碩士班(日間),澳門,港澳,4,3,1,0,0,0,0,0,0,4,3,1,0,0,0
108,私立,一般大學,1019,高雄醫學大學,博士班,史瓦帝尼王國,非洲,2,1,1,2,1,1,0,0,0,0,0,0,0,0,0
108,私立,一般大學,1019,高雄醫學大學,博士班,匈牙利共和國,歐洲,2,0,2,2,0,2,0,0,0,0,0,0,0,0,0
108,私立,一般大學,1019,高雄醫學大學,博士班,坦尚尼亞聯合共和國,非洲,1,1,0,1,1,0,0,0,0,0,0,0,0,0,0
108,私立,一般大學,1019,高雄醫學大學,博士班,馬來西亞,東協,5,3,2,0,0,0,5,3,2,0,0,0,0,0,0
108,私立,一般大學,1019,高雄醫學大學,博士班,菲律賓共和國,東協,3,0,3,3,0,3,0,0,0,0,0,0,0,0,0
108,私立,一般大學,1019,高雄醫學大學,博士班,越南社會主義共和國,東協,3,1,2,3,1,2,0,0,0,0,0,0,0,0,0
108,私立,一般大學,1019,高雄醫學大學,博士班,蒙古國,其他亞洲地區,1,0,1,1,0,1,0,0,0,0,0,0,0,0,0
108,私立,一般大學,1019,高雄醫學大學,博士班,大陸地區,大陸地區,1,0,1,0,0,0,0,0,0,0,0,0,1,0,1
108,私立,一般大學,1019,高雄醫學大學,博士班,巴基斯坦,南亞,1,1,0,1,1,0,0,0,0,0,0,0,0,0,0
108,私立,一般大學,1019,高雄醫學大學,博士班,日本,其他亞洲地區,1,1,0,1,1,0,0,0,0,0,0,0,0,0,0
108,私立,一般大學,1019,高雄醫學大學,博士班,印度,南亞,29,18,11,29,18,11,0,0,0,0,0,0,0,0,0
108,私立,一般大學,1019,高雄醫學大學,博士班,印度尼西亞共和國,東協,9,3,6,9,3,6,0,0,0,0,0,0,0,0,0
108,私立,一般大學,1019,高雄醫學大學,博士班,貝里斯,中南美洲,1,0,1,1,0,1,0,0,0,0,0,0,0,0,0
108,私立,一般大學,1019,高雄醫學大學,博士班,緬甸,東協,1,1,0,1,1,0,0,0,0,0,0,0,0,0,0
108,私立,一般大學,1020,南華大學,學士班(日間),大陸地區,大陸地區,1,1,0,0,0,0,0,0,0,0,0,0,1,1,0
108,私立,一般大學,1020,南華大學,學士班(日間),巴西聯邦共和國,中南美洲,24,24,0,24,24,0,0,0,0,0,0,0,0,0,0
108,私立,一般大學,1020,南華大學,學士班(日間),史瓦帝尼王國,非洲,1,0,1,1,0,1,0,0,0,0,0,0,0,0,0
108,私立,一般大學,1020,南華大學,學士班(日間),印度尼西亞共和國,東協,5,4,1,4,3,1,1,1,0,0,0,0,0,0,0
108,私立,一般大學,1020,南華大學,學士班(日間),南非共和國,非洲,1,1,0,1,1,0,0,0,0,0,0,0,0,0,0
108,私立,一般大學,1020,南華大學,學士班(日間),柬埔寨王國,東協,7,3,4,7,3,4,0,0,0,0,0,0,0,0,0
108,私立,一般大學,1020,南華大學,學士班(日間),英國,歐洲,1,1,0,1,1,0,0,0,0,0,0,0,0,0,0
108,私立,一般大學,1020,南華大學,學士班(日間),香港,港澳,12,4,8,0,0,0,0,0,0,12,4,8,0,0,0
108,私立,一般大學,1020,南華大學,學士班(日間),馬來西亞,東協,63,35,28,38,21,17,25,14,11,0,0,0,0,0,0
108,私立,一般大學,1020,南華大學,學士班(日間),越南社會主義共和國,東協,17,9,8,17,9,8,0,0,0,0,0,0,0,0,0
108,私立,一般大學,1020,南華大學,學士班(日間),緬甸,東協,1,1,0,1,1,0,0,0,0,0,0,0,0,0,0
108,私立,一般大學,1020,南華大學,學士班(日間),澳門,港澳,7,2,5,0,0,0,0,0,0,7,2,5,0,0,0
108,私立,一般大學,1020,南華大學,學士班(日間),大韓民國(南韓),其他亞洲地區,1,1,0,1,1,0,0,0,0,0,0,0,0,0,0
108,私立,一般大學,1020,南華大學,學士班(日間),日本,其他亞洲地區,11,5,6,11,5,6,0,0,0,0,0,0,0,0,0
108,私立,一般大學,1020,南華大學,學士班(日間),尼泊爾聯邦民主共和國,南亞,4,2,2,4,2,2,0,0,0,0,0,0,0,0,0
108,私立,一般大學,1020,南華大學,學士班(日間),印度,南亞,9,6,3,9,6,3,0,0,0,0,0,0,0,0,0
108,私立,一般大學,1020,南華大學,學士班(日間),吉爾吉斯,其他亞洲地區,4,4,0,4,4,0,0,0,0,0,0,0,0,0,0
108,私立,一般大學,1020,南華大學,學士班(日間),斯里蘭卡民主社會主義共和國,南亞,1,0,1,1,0,1,0,0,0,0,0,0,0,0,0
108,私立,一般大學,1020,南華大學,學士班(日間),蒙古國,其他亞洲地區,96,59,37,96,59,37,0,0,0,0,0,0,0,0,0
108,私立,一般大學,1020,南華大學,碩士班(日間),吉爾吉斯,其他亞洲地區,2,2,0,2,2,0,0,0,0,0,0,0,0,0,0
108,私立,一般大學,1020,南華大學,碩士班(日間),孟加拉人民共和國,南亞,4,4,0,4,4,0,0,0,0,0,0,0,0,0,0
108,私立,一般大學,1020,南華大學,碩士班(日間),蒙古國,其他亞洲地區,40,14,26,40,14,26,0,0,0,0,0,0,0,0,0
108,私立,一般大學,1020,南華大學,碩士班(日間),印度,南亞,14,13,1,14,13,1,0,0,0,0,0,0,0,0,0
108,私立,一般大學,1020,南華大學,碩士班(日間),印度尼西亞共和國,東協,2,0,2,2,0,2,0,0,0,0,0,0,0,0,0
108,私立,一般大學,1020,南華大學,碩士班(日間),柬埔寨王國,東協,14,7,7,14,7,7,0,0,0,0,0,0,0,0,0
108,私立,一般大學,1020,南華大學,碩士班(日間),馬來西亞,東協,11,2,9,6,1,5,5,1,4,0,0,0,0,0,0
108,私立,一般大學,1020,南華大學,碩士班(日間),菲律賓共和國,東協,16,6,10,16,6,10,0,0,0,0,0,0,0,0,0
108,私立,一般大學,1020,南華大學,碩士班(日間),越南社會主義共和國,東協,23,7,16,23,7,16,0,0,0,0,0,0,0,0,0
108,私立,一般大學,1020,南華大學,碩士班(日間),澳門,港澳,1,0,1,0,0,0,0,0,0,1,0,1,0,0,0
108,私立,一般大學,1020,南華大學,博士班,大陸地區,大陸地區,1,0,1,0,0,0,0,0,0,0,0,0,1,0,1
108,私立,一般大學,1020,南華大學,博士班,印度,南亞,3,3,0,3,3,0,0,0,0,0,0,0,0,0,0
108,私立,一般大學,1020,南華大學,博士班,越南社會主義共和國,東協,17,10,7,17,10,7,0,0,0,0,0,0,0,0,0
108,私立,一般大學,1020,南華大學,博士班,蒙古國,其他亞洲地區,1,0,1,1,0,1,0,0,0,0,0,0,0,0,0
108,私立,一般大學,1021,真理大學,學士班(日間),大陸地區,大陸地區,1,0,1,0,0,0,0,0,0,0,0,0,1,0,1
108,私立,一般大學,1021,真理大學,學士班(日間),印度尼西亞共和國,東協,1,0,1,0,0,0,1,0,1,0,0,0,0,0,0
108,私立,一般大學,1021,真理大學,學士班(日間),香港,港澳,28,19,9,0,0,0,0,0,0,28,19,9,0,0,0
108,私立,一般大學,1021,真理大學,學士班(日間),馬來西亞,東協,22,14,8,1,0,1,21,14,7,0,0,0,0,0,0
108,私立,一般大學,1021,真理大學,學士班(日間),澳門,港澳,4,4,0,0,0,0,0,0,0,4,4,0,0,0,0
108,私立,一般大學,1021,真理大學,學士班(日間),日本,其他亞洲地區,22,8,14,20,8,12,2,0,2,0,0,0,0,0,0
108,私立,一般大學,1021,真理大學,學士班(日間),美國,北美洲,2,1,1,2,1,1,0,0,0,0,0,0,0,0,0
108,私立,一般大學,1021,真理大學,學士班(日間),越南社會主義共和國,東協,12,6,6,10,5,5,2,1,1,0,0,0,0,0,0
108,私立,一般大學,1021,真理大學,碩士班(日間),越南社會主義共和國,東協,4,3,1,4,3,1,0,0,0,0,0,0,0,0,0
108,私立,一般大學,1021,真理大學,碩士班(日間),香港,港澳,1,1,0,0,0,0,0,0,0,1,1,0,0,0,0
108,私立,一般大學,1021,真理大學,碩士班(日間),馬來西亞,東協,1,1,0,0,0,0,1,1,0,0,0,0,0,0,0
108,私立,一般大學,1021,真理大學,碩士班(日間),菲律賓共和國,東協,4,0,4,4,0,4,0,0,0,0,0,0,0,0,0
108,私立,一般大學,1022,大同大學,學士班(日間),日本,其他亞洲地區,2,1,1,2,1,1,0,0,0,0,0,0,0,0,0
108,私立,一般大學,1022,大同大學,學士班(日間),馬來西亞,東協,3,2,1,0,0,0,3,2,1,0,0,0,0,0,0
108,私立,一般大學,1022,大同大學,學士班(日間),菲律賓共和國,東協,1,1,0,0,0,0,1,1,0,0,0,0,0,0,0
108,私立,一般大學,1022,大同大學,學士班(日間),新加坡共和國,東協,1,1,0,0,0,0,1,1,0,0,0,0,0,0,0
108,私立,一般大學,1022,大同大學,學士班(日間),大陸地區,大陸地區,44,34,10,0,0,0,0,0,0,0,0,0,44,34,10
108,私立,一般大學,1022,大同大學,學士班(日間),印度尼西亞共和國,東協,1,0,1,1,0,1,0,0,0,0,0,0,0,0,0
108,私立,一般大學,1022,大同大學,學士班(日間),香港,港澳,18,13,5,0,0,0,0,0,0,18,13,5,0,0,0
108,私立,一般大學,1022,大同大學,學士班(日間),緬甸,東協,1,1,0,0,0,0,1,1,0,0,0,0,0,0,0
108,私立,一般大學,1022,大同大學,學士班(日間),澳門,港澳,7,7,0,0,0,0,0,0,0,7,7,0,0,0,0
108,私立,一般大學,1022,大同大學,碩士班(日間),大陸地區,大陸地區,8,6,2,0,0,0,0,0,0,0,0,0,8,6,2
108,私立,一般大學,1022,大同大學,碩士班(日間),德意志聯邦共和國,歐洲,3,2,1,3,2,1,0,0,0,0,0,0,0,0,0
108,私立,一般大學,1022,大同大學,碩士班(日間),日本,其他亞洲地區,1,1,0,1,1,0,0,0,0,0,0,0,0,0,0
108,私立,一般大學,1022,大同大學,博士班,大陸地區,大陸地區,24,13,11,0,0,0,0,0,0,0,0,0,24,13,11
108,私立,技專校院,1023,南臺學校財團法人南臺科技大學,學士班(日間),巴西聯邦共和國,中南美洲,1,1,0,0,0,0,1,1,0,0,0,0,0,0,0
108,私立,技專校院,1023,南臺學校財團法人南臺科技大學,學士班(日間),巴拉圭,中南美洲,1,0,1,1,0,1,0,0,0,0,0,0,0,0,0
108,私立,技專校院,1023,南臺學校財團法人南臺科技大學,學士班(日間),史瓦帝尼王國,非洲,9,3,6,9,3,6,0,0,0,0,0,0,0,0,0
108,私立,技專校院,1023,南臺學校財團法人南臺科技大學,學士班(日間),匈牙利共和國,歐洲,1,1,0,1,1,0,0,0,0,0,0,0,0,0,0
108,私立,技專校院,1023,南臺學校財團法人南臺科技大學,學士班(日間),克羅埃西亞共和國,歐洲,1,1,0,1,1,0,0,0,0,0,0,0,0,0,0
108,私立,技專校院,1023,南臺學校財團法人南臺科技大學,學士班(日間),美國,北美洲,2,2,0,1,1,0,1,1,0,0,0,0,0,0,0
108,私立,技專校院,1023,南臺學校財團法人南臺科技大學,學士班(日間),泰國,東協,6,0,6,6,0,6,0,0,0,0,0,0,0,0,0
108,私立,技專校院,1023,南臺學校財團法人南臺科技大學,學士班(日間),海地共和國,中南美洲,1,1,0,1,1,0,0,0,0,0,0,0,0,0,0
108,私立,技專校院,1023,南臺學校財團法人南臺科技大學,學士班(日間),越南社會主義共和國,東協,33,20,13,29,20,9,4,0,4,0,0,0,0,0,0
108,私立,技專校院,1023,南臺學校財團法人南臺科技大學,學士班(日間),瑞典王國,歐洲,1,0,1,1,0,1,0,0,0,0,0,0,0,0,0
108,私立,技專校院,1023,南臺學校財團法人南臺科技大學,學士班(日間),摩洛哥王國,非洲,2,2,0,2,2,0,0,0,0,0,0,0,0,0,0
108,私立,技專校院,1023,南臺學校財團法人南臺科技大學,學士班(日間),大陸地區,大陸地區,44,29,15,0,0,0,0,0,0,0,0,0,44,29,15
108,私立,技專校院,1023,南臺學校財團法人南臺科技大學,學士班(日間),巴拿馬共和國,中南美洲,2,0,2,1,0,1,1,0,1,0,0,0,0,0,0
108,私立,技專校院,1023,南臺學校財團法人南臺科技大學,學士班(日間),日本,其他亞洲地區,2,2,0,2,2,0,0,0,0,0,0,0,0,0,0
108,私立,技專校院,1023,南臺學校財團法人南臺科技大學,學士班(日間),加拿大,北美洲,3,2,1,2,1,1,1,1,0,0,0,0,0,0,0
108,私立,技專校院,1023,南臺學校財團法人南臺科技大學,學士班(日間),印度,南亞,1,1,0,1,1,0,0,0,0,0,0,0,0,0,0
108,私立,技專校院,1023,南臺學校財團法人南臺科技大學,學士班(日間),印度尼西亞共和國,東協,8,5,3,7,4,3,1,1,0,0,0,0,0,0,0
108,私立,技專校院,1023,南臺學校財團法人南臺科技大學,學士班(日間),吉里巴斯共和國,其他亞洲地區,15,7,8,15,7,8,0,0,0,0,0,0,0,0,0
108,私立,技專校院,1023,南臺學校財團法人南臺科技大學,學士班(日間),宏都拉斯共和國,中南美洲,5,2,3,5,2,3,0,0,0,0,0,0,0,0,0
108,私立,技專校院,1023,南臺學校財團法人南臺科技大學,學士班(日間),香港,港澳,48,32,16,0,0,0,0,0,0,48,32,16,0,0,0
108,私立,技專校院,1023,南臺學校財團法人南臺科技大學,學士班(日間),馬來西亞,東協,97,59,38,71,45,26,26,14,12,0,0,0,0,0,0
108,私立,技專校院,1023,南臺學校財團法人南臺科技大學,學士班(日間),斯洛伐克共和國,歐洲,2,2,0,2,2,0,0,0,0,0,0,0,0,0,0
108,私立,技專校院,1023,南臺學校財團法人南臺科技大學,學士班(日間),菲律賓共和國,東協,3,0,3,3,0,3,0,0,0,0,0,0,0,0,0
108,私立,技專校院,1023,南臺學校財團法人南臺科技大學,學士班(日間),蒙古國,其他亞洲地區,20,10,10,20,10,10,0,0,0,0,0,0,0,0,0
108,私立,技專校院,1023,南臺學校財團法人南臺科技大學,學士班(日間),澳門,港澳,10,7,3,0,0,0,0,0,0,10,7,3,0,0,0
108,私立,技專校院,1023,南臺學校財團法人南臺科技大學,學士班(日間),薩爾瓦多,中南美洲,3,1,2,3,1,2,0,0,0,0,0,0,0,0,0
108,私立,技專校院,1023,南臺學校財團法人南臺科技大學,碩士班(日間),大陸地區,大陸地區,14,9,5,0,0,0,0,0,0,0,0,0,14,9,5
108,私立,技專校院,1023,南臺學校財團法人南臺科技大學,碩士班(日間),大韓民國(南韓),其他亞洲地區,2,0,2,2,0,2,0,0,0,0,0,0,0,0,0
108,私立,技專校院,1023,南臺學校財團法人南臺科技大學,碩士班(日間),印度,南亞,6,5,1,6,5,1,0,0,0,0,0,0,0,0,0
108,私立,技專校院,1023,南臺學校財團法人南臺科技大學,碩士班(日間),約旦哈什米王國,其他亞洲地區,1,1,0,1,1,0,0,0,0,0,0,0,0,0,0
108,私立,技專校院,1023,南臺學校財團法人南臺科技大學,碩士班(日間),香港,港澳,5,2,3,0,0,0,0,0,0,5,2,3,0,0,0
108,私立,技專校院,1023,南臺學校財團法人南臺科技大學,碩士班(日間),馬來西亞,東協,23,16,7,22,16,6,1,0,1,0,0,0,0,0,0
108,私立,技專校院,1023,南臺學校財團法人南臺科技大學,碩士班(日間),捷克共和國,歐洲,1,0,1,1,0,1,0,0,0,0,0,0,0,0,0
108,私立,技專校院,1023,南臺學校財團法人南臺科技大學,碩士班(日間),菲律賓共和國,東協,5,1,4,5,1,4,0,0,0,0,0,0,0,0,0
108,私立,技專校院,1023,南臺學校財團法人南臺科技大學,碩士班(日間),蒙古國,其他亞洲地區,9,2,7,9,2,7,0,0,0,0,0,0,0,0,0
108,私立,技專校院,1023,南臺學校財團法人南臺科技大學,碩士班(日間),薩爾瓦多,中南美洲,1,1,0,1,1,0,0,0,0,0,0,0,0,0,0
108,私立,技專校院,1023,南臺學校財團法人南臺科技大學,碩士班(日間),土耳其共和國,其他亞洲地區,1,1,0,1,1,0,0,0,0,0,0,0,0,0,0
108,私立,技專校院,1023,南臺學校財團法人南臺科技大學,碩士班(日間),史瓦帝尼王國,非洲,1,1,0,1,1,0,0,0,0,0,0,0,0,0,0
108,私立,技專校院,1023,南臺學校財團法人南臺科技大學,碩士班(日間),甘比亞共和國,非洲,1,1,0,1,1,0,0,0,0,0,0,0,0,0,0
108,私立,技專校院,1023,南臺學校財團法人南臺科技大學,碩士班(日間),印度尼西亞共和國,東協,1,1,0,1,1,0,0,0,0,0,0,0,0,0,0
108,私立,技專校院,1023,南臺學校財團法人南臺科技大學,碩士班(日間),克羅埃西亞共和國,歐洲,1,1,0,1,1,0,0,0,0,0,0,0,0,0,0
108,私立,技專校院,1023,南臺學校財團法人南臺科技大學,碩士班(日間),法國,歐洲,8,3,5,8,3,5,0,0,0,0,0,0,0,0,0
108,私立,技專校院,1023,南臺學校財團法人南臺科技大學,碩士班(日間),俄羅斯聯邦,其他亞洲地區,2,1,1,2,1,1,0,0,0,0,0,0,0,0,0
108,私立,技專校院,1023,南臺學校財團法人南臺科技大學,碩士班(日間),美國,北美洲,1,1,0,1,1,0,0,0,0,0,0,0,0,0,0
108,私立,技專校院,1023,南臺學校財團法人南臺科技大學,碩士班(日間),泰國,東協,1,0,1,1,0,1,0,0,0,0,0,0,0,0,0
108,私立,技專校院,1023,南臺學校財團法人南臺科技大學,碩士班(日間),越南社會主義共和國,東協,15,7,8,15,7,8,0,0,0,0,0,0,0,0,0
108,私立,技專校院,1023,南臺學校財團法人南臺科技大學,碩士班(日間),奧地利共和國,歐洲,3,2,1,3,2,1,0,0,0,0,0,0,0,0,0
108,私立,技專校院,1023,南臺學校財團法人南臺科技大學,博士班,伊拉克共和國,其他亞洲地區,1,1,0,1,1,0,0,0,0,0,0,0,0,0,0
108,私立,技專校院,1023,南臺學校財團法人南臺科技大學,博士班,法國,歐洲,1,0,1,1,0,1,0,0,0,0,0,0,0,0,0
108,私立,技專校院,1023,南臺學校財團法人南臺科技大學,博士班,美國,北美洲,1,1,0,1,1,0,0,0,0,0,0,0,0,0,0
108,私立,技專校院,1023,南臺學校財團法人南臺科技大學,博士班,埃及阿拉伯共和國,非洲,2,2,0,2,2,0,0,0,0,0,0,0,0,0,0
108,私立,技專校院,1023,南臺學校財團法人南臺科技大學,博士班,泰國,東協,4,2,2,4,2,2,0,0,0,0,0,0,0,0,0
108,私立,技專校院,1023,南臺學校財團法人南臺科技大學,博士班,秘魯共和國,中南美洲,1,1,0,1,1,0,0,0,0,0,0,0,0,0,0
108,私立,技專校院,1023,南臺學校財團法人南臺科技大學,博士班,馬來西亞,東協,1,1,0,1,1,0,0,0,0,0,0,0,0,0,0
108,私立,技專校院,1023,南臺學校財團法人南臺科技大學,博士班,捷克共和國,歐洲,1,1,0,1,1,0,0,0,0,0,0,0,0,0,0
108,私立,技專校院,1023,南臺學校財團法人南臺科技大學,博士班,菲律賓共和國,東協,4,1,3,4,1,3,0,0,0,0,0,0,0,0,0
108,私立,技專校院,1023,南臺學校財團法人南臺科技大學,博士班,越南社會主義共和國,東協,19,11,8,19,11,8,0,0,0,0,0,0,0,0,0
108,私立,技專校院,1023,南臺學校財團法人南臺科技大學,博士班,大陸地區,大陸地區,1,1,0,0,0,0,0,0,0,0,0,0,1,1,0
108,私立,技專校院,1023,南臺學校財團法人南臺科技大學,博士班,丹麥王國,歐洲,1,1,0,1,1,0,0,0,0,0,0,0,0,0,0
108,私立,技專校院,1023,南臺學校財團法人南臺科技大學,博士班,印度,南亞,5,4,1,5,4,1,0,0,0,0,0,0,0,0,0
108,私立,技專校院,1023,南臺學校財團法人南臺科技大學,博士班,印度尼西亞共和國,東協,17,13,4,17,13,4,0,0,0,0,0,0,0,0,0
108,私立,技專校院,1023,南臺學校財團法人南臺科技大學,博士班,克羅埃西亞共和國,歐洲,1,1,0,1,1,0,0,0,0,0,0,0,0,0,0
108,私立,技專校院,1023,南臺學校財團法人南臺科技大學,博士班,南非共和國,非洲,1,0,1,1,0,1,0,0,0,0,0,0,0,0,0
108,私立,技專校院,1023,南臺學校財團法人南臺科技大學,博士班,約旦哈什米王國,其他亞洲地區,1,1,0,1,1,0,0,0,0,0,0,0,0,0,0
108,私立,技專校院,1023,南臺學校財團法人南臺科技大學,博士班,墨西哥合眾國,中南美洲,1,1,0,1,1,0,0,0,0,0,0,0,0,0,0
108,私立,技專校院,1024,崑山科技大學,學士班(日間),大陸地區,大陸地區,26,15,11,0,0,0,0,0,0,0,0,0,26,15,11
108,私立,技專校院,1024,崑山科技大學,學士班(日間),大韓民國(南韓),其他亞洲地區,10,8,2,10,8,2,0,0,0,0,0,0,0,0,0
108,私立,技專校院,1024,崑山科技大學,學士班(日間),巴布亞紐幾內亞獨立國,其他亞洲地區,1,0,1,1,0,1,0,0,0,0,0,0,0,0,0
108,私立,技專校院,1024,崑山科技大學,學士班(日間),巴拉圭,中南美洲,2,1,1,2,1,1,0,0,0,0,0,0,0,0,0
108,私立,技專校院,1024,崑山科技大學,學士班(日間),尼加拉瓜,中南美洲,3,0,3,3,0,3,0,0,0,0,0,0,0,0,0
108,私立,技專校院,1024,崑山科技大學,學士班(日間),瓜地馬拉共和國,中南美洲,1,1,0,1,1,0,0,0,0,0,0,0,0,0,0
108,私立,技專校院,1024,崑山科技大學,學士班(日間),貝里斯,中南美洲,14,9,5,14,9,5,0,0,0,0,0,0,0,0,0
108,私立,技專校院,1024,崑山科技大學,學士班(日間),帛琉共和國,其他亞洲地區,2,2,0,2,2,0,0,0,0,0,0,0,0,0,0
108,私立,技專校院,1024,崑山科技大學,學士班(日間),香港,港澳,14,10,4,0,0,0,0,0,0,14,10,4,0,0,0
108,私立,技專校院,1024,崑山科技大學,學士班(日間),泰國,東協,2,2,0,1,1,0,1,1,0,0,0,0,0,0,0
108,私立,技專校院,1024,崑山科技大學,學士班(日間),海地共和國,中南美洲,3,3,0,3,3,0,0,0,0,0,0,0,0,0,0
108,私立,技專校院,1024,崑山科技大學,學士班(日間),秘魯共和國,中南美洲,2,1,1,2,1,1,0,0,0,0,0,0,0,0,0
108,私立,技專校院,1024,崑山科技大學,學士班(日間),索羅門群島,其他亞洲地區,2,1,1,2,1,1,0,0,0,0,0,0,0,0,0
108,私立,技專校院,1024,崑山科技大學,學士班(日間),菲律賓共和國,東協,83,29,54,83,29,54,0,0,0,0,0,0,0,0,0
108,私立,技專校院,1024,崑山科技大學,學士班(日間),越南社會主義共和國,東協,167,79,88,138,61,77,29,18,11,0,0,0,0,0,0
108,私立,技專校院,1024,崑山科技大學,學士班(日間),聖文森(及格瑞那丁),中南美洲,3,2,1,3,2,1,0,0,0,0,0,0,0,0,0
108,私立,技專校院,1024,崑山科技大學,學士班(日間),聖克里斯多福及尼維斯,中南美洲,4,4,0,4,4,0,0,0,0,0,0,0,0,0,0
108,私立,技專校院,1024,崑山科技大學,學士班(日間),聖露西亞,中南美洲,4,4,0,4,4,0,0,0,0,0,0,0,0,0,0
108,私立,技專校院,1024,崑山科技大學,學士班(日間),蒙古國,其他亞洲地區,3,2,1,3,2,1,0,0,0,0,0,0,0,0,0
108,私立,技專校院,1024,崑山科技大學,學士班(日間),澳門,港澳,2,0,2,0,0,0,0,0,0,2,0,2,0,0,0
108,私立,技專校院,1024,崑山科技大學,學士班(日間),薩爾瓦多,中南美洲,2,2,0,2,2,0,0,0,0,0,0,0,0,0,0
108,私立,技專校院,1024,崑山科技大學,學士班(日間),巴拿馬共和國,中南美洲,1,1,0,1,1,0,0,0,0,0,0,0,0,0,0
108,私立,技專校院,1024,崑山科技大學,學士班(日間),日本,其他亞洲地區,24,6,18,24,6,18,0,0,0,0,0,0,0,0,0
108,私立,技專校院,1024,崑山科技大學,學士班(日間),史瓦帝尼王國,非洲,13,9,4,13,9,4,0,0,0,0,0,0,0,0,0
108,私立,技專校院,1024,崑山科技大學,學士班(日間),印度尼西亞共和國,東協,47,33,14,44,32,12,3,1,2,0,0,0,0,0,0
108,私立,技專校院,1024,崑山科技大學,學士班(日間),宏都拉斯共和國,中南美洲,8,6,2,8,6,2,0,0,0,0,0,0,0,0,0
108,私立,技專校院,1024,崑山科技大學,學士班(日間),馬來西亞,東協,35,27,8,24,16,8,11,11,0,0,0,0,0,0,0
108,私立,技專校院,1024,崑山科技大學,學士班(日間),諾魯共和國,其他亞洲地區,1,1,0,1,1,0,0,0,0,0,0,0,0,0,0
108,私立,技專校院,1024,崑山科技大學,碩士班(日間),巴拿馬共和國,中南美洲,2,1,1,2,1,1,0,0,0,0,0,0,0,0,0
108,私立,技專校院,1024,崑山科技大學,碩士班(日間),印度,南亞,1,1,0,1,1,0,0,0,0,0,0,0,0,0,0
108,私立,技專校院,1024,崑山科技大學,碩士班(日間),印度尼西亞共和國,東協,1,1,0,1,1,0,0,0,0,0,0,0,0,0,0
108,私立,技專校院,1024,崑山科技大學,碩士班(日間),薩爾瓦多,中南美洲,1,1,0,1,1,0,0,0,0,0,0,0,0,0,0
108,私立,技專校院,1024,崑山科技大學,碩士班(日間),土耳其共和國,其他亞洲地區,1,1,0,1,1,0,0,0,0,0,0,0,0,0,0
108,私立,技專校院,1024,崑山科技大學,碩士班(日間),大陸地區,大陸地區,7,3,4,0,0,0,0,0,0,0,0,0,7,3,4
108,私立,技專校院,1024,崑山科技大學,碩士班(日間),大韓民國(南韓),其他亞洲地區,1,1,0,1,1,0,0,0,0,0,0,0,0,0,0
108,私立,技專校院,1024,崑山科技大學,碩士班(日間),厄瓜多共和國,中南美洲,1,1,0,1,1,0,0,0,0,0,0,0,0,0,0
108,私立,技專校院,1024,崑山科技大學,碩士班(日間),尼加拉瓜,中南美洲,1,1,0,1,1,0,0,0,0,0,0,0,0,0,0
108,私立,技專校院,1024,崑山科技大學,碩士班(日間),宏都拉斯共和國,中南美洲,1,1,0,1,1,0,0,0,0,0,0,0,0,0,0
108,私立,技專校院,1024,崑山科技大學,碩士班(日間),貝里斯,中南美洲,2,2,0,2,2,0,0,0,0,0,0,0,0,0,0
108,私立,技專校院,1024,崑山科技大學,碩士班(日間),香港,港澳,2,1,1,0,0,0,0,0,0,2,1,1,0,0,0
108,私立,技專校院,1024,崑山科技大學,碩士班(日間),智利,中南美洲,1,0,1,1,0,1,0,0,0,0,0,0,0,0,0
108,私立,技專校院,1024,崑山科技大學,碩士班(日間),越南社會主義共和國,東協,1,0,1,1,0,1,0,0,0,0,0,0,0,0,0
108,私立,技專校院,1024,崑山科技大學,碩士班(日間),聖露西亞,中南美洲,1,1,0,1,1,0,0,0,0,0,0,0,0,0,0
108,私立,技專校院,1024,崑山科技大學,博士班,大陸地區,大陸地區,1,0,1,0,0,0,0,0,0,0,0,0,1,0,1
108,私立,技專校院,1024,崑山科技大學,博士班,印度,南亞,1,1,0,1,1,0,0,0,0,0,0,0,0,0,0
108,私立,技專校院,1024,崑山科技大學,博士班,印度尼西亞共和國,東協,2,2,0,2,2,0,0,0,0,0,0,0,0,0,0
108,私立,技專校院,1024,崑山科技大學,博士班,貝里斯,中南美洲,2,1,1,2,1,1,0,0,0,0,0,0,0,0,0
108,私立,技專校院,1025,嘉藥學校財團法人嘉南藥理大學,學士班(日間),巴西聯邦共和國,中南美洲,2,1,1,0,0,0,2,1,1,0,0,0,0,0,0
108,私立,技專校院,1025,嘉藥學校財團法人嘉南藥理大學,學士班(日間),日本,其他亞洲地區,3,0,3,3,0,3,0,0,0,0,0,0,0,0,0
108,私立,技專校院,1025,嘉藥學校財團法人嘉南藥理大學,學士班(日間),大韓民國(南韓),其他亞洲地區,2,2,0,0,0,0,2,2,0,0,0,0,0,0,0
108,私立,技專校院,1025,嘉藥學校財團法人嘉南藥理大學,學士班(日間),巴拉圭,中南美洲,1,1,0,0,0,0,1,1,0,0,0,0,0,0,0
108,私立,技專校院,1025,嘉藥學校財團法人嘉南藥理大學,學士班(日間),印度尼西亞共和國,東協,84,80,4,84,80,4,0,0,0,0,0,0,0,0,0
108,私立,技專校院,1025,嘉藥學校財團法人嘉南藥理大學,學士班(日間),香港,港澳,36,21,15,0,0,0,0,0,0,36,21,15,0,0,0
108,私立,技專校院,1025,嘉藥學校財團法人嘉南藥理大學,學士班(日間),馬來西亞,東協,10,2,8,4,0,4,6,2,4,0,0,0,0,0,0
108,私立,技專校院,1025,嘉藥學校財團法人嘉南藥理大學,學士班(日間),澳門,港澳,3,3,0,0,0,0,0,0,0,3,3,0,0,0,0
108,私立,技專校院,1025,嘉藥學校財團法人嘉南藥理大學,碩士班(日間),越南社會主義共和國,東協,1,0,1,1,0,1,0,0,0,0,0,0,0,0,0
108,私立,技專校院,1025,嘉藥學校財團法人嘉南藥理大學,碩士班(日間),泰國,東協,7,2,5,7,2,5,0,0,0,0,0,0,0,0,0
108,私立,技專校院,1025,嘉藥學校財團法人嘉南藥理大學,碩士班(日間),菲律賓共和國,東協,1,0,1,1,0,1,0,0,0,0,0,0,0,0,0
108,私立,技專校院,1026,樹德科技大學,學士班(日間),大陸地區,大陸地區,98,38,60,0,0,0,0,0,0,0,0,0,98,38,60
108,私立,技專校院,1026,樹德科技大學,學士班(日間),印度尼西亞共和國,東協,74,36,38,69,34,35,5,2,3,0,0,0,0,0,0
108,私立,技專校院,1026,樹德科技大學,學士班(日間),索羅門群島,其他亞洲地區,1,1,0,1,1,0,0,0,0,0,0,0,0,0,0
108,私立,技專校院,1026,樹德科技大學,學士班(日間),馬來西亞,東協,150,64,86,65,33,32,85,31,54,0,0,0,0,0,0
108,私立,技專校院,1026,樹德科技大學,學士班(日間),越南社會主義共和國,東協,10,3,7,5,1,4,5,2,3,0,0,0,0,0,0
108,私立,技專校院,1026,樹德科技大學,學士班(日間),蒙古國,其他亞洲地區,1,0,1,1,0,1,0,0,0,0,0,0,0,0,0
108,私立,技專校院,1026,樹德科技大學,學士班(日間),澳門,港澳,8,4,4,0,0,0,0,0,0,8,4,4,0,0,0
108,私立,技專校院,1026,樹德科技大學,學士班(日間),大韓民國(南韓),其他亞洲地區,1,1,0,1,1,0,0,0,0,0,0,0,0,0,0
108,私立,技專校院,1026,樹德科技大學,學士班(日間),日本,其他亞洲地區,45,17,28,44,17,27,1,0,1,0,0,0,0,0,0
108,私立,技專校院,1026,樹德科技大學,學士班(日間),印度,南亞,1,0,1,1,0,1,0,0,0,0,0,0,0,0,0
108,私立,技專校院,1026,樹德科技大學,學士班(日間),香港,港澳,114,49,65,0,0,0,0,0,0,114,49,65,0,0,0
108,私立,技專校院,1026,樹德科技大學,學士班(日間),緬甸,東協,1,0,1,0,0,0,1,0,1,0,0,0,0,0,0
108,私立,技專校院,1026,樹德科技大學,碩士班(日間),馬來西亞,東協,7,5,2,6,4,2,1,1,0,0,0,0,0,0,0
108,私立,技專校院,1026,樹德科技大學,碩士班(日間),大陸地區,大陸地區,13,10,3,0,0,0,0,0,0,0,0,0,13,10,3
108,私立,技專校院,1026,樹德科技大學,碩士班(日間),印度尼西亞共和國,東協,1,0,1,1,0,1,0,0,0,0,0,0,0,0,0
108,私立,技專校院,1026,樹德科技大學,碩士班(日間),越南社會主義共和國,東協,6,4,2,6,4,2,0,0,0,0,0,0,0,0,0
108,私立,技專校院,1026,樹德科技大學,博士班,馬來西亞,東協,1,1,0,1,1,0,0,0,0,0,0,0,0,0,0
108,私立,技專校院,1026,樹德科技大學,博士班,越南社會主義共和國,東協,1,1,0,1,1,0,0,0,0,0,0,0,0,0,0
108,私立,一般大學,1027,慈濟學校財團法人慈濟大學,學士班(日間),加拿大,北美洲,1,0,1,0,0,0,1,0,1,0,0,0,0,0,0
108,私立,一般大學,1027,慈濟學校財團法人慈濟大學,學士班(日間),史瓦帝尼王國,非洲,1,0,1,1,0,1,0,0,0,0,0,0,0,0,0
108,私立,一般大學,1027,慈濟學校財團法人慈濟大學,學士班(日間),印度尼西亞共和國,東協,38,11,27,34,11,23,4,0,4,0,0,0,0,0,0
108,私立,一般大學,1027,慈濟學校財團法人慈濟大學,學士班(日間),美國,北美洲,2,2,0,0,0,0,2,2,0,0,0,0,0,0,0
108,私立,一般大學,1027,慈濟學校財團法人慈濟大學,學士班(日間),英國,歐洲,1,1,0,1,1,0,0,0,0,0,0,0,0,0,0
108,私立,一般大學,1027,慈濟學校財團法人慈濟大學,學士班(日間),馬來西亞,東協,160,52,108,117,35,82,43,17,26,0,0,0,0,0,0
108,私立,一般大學,1027,慈濟學校財團法人慈濟大學,學士班(日間),新加坡共和國,東協,2,0,2,1,0,1,1,0,1,0,0,0,0,0,0
108,私立,一般大學,1027,慈濟學校財團法人慈濟大學,學士班(日間),大陸地區,大陸地區,11,3,8,0,0,0,0,0,0,0,0,0,11,3,8
108,私立,一般大學,1027,慈濟學校財團法人慈濟大學,學士班(日間),大韓民國(南韓),其他亞洲地區,14,6,8,13,5,8,1,1,0,0,0,0,0,0,0
108,私立,一般大學,1027,慈濟學校財團法人慈濟大學,學士班(日間),法國,歐洲,1,1,0,1,1,0,0,0,0,0,0,0,0,0,0
108,私立,一般大學,1027,慈濟學校財團法人慈濟大學,學士班(日間),香港,港澳,8,3,5,0,0,0,0,0,0,8,3,5,0,0,0
108,私立,一般大學,1027,慈濟學校財團法人慈濟大學,學士班(日間),泰國,東協,6,3,3,6,3,3,0,0,0,0,0,0,0,0,0
108,私立,一般大學,1027,慈濟學校財團法人慈濟大學,學士班(日間),索羅門群島,其他亞洲地區,1,0,1,1,0,1,0,0,0,0,0,0,0,0,0
108,私立,一般大學,1027,慈濟學校財團法人慈濟大學,學士班(日間),越南社會主義共和國,東協,5,1,4,5,1,4,0,0,0,0,0,0,0,0,0
108,私立,一般大學,1027,慈濟學校財團法人慈濟大學,學士班(日間),緬甸,東協,1,0,1,1,0,1,0,0,0,0,0,0,0,0,0
108,私立,一般大學,1027,慈濟學校財團法人慈濟大學,學士班(日間),澳大利亞,其他亞洲地區,1,1,0,0,0,0,1,1,0,0,0,0,0,0,0
108,私立,一般大學,1027,慈濟學校財團法人慈濟大學,學士班(日間),澳門,港澳,14,9,5,0,0,0,0,0,0,14,9,5,0,0,0
108,私立,一般大學,1027,慈濟學校財團法人慈濟大學,碩士班(日間),大陸地區,大陸地區,1,0,1,0,0,0,0,0,0,0,0,0,1,0,1
108,私立,一般大學,1027,慈濟學校財團法人慈濟大學,碩士班(日間),尼泊爾聯邦民主共和國,南亞,1,1,0,1,1,0,0,0,0,0,0,0,0,0,0
108,私立,一般大學,1027,慈濟學校財團法人慈濟大學,碩士班(日間),印度,南亞,8,2,6,8,2,6,0,0,0,0,0,0,0,0,0
108,私立,一般大學,1027,慈濟學校財團法人慈濟大學,碩士班(日間),孟加拉人民共和國,南亞,2,1,1,2,1,1,0,0,0,0,0,0,0,0,0
108,私立,一般大學,1027,慈濟學校財團法人慈濟大學,碩士班(日間),香港,港澳,1,0,1,0,0,0,0,0,0,1,0,1,0,0,0
108,私立,一般大學,1027,慈濟學校財團法人慈濟大學,碩士班(日間),越南社會主義共和國,東協,4,0,4,4,0,4,0,0,0,0,0,0,0,0,0
108,私立,一般大學,1027,慈濟學校財團法人慈濟大學,碩士班(日間),蒙古國,其他亞洲地區,2,0,2,2,0,2,0,0,0,0,0,0,0,0,0
108,私立,一般大學,1027,慈濟學校財團法人慈濟大學,碩士班(日間),澳門,港澳,4,2,2,0,0,0,0,0,0,4,2,2,0,0,0
108,私立,一般大學,1027,慈濟學校財團法人慈濟大學,碩士班(日間),大韓民國(南韓),其他亞洲地區,1,0,1,1,0,1,0,0,0,0,0,0,0,0,0
108,私立,一般大學,1027,慈濟學校財團法人慈濟大學,碩士班(日間),日本,其他亞洲地區,1,1,0,1,1,0,0,0,0,0,0,0,0,0,0
108,私立,一般大學,1027,慈濟學校財團法人慈濟大學,碩士班(日間),印度尼西亞共和國,東協,7,4,3,6,4,2,1,0,1,0,0,0,0,0,0
108,私立,一般大學,1027,慈濟學校財團法人慈濟大學,碩士班(日間),美國,北美洲,1,1,0,0,0,0,1,1,0,0,0,0,0,0,0
108,私立,一般大學,1027,慈濟學校財團法人慈濟大學,碩士班(日間),泰國,東協,2,2,0,2,2,0,0,0,0,0,0,0,0,0,0
108,私立,一般大學,1027,慈濟學校財團法人慈濟大學,碩士班(日間),馬來西亞,東協,14,5,9,13,4,9,1,1,0,0,0,0,0,0,0
108,私立,一般大學,1027,慈濟學校財團法人慈濟大學,博士班,印度,南亞,6,2,4,6,2,4,0,0,0,0,0,0,0,0,0
108,私立,一般大學,1027,慈濟學校財團法人慈濟大學,博士班,印度尼西亞共和國,東協,5,1,4,5,1,4,0,0,0,0,0,0,0,0,0
108,私立,一般大學,1027,慈濟學校財團法人慈濟大學,博士班,香港,港澳,1,1,0,0,0,0,0,0,0,1,1,0,0,0,0
108,私立,一般大學,1027,慈濟學校財團法人慈濟大學,博士班,馬來西亞,東協,3,2,1,2,1,1,1,1,0,0,0,0,0,0,0
108,私立,一般大學,1027,慈濟學校財團法人慈濟大學,博士班,越南社會主義共和國,東協,2,2,0,2,2,0,0,0,0,0,0,0,0,0,0
108,私立,一般大學,1027,慈濟學校財團法人慈濟大學,博士班,緬甸,東協,2,0,2,2,0,2,0,0,0,0,0,0,0,0,0
108,私立,一般大學,1027,慈濟學校財團法人慈濟大學,博士班,尼泊爾聯邦民主共和國,南亞,3,3,0,3,3,0,0,0,0,0,0,0,0,0,0
108,私立,一般大學,1027,慈濟學校財團法人慈濟大學,博士班,孟加拉人民共和國,南亞,1,1,0,1,1,0,0,0,0,0,0,0,0,0,0
108,私立,一般大學,1027,慈濟學校財團法人慈濟大學,博士班,泰國,東協,3,1,2,3,1,2,0,0,0,0,0,0,0,0,0
108,私立,一般大學,1028,臺北醫學大學,學士班(日間),大陸地區,大陸地區,40,13,27,0,0,0,0,0,0,0,0,0,40,13,27
108,私立,一般大學,1028,臺北醫學大學,學士班(日間),大韓民國(南韓),其他亞洲地區,14,4,10,3,0,3,11,4,7,0,0,0,0,0,0
108,私立,一般大學,1028,臺北醫學大學,學士班(日間),巴拉圭,中南美洲,1,0,1,0,0,0,1,0,1,0,0,0,0,0,0
108,私立,一般大學,1028,臺北醫學大學,學士班(日間),加拿大,北美洲,9,6,3,0,0,0,9,6,3,0,0,0,0,0,0
108,私立,一般大學,1028,臺北醫學大學,學士班(日間),伊朗伊斯蘭共和國,其他亞洲地區,1,0,1,0,0,0,1,0,1,0,0,0,0,0,0
108,私立,一般大學,1028,臺北醫學大學,學士班(日間),印度尼西亞共和國,東協,16,7,9,0,0,0,16,7,9,0,0,0,0,0,0
108,私立,一般大學,1028,臺北醫學大學,學士班(日間),香港,港澳,43,23,20,0,0,0,0,0,0,43,23,20,0,0,0
108,私立,一般大學,1028,臺北醫學大學,學士班(日間),馬來西亞,東協,121,30,91,12,1,11,109,29,80,0,0,0,0,0,0
108,私立,一般大學,1028,臺北醫學大學,學士班(日間),越南社會主義共和國,東協,5,2,3,0,0,0,5,2,3,0,0,0,0,0,0
108,私立,一般大學,1028,臺北醫學大學,學士班(日間),澳門,港澳,32,16,16,0,0,0,0,0,0,32,16,16,0,0,0
108,私立,一般大學,1028,臺北醫學大學,學士班(日間),日本,其他亞洲地區,6,3,3,5,2,3,1,1,0,0,0,0,0,0,0
108,私立,一般大學,1028,臺北醫學大學,學士班(日間),美國,北美洲,21,12,9,9,4,5,12,8,4,0,0,0,0,0,0
108,私立,一般大學,1028,臺北醫學大學,學士班(日間),泰國,東協,3,0,3,1,0,1,2,0,2,0,0,0,0,0,0
108,私立,一般大學,1028,臺北醫學大學,學士班(日間),紐西蘭,其他亞洲地區,2,2,0,0,0,0,2,2,0,0,0,0,0,0,0
108,私立,一般大學,1028,臺北醫學大學,學士班(日間),新加坡共和國,東協,9,1,8,0,0,0,9,1,8,0,0,0,0,0,0
108,私立,一般大學,1028,臺北醫學大學,學士班(日間),葡萄牙共和國,歐洲,1,0,1,1,0,1,0,0,0,0,0,0,0,0,0
108,私立,一般大學,1028,臺北醫學大學,碩士班(日間),史瓦帝尼王國,非洲,3,3,0,3,3,0,0,0,0,0,0,0,0,0,0
108,私立,一般大學,1028,臺北醫學大學,碩士班(日間),美國,北美洲,4,4,0,4,4,0,0,0,0,0,0,0,0,0,0
108,私立,一般大學,1028,臺北醫學大學,碩士班(日間),泰國,東協,1,1,0,1,1,0,0,0,0,0,0,0,0,0,0
108,私立,一般大學,1028,臺北醫學大學,碩士班(日間),索馬利蘭共和國,非洲,1,1,0,1,1,0,0,0,0,0,0,0,0,0,0
108,私立,一般大學,1028,臺北醫學大學,碩士班(日間),菲律賓共和國,東協,1,1,0,1,1,0,0,0,0,0,0,0,0,0,0
108,私立,一般大學,1028,臺北醫學大學,碩士班(日間),蒙古國,其他亞洲地區,5,1,4,5,1,4,0,0,0,0,0,0,0,0,0
108,私立,一般大學,1028,臺北醫學大學,碩士班(日間),澳大利亞,其他亞洲地區,1,1,0,1,1,0,0,0,0,0,0,0,0,0,0
108,私立,一般大學,1028,臺北醫學大學,碩士班(日間),大陸地區,大陸地區,3,2,1,0,0,0,0,0,0,0,0,0,3,2,1
108,私立,一般大學,1028,臺北醫學大學,碩士班(日間),加拿大,北美洲,1,1,0,0,0,0,1,1,0,0,0,0,0,0,0
108,私立,一般大學,1028,臺北醫學大學,碩士班(日間),尼加拉瓜,中南美洲,2,1,1,2,1,1,0,0,0,0,0,0,0,0,0
108,私立,一般大學,1028,臺北醫學大學,碩士班(日間),瓜地馬拉共和國,中南美洲,2,1,1,2,1,1,0,0,0,0,0,0,0,0,0
108,私立,一般大學,1028,臺北醫學大學,碩士班(日間),印度,南亞,4,0,4,4,0,4,0,0,0,0,0,0,0,0,0
108,私立,一般大學,1028,臺北醫學大學,碩士班(日間),印度尼西亞共和國,東協,26,12,14,26,12,14,0,0,0,0,0,0,0,0,0
108,私立,一般大學,1028,臺北醫學大學,碩士班(日間),宏都拉斯共和國,中南美洲,3,2,1,3,2,1,0,0,0,0,0,0,0,0,0
108,私立,一般大學,1028,臺北醫學大學,碩士班(日間),貝里斯,中南美洲,1,0,1,1,0,1,0,0,0,0,0,0,0,0,0
108,私立,一般大學,1028,臺北醫學大學,碩士班(日間),香港,港澳,6,3,3,0,0,0,0,0,0,6,3,3,0,0,0
108,私立,一般大學,1028,臺北醫學大學,碩士班(日間),海地共和國,中南美洲,3,1,2,3,1,2,0,0,0,0,0,0,0,0,0
108,私立,一般大學,1028,臺北醫學大學,碩士班(日間),馬來西亞,東協,4,1,3,1,0,1,3,1,2,0,0,0,0,0,0
108,私立,一般大學,1028,臺北醫學大學,碩士班(日間),馬拉威共和國,非洲,4,3,1,4,3,1,0,0,0,0,0,0,0,0,0
108,私立,一般大學,1028,臺北醫學大學,碩士班(日間),馬紹爾群島共和國,其他亞洲地區,1,0,1,1,0,1,0,0,0,0,0,0,0,0,0
108,私立,一般大學,1028,臺北醫學大學,碩士班(日間),越南社會主義共和國,東協,18,6,12,18,6,12,0,0,0,0,0,0,0,0,0
108,私立,一般大學,1028,臺北醫學大學,碩士班(日間),新加坡共和國,東協,3,1,2,2,0,2,1,1,0,0,0,0,0,0,0
108,私立,一般大學,1028,臺北醫學大學,碩士班(日間),聖露西亞,中南美洲,1,0,1,1,0,1,0,0,0,0,0,0,0,0,0
108,私立,一般大學,1028,臺北醫學大學,碩士班(日間),葉門共和國,其他亞洲地區,1,0,1,1,0,1,0,0,0,0,0,0,0,0,0
108,私立,一般大學,1028,臺北醫學大學,碩士班(日間),緬甸,東協,1,0,1,1,0,1,0,0,0,0,0,0,0,0,0
108,私立,一般大學,1028,臺北醫學大學,碩士班(日間),澳門,港澳,2,1,1,0,0,0,0,0,0,2,1,1,0,0,0
108,私立,一般大學,1028,臺北醫學大學,博士班,史瓦帝尼王國,非洲,2,2,0,2,2,0,0,0,0,0,0,0,0,0,0
108,私立,一般大學,1028,臺北醫學大學,博士班,瓜地馬拉共和國,中南美洲,1,1,0,1,1,0,0,0,0,0,0,0,0,0,0
108,私立,一般大學,1028,臺北醫學大學,博士班,甘比亞共和國,非洲,4,4,0,4,4,0,0,0,0,0,0,0,0,0,0
108,私立,一般大學,1028,臺北醫學大學,博士班,貝里斯,中南美洲,1,0,1,1,0,1,0,0,0,0,0,0,0,0,0
108,私立,一般大學,1028,臺北醫學大學,博士班,奈及利亞聯邦共和國,非洲,3,2,1,3,2,1,0,0,0,0,0,0,0,0,0
108,私立,一般大學,1028,臺北醫學大學,博士班,孟加拉人民共和國,南亞,3,2,1,3,2,1,0,0,0,0,0,0,0,0,0
108,私立,一般大學,1028,臺北醫學大學,博士班,美國,北美洲,1,1,0,1,1,0,0,0,0,0,0,0,0,0,0
108,私立,一般大學,1028,臺北醫學大學,博士班,泰國,東協,7,1,6,7,1,6,0,0,0,0,0,0,0,0,0
108,私立,一般大學,1028,臺北醫學大學,博士班,越南社會主義共和國,東協,36,23,13,36,23,13,0,0,0,0,0,0,0,0,0
108,私立,一般大學,1028,臺北醫學大學,博士班,獅子山共和國,非洲,2,1,1,2,1,1,0,0,0,0,0,0,0,0,0
108,私立,一般大學,1028,臺北醫學大學,博士班,澳門,港澳,1,1,0,0,0,0,0,0,0,1,1,0,0,0,0
108,私立,一般大學,1028,臺北醫學大學,博士班,大陸地區,大陸地區,2,2,0,0,0,0,0,0,0,0,0,0,2,2,0
108,私立,一般大學,1028,臺北醫學大學,博士班,大韓民國(南韓),其他亞洲地區,1,0,1,1,0,1,0,0,0,0,0,0,0,0,0
108,私立,一般大學,1028,臺北醫學大學,博士班,巴基斯坦,南亞,1,1,0,1,1,0,0,0,0,0,0,0,0,0,0
108,私立,一般大學,1028,臺北醫學大學,博士班,布吉納法索,非洲,5,4,1,5,4,1,0,0,0,0,0,0,0,0,0
108,私立,一般大學,1028,臺北醫學大學,博士班,印度,南亞,22,12,10,22,12,10,0,0,0,0,0,0,0,0,0
108,私立,一般大學,1028,臺北醫學大學,博士班,印度尼西亞共和國,東協,69,32,37,69,32,37,0,0,0,0,0,0,0,0,0
108,私立,一般大學,1028,臺北醫學大學,博士班,西班牙王國,歐洲,1,1,0,1,1,0,0,0,0,0,0,0,0,0,0
108,私立,一般大學,1028,臺北醫學大學,博士班,俄羅斯聯邦,其他亞洲地區,2,1,1,2,1,1,0,0,0,0,0,0,0,0,0
108,私立,一般大學,1028,臺北醫學大學,博士班,南非共和國,非洲,1,1,0,1,1,0,0,0,0,0,0,0,0,0,0
108,私立,一般大學,1028,臺北醫學大學,博士班,約旦哈什米王國,其他亞洲地區,1,1,0,1,1,0,0,0,0,0,0,0,0,0,0
108,私立,一般大學,1028,臺北醫學大學,博士班,香港,港澳,1,1,0,0,0,0,0,0,0,1,1,0,0,0,0
108,私立,一般大學,1028,臺北醫學大學,博士班,馬來西亞,東協,3,2,1,1,1,0,2,1,1,0,0,0,0,0,0
108,私立,一般大學,1028,臺北醫學大學,博士班,馬拉威共和國,非洲,7,4,3,7,4,3,0,0,0,0,0,0,0,0,0
108,私立,一般大學,1028,臺北醫學大學,博士班,喀麥隆共和國,非洲,1,0,1,1,0,1,0,0,0,0,0,0,0,0,0
108,私立,一般大學,1028,臺北醫學大學,博士班,聖文森(及格瑞那丁),中南美洲,1,0,1,1,0,1,0,0,0,0,0,0,0,0,0
108,私立,一般大學,1028,臺北醫學大學,博士班,聖克里斯多福及尼維斯,中南美洲,1,1,0,1,1,0,0,0,0,0,0,0,0,0,0
108,私立,一般大學,1028,臺北醫學大學,博士班,蒙古國,其他亞洲地區,8,2,6,8,2,6,0,0,0,0,0,0,0,0,0
108,私立,一般大學,1029,中山醫學大學,學士班(日間),巴拉圭,中南美洲,1,0,1,0,0,0,1,0,1,0,0,0,0,0,0
108,私立,一般大學,1029,中山醫學大學,學士班(日間),美國,北美洲,4,2,2,0,0,0,4,2,2,0,0,0,0,0,0
108,私立,一般大學,1029,中山醫學大學,學士班(日間),泰國,東協,1,0,1,0,0,0,1,0,1,0,0,0,0,0,0
108,私立,一般大學,1029,中山醫學大學,學士班(日間),馬來西亞,東協,72,21,51,3,1,2,69,20,49,0,0,0,0,0,0
108,私立,一般大學,1029,中山醫學大學,學士班(日間),越南社會主義共和國,東協,2,0,2,0,0,0,2,0,2,0,0,0,0,0,0
108,私立,一般大學,1029,中山醫學大學,學士班(日間),大陸地區,大陸地區,25,12,13,0,0,0,0,0,0,0,0,0,25,12,13
108,私立,一般大學,1029,中山醫學大學,學士班(日間),大韓民國(南韓),其他亞洲地區,4,2,2,0,0,0,4,2,2,0,0,0,0,0,0
108,私立,一般大學,1029,中山醫學大學,學士班(日間),日本,其他亞洲地區,1,0,1,0,0,0,1,0,1,0,0,0,0,0,0
108,私立,一般大學,1029,中山醫學大學,學士班(日間),加拿大,北美洲,6,3,3,0,0,0,6,3,3,0,0,0,0,0,0
108,私立,一般大學,1029,中山醫學大學,學士班(日間),印度尼西亞共和國,東協,5,1,4,0,0,0,5,1,4,0,0,0,0,0,0
108,私立,一般大學,1029,中山醫學大學,學士班(日間),南非共和國,非洲,1,1,0,0,0,0,1,1,0,0,0,0,0,0,0
108,私立,一般大學,1029,中山醫學大學,學士班(日間),香港,港澳,38,17,21,0,0,0,0,0,0,38,17,21,0,0,0
108,私立,一般大學,1029,中山醫學大學,學士班(日間),新加坡共和國,東協,3,1,2,0,0,0,3,1,2,0,0,0,0,0,0
108,私立,一般大學,1029,中山醫學大學,學士班(日間),緬甸,東協,3,1,2,0,0,0,3,1,2,0,0,0,0,0,0
108,私立,一般大學,1029,中山醫學大學,學士班(日間),澳門,港澳,88,33,55,0,0,0,0,0,0,88,33,55,0,0,0
108,私立,一般大學,1029,中山醫學大學,碩士班(日間),大陸地區,大陸地區,5,2,3,0,0,0,0,0,0,0,0,0,5,2,3
108,私立,一般大學,1029,中山醫學大學,碩士班(日間),澳門,港澳,3,0,3,0,0,0,0,0,0,3,0,3,0,0,0
108,私立,一般大學,1029,中山醫學大學,碩士班(日間),史瓦帝尼王國,非洲,1,0,1,1,0,1,0,0,0,0,0,0,0,0,0
108,私立,一般大學,1029,中山醫學大學,碩士班(日間),馬來西亞,東協,8,4,4,1,0,1,7,4,3,0,0,0,0,0,0
108,私立,一般大學,1029,中山醫學大學,博士班,馬來西亞,東協,6,4,2,0,0,0,6,4,2,0,0,0,0,0,0
108,私立,一般大學,1029,中山醫學大學,博士班,加拿大,北美洲,1,1,0,0,0,0,1,1,0,0,0,0,0,0,0
108,私立,一般大學,1029,中山醫學大學,博士班,白俄羅斯共和國,其他亞洲地區,1,0,1,1,0,1,0,0,0,0,0,0,0,0,0
108,私立,一般大學,1029,中山醫學大學,博士班,印度尼西亞共和國,東協,1,1,0,0,0,0,1,1,0,0,0,0,0,0,0
108,私立,技專校院,1030,龍華科技大學,學士班(日間),大韓民國(南韓),其他亞洲地區,1,0,1,1,0,1,0,0,0,0,0,0,0,0,0
108,私立,技專校院,1030,龍華科技大學,學士班(日間),泰國,東協,1,0,1,1,0,1,0,0,0,0,0,0,0,0,0
108,私立,技專校院,1030,龍華科技大學,學士班(日間),馬來西亞,東協,72,63,9,61,54,7,11,9,2,0,0,0,0,0,0
108,私立,技專校院,1030,龍華科技大學,學士班(日間),菲律賓共和國,東協,1,0,1,0,0,0,1,0,1,0,0,0,0,0,0
108,私立,技專校院,1030,龍華科技大學,學士班(日間),越南社會主義共和國,東協,526,253,273,452,212,240,74,41,33,0,0,0,0,0,0
108,私立,技專校院,1030,龍華科技大學,學士班(日間),大陸地區,大陸地區,25,17,8,0,0,0,0,0,0,0,0,0,25,17,8
108,私立,技專校院,1030,龍華科技大學,學士班(日間),印度尼西亞共和國,東協,93,74,19,80,66,14,13,8,5,0,0,0,0,0,0
108,私立,技專校院,1030,龍華科技大學,學士班(日間),香港,港澳,30,21,9,0,0,0,0,0,0,30,21,9,0,0,0
108,私立,技專校院,1030,龍華科技大學,學士班(日間),緬甸,東協,3,1,2,0,0,0,3,1,2,0,0,0,0,0,0
108,私立,技專校院,1030,龍華科技大學,碩士班(日間),印度尼西亞共和國,東協,1,1,0,1,1,0,0,0,0,0,0,0,0,0,0
108,私立,技專校院,1030,龍華科技大學,碩士班(日間),香港,港澳,3,1,2,0,0,0,0,0,0,3,1,2,0,0,0
108,私立,技專校院,1030,龍華科技大學,碩士班(日間),馬來西亞,東協,1,0,1,1,0,1,0,0,0,0,0,0,0,0,0
108,私立,技專校院,1030,龍華科技大學,碩士班(日間),越南社會主義共和國,東協,35,16,19,35,16,19,0,0,0,0,0,0,0,0,0
108,私立,技專校院,1031,輔英科技大學,學士班(日間),西班牙王國,歐洲,2,1,1,2,1,1,0,0,0,0,0,0,0,0,0
108,私立,技專校院,1031,輔英科技大學,學士班(日間),香港,港澳,26,11,15,0,0,0,0,0,0,26,11,15,0,0,0
108,私立,技專校院,1031,輔英科技大學,學士班(日間),馬來西亞,東協,15,5,10,1,0,1,14,5,9,0,0,0,0,0,0
108,私立,技專校院,1031,輔英科技大學,學士班(日間),馬拉威共和國,非洲,3,0,3,3,0,3,0,0,0,0,0,0,0,0,0
108,私立,技專校院,1031,輔英科技大學,學士班(日間),越南社會主義共和國,東協,59,14,45,35,8,27,24,6,18,0,0,0,0,0,0
108,私立,技專校院,1031,輔英科技大學,學士班(日間),蒙古國,其他亞洲地區,1,0,1,1,0,1,0,0,0,0,0,0,0,0,0
108,私立,技專校院,1031,輔英科技大學,學士班(日間),澳門,港澳,26,14,12,0,0,0,0,0,0,26,14,12,0,0,0
108,私立,技專校院,1031,輔英科技大學,碩士班(日間),越南社會主義共和國,東協,6,4,2,6,4,2,0,0,0,0,0,0,0,0,0
108,私立,技專校院,1032,明新學校財團法人明新科技大學,學士班(日間),大陸地區,大陸地區,1,1,0,0,0,0,0,0,0,0,0,0,1,1,0
108,私立,技專校院,1032,明新學校財團法人明新科技大學,學士班(日間),大韓民國(南韓),其他亞洲地區,15,6,9,15,6,9,0,0,0,0,0,0,0,0,0
108,私立,技專校院,1032,明新學校財團法人明新科技大學,學士班(日間),印度尼西亞共和國,東協,24,11,13,21,10,11,3,1,2,0,0,0,0,0,0
108,私立,技專校院,1032,明新學校財團法人明新科技大學,學士班(日間),馬來西亞,東協,17,12,5,11,8,3,6,4,2,0,0,0,0,0,0
108,私立,技專校院,1032,明新學校財團法人明新科技大學,學士班(日間),菲律賓共和國,東協,68,18,50,68,18,50,0,0,0,0,0,0,0,0,0
108,私立,技專校院,1032,明新學校財團法人明新科技大學,學士班(日間),越南社會主義共和國,東協,1007,567,440,985,560,425,22,7,15,0,0,0,0,0,0
108,私立,技專校院,1032,明新學校財團法人明新科技大學,學士班(日間),新加坡共和國,東協,1,1,0,0,0,0,1,1,0,0,0,0,0,0,0
108,私立,技專校院,1032,明新學校財團法人明新科技大學,學士班(日間),蒙古國,其他亞洲地區,5,2,3,5,2,3,0,0,0,0,0,0,0,0,0
108,私立,技專校院,1032,明新學校財團法人明新科技大學,學士班(日間),日本,其他亞洲地區,23,15,8,23,15,8,0,0,0,0,0,0,0,0,0
108,私立,技專校院,1032,明新學校財團法人明新科技大學,學士班(日間),香港,港澳,9,5,4,0,0,0,0,0,0,9,5,4,0,0,0
108,私立,技專校院,1032,明新學校財團法人明新科技大學,學士班(日間),海地共和國,中南美洲,1,1,0,1,1,0,0,0,0,0,0,0,0,0,0
108,私立,技專校院,1032,明新學校財團法人明新科技大學,學士班(日間),緬甸,東協,34,13,21,32,13,19,2,0,2,0,0,0,0,0,0
108,私立,技專校院,1032,明新學校財團法人明新科技大學,碩士班(日間),印度,南亞,1,1,0,1,1,0,0,0,0,0,0,0,0,0,0
108,私立,技專校院,1032,明新學校財團法人明新科技大學,碩士班(日間),俄羅斯聯邦,其他亞洲地區,1,0,1,1,0,1,0,0,0,0,0,0,0,0,0
108,私立,技專校院,1032,明新學校財團法人明新科技大學,碩士班(日間),烏克蘭,其他亞洲地區,1,0,1,1,0,1,0,0,0,0,0,0,0,0,0
108,私立,技專校院,1032,明新學校財團法人明新科技大學,碩士班(日間),菲律賓共和國,東協,8,6,2,8,6,2,0,0,0,0,0,0,0,0,0
108,私立,技專校院,1032,明新學校財團法人明新科技大學,碩士班(日間),越南社會主義共和國,東協,29,8,21,29,8,21,0,0,0,0,0,0,0,0,0
108,私立,技專校院,1032,明新學校財團法人明新科技大學,碩士班(日間),蒙古國,其他亞洲地區,2,1,1,2,1,1,0,0,0,0,0,0,0,0,0
108,私立,一般大學,1033,長榮大學,學士班(日間),大陸地區,大陸地區,11,4,7,0,0,0,0,0,0,0,0,0,11,4,7
108,私立,一般大學,1033,長榮大學,學士班(日間),大韓民國(南韓),其他亞洲地區,4,3,1,3,3,0,1,0,1,0,0,0,0,0,0
108,私立,一般大學,1033,長榮大學,學士班(日間),印度尼西亞共和國,東協,34,14,20,4,1,3,30,13,17,0,0,0,0,0,0
108,私立,一般大學,1033,長榮大學,學士班(日間),南非共和國,非洲,1,0,1,0,0,0,1,0,1,0,0,0,0,0,0
108,私立,一般大學,1033,長榮大學,學士班(日間),香港,港澳,43,20,23,0,0,0,0,0,0,43,20,23,0,0,0
108,私立,一般大學,1033,長榮大學,學士班(日間),馬來西亞,東協,115,54,61,19,9,10,96,45,51,0,0,0,0,0,0
108,私立,一般大學,1033,長榮大學,學士班(日間),蒙古國,其他亞洲地區,6,4,2,6,4,2,0,0,0,0,0,0,0,0,0
108,私立,一般大學,1033,長榮大學,學士班(日間),日本,其他亞洲地區,39,13,26,38,13,25,1,0,1,0,0,0,0,0,0
108,私立,一般大學,1033,長榮大學,學士班(日間),史瓦帝尼王國,非洲,2,1,1,2,1,1,0,0,0,0,0,0,0,0,0
108,私立,一般大學,1033,長榮大學,學士班(日間),坦尚尼亞聯合共和國,非洲,29,12,17,29,12,17,0,0,0,0,0,0,0,0,0
108,私立,一般大學,1033,長榮大學,學士班(日間),孟加拉人民共和國,南亞,1,0,1,1,0,1,0,0,0,0,0,0,0,0,0
108,私立,一般大學,1033,長榮大學,學士班(日間),阿爾及利亞人民民主共和國,非洲,1,1,0,1,1,0,0,0,0,0,0,0,0,0,0
108,私立,一般大學,1033,長榮大學,學士班(日間),美國,北美洲,2,0,2,2,0,2,0,0,0,0,0,0,0,0,0
108,私立,一般大學,1033,長榮大學,學士班(日間),烏干達共和國,非洲,2,2,0,2,2,0,0,0,0,0,0,0,0,0,0
108,私立,一般大學,1033,長榮大學,學士班(日間),索羅門群島,其他亞洲地區,1,0,1,1,0,1,0,0,0,0,0,0,0,0,0
108,私立,一般大學,1033,長榮大學,學士班(日間),越南社會主義共和國,東協,2,1,1,2,1,1,0,0,0,0,0,0,0,0,0
108,私立,一般大學,1033,長榮大學,學士班(日間),義大利共和國,歐洲,1,1,0,1,1,0,0,0,0,0,0,0,0,0,0
108,私立,一般大學,1033,長榮大學,學士班(日間),蒲隆地共和國,非洲,14,10,4,14,10,4,0,0,0,0,0,0,0,0,0
108,私立,一般大學,1033,長榮大學,學士班(日間),緬甸,東協,1,1,0,0,0,0,1,1,0,0,0,0,0,0,0
108,私立,一般大學,1033,長榮大學,學士班(日間),澳門,港澳,25,15,10,0,0,0,0,0,0,25,15,10,0,0,0
108,私立,一般大學,1033,長榮大學,碩士班(日間),貝里斯,中南美洲,2,0,2,2,0,2,0,0,0,0,0,0,0,0,0
108,私立,一般大學,1033,長榮大學,碩士班(日間),泰國,東協,2,0,2,2,0,2,0,0,0,0,0,0,0,0,0
108,私立,一般大學,1033,長榮大學,碩士班(日間),瑞典王國,歐洲,1,1,0,1,1,0,0,0,0,0,0,0,0,0,0
108,私立,一般大學,1033,長榮大學,碩士班(日間),印度,南亞,2,2,0,2,2,0,0,0,0,0,0,0,0,0,0
108,私立,一般大學,1033,長榮大學,碩士班(日間),印度尼西亞共和國,東協,3,1,2,2,0,2,1,1,0,0,0,0,0,0,0
108,私立,一般大學,1033,長榮大學,碩士班(日間),香港,港澳,1,0,1,0,0,0,0,0,0,1,0,1,0,0,0
108,私立,一般大學,1033,長榮大學,碩士班(日間),馬來西亞,東協,2,1,1,1,0,1,1,1,0,0,0,0,0,0,0
108,私立,一般大學,1033,長榮大學,碩士班(日間),馬拉威共和國,非洲,1,1,0,1,1,0,0,0,0,0,0,0,0,0,0
108,私立,一般大學,1033,長榮大學,碩士班(日間),越南社會主義共和國,東協,6,2,4,6,2,4,0,0,0,0,0,0,0,0,0
108,私立,一般大學,1033,長榮大學,碩士班(日間),蒙古國,其他亞洲地區,1,1,0,1,1,0,0,0,0,0,0,0,0,0,0
108,私立,一般大學,1033,長榮大學,博士班,大陸地區,大陸地區,1,1,0,0,0,0,0,0,0,0,0,0,1,1,0
108,私立,一般大學,1033,長榮大學,博士班,孟加拉人民共和國,南亞,1,1,0,1,1,0,0,0,0,0,0,0,0,0,0
108,私立,技專校院,1034,弘光科技大學,學士班(日間),馬來西亞,東協,207,87,120,114,56,58,93,31,62,0,0,0,0,0,0
108,私立,技專校院,1034,弘光科技大學,學士班(日間),越南社會主義共和國,東協,3,1,2,2,0,2,1,1,0,0,0,0,0,0,0
108,私立,技專校院,1034,弘光科技大學,學士班(日間),蒙古國,其他亞洲地區,1,0,1,1,0,1,0,0,0,0,0,0,0,0,0
108,私立,技專校院,1034,弘光科技大學,學士班(日間),澳門,港澳,52,26,26,0,0,0,0,0,0,52,26,26,0,0,0
108,私立,技專校院,1034,弘光科技大學,學士班(日間),大陸地區,大陸地區,9,6,3,0,0,0,0,0,0,0,0,0,9,6,3
108,私立,技專校院,1034,弘光科技大學,學士班(日間),日本,其他亞洲地區,6,2,4,6,2,4,0,0,0,0,0,0,0,0,0
108,私立,技專校院,1034,弘光科技大學,學士班(日間),加拿大,北美洲,1,1,0,1,1,0,0,0,0,0,0,0,0,0,0
108,私立,技專校院,1034,弘光科技大學,學士班(日間),印度尼西亞共和國,東協,5,0,5,2,0,2,3,0,3,0,0,0,0,0,0
108,私立,技專校院,1034,弘光科技大學,學士班(日間),柬埔寨王國,東協,1,0,1,1,0,1,0,0,0,0,0,0,0,0,0
108,私立,技專校院,1034,弘光科技大學,學士班(日間),香港,港澳,91,39,52,0,0,0,0,0,0,91,39,52,0,0,0
108,私立,技專校院,1034,弘光科技大學,碩士班(日間),馬來西亞,東協,5,3,2,5,3,2,0,0,0,0,0,0,0,0,0
108,私立,技專校院,1034,弘光科技大學,博士班,越南社會主義共和國,東協,1,1,0,1,1,0,0,0,0,0,0,0,0,0,0
108,私立,一般大學,1035,中國醫藥大學,學士班(日間),巴西聯邦共和國,中南美洲,1,0,1,0,0,0,1,0,1,0,0,0,0,0,0
108,私立,一般大學,1035,中國醫藥大學,學士班(日間),日本,其他亞洲地區,17,7,10,15,7,8,2,0,2,0,0,0,0,0,0
108,私立,一般大學,1035,中國醫藥大學,學士班(日間),史瓦帝尼王國,非洲,1,0,1,1,0,1,0,0,0,0,0,0,0,0,0
108,私立,一般大學,1035,中國醫藥大學,學士班(日間),美國,北美洲,25,16,9,6,6,0,19,10,9,0,0,0,0,0,0
108,私立,一般大學,1035,中國醫藥大學,學士班(日間),泰國,東協,3,1,2,2,0,2,1,1,0,0,0,0,0,0,0
108,私立,一般大學,1035,中國醫藥大學,學士班(日間),紐西蘭,其他亞洲地區,2,0,2,0,0,0,2,0,2,0,0,0,0,0,0
108,私立,一般大學,1035,中國醫藥大學,學士班(日間),大陸地區,大陸地區,25,6,19,0,0,0,0,0,0,0,0,0,25,6,19
108,私立,一般大學,1035,中國醫藥大學,學士班(日間),大韓民國(南韓),其他亞洲地區,15,6,9,6,4,2,9,2,7,0,0,0,0,0,0
108,私立,一般大學,1035,中國醫藥大學,學士班(日間),加拿大,北美洲,11,3,8,1,0,1,10,3,7,0,0,0,0,0,0
108,私立,一般大學,1035,中國醫藥大學,學士班(日間),印度尼西亞共和國,東協,12,4,8,4,1,3,8,3,5,0,0,0,0,0,0
108,私立,一般大學,1035,中國醫藥大學,學士班(日間),尚比亞共和國,非洲,2,0,2,2,0,2,0,0,0,0,0,0,0,0,0
108,私立,一般大學,1035,中國醫藥大學,學士班(日間),香港,港澳,47,25,22,0,0,0,0,0,0,47,25,22,0,0,0
108,私立,一般大學,1035,中國醫藥大學,學士班(日間),馬來西亞,東協,143,50,93,36,12,24,107,38,69,0,0,0,0,0,0
108,私立,一般大學,1035,中國醫藥大學,學士班(日間),馬拉威共和國,非洲,1,1,0,1,1,0,0,0,0,0,0,0,0,0,0
108,私立,一般大學,1035,中國醫藥大學,學士班(日間),越南社會主義共和國,東協,4,2,2,2,1,1,2,1,1,0,0,0,0,0,0
108,私立,一般大學,1035,中國醫藥大學,學士班(日間),新加坡共和國,東協,15,8,7,3,2,1,12,6,6,0,0,0,0,0,0
108,私立,一般大學,1035,中國醫藥大學,學士班(日間),聖文森(及格瑞那丁),中南美洲,2,1,1,2,1,1,0,0,0,0,0,0,0,0,0
108,私立,一般大學,1035,中國醫藥大學,學士班(日間),聖克里斯多福及尼維斯,中南美洲,1,1,0,1,1,0,0,0,0,0,0,0,0,0,0
108,私立,一般大學,1035,中國醫藥大學,學士班(日間),聖露西亞,中南美洲,1,1,0,1,1,0,0,0,0,0,0,0,0,0,0
108,私立,一般大學,1035,中國醫藥大學,學士班(日間),葡萄牙共和國,歐洲,1,0,1,1,0,1,0,0,0,0,0,0,0,0,0
108,私立,一般大學,1035,中國醫藥大學,學士班(日間),緬甸,東協,7,3,4,0,0,0,7,3,4,0,0,0,0,0,0
108,私立,一般大學,1035,中國醫藥大學,學士班(日間),澳門,港澳,67,38,29,0,0,0,0,0,0,67,38,29,0,0,0
108,私立,一般大學,1035,中國醫藥大學,碩士班(日間),大陸地區,大陸地區,1,0,1,0,0,0,0,0,0,0,0,0,1,0,1
108,私立,一般大學,1035,中國醫藥大學,碩士班(日間),加拿大,北美洲,2,1,1,0,0,0,2,1,1,0,0,0,0,0,0
108,私立,一般大學,1035,中國醫藥大學,碩士班(日間),印度,南亞,2,1,1,2,1,1,0,0,0,0,0,0,0,0,0
108,私立,一般大學,1035,中國醫藥大學,碩士班(日間),印度尼西亞共和國,東協,1,0,1,1,0,1,0,0,0,0,0,0,0,0,0
108,私立,一般大學,1035,中國醫藥大學,碩士班(日間),英國,歐洲,1,1,0,1,1,0,0,0,0,0,0,0,0,0,0
108,私立,一般大學,1035,中國醫藥大學,碩士班(日間),香港,港澳,2,0,2,0,0,0,0,0,0,2,0,2,0,0,0
108,私立,一般大學,1035,中國醫藥大學,碩士班(日間),哥倫比亞共和國,中南美洲,1,0,1,1,0,1,0,0,0,0,0,0,0,0,0
108,私立,一般大學,1035,中國醫藥大學,碩士班(日間),馬來西亞,東協,3,1,2,1,0,1,2,1,1,0,0,0,0,0,0
108,私立,一般大學,1035,中國醫藥大學,碩士班(日間),聖克里斯多福及尼維斯,中南美洲,1,1,0,1,1,0,0,0,0,0,0,0,0,0,0
108,私立,一般大學,1035,中國醫藥大學,碩士班(日間),蒙古國,其他亞洲地區,5,2,3,5,2,3,0,0,0,0,0,0,0,0,0
108,私立,一般大學,1035,中國醫藥大學,碩士班(日間),智利,中南美洲,1,0,1,1,0,1,0,0,0,0,0,0,0,0,0
108,私立,一般大學,1035,中國醫藥大學,碩士班(日間),越南社會主義共和國,東協,15,8,7,15,8,7,0,0,0,0,0,0,0,0,0
108,私立,一般大學,1035,中國醫藥大學,碩士班(日間),墨西哥合眾國,中南美洲,1,1,0,1,1,0,0,0,0,0,0,0,0,0,0
108,私立,一般大學,1035,中國醫藥大學,博士班,巴基斯坦,南亞,1,1,0,1,1,0,0,0,0,0,0,0,0,0,0
108,私立,一般大學,1035,中國醫藥大學,博士班,以色列,其他亞洲地區,2,2,0,2,2,0,0,0,0,0,0,0,0,0,0
108,私立,一般大學,1035,中國醫藥大學,博士班,衣索比亞聯邦民主共和國,非洲,1,1,0,1,1,0,0,0,0,0,0,0,0,0,0
108,私立,一般大學,1035,中國醫藥大學,博士班,泰國,東協,4,1,3,4,1,3,0,0,0,0,0,0,0,0,0
108,私立,一般大學,1035,中國醫藥大學,博士班,秘魯共和國,中南美洲,1,0,1,1,0,1,0,0,0,0,0,0,0,0,0
108,私立,一般大學,1035,中國醫藥大學,博士班,馬來西亞,東協,3,2,1,0,0,0,3,2,1,0,0,0,0,0,0
108,私立,一般大學,1035,中國醫藥大學,博士班,越南社會主義共和國,東協,9,5,4,9,5,4,0,0,0,0,0,0,0,0,0
108,私立,一般大學,1035,中國醫藥大學,博士班,墨西哥合眾國,中南美洲,1,0,1,1,0,1,0,0,0,0,0,0,0,0,0
108,私立,一般大學,1035,中國醫藥大學,博士班,日本,其他亞洲地區,1,1,0,1,1,0,0,0,0,0,0,0,0,0,0
108,私立,一般大學,1035,中國醫藥大學,博士班,印度,南亞,9,9,0,9,9,0,0,0,0,0,0,0,0,0,0
108,私立,一般大學,1035,中國醫藥大學,博士班,印度尼西亞共和國,東協,5,3,2,4,2,2,1,1,0,0,0,0,0,0,0
108,私立,一般大學,1035,中國醫藥大學,博士班,南非共和國,非洲,1,0,1,1,0,1,0,0,0,0,0,0,0,0,0
108,私立,一般大學,1035,中國醫藥大學,博士班,剛果民主共和國,非洲,1,0,1,1,0,1,0,0,0,0,0,0,0,0,0
108,私立,一般大學,1035,中國醫藥大學,博士班,馬拉威共和國,非洲,2,2,0,2,2,0,0,0,0,0,0,0,0,0,0
108,私立,技專校院,1036,健行學校財團法人健行科技大學,學士班(日間),巴基斯坦,南亞,1,1,0,1,1,0,0,0,0,0,0,0,0,0,0
108,私立,技專校院,1036,健行學校財團法人健行科技大學,學士班(日間),印度尼西亞共和國,東協,569,406,163,565,404,161,4,2,2,0,0,0,0,0,0
108,私立,技專校院,1036,健行學校財團法人健行科技大學,學士班(日間),香港,港澳,6,3,3,0,0,0,0,0,0,6,3,3,0,0,0
108,私立,技專校院,1036,健行學校財團法人健行科技大學,學士班(日間),馬來西亞,東協,37,17,20,37,17,20,0,0,0,0,0,0,0,0,0
108,私立,技專校院,1036,健行學校財團法人健行科技大學,學士班(日間),越南社會主義共和國,東協,49,15,34,49,15,34,0,0,0,0,0,0,0,0,0
108,私立,技專校院,1036,健行學校財團法人健行科技大學,學士班(日間),聖文森(及格瑞那丁),中南美洲,2,2,0,2,2,0,0,0,0,0,0,0,0,0,0
108,私立,技專校院,1036,健行學校財團法人健行科技大學,學士班(日間),甘比亞共和國,非洲,1,1,0,1,1,0,0,0,0,0,0,0,0,0,0
108,私立,技專校院,1036,健行學校財團法人健行科技大學,學士班(日間),俄羅斯聯邦,其他亞洲地區,1,0,1,1,0,1,0,0,0,0,0,0,0,0,0
108,私立,技專校院,1036,健行學校財團法人健行科技大學,碩士班(日間),越南社會主義共和國,東協,26,14,12,26,14,12,0,0,0,0,0,0,0,0,0
108,私立,技專校院,1036,健行學校財團法人健行科技大學,碩士班(日間),馬來西亞,東協,2,1,1,1,0,1,1,1,0,0,0,0,0,0,0
108,私立,技專校院,1037,正修學校財團法人正修科技大學,學士班(日間),大陸地區,大陸地區,5,3,2,0,0,0,0,0,0,0,0,0,5,3,2
108,私立,技專校院,1037,正修學校財團法人正修科技大學,學士班(日間),大韓民國(南韓),其他亞洲地區,1,1,0,0,0,0,1,1,0,0,0,0,0,0,0
108,私立,技專校院,1037,正修學校財團法人正修科技大學,學士班(日間),瓜地馬拉共和國,中南美洲,1,1,0,1,1,0,0,0,0,0,0,0,0,0,0
108,私立,技專校院,1037,正修學校財團法人正修科技大學,學士班(日間),美國,北美洲,1,1,0,1,1,0,0,0,0,0,0,0,0,0,0
108,私立,技專校院,1037,正修學校財團法人正修科技大學,學士班(日間),香港,港澳,6,3,3,0,0,0,0,0,0,6,3,3,0,0,0
108,私立,技專校院,1037,正修學校財團法人正修科技大學,學士班(日間),泰國,東協,12,6,6,8,5,3,4,1,3,0,0,0,0,0,0
108,私立,技專校院,1037,正修學校財團法人正修科技大學,學士班(日間),越南社會主義共和國,東協,205,90,115,23,9,14,182,81,101,0,0,0,0,0,0
108,私立,技專校院,1037,正修學校財團法人正修科技大學,學士班(日間),瑞士聯邦,歐洲,1,0,1,1,0,1,0,0,0,0,0,0,0,0,0
108,私立,技專校院,1037,正修學校財團法人正修科技大學,學士班(日間),德意志聯邦共和國,歐洲,1,1,0,1,1,0,0,0,0,0,0,0,0,0,0
108,私立,技專校院,1037,正修學校財團法人正修科技大學,學士班(日間),緬甸,東協,1,0,1,0,0,0,1,0,1,0,0,0,0,0,0
108,私立,技專校院,1037,正修學校財團法人正修科技大學,學士班(日間),澳門,港澳,1,1,0,0,0,0,0,0,0,1,1,0,0,0,0
108,私立,技專校院,1037,正修學校財團法人正修科技大學,學士班(日間),日本,其他亞洲地區,1,1,0,1,1,0,0,0,0,0,0,0,0,0,0
108,私立,技專校院,1037,正修學校財團法人正修科技大學,學士班(日間),加拿大,北美洲,1,1,0,1,1,0,0,0,0,0,0,0,0,0,0
108,私立,技專校院,1037,正修學校財團法人正修科技大學,學士班(日間),印度尼西亞共和國,東協,272,173,99,195,123,72,77,50,27,0,0,0,0,0,0
108,私立,技專校院,1037,正修學校財團法人正修科技大學,學士班(日間),肯亞共和國,非洲,1,1,0,1,1,0,0,0,0,0,0,0,0,0,0
108,私立,技專校院,1037,正修學校財團法人正修科技大學,學士班(日間),挪威王國,歐洲,1,0,1,1,0,1,0,0,0,0,0,0,0,0,0
108,私立,技專校院,1037,正修學校財團法人正修科技大學,學士班(日間),馬來西亞,東協,23,16,7,3,3,0,20,13,7,0,0,0,0,0,0
108,私立,技專校院,1037,正修學校財團法人正修科技大學,碩士班(日間),印度尼西亞共和國,東協,36,11,25,35,10,25,1,1,0,0,0,0,0,0,0
108,私立,技專校院,1037,正修學校財團法人正修科技大學,碩士班(日間),泰國,東協,2,0,2,2,0,2,0,0,0,0,0,0,0,0,0
108,私立,技專校院,1037,正修學校財團法人正修科技大學,碩士班(日間),墨西哥合眾國,中南美洲,1,0,1,1,0,1,0,0,0,0,0,0,0,0,0
108,私立,技專校院,1037,正修學校財團法人正修科技大學,碩士班(日間),印度,南亞,1,1,0,1,1,0,0,0,0,0,0,0,0,0,0
108,私立,技專校院,1038,萬能學校財團法人萬能科技大學,學士班(日間),大陸地區,大陸地區,1,1,0,0,0,0,0,0,0,0,0,0,1,1,0
108,私立,技專校院,1038,萬能學校財團法人萬能科技大學,學士班(日間),奈及利亞聯邦共和國,非洲,1,1,0,1,1,0,0,0,0,0,0,0,0,0,0
108,私立,技專校院,1038,萬能學校財團法人萬能科技大學,學士班(日間),香港,港澳,38,21,17,0,0,0,0,0,0,38,21,17,0,0,0
108,私立,技專校院,1038,萬能學校財團法人萬能科技大學,學士班(日間),越南社會主義共和國,東協,76,25,51,75,24,51,1,1,0,0,0,0,0,0,0
108,私立,技專校院,1038,萬能學校財團法人萬能科技大學,學士班(日間),日本,其他亞洲地區,2,1,1,2,1,1,0,0,0,0,0,0,0,0,0
108,私立,技專校院,1038,萬能學校財團法人萬能科技大學,學士班(日間),印度尼西亞共和國,東協,49,23,26,39,16,23,10,7,3,0,0,0,0,0,0
108,私立,技專校院,1038,萬能學校財團法人萬能科技大學,學士班(日間),泰國,東協,38,16,22,38,16,22,0,0,0,0,0,0,0,0,0
108,私立,技專校院,1038,萬能學校財團法人萬能科技大學,學士班(日間),馬來西亞,東協,167,104,63,163,101,62,4,3,1,0,0,0,0,0,0
108,私立,技專校院,1038,萬能學校財團法人萬能科技大學,碩士班(日間),馬來西亞,東協,7,5,2,7,5,2,0,0,0,0,0,0,0,0,0
108,私立,技專校院,1038,萬能學校財團法人萬能科技大學,碩士班(日間),越南社會主義共和國,東協,4,2,2,4,2,2,0,0,0,0,0,0,0,0,0
108,私立,一般大學,1039,玄奘大學,學士班(日間),印度,南亞,5,3,2,5,3,2,0,0,0,0,0,0,0,0,0
108,私立,一般大學,1039,玄奘大學,學士班(日間),越南社會主義共和國,東協,8,1,7,8,1,7,0,0,0,0,0,0,0,0,0
108,私立,一般大學,1039,玄奘大學,學士班(日間),澳門,港澳,1,1,0,0,0,0,0,0,0,1,1,0,0,0,0
108,私立,一般大學,1039,玄奘大學,學士班(日間),大陸地區,大陸地區,3,0,3,0,0,0,0,0,0,0,0,0,3,0,3
108,私立,一般大學,1039,玄奘大學,學士班(日間),印度尼西亞共和國,東協,1,1,0,1,1,0,0,0,0,0,0,0,0,0,0
108,私立,一般大學,1039,玄奘大學,學士班(日間),南非共和國,非洲,1,1,0,1,1,0,0,0,0,0,0,0,0,0,0
108,私立,一般大學,1039,玄奘大學,學士班(日間),香港,港澳,56,34,22,0,0,0,0,0,0,56,34,22,0,0,0
108,私立,一般大學,1039,玄奘大學,學士班(日間),泰國,東協,1,0,1,1,0,1,0,0,0,0,0,0,0,0,0
108,私立,一般大學,1039,玄奘大學,學士班(日間),馬來西亞,東協,97,36,61,63,23,40,34,13,21,0,0,0,0,0,0
108,私立,一般大學,1039,玄奘大學,碩士班(日間),大陸地區,大陸地區,4,4,0,0,0,0,0,0,0,0,0,0,4,4,0
108,私立,一般大學,1039,玄奘大學,碩士班(日間),加拿大,北美洲,1,0,1,1,0,1,0,0,0,0,0,0,0,0,0
108,私立,一般大學,1039,玄奘大學,碩士班(日間),印度,南亞,4,2,2,4,2,2,0,0,0,0,0,0,0,0,0
108,私立,一般大學,1039,玄奘大學,碩士班(日間),香港,港澳,3,2,1,0,0,0,0,0,0,3,2,1,0,0,0
108,私立,一般大學,1039,玄奘大學,碩士班(日間),馬來西亞,東協,8,5,3,6,5,1,2,0,2,0,0,0,0,0,0
108,私立,一般大學,1039,玄奘大學,碩士班(日間),越南社會主義共和國,東協,7,0,7,7,0,7,0,0,0,0,0,0,0,0,0
108,私立,一般大學,1039,玄奘大學,碩士班(日間),澳門,港澳,4,1,3,0,0,0,0,0,0,4,1,3,0,0,0
108,私立,技專校院,1040,建國科技大學,學士班(日間),大陸地區,大陸地區,2,2,0,0,0,0,0,0,0,0,0,0,2,2,0
108,私立,技專校院,1040,建國科技大學,學士班(日間),香港,港澳,6,2,4,0,0,0,0,0,0,6,2,4,0,0,0
108,私立,技專校院,1040,建國科技大學,學士班(日間),越南社會主義共和國,東協,83,56,27,81,55,26,2,1,1,0,0,0,0,0,0
108,私立,技專校院,1040,建國科技大學,學士班(日間),緬甸,東協,4,2,2,4,2,2,0,0,0,0,0,0,0,0,0
108,私立,技專校院,1040,建國科技大學,學士班(日間),澳門,港澳,2,2,0,0,0,0,0,0,0,2,2,0,0,0,0
108,私立,技專校院,1040,建國科技大學,學士班(日間),大韓民國(南韓),其他亞洲地區,2,2,0,2,2,0,0,0,0,0,0,0,0,0,0
108,私立,技專校院,1040,建國科技大學,學士班(日間),日本,其他亞洲地區,8,3,5,8,3,5,0,0,0,0,0,0,0,0,0
108,私立,技專校院,1040,建國科技大學,學士班(日間),印度尼西亞共和國,東協,97,81,16,96,80,16,1,1,0,0,0,0,0,0,0
108,私立,技專校院,1040,建國科技大學,學士班(日間),馬來西亞,東協,102,83,19,94,80,14,8,3,5,0,0,0,0,0,0
108,私立,技專校院,1040,建國科技大學,學士班(日間),蒙古國,其他亞洲地區,52,31,21,52,31,21,0,0,0,0,0,0,0,0,0
108,私立,技專校院,1040,建國科技大學,碩士班(日間),馬來西亞,東協,1,1,0,1,1,0,0,0,0,0,0,0,0,0,0
108,私立,技專校院,1040,建國科技大學,碩士班(日間),越南社會主義共和國,東協,4,0,4,4,0,4,0,0,0,0,0,0,0,0,0
108,私立,技專校院,1040,建國科技大學,碩士班(日間),蒙古國,其他亞洲地區,8,2,6,8,2,6,0,0,0,0,0,0,0,0,0
108,私立,技專校院,1041,明志科技大學,學士班(日間),大陸地區,大陸地區,18,12,6,0,0,0,0,0,0,0,0,0,18,12,6
108,私立,技專校院,1041,明志科技大學,學士班(日間),馬來西亞,東協,2,1,1,1,0,1,1,1,0,0,0,0,0,0,0
108,私立,技專校院,1041,明志科技大學,學士班(日間),大韓民國(南韓),其他亞洲地區,1,1,0,0,0,0,1,1,0,0,0,0,0,0,0
108,私立,技專校院,1041,明志科技大學,碩士班(日間),甘比亞共和國,非洲,1,0,1,1,0,1,0,0,0,0,0,0,0,0,0
108,私立,技專校院,1041,明志科技大學,碩士班(日間),印度,南亞,16,10,6,16,10,6,0,0,0,0,0,0,0,0,0
108,私立,技專校院,1041,明志科技大學,碩士班(日間),香港,港澳,1,1,0,0,0,0,0,0,0,1,1,0,0,0,0
108,私立,技專校院,1041,明志科技大學,碩士班(日間),泰國,東協,7,4,3,7,4,3,0,0,0,0,0,0,0,0,0
108,私立,技專校院,1041,明志科技大學,碩士班(日間),越南社會主義共和國,東協,18,6,12,18,6,12,0,0,0,0,0,0,0,0,0
108,私立,技專校院,1041,明志科技大學,碩士班(日間),蒙古國,其他亞洲地區,1,1,0,1,1,0,0,0,0,0,0,0,0,0,0
108,私立,技專校院,1041,明志科技大學,碩士班(日間),大陸地區,大陸地區,2,2,0,0,0,0,0,0,0,0,0,0,2,2,0
108,私立,技專校院,1041,明志科技大學,碩士班(日間),印度尼西亞共和國,東協,15,10,5,15,10,5,0,0,0,0,0,0,0,0,0
108,私立,技專校院,1041,明志科技大學,碩士班(日間),馬來西亞,東協,1,1,0,1,1,0,0,0,0,0,0,0,0,0,0
108,私立,技專校院,1041,明志科技大學,博士班,印度,南亞,4,2,2,4,2,2,0,0,0,0,0,0,0,0,0
108,私立,技專校院,1041,明志科技大學,博士班,衣索比亞聯邦民主共和國,非洲,9,9,0,9,9,0,0,0,0,0,0,0,0,0,0
108,私立,技專校院,1041,明志科技大學,博士班,越南社會主義共和國,東協,2,1,1,2,1,1,0,0,0,0,0,0,0,0,0
108,私立,技專校院,1042,高苑科技大學,學士班(日間),馬來西亞,東協,14,10,4,11,7,4,3,3,0,0,0,0,0,0,0
108,私立,技專校院,1042,高苑科技大學,學士班(日間),菲律賓共和國,東協,129,70,59,129,70,59,0,0,0,0,0,0,0,0,0
108,私立,技專校院,1042,高苑科技大學,學士班(日間),越南社會主義共和國,東協,251,132,119,233,126,107,18,6,12,0,0,0,0,0,0
108,私立,技專校院,1042,高苑科技大學,學士班(日間),澳門,港澳,1,0,1,0,0,0,0,0,0,1,0,1,0,0,0
108,私立,技專校院,1042,高苑科技大學,學士班(日間),日本,其他亞洲地區,1,1,0,1,1,0,0,0,0,0,0,0,0,0,0
108,私立,技專校院,1042,高苑科技大學,學士班(日間),印度尼西亞共和國,東協,259,199,60,243,193,50,16,6,10,0,0,0,0,0,0
108,私立,技專校院,1042,高苑科技大學,學士班(日間),柬埔寨王國,東協,15,10,5,15,10,5,0,0,0,0,0,0,0,0,0
108,私立,技專校院,1042,高苑科技大學,學士班(日間),香港,港澳,1,1,0,0,0,0,0,0,0,1,1,0,0,0,0
108,私立,技專校院,1042,高苑科技大學,學士班(日間),泰國,東協,1,0,1,1,0,1,0,0,0,0,0,0,0,0,0
108,私立,技專校院,1042,高苑科技大學,學士班(日間),斯里蘭卡民主社會主義共和國,南亞,2,1,1,2,1,1,0,0,0,0,0,0,0,0,0
108,私立,技專校院,1042,高苑科技大學,學士班(日間),瑞士聯邦,歐洲,1,1,0,1,1,0,0,0,0,0,0,0,0,0,0
108,私立,技專校院,1042,高苑科技大學,學士班(日間),緬甸,東協,23,11,12,23,11,12,0,0,0,0,0,0,0,0,0
108,私立,技專校院,1042,高苑科技大學,碩士班(日間),馬來西亞,東協,1,1,0,1,1,0,0,0,0,0,0,0,0,0,0
108,私立,技專校院,1042,高苑科技大學,碩士班(日間),越南社會主義共和國,東協,1,0,1,1,0,1,0,0,0,0,0,0,0,0,0
108,私立,技專校院,1043,大仁科技大學,學士班(日間),美國,北美洲,2,2,0,0,0,0,2,2,0,0,0,0,0,0,0
108,私立,技專校院,1043,大仁科技大學,學士班(日間),越南社會主義共和國,東協,15,6,9,1,1,0,14,5,9,0,0,0,0,0,0
108,私立,技專校院,1043,大仁科技大學,學士班(日間),大陸地區,大陸地區,1,0,1,0,0,0,0,0,0,0,0,0,1,0,1
108,私立,技專校院,1043,大仁科技大學,學士班(日間),日本,其他亞洲地區,2,0,2,1,0,1,1,0,1,0,0,0,0,0,0
108,私立,技專校院,1043,大仁科技大學,學士班(日間),印度尼西亞共和國,東協,4,2,2,0,0,0,4,2,2,0,0,0,0,0,0
108,私立,技專校院,1043,大仁科技大學,學士班(日間),英國,歐洲,1,0,1,1,0,1,0,0,0,0,0,0,0,0,0
108,私立,技專校院,1043,大仁科技大學,學士班(日間),香港,港澳,80,23,57,0,0,0,0,0,0,80,23,57,0,0,0
108,私立,技專校院,1043,大仁科技大學,學士班(日間),馬來西亞,東協,30,13,17,10,5,5,20,8,12,0,0,0,0,0,0
108,私立,技專校院,1043,大仁科技大學,學士班(日間),緬甸,東協,1,0,1,0,0,0,1,0,1,0,0,0,0,0,0
108,私立,技專校院,1043,大仁科技大學,學士班(日間),澳門,港澳,9,3,6,0,0,0,0,0,0,9,3,6,0,0,0
108,私立,技專校院,1043,大仁科技大學,學士班(日間),諾魯共和國,其他亞洲地區,1,0,1,1,0,1,0,0,0,0,0,0,0,0,0
108,私立,技專校院,1044,聖約翰科技大學,五專,印度尼西亞共和國,東協,1,0,1,1,0,1,0,0,0,0,0,0,0,0,0
108,私立,技專校院,1044,聖約翰科技大學,五專,馬來西亞,東協,1,1,0,0,0,0,1,1,0,0,0,0,0,0,0
108,私立,技專校院,1044,聖約翰科技大學,學士班(日間),大陸地區,大陸地區,15,11,4,0,0,0,0,0,0,0,0,0,15,11,4
108,私立,技專校院,1044,聖約翰科技大學,學士班(日間),日本,其他亞洲地區,2,2,0,0,0,0,2,2,0,0,0,0,0,0,0
108,私立,技專校院,1044,聖約翰科技大學,學士班(日間),加拿大,北美洲,1,1,0,0,0,0,1,1,0,0,0,0,0,0,0
108,私立,技專校院,1044,聖約翰科技大學,學士班(日間),印度尼西亞共和國,東協,1,0,1,1,0,1,0,0,0,0,0,0,0,0,0
108,私立,技專校院,1044,聖約翰科技大學,學士班(日間),馬來西亞,東協,133,89,44,130,88,42,3,1,2,0,0,0,0,0,0
108,私立,技專校院,1044,聖約翰科技大學,學士班(日間),奈及利亞聯邦共和國,非洲,1,0,1,1,0,1,0,0,0,0,0,0,0,0,0
108,私立,技專校院,1044,聖約翰科技大學,學士班(日間),香港,港澳,28,25,3,0,0,0,0,0,0,28,25,3,0,0,0
108,私立,技專校院,1044,聖約翰科技大學,學士班(日間),越南社會主義共和國,東協,134,80,54,134,80,54,0,0,0,0,0,0,0,0,0
108,私立,技專校院,1044,聖約翰科技大學,學士班(日間),澳門,港澳,2,1,1,0,0,0,0,0,0,2,1,1,0,0,0
108,私立,技專校院,1044,聖約翰科技大學,碩士班(日間),越南社會主義共和國,東協,1,1,0,1,1,0,0,0,0,0,0,0,0,0,0
108,私立,技專校院,1044,聖約翰科技大學,碩士班(日間),馬來西亞,東協,24,17,7,24,17,7,0,0,0,0,0,0,0,0,0
108,私立,技專校院,1045,嶺東科技大學,學士班(日間),大陸地區,大陸地區,33,11,22,0,0,0,0,0,0,0,0,0,33,11,22
108,私立,技專校院,1045,嶺東科技大學,學士班(日間),香港,港澳,7,4,3,0,0,0,0,0,0,7,4,3,0,0,0
108,私立,技專校院,1045,嶺東科技大學,學士班(日間),澳門,港澳,4,2,2,0,0,0,0,0,0,4,2,2,0,0,0
108,私立,技專校院,1045,嶺東科技大學,學士班(日間),印度尼西亞共和國,東協,2,0,2,1,0,1,1,0,1,0,0,0,0,0,0
108,私立,技專校院,1045,嶺東科技大學,學士班(日間),馬來西亞,東協,38,20,18,31,15,16,7,5,2,0,0,0,0,0,0
108,私立,技專校院,1045,嶺東科技大學,學士班(日間),越南社會主義共和國,東協,3,2,1,3,2,1,0,0,0,0,0,0,0,0,0
108,私立,技專校院,1045,嶺東科技大學,碩士班(日間),大韓民國(南韓),其他亞洲地區,1,1,0,1,1,0,0,0,0,0,0,0,0,0,0
108,私立,技專校院,1045,嶺東科技大學,碩士班(日間),馬來西亞,東協,2,1,1,1,1,0,1,0,1,0,0,0,0,0,0
108,私立,技專校院,1045,嶺東科技大學,碩士班(日間),越南社會主義共和國,東協,1,0,1,1,0,1,0,0,0,0,0,0,0,0,0
108,私立,技專校院,1045,嶺東科技大學,碩士班(日間),蒙古國,其他亞洲地區,1,0,1,1,0,1,0,0,0,0,0,0,0,0,0
108,私立,技專校院,1045,嶺東科技大學,碩士班(日間),大陸地區,大陸地區,7,5,2,0,0,0,0,0,0,0,0,0,7,5,2
108,私立,技專校院,1045,嶺東科技大學,碩士班(日間),香港,港澳,2,2,0,0,0,0,0,0,0,2,2,0,0,0,0
108,私立,技專校院,1046,中國科技大學,學士班(日間),大陸地區,大陸地區,50,24,26,0,0,0,0,0,0,0,0,0,50,24,26
108,私立,技專校院,1046,中國科技大學,學士班(日間),美國,北美洲,1,1,0,0,0,0,1,1,0,0,0,0,0,0,0
108,私立,技專校院,1046,中國科技大學,學士班(日間),香港,港澳,3,1,2,0,0,0,0,0,0,3,1,2,0,0,0
108,私立,技專校院,1046,中國科技大學,學士班(日間),泰國,東協,1,0,1,1,0,1,0,0,0,0,0,0,0,0,0
108,私立,技專校院,1046,中國科技大學,學士班(日間),越南社會主義共和國,東協,48,4,44,45,3,42,3,1,2,0,0,0,0,0,0
108,私立,技專校院,1046,中國科技大學,學士班(日間),緬甸,東協,2,2,0,0,0,0,2,2,0,0,0,0,0,0,0
108,私立,技專校院,1046,中國科技大學,學士班(日間),澳門,港澳,2,2,0,0,0,0,0,0,0,2,2,0,0,0,0
108,私立,技專校院,1046,中國科技大學,學士班(日間),日本,其他亞洲地區,5,1,4,5,1,4,0,0,0,0,0,0,0,0,0
108,私立,技專校院,1046,中國科技大學,學士班(日間),伊拉克共和國,其他亞洲地區,1,1,0,1,1,0,0,0,0,0,0,0,0,0,0
108,私立,技專校院,1046,中國科技大學,學士班(日間),印度尼西亞共和國,東協,10,7,3,4,3,1,6,4,2,0,0,0,0,0,0
108,私立,技專校院,1046,中國科技大學,學士班(日間),馬來西亞,東協,64,36,28,55,29,26,9,7,2,0,0,0,0,0,0
108,私立,技專校院,1046,中國科技大學,學士班(日間),菲律賓共和國,東協,2,1,1,0,0,0,2,1,1,0,0,0,0,0,0
108,私立,技專校院,1046,中國科技大學,學士班(日間),寮人民民主共和國(寮國),東協,1,0,1,1,0,1,0,0,0,0,0,0,0,0,0
108,私立,技專校院,1046,中國科技大學,碩士班(日間),馬來西亞,東協,2,1,1,1,0,1,1,1,0,0,0,0,0,0,0
108,私立,技專校院,1046,中國科技大學,碩士班(日間),大陸地區,大陸地區,1,0,1,0,0,0,0,0,0,0,0,0,1,0,1
108,私立,技專校院,1046,中國科技大學,碩士班(日間),越南社會主義共和國,東協,1,0,1,1,0,1,0,0,0,0,0,0,0,0,0
108,私立,技專校院,1047,中臺科技大學,二專(日間),越南社會主義共和國,東協,43,19,24,43,19,24,0,0,0,0,0,0,0,0,0
108,私立,技專校院,1047,中臺科技大學,學士班(日間),印度尼西亞共和國,東協,1,0,1,0,0,0,1,0,1,0,0,0,0,0,0
108,私立,技專校院,1047,中臺科技大學,學士班(日間),馬來西亞,東協,16,8,8,12,7,5,4,1,3,0,0,0,0,0,0
108,私立,技專校院,1047,中臺科技大學,學士班(日間),大陸地區,大陸地區,3,1,2,0,0,0,0,0,0,0,0,0,3,1,2
108,私立,技專校院,1047,中臺科技大學,學士班(日間),香港,港澳,4,4,0,0,0,0,0,0,0,4,4,0,0,0,0
108,私立,技專校院,1047,中臺科技大學,學士班(日間),澳門,港澳,1,1,0,0,0,0,0,0,0,1,1,0,0,0,0
108,私立,技專校院,1047,中臺科技大學,碩士班(日間),馬來西亞,東協,1,0,1,1,0,1,0,0,0,0,0,0,0,0,0
108,私立,一般大學,1048,亞洲大學,學士班(日間),大陸地區,大陸地區,55,28,27,0,0,0,0,0,0,0,0,0,55,28,27
108,私立,一般大學,1048,亞洲大學,學士班(日間),日本,其他亞洲地區,32,8,24,32,8,24,0,0,0,0,0,0,0,0,0
108,私立,一般大學,1048,亞洲大學,學士班(日間),甘比亞共和國,非洲,2,2,0,2,2,0,0,0,0,0,0,0,0,0,0
108,私立,一般大學,1048,亞洲大學,學士班(日間),印度,南亞,2,0,2,2,0,2,0,0,0,0,0,0,0,0,0
108,私立,一般大學,1048,亞洲大學,學士班(日間),印度尼西亞共和國,東協,60,20,40,51,18,33,9,2,7,0,0,0,0,0,0
108,私立,一般大學,1048,亞洲大學,學士班(日間),宏都拉斯共和國,中南美洲,1,0,1,1,0,1,0,0,0,0,0,0,0,0,0
108,私立,一般大學,1048,亞洲大學,學士班(日間),香港,港澳,45,23,22,0,0,0,0,0,0,45,23,22,0,0,0
108,私立,一般大學,1048,亞洲大學,學士班(日間),泰國,東協,2,1,1,2,1,1,0,0,0,0,0,0,0,0,0
108,私立,一般大學,1048,亞洲大學,學士班(日間),智利,中南美洲,1,1,0,0,0,0,1,1,0,0,0,0,0,0,0
108,私立,一般大學,1048,亞洲大學,學士班(日間),大韓民國(南韓),其他亞洲地區,1,1,0,1,1,0,0,0,0,0,0,0,0,0,0
108,私立,一般大學,1048,亞洲大學,學士班(日間),尼泊爾聯邦民主共和國,南亞,1,1,0,1,1,0,0,0,0,0,0,0,0,0,0
108,私立,一般大學,1048,亞洲大學,學士班(日間),瓜地馬拉共和國,中南美洲,1,0,1,1,0,1,0,0,0,0,0,0,0,0,0
108,私立,一般大學,1048,亞洲大學,學士班(日間),南非共和國,非洲,1,1,0,1,1,0,0,0,0,0,0,0,0,0,0
108,私立,一般大學,1048,亞洲大學,學士班(日間),索羅門群島,其他亞洲地區,1,0,1,1,0,1,0,0,0,0,0,0,0,0,0
108,私立,一般大學,1048,亞洲大學,學士班(日間),馬來西亞,東協,36,13,23,6,2,4,30,11,19,0,0,0,0,0,0
108,私立,一般大學,1048,亞洲大學,學士班(日間),越南社會主義共和國,東協,11,4,7,9,3,6,2,1,1,0,0,0,0,0,0
108,私立,一般大學,1048,亞洲大學,學士班(日間),蒙古國,其他亞洲地區,100,35,65,100,35,65,0,0,0,0,0,0,0,0,0
108,私立,一般大學,1048,亞洲大學,學士班(日間),澳大利亞,其他亞洲地區,1,1,0,1,1,0,0,0,0,0,0,0,0,0,0
108,私立,一般大學,1048,亞洲大學,學士班(日間),澳門,港澳,22,8,14,0,0,0,0,0,0,22,8,14,0,0,0
108,私立,一般大學,1048,亞洲大學,學士班(日間),賴索托王國,非洲,1,0,1,1,0,1,0,0,0,0,0,0,0,0,0
108,私立,一般大學,1048,亞洲大學,碩士班(日間),巴基斯坦,南亞,2,2,0,2,2,0,0,0,0,0,0,0,0,0,0
108,私立,一般大學,1048,亞洲大學,碩士班(日間),美國,北美洲,1,1,0,1,1,0,0,0,0,0,0,0,0,0,0
108,私立,一般大學,1048,亞洲大學,碩士班(日間),英國,歐洲,1,1,0,1,1,0,0,0,0,0,0,0,0,0,0
108,私立,一般大學,1048,亞洲大學,碩士班(日間),索馬利蘭共和國,非洲,1,1,0,1,1,0,0,0,0,0,0,0,0,0,0
108,私立,一般大學,1048,亞洲大學,碩士班(日間),馬來西亞,東協,7,5,2,4,3,1,3,2,1,0,0,0,0,0,0
108,私立,一般大學,1048,亞洲大學,碩士班(日間),菲律賓共和國,東協,3,1,2,3,1,2,0,0,0,0,0,0,0,0,0
108,私立,一般大學,1048,亞洲大學,碩士班(日間),越南社會主義共和國,東協,3,0,3,3,0,3,0,0,0,0,0,0,0,0,0
108,私立,一般大學,1048,亞洲大學,碩士班(日間),蒙古國,其他亞洲地區,17,3,14,17,3,14,0,0,0,0,0,0,0,0,0
108,私立,一般大學,1048,亞洲大學,碩士班(日間),澳門,港澳,4,1,3,0,0,0,0,0,0,4,1,3,0,0,0
108,私立,一般大學,1048,亞洲大學,碩士班(日間),大陸地區,大陸地區,7,5,2,0,0,0,0,0,0,0,0,0,7,5,2
108,私立,一般大學,1048,亞洲大學,碩士班(日間),布吉納法索,非洲,1,1,0,1,1,0,0,0,0,0,0,0,0,0,0
108,私立,一般大學,1048,亞洲大學,碩士班(日間),甘比亞共和國,非洲,5,5,0,5,5,0,0,0,0,0,0,0,0,0,0
108,私立,一般大學,1048,亞洲大學,碩士班(日間),印度,南亞,13,7,6,13,7,6,0,0,0,0,0,0,0,0,0
108,私立,一般大學,1048,亞洲大學,碩士班(日間),印度尼西亞共和國,東協,43,16,27,43,16,27,0,0,0,0,0,0,0,0,0
108,私立,一般大學,1048,亞洲大學,碩士班(日間),迦納共和國,非洲,1,1,0,1,1,0,0,0,0,0,0,0,0,0,0
108,私立,一般大學,1048,亞洲大學,碩士班(日間),香港,港澳,1,0,1,0,0,0,0,0,0,1,0,1,0,0,0
108,私立,一般大學,1048,亞洲大學,碩士班(日間),泰國,東協,7,0,7,7,0,7,0,0,0,0,0,0,0,0,0
108,私立,一般大學,1048,亞洲大學,碩士班(日間),納米比亞共和國,非洲,1,1,0,1,1,0,0,0,0,0,0,0,0,0,0
108,私立,一般大學,1048,亞洲大學,碩士班(日間),荷蘭王國,歐洲,1,1,0,1,1,0,0,0,0,0,0,0,0,0,0
108,私立,一般大學,1048,亞洲大學,碩士班(日間),瑞士聯邦,歐洲,1,1,0,1,1,0,0,0,0,0,0,0,0,0,0
108,私立,一般大學,1048,亞洲大學,碩士班(日間),盧安達共和國,非洲,1,1,0,1,1,0,0,0,0,0,0,0,0,0,0
108,私立,一般大學,1048,亞洲大學,博士班,土耳其共和國,其他亞洲地區,1,1,0,1,1,0,0,0,0,0,0,0,0,0,0
108,私立,一般大學,1048,亞洲大學,博士班,大陸地區,大陸地區,13,5,8,0,0,0,0,0,0,0,0,0,13,5,8
108,私立,一般大學,1048,亞洲大學,博士班,甘比亞共和國,非洲,3,3,0,3,3,0,0,0,0,0,0,0,0,0,0
108,私立,一般大學,1048,亞洲大學,博士班,印度尼西亞共和國,東協,36,26,10,36,26,10,0,0,0,0,0,0,0,0,0
108,私立,一般大學,1048,亞洲大學,博士班,衣索比亞聯邦民主共和國,非洲,1,1,0,1,1,0,0,0,0,0,0,0,0,0,0
108,私立,一般大學,1048,亞洲大學,博士班,泰國,東協,6,3,3,6,3,3,0,0,0,0,0,0,0,0,0
108,私立,一般大學,1048,亞洲大學,博士班,越南社會主義共和國,東協,9,6,3,9,6,3,0,0,0,0,0,0,0,0,0
108,私立,一般大學,1048,亞洲大學,博士班,巴基斯坦,南亞,1,0,1,1,0,1,0,0,0,0,0,0,0,0,0
108,私立,一般大學,1048,亞洲大學,博士班,日本,其他亞洲地區,2,2,0,2,2,0,0,0,0,0,0,0,0,0,0
108,私立,一般大學,1048,亞洲大學,博士班,印度,南亞,4,3,1,4,3,1,0,0,0,0,0,0,0,0,0
108,私立,一般大學,1048,亞洲大學,博士班,奈及利亞聯邦共和國,非洲,1,1,0,1,1,0,0,0,0,0,0,0,0,0,0
108,私立,一般大學,1048,亞洲大學,博士班,索馬利蘭共和國,非洲,1,1,0,1,1,0,0,0,0,0,0,0,0,0,0
108,私立,一般大學,1048,亞洲大學,博士班,紐西蘭,其他亞洲地區,1,1,0,1,1,0,0,0,0,0,0,0,0,0,0
108,私立,一般大學,1048,亞洲大學,博士班,蒙古國,其他亞洲地區,1,0,1,1,0,1,0,0,0,0,0,0,0,0,0
108,私立,一般大學,1049,開南大學,學士班(日間),大陸地區,大陸地區,1,1,0,0,0,0,0,0,0,0,0,0,1,1,0
108,私立,一般大學,1049,開南大學,學士班(日間),日本,其他亞洲地區,81,40,41,81,40,41,0,0,0,0,0,0,0,0,0
108,私立,一般大學,1049,開南大學,學士班(日間),印度尼西亞共和國,東協,9,3,6,6,1,5,3,2,1,0,0,0,0,0,0
108,私立,一般大學,1049,開南大學,學士班(日間),俄羅斯聯邦,其他亞洲地區,1,0,1,1,0,1,0,0,0,0,0,0,0,0,0
108,私立,一般大學,1049,開南大學,學士班(日間),南非共和國,非洲,1,1,0,1,1,0,0,0,0,0,0,0,0,0,0
108,私立,一般大學,1049,開南大學,學士班(日間),泰國,東協,8,0,8,8,0,8,0,0,0,0,0,0,0,0,0
108,私立,一般大學,1049,開南大學,學士班(日間),馬來西亞,東協,9,5,4,2,1,1,7,4,3,0,0,0,0,0,0
108,私立,一般大學,1049,開南大學,學士班(日間),寮人民民主共和國(寮國),東協,15,7,8,15,7,8,0,0,0,0,0,0,0,0,0
108,私立,一般大學,1049,開南大學,學士班(日間),大韓民國(南韓),其他亞洲地區,1,1,0,1,1,0,0,0,0,0,0,0,0,0,0
108,私立,一般大學,1049,開南大學,學士班(日間),帛琉共和國,其他亞洲地區,4,3,1,4,3,1,0,0,0,0,0,0,0,0,0
108,私立,一般大學,1049,開南大學,學士班(日間),美國,北美洲,1,1,0,0,0,0,1,1,0,0,0,0,0,0,0
108,私立,一般大學,1049,開南大學,學士班(日間),香港,港澳,12,8,4,0,0,0,0,0,0,12,8,4,0,0,0
108,私立,一般大學,1049,開南大學,學士班(日間),海地共和國,中南美洲,15,12,3,15,12,3,0,0,0,0,0,0,0,0,0
108,私立,一般大學,1049,開南大學,學士班(日間),菲律賓共和國,東協,4,1,3,4,1,3,0,0,0,0,0,0,0,0,0
108,私立,一般大學,1049,開南大學,學士班(日間),越南社會主義共和國,東協,408,127,281,369,119,250,39,8,31,0,0,0,0,0,0
108,私立,一般大學,1049,開南大學,學士班(日間),蒙古國,其他亞洲地區,20,13,7,20,13,7,0,0,0,0,0,0,0,0,0
108,私立,一般大學,1049,開南大學,學士班(日間),澳門,港澳,2,2,0,0,0,0,0,0,0,2,2,0,0,0,0
108,私立,一般大學,1049,開南大學,碩士班(日間),美國,北美洲,2,2,0,2,2,0,0,0,0,0,0,0,0,0,0
108,私立,一般大學,1049,開南大學,碩士班(日間),香港,港澳,1,0,1,0,0,0,0,0,0,1,0,1,0,0,0
108,私立,一般大學,1049,開南大學,碩士班(日間),越南社會主義共和國,東協,10,4,6,9,4,5,1,0,1,0,0,0,0,0,0
108,私立,一般大學,1049,開南大學,碩士班(日間),蒙古國,其他亞洲地區,3,2,1,3,2,1,0,0,0,0,0,0,0,0,0
108,私立,一般大學,1049,開南大學,碩士班(日間),大陸地區,大陸地區,1,1,0,0,0,0,0,0,0,0,0,0,1,1,0
108,私立,一般大學,1049,開南大學,碩士班(日間),馬來西亞,東協,1,0,1,1,0,1,0,0,0,0,0,0,0,0,0
108,私立,一般大學,1049,開南大學,碩士班(日間),菲律賓共和國,東協,10,1,9,10,1,9,0,0,0,0,0,0,0,0,0
108,私立,一般大學,1050,佛光大學,學士班(日間),大陸地區,大陸地區,3,0,3,0,0,0,0,0,0,0,0,0,3,0,3
108,私立,一般大學,1050,佛光大學,學士班(日間),印度,南亞,3,3,0,3,3,0,0,0,0,0,0,0,0,0,0
108,私立,一般大學,1050,佛光大學,學士班(日間),阿根廷,中南美洲,2,0,2,0,0,0,2,0,2,0,0,0,0,0,0
108,私立,一般大學,1050,佛光大學,學士班(日間),香港,港澳,19,11,8,0,0,0,0,0,0,19,11,8,0,0,0
108,私立,一般大學,1050,佛光大學,學士班(日間),越南社會主義共和國,東協,20,7,13,20,7,13,0,0,0,0,0,0,0,0,0
108,私立,一般大學,1050,佛光大學,學士班(日間),新加坡共和國,東協,1,0,1,1,0,1,0,0,0,0,0,0,0,0,0
108,私立,一般大學,1050,佛光大學,學士班(日間),澳門,港澳,1,1,0,0,0,0,0,0,0,1,1,0,0,0,0
108,私立,一般大學,1050,佛光大學,學士班(日間),大韓民國(南韓),其他亞洲地區,2,2,0,2,2,0,0,0,0,0,0,0,0,0,0
108,私立,一般大學,1050,佛光大學,學士班(日間),巴西聯邦共和國,中南美洲,1,0,1,0,0,0,1,0,1,0,0,0,0,0,0
108,私立,一般大學,1050,佛光大學,學士班(日間),日本,其他亞洲地區,1,1,0,0,0,0,1,1,0,0,0,0,0,0,0
108,私立,一般大學,1050,佛光大學,學士班(日間),印度尼西亞共和國,東協,12,3,9,4,0,4,8,3,5,0,0,0,0,0,0
108,私立,一般大學,1050,佛光大學,學士班(日間),美國,北美洲,1,1,0,0,0,0,1,1,0,0,0,0,0,0,0
108,私立,一般大學,1050,佛光大學,學士班(日間),馬來西亞,東協,62,27,35,8,2,6,54,25,29,0,0,0,0,0,0
108,私立,一般大學,1050,佛光大學,學士班(日間),義大利共和國,歐洲,1,0,1,1,0,1,0,0,0,0,0,0,0,0,0
108,私立,一般大學,1050,佛光大學,碩士班(日間),大韓民國(南韓),其他亞洲地區,4,2,2,4,2,2,0,0,0,0,0,0,0,0,0
108,私立,一般大學,1050,佛光大學,碩士班(日間),日本,其他亞洲地區,1,0,1,0,0,0,1,0,1,0,0,0,0,0,0
108,私立,一般大學,1050,佛光大學,碩士班(日間),吉爾吉斯,其他亞洲地區,1,0,1,1,0,1,0,0,0,0,0,0,0,0,0
108,私立,一般大學,1050,佛光大學,碩士班(日間),法國,歐洲,1,0,1,1,0,1,0,0,0,0,0,0,0,0,0
108,私立,一般大學,1050,佛光大學,碩士班(日間),馬來西亞,東協,5,0,5,3,0,3,2,0,2,0,0,0,0,0,0
108,私立,一般大學,1050,佛光大學,碩士班(日間),荷蘭王國,歐洲,1,1,0,1,1,0,0,0,0,0,0,0,0,0,0
108,私立,一般大學,1050,佛光大學,碩士班(日間),菲律賓共和國,東協,2,0,2,2,0,2,0,0,0,0,0,0,0,0,0
108,私立,一般大學,1050,佛光大學,碩士班(日間),大陸地區,大陸地區,4,1,3,0,0,0,0,0,0,0,0,0,4,1,3
108,私立,一般大學,1050,佛光大學,碩士班(日間),阿根廷,中南美洲,1,0,1,0,0,0,1,0,1,0,0,0,0,0,0
108,私立,一般大學,1050,佛光大學,碩士班(日間),香港,港澳,2,2,0,0,0,0,0,0,0,2,2,0,0,0,0
108,私立,一般大學,1050,佛光大學,碩士班(日間),越南社會主義共和國,東協,16,10,6,16,10,6,0,0,0,0,0,0,0,0,0
108,私立,一般大學,1050,佛光大學,碩士班(日間),新加坡共和國,東協,1,0,1,1,0,1,0,0,0,0,0,0,0,0,0
108,私立,一般大學,1050,佛光大學,碩士班(日間),緬甸,東協,1,0,1,1,0,1,0,0,0,0,0,0,0,0,0
108,私立,一般大學,1050,佛光大學,博士班,大陸地區,大陸地區,5,1,4,0,0,0,0,0,0,0,0,0,5,1,4
108,私立,一般大學,1050,佛光大學,博士班,馬來西亞,東協,4,0,4,4,0,4,0,0,0,0,0,0,0,0,0
108,私立,一般大學,1050,佛光大學,博士班,越南社會主義共和國,東協,1,0,1,1,0,1,0,0,0,0,0,0,0,0,0
108,私立,技專校院,1051,台南家專學校財團法人台南應用科技大學,五專,日本,其他亞洲地區,1,1,0,0,0,0,1,1,0,0,0,0,0,0,0
108,私立,技專校院,1051,台南家專學校財團法人台南應用科技大學,五專,美國,北美洲,2,2,0,2,2,0,0,0,0,0,0,0,0,0,0
108,私立,技專校院,1051,台南家專學校財團法人台南應用科技大學,五專,奧地利共和國,歐洲,1,0,1,1,0,1,0,0,0,0,0,0,0,0,0
108,私立,技專校院,1051,台南家專學校財團法人台南應用科技大學,學士班(日間),大陸地區,大陸地區,21,8,13,0,0,0,0,0,0,0,0,0,21,8,13
108,私立,技專校院,1051,台南家專學校財團法人台南應用科技大學,學士班(日間),大韓民國(南韓),其他亞洲地區,1,0,1,1,0,1,0,0,0,0,0,0,0,0,0
108,私立,技專校院,1051,台南家專學校財團法人台南應用科技大學,學士班(日間),巴西聯邦共和國,中南美洲,1,1,0,0,0,0,1,1,0,0,0,0,0,0,0
108,私立,技專校院,1051,台南家專學校財團法人台南應用科技大學,學士班(日間),香港,港澳,21,6,15,0,0,0,0,0,0,21,6,15,0,0,0
108,私立,技專校院,1051,台南家專學校財團法人台南應用科技大學,學士班(日間),馬來西亞,東協,40,14,26,20,7,13,20,7,13,0,0,0,0,0,0
108,私立,技專校院,1051,台南家專學校財團法人台南應用科技大學,學士班(日間),澳門,港澳,5,2,3,0,0,0,0,0,0,5,2,3,0,0,0
108,私立,技專校院,1051,台南家專學校財團法人台南應用科技大學,學士班(日間),日本,其他亞洲地區,1,0,1,1,0,1,0,0,0,0,0,0,0,0,0
108,私立,技專校院,1051,台南家專學校財團法人台南應用科技大學,學士班(日間),印度尼西亞共和國,東協,1,1,0,0,0,0,1,1,0,0,0,0,0,0,0
108,私立,技專校院,1051,台南家專學校財團法人台南應用科技大學,碩士班(日間),大陸地區,大陸地區,5,2,3,0,0,0,0,0,0,0,0,0,5,2,3
108,私立,技專校院,1052,遠東科技大學,學士班(日間),大陸地區,大陸地區,3,1,2,0,0,0,0,0,0,0,0,0,3,1,2
108,私立,技專校院,1052,遠東科技大學,學士班(日間),印度尼西亞共和國,東協,55,37,18,52,35,17,3,2,1,0,0,0,0,0,0
108,私立,技專校院,1052,遠東科技大學,學士班(日間),香港,港澳,13,9,4,0,0,0,0,0,0,13,9,4,0,0,0
108,私立,技專校院,1052,遠東科技大學,學士班(日間),越南社會主義共和國,東協,1,0,1,0,0,0,1,0,1,0,0,0,0,0,0
108,私立,技專校院,1052,遠東科技大學,學士班(日間),大韓民國(南韓),其他亞洲地區,16,14,2,16,14,2,0,0,0,0,0,0,0,0,0
108,私立,技專校院,1052,遠東科技大學,學士班(日間),美國,北美洲,1,1,0,1,1,0,0,0,0,0,0,0,0,0,0
108,私立,技專校院,1052,遠東科技大學,學士班(日間),泰國,東協,1,0,1,1,0,1,0,0,0,0,0,0,0,0,0
108,私立,技專校院,1052,遠東科技大學,學士班(日間),馬來西亞,東協,22,14,8,17,10,7,5,4,1,0,0,0,0,0,0
108,私立,技專校院,1052,遠東科技大學,學士班(日間),菲律賓共和國,東協,20,20,0,20,20,0,0,0,0,0,0,0,0,0,0
108,私立,技專校院,1052,遠東科技大學,碩士班(日間),大韓民國(南韓),其他亞洲地區,1,1,0,1,1,0,0,0,0,0,0,0,0,0,0
108,私立,技專校院,1052,遠東科技大學,碩士班(日間),越南社會主義共和國,東協,1,1,0,1,1,0,0,0,0,0,0,0,0,0,0
108,私立,技專校院,1053,光宇學校財團法人元培醫事科技大學,二專(日間),越南社會主義共和國,東協,35,27,8,35,27,8,0,0,0,0,0,0,0,0,0
108,私立,技專校院,1053,光宇學校財團法人元培醫事科技大學,學士班(日間),大陸地區,大陸地區,2,2,0,0,0,0,0,0,0,0,0,0,2,2,0
108,私立,技專校院,1053,光宇學校財團法人元培醫事科技大學,學士班(日間),日本,其他亞洲地區,1,1,0,1,1,0,0,0,0,0,0,0,0,0,0
108,私立,技專校院,1053,光宇學校財團法人元培醫事科技大學,學士班(日間),加拿大,北美洲,1,1,0,1,1,0,0,0,0,0,0,0,0,0,0
108,私立,技專校院,1053,光宇學校財團法人元培醫事科技大學,學士班(日間),香港,港澳,10,3,7,0,0,0,0,0,0,10,3,7,0,0,0
108,私立,技專校院,1053,光宇學校財團法人元培醫事科技大學,學士班(日間),新加坡共和國,東協,1,0,1,1,0,1,0,0,0,0,0,0,0,0,0
108,私立,技專校院,1053,光宇學校財團法人元培醫事科技大學,學士班(日間),史瓦帝尼王國,非洲,1,0,1,1,0,1,0,0,0,0,0,0,0,0,0
108,私立,技專校院,1053,光宇學校財團法人元培醫事科技大學,學士班(日間),印度尼西亞共和國,東協,44,24,20,44,24,20,0,0,0,0,0,0,0,0,0
108,私立,技專校院,1053,光宇學校財團法人元培醫事科技大學,學士班(日間),美國,北美洲,1,0,1,0,0,0,1,0,1,0,0,0,0,0,0
108,私立,技專校院,1053,光宇學校財團法人元培醫事科技大學,學士班(日間),馬來西亞,東協,42,21,21,38,18,20,4,3,1,0,0,0,0,0,0
108,私立,技專校院,1053,光宇學校財團法人元培醫事科技大學,學士班(日間),菲律賓共和國,東協,1,1,0,0,0,0,1,1,0,0,0,0,0,0,0
108,私立,技專校院,1053,光宇學校財團法人元培醫事科技大學,學士班(日間),越南社會主義共和國,東協,126,71,55,126,71,55,0,0,0,0,0,0,0,0,0
108,私立,技專校院,1053,光宇學校財團法人元培醫事科技大學,學士班(日間),澳門,港澳,2,1,1,0,0,0,0,0,0,2,1,1,0,0,0
108,私立,技專校院,1053,光宇學校財團法人元培醫事科技大學,碩士班(日間),馬來西亞,東協,2,1,1,2,1,1,0,0,0,0,0,0,0,0,0
108,私立,技專校院,1053,光宇學校財團法人元培醫事科技大學,碩士班(日間),越南社會主義共和國,東協,1,0,1,1,0,1,0,0,0,0,0,0,0,0,0
108,私立,技專校院,1053,光宇學校財團法人元培醫事科技大學,碩士班(日間),緬甸,東協,1,0,1,1,0,1,0,0,0,0,0,0,0,0,0
108,私立,技專校院,1054,景文科技大學,學士班(日間),大陸地區,大陸地區,24,11,13,0,0,0,0,0,0,0,0,0,24,11,13
108,私立,技專校院,1054,景文科技大學,學士班(日間),印度尼西亞共和國,東協,9,2,7,4,1,3,5,1,4,0,0,0,0,0,0
108,私立,技專校院,1054,景文科技大學,學士班(日間),香港,港澳,67,30,37,0,0,0,0,0,0,67,30,37,0,0,0
108,私立,技專校院,1054,景文科技大學,學士班(日間),馬來西亞,東協,43,16,27,12,5,7,31,11,20,0,0,0,0,0,0
108,私立,技專校院,1054,景文科技大學,學士班(日間),蒙古國,其他亞洲地區,4,3,1,4,3,1,0,0,0,0,0,0,0,0,0
108,私立,技專校院,1054,景文科技大學,學士班(日間),緬甸,東協,1,0,1,0,0,0,1,0,1,0,0,0,0,0,0
108,私立,技專校院,1054,景文科技大學,學士班(日間),澳門,港澳,16,7,9,0,0,0,0,0,0,16,7,9,0,0,0
108,私立,技專校院,1054,景文科技大學,學士班(日間),日本,其他亞洲地區,37,20,17,35,19,16,2,1,1,0,0,0,0,0,0
108,私立,技專校院,1054,景文科技大學,學士班(日間),越南社會主義共和國,東協,345,135,210,344,134,210,1,1,0,0,0,0,0,0,0
108,私立,技專校院,1054,景文科技大學,碩士班(日間),越南社會主義共和國,東協,1,1,0,1,1,0,0,0,0,0,0,0,0,0,0
108,私立,技專校院,1055,中華醫事科技大學,學士班(日間),泰國,東協,1,0,1,1,0,1,0,0,0,0,0,0,0,0,0
108,私立,技專校院,1055,中華醫事科技大學,學士班(日間),印度尼西亞共和國,東協,201,146,55,201,146,55,0,0,0,0,0,0,0,0,0
108,私立,技專校院,1055,中華醫事科技大學,學士班(日間),香港,港澳,2,1,1,0,0,0,0,0,0,2,1,1,0,0,0
108,私立,技專校院,1055,中華醫事科技大學,學士班(日間),馬來西亞,東協,11,4,7,9,3,6,2,1,1,0,0,0,0,0,0
108,私立,技專校院,1055,中華醫事科技大學,學士班(日間),越南社會主義共和國,東協,179,55,124,178,54,124,1,1,0,0,0,0,0,0,0
108,私立,技專校院,1055,中華醫事科技大學,學士班(日間),緬甸,東協,1,1,0,0,0,0,1,1,0,0,0,0,0,0,0
108,私立,技專校院,1056,東南科技大學,學士班(日間),日本,其他亞洲地區,4,2,2,3,1,2,1,1,0,0,0,0,0,0,0
108,私立,技專校院,1056,東南科技大學,學士班(日間),大陸地區,大陸地區,1,1,0,0,0,0,0,0,0,0,0,0,1,1,0
108,私立,技專校院,1056,東南科技大學,學士班(日間),印度尼西亞共和國,東協,11,4,7,0,0,0,11,4,7,0,0,0,0,0,0
108,私立,技專校院,1056,東南科技大學,學士班(日間),香港,港澳,10,6,4,0,0,0,0,0,0,10,6,4,0,0,0
108,私立,技專校院,1056,東南科技大學,學士班(日間),馬來西亞,東協,123,80,43,40,30,10,83,50,33,0,0,0,0,0,0
108,私立,技專校院,1056,東南科技大學,學士班(日間),越南社會主義共和國,東協,321,150,171,307,145,162,14,5,9,0,0,0,0,0,0
108,私立,技專校院,1056,東南科技大學,學士班(日間),澳門,港澳,3,1,2,0,0,0,0,0,0,3,1,2,0,0,0
108,私立,技專校院,1056,東南科技大學,碩士班(日間),香港,港澳,1,0,1,0,0,0,0,0,0,1,0,1,0,0,0
108,私立,技專校院,1057,德明財經科技大學,學士班(日間),大韓民國(南韓),其他亞洲地區,3,2,1,3,2,1,0,0,0,0,0,0,0,0,0
108,私立,技專校院,1057,德明財經科技大學,學士班(日間),孟加拉人民共和國,南亞,1,1,0,1,1,0,0,0,0,0,0,0,0,0,0
108,私立,技專校院,1057,德明財經科技大學,學士班(日間),香港,港澳,2,1,1,0,0,0,0,0,0,2,1,1,0,0,0
108,私立,技專校院,1057,德明財經科技大學,學士班(日間),泰國,東協,1,0,1,0,0,0,1,0,1,0,0,0,0,0,0
108,私立,技專校院,1057,德明財經科技大學,學士班(日間),越南社會主義共和國,東協,386,151,235,384,151,233,2,0,2,0,0,0,0,0,0
108,私立,技專校院,1057,德明財經科技大學,學士班(日間),日本,其他亞洲地區,13,8,5,12,8,4,1,0,1,0,0,0,0,0,0
108,私立,技專校院,1057,德明財經科技大學,學士班(日間),印度尼西亞共和國,東協,11,2,9,11,2,9,0,0,0,0,0,0,0,0,0
108,私立,技專校院,1057,德明財經科技大學,學士班(日間),柬埔寨王國,東協,1,0,1,1,0,1,0,0,0,0,0,0,0,0,0
108,私立,技專校院,1057,德明財經科技大學,學士班(日間),馬來西亞,東協,2,1,1,1,0,1,1,1,0,0,0,0,0,0,0
108,私立,技專校院,1057,德明財經科技大學,碩士班(日間),越南社會主義共和國,東協,17,8,9,17,8,9,0,0,0,0,0,0,0,0,0
108,私立,一般大學,1058,明道學校財團法人明道大學,學士班(日間),史瓦帝尼王國,非洲,50,29,21,50,29,21,0,0,0,0,0,0,0,0,0
108,私立,一般大學,1058,明道學校財團法人明道大學,學士班(日間),印度尼西亞共和國,東協,150,92,58,132,84,48,18,8,10,0,0,0,0,0,0
108,私立,一般大學,1058,明道學校財團法人明道大學,學士班(日間),泰國,東協,26,19,7,26,19,7,0,0,0,0,0,0,0,0,0
108,私立,一般大學,1058,明道學校財團法人明道大學,學士班(日間),莫三比克共和國,非洲,1,1,0,1,1,0,0,0,0,0,0,0,0,0,0
108,私立,一般大學,1058,明道學校財團法人明道大學,學士班(日間),澳門,港澳,11,9,2,0,0,0,0,0,0,11,9,2,0,0,0
108,私立,一般大學,1058,明道學校財團法人明道大學,學士班(日間),大陸地區,大陸地區,3,2,1,0,0,0,0,0,0,0,0,0,3,2,1
108,私立,一般大學,1058,明道學校財團法人明道大學,學士班(日間),大韓民國(南韓),其他亞洲地區,8,6,2,8,6,2,0,0,0,0,0,0,0,0,0
108,私立,一般大學,1058,明道學校財團法人明道大學,學士班(日間),日本,其他亞洲地區,11,2,9,11,2,9,0,0,0,0,0,0,0,0,0
108,私立,一般大學,1058,明道學校財團法人明道大學,學士班(日間),奈及利亞聯邦共和國,非洲,1,1,0,1,1,0,0,0,0,0,0,0,0,0,0
108,私立,一般大學,1058,明道學校財團法人明道大學,學士班(日間),英國,歐洲,1,1,0,1,1,0,0,0,0,0,0,0,0,0,0
108,私立,一般大學,1058,明道學校財團法人明道大學,學士班(日間),香港,港澳,46,27,19,0,0,0,0,0,0,46,27,19,0,0,0
108,私立,一般大學,1058,明道學校財團法人明道大學,學士班(日間),馬來西亞,東協,75,43,32,44,24,20,31,19,12,0,0,0,0,0,0
108,私立,一般大學,1058,明道學校財團法人明道大學,學士班(日間),蒙古國,其他亞洲地區,9,4,5,9,4,5,0,0,0,0,0,0,0,0,0
108,私立,一般大學,1058,明道學校財團法人明道大學,碩士班(日間),大韓民國(南韓),其他亞洲地區,1,1,0,1,1,0,0,0,0,0,0,0,0,0,0
108,私立,一般大學,1058,明道學校財團法人明道大學,碩士班(日間),馬來西亞,東協,7,4,3,3,1,2,4,3,1,0,0,0,0,0,0
108,私立,一般大學,1058,明道學校財團法人明道大學,碩士班(日間),蒙古國,其他亞洲地區,10,1,9,10,1,9,0,0,0,0,0,0,0,0,0
108,私立,一般大學,1058,明道學校財團法人明道大學,碩士班(日間),印度尼西亞共和國,東協,1,1,0,1,1,0,0,0,0,0,0,0,0,0,0
108,私立,一般大學,1058,明道學校財團法人明道大學,碩士班(日間),泰國,東協,2,0,2,2,0,2,0,0,0,0,0,0,0,0,0
108,私立,一般大學,1058,明道學校財團法人明道大學,碩士班(日間),越南社會主義共和國,東協,14,8,6,14,8,6,0,0,0,0,0,0,0,0,0
108,私立,一般大學,1058,明道學校財團法人明道大學,博士班,大陸地區,大陸地區,5,5,0,0,0,0,0,0,0,0,0,0,5,5,0
108,私立,技專校院,1060,南開科技大學,學士班(日間),越南社會主義共和國,東協,111,54,57,109,52,57,2,2,0,0,0,0,0,0,0
108,私立,技專校院,1060,南開科技大學,學士班(日間),印度尼西亞共和國,東協,75,41,34,75,41,34,0,0,0,0,0,0,0,0,0
108,私立,技專校院,1060,南開科技大學,學士班(日間),香港,港澳,3,3,0,0,0,0,0,0,0,3,3,0,0,0,0
108,私立,技專校院,1060,南開科技大學,學士班(日間),馬來西亞,東協,109,89,20,40,33,7,69,56,13,0,0,0,0,0,0
108,私立,技專校院,1060,南開科技大學,學士班(日間),澳門,港澳,5,5,0,0,0,0,0,0,0,5,5,0,0,0,0
108,私立,技專校院,1061,中華學校財團法人中華科技大學,學士班(日間),美國,北美洲,1,1,0,0,0,0,1,1,0,0,0,0,0,0,0
108,私立,技專校院,1061,中華學校財團法人中華科技大學,學士班(日間),大陸地區,大陸地區,3,3,0,0,0,0,0,0,0,0,0,0,3,3,0
108,私立,技專校院,1061,中華學校財團法人中華科技大學,學士班(日間),香港,港澳,1,1,0,0,0,0,0,0,0,1,1,0,0,0,0
108,私立,技專校院,1061,中華學校財團法人中華科技大學,學士班(日間),馬來西亞,東協,14,2,12,13,1,12,1,1,0,0,0,0,0,0,0
108,私立,技專校院,1061,中華學校財團法人中華科技大學,學士班(日間),越南社會主義共和國,東協,2,1,1,2,1,1,0,0,0,0,0,0,0,0,0
108,私立,技專校院,1061,中華學校財團法人中華科技大學,學士班(日間),緬甸,東協,3,1,2,3,1,2,0,0,0,0,0,0,0,0,0
108,私立,技專校院,1062,僑光科技大學,學士班(日間),大陸地區,大陸地區,3,2,1,0,0,0,0,0,0,0,0,0,3,2,1
108,私立,技專校院,1062,僑光科技大學,學士班(日間),印度尼西亞共和國,東協,76,66,10,75,66,9,1,0,1,0,0,0,0,0,0
108,私立,技專校院,1062,僑光科技大學,學士班(日間),香港,港澳,4,3,1,0,0,0,0,0,0,4,3,1,0,0,0
108,私立,技專校院,1062,僑光科技大學,學士班(日間),馬來西亞,東協,90,70,20,80,64,16,10,6,4,0,0,0,0,0,0
108,私立,技專校院,1062,僑光科技大學,學士班(日間),越南社會主義共和國,東協,3,1,2,3,1,2,0,0,0,0,0,0,0,0,0
108,私立,技專校院,1062,僑光科技大學,學士班(日間),澳門,港澳,1,0,1,0,0,0,0,0,0,1,0,1,0,0,0
108,私立,技專校院,1062,僑光科技大學,學士班(日間),日本,其他亞洲地區,1,1,0,1,1,0,0,0,0,0,0,0,0,0,0
108,私立,技專校院,1062,僑光科技大學,學士班(日間),泰國,東協,4,2,2,4,2,2,0,0,0,0,0,0,0,0,0
108,私立,技專校院,1062,僑光科技大學,碩士班(日間),印度尼西亞共和國,東協,1,1,0,1,1,0,0,0,0,0,0,0,0,0,0
108,私立,技專校院,1062,僑光科技大學,碩士班(日間),越南社會主義共和國,東協,1,0,1,1,0,1,0,0,0,0,0,0,0,0,0
108,私立,技專校院,1063,廣亞學校財團法人育達科技大學,學士班(日間),馬來西亞,東協,9,8,1,8,7,1,1,1,0,0,0,0,0,0,0
108,私立,技專校院,1063,廣亞學校財團法人育達科技大學,學士班(日間),越南社會主義共和國,東協,228,90,138,228,90,138,0,0,0,0,0,0,0,0,0
108,私立,技專校院,1063,廣亞學校財團法人育達科技大學,學士班(日間),印度尼西亞共和國,東協,22,8,14,21,8,13,1,0,1,0,0,0,0,0,0
108,私立,技專校院,1063,廣亞學校財團法人育達科技大學,碩士班(日間),菲律賓共和國,東協,34,8,26,34,8,26,0,0,0,0,0,0,0,0,0
108,私立,技專校院,1064,美和學校財團法人美和科技大學,學士班(日間),印度尼西亞共和國,東協,28,10,18,27,10,17,1,0,1,0,0,0,0,0,0
108,私立,技專校院,1064,美和學校財團法人美和科技大學,學士班(日間),香港,港澳,3,1,2,0,0,0,0,0,0,3,1,2,0,0,0
108,私立,技專校院,1064,美和學校財團法人美和科技大學,學士班(日間),澳門,港澳,1,1,0,0,0,0,0,0,0,1,1,0,0,0,0
108,私立,技專校院,1064,美和學校財團法人美和科技大學,學士班(日間),馬來西亞,東協,1,1,0,0,0,0,1,1,0,0,0,0,0,0,0
108,私立,技專校院,1065,吳鳳科技大學,學士班(日間),大韓民國(南韓),其他亞洲地區,9,9,0,9,9,0,0,0,0,0,0,0,0,0,0
108,私立,技專校院,1065,吳鳳科技大學,學士班(日間),印度,南亞,1,1,0,1,1,0,0,0,0,0,0,0,0,0,0
108,私立,技專校院,1065,吳鳳科技大學,學士班(日間),印度尼西亞共和國,東協,18,13,5,18,13,5,0,0,0,0,0,0,0,0,0
108,私立,技專校院,1065,吳鳳科技大學,學士班(日間),香港,港澳,2,2,0,0,0,0,0,0,0,2,2,0,0,0,0
108,私立,技專校院,1065,吳鳳科技大學,學士班(日間),馬來西亞,東協,6,4,2,2,1,1,4,3,1,0,0,0,0,0,0
108,私立,技專校院,1065,吳鳳科技大學,學士班(日間),越南社會主義共和國,東協,165,82,83,115,64,51,50,18,32,0,0,0,0,0,0
108,私立,技專校院,1066,環球學校財團法人環球科技大學,學士班(日間),印度尼西亞共和國,東協,95,61,34,87,56,31,8,5,3,0,0,0,0,0,0
108,私立,技專校院,1066,環球學校財團法人環球科技大學,學士班(日間),香港,港澳,12,5,7,0,0,0,0,0,0,12,5,7,0,0,0
108,私立,技專校院,1066,環球學校財團法人環球科技大學,學士班(日間),馬來西亞,東協,239,113,126,206,98,108,33,15,18,0,0,0,0,0,0
108,私立,技專校院,1066,環球學校財團法人環球科技大學,學士班(日間),菲律賓共和國,東協,2,0,2,2,0,2,0,0,0,0,0,0,0,0,0
108,私立,技專校院,1066,環球學校財團法人環球科技大學,學士班(日間),新加坡共和國,東協,1,0,1,1,0,1,0,0,0,0,0,0,0,0,0
108,私立,技專校院,1066,環球學校財團法人環球科技大學,學士班(日間),澳門,港澳,3,1,2,0,0,0,0,0,0,3,1,2,0,0,0
108,私立,技專校院,1066,環球學校財團法人環球科技大學,學士班(日間),日本,其他亞洲地區,12,5,7,12,5,7,0,0,0,0,0,0,0,0,0
108,私立,技專校院,1066,環球學校財團法人環球科技大學,學士班(日間),泰國,東協,1,0,1,1,0,1,0,0,0,0,0,0,0,0,0
108,私立,技專校院,1066,環球學校財團法人環球科技大學,學士班(日間),越南社會主義共和國,東協,19,10,9,3,1,2,16,9,7,0,0,0,0,0,0
108,私立,技專校院,1066,環球學校財團法人環球科技大學,碩士班(日間),越南社會主義共和國,東協,1,0,1,1,0,1,0,0,0,0,0,0,0,0,0
108,私立,技專校院,1066,環球學校財團法人環球科技大學,碩士班(日間),馬來西亞,東協,21,13,8,21,13,8,0,0,0,0,0,0,0,0,0
108,私立,技專校院,1066,環球學校財團法人環球科技大學,碩士班(日間),菲律賓共和國,東協,3,1,2,3,1,2,0,0,0,0,0,0,0,0,0
108,私立,一般大學,1067,台灣首府學校財團法人台灣首府大學,學士班(日間),泰國,東協,1,0,1,1,0,1,0,0,0,0,0,0,0,0,0
108,私立,一般大學,1067,台灣首府學校財團法人台灣首府大學,學士班(日間),大陸地區,大陸地區,1,0,1,0,0,0,0,0,0,0,0,0,1,0,1
108,私立,一般大學,1067,台灣首府學校財團法人台灣首府大學,學士班(日間),印度尼西亞共和國,東協,209,115,94,155,90,65,54,25,29,0,0,0,0,0,0
108,私立,一般大學,1067,台灣首府學校財團法人台灣首府大學,學士班(日間),柬埔寨王國,東協,1,1,0,0,0,0,1,1,0,0,0,0,0,0,0
108,私立,一般大學,1067,台灣首府學校財團法人台灣首府大學,學士班(日間),香港,港澳,7,2,5,0,0,0,0,0,0,7,2,5,0,0,0
108,私立,一般大學,1067,台灣首府學校財團法人台灣首府大學,學士班(日間),馬來西亞,東協,24,11,13,8,4,4,16,7,9,0,0,0,0,0,0
108,私立,一般大學,1067,台灣首府學校財團法人台灣首府大學,學士班(日間),越南社會主義共和國,東協,4,0,4,0,0,0,4,0,4,0,0,0,0,0,0
108,私立,一般大學,1067,台灣首府學校財團法人台灣首府大學,學士班(日間),緬甸,東協,2,0,2,2,0,2,0,0,0,0,0,0,0,0,0
108,私立,一般大學,1067,台灣首府學校財團法人台灣首府大學,學士班(日間),澳門,港澳,16,4,12,0,0,0,0,0,0,16,4,12,0,0,0
108,私立,一般大學,1067,台灣首府學校財團法人台灣首府大學,碩士班(日間),印度尼西亞共和國,東協,5,1,4,4,1,3,1,0,1,0,0,0,0,0,0
108,私立,一般大學,1067,台灣首府學校財團法人台灣首府大學,碩士班(日間),柬埔寨王國,東協,1,1,0,1,1,0,0,0,0,0,0,0,0,0,0
108,私立,一般大學,1067,台灣首府學校財團法人台灣首府大學,碩士班(日間),馬來西亞,東協,1,1,0,1,1,0,0,0,0,0,0,0,0,0,0
108,私立,技專校院,1068,中州學校財團法人中州科技大學,學士班(日間),史瓦帝尼王國,非洲,27,13,14,27,13,14,0,0,0,0,0,0,0,0,0
108,私立,技專校院,1068,中州學校財團法人中州科技大學,學士班(日間),烏干達共和國,非洲,19,10,9,19,10,9,0,0,0,0,0,0,0,0,0
108,私立,技專校院,1068,中州學校財團法人中州科技大學,學士班(日間),越南社會主義共和國,東協,5,2,3,5,2,3,0,0,0,0,0,0,0,0,0
108,私立,技專校院,1068,中州學校財團法人中州科技大學,學士班(日間),緬甸,東協,4,2,2,4,2,2,0,0,0,0,0,0,0,0,0
108,私立,技專校院,1068,中州學校財團法人中州科技大學,學士班(日間),印度尼西亞共和國,東協,4,0,4,4,0,4,0,0,0,0,0,0,0,0,0
108,私立,技專校院,1068,中州學校財團法人中州科技大學,學士班(日間),馬來西亞,東協,50,28,22,46,24,22,4,4,0,0,0,0,0,0,0
108,私立,技專校院,1068,中州學校財團法人中州科技大學,學士班(日間),塞內加爾共和國,非洲,1,1,0,1,1,0,0,0,0,0,0,0,0,0,0
108,私立,技專校院,1068,中州學校財團法人中州科技大學,學士班(日間),蒙古國,其他亞洲地區,9,4,5,9,4,5,0,0,0,0,0,0,0,0,0
108,私立,技專校院,1068,中州學校財團法人中州科技大學,碩士班(日間),馬來西亞,東協,3,2,1,3,2,1,0,0,0,0,0,0,0,0,0
108,私立,技專校院,1069,修平學校財團法人修平科技大學,學士班(日間),日本,其他亞洲地區,3,2,1,2,1,1,1,1,0,0,0,0,0,0,0
108,私立,技專校院,1069,修平學校財團法人修平科技大學,學士班(日間),馬來西亞,東協,30,25,5,30,25,5,0,0,0,0,0,0,0,0,0
108,私立,技專校院,1069,修平學校財團法人修平科技大學,學士班(日間),印度尼西亞共和國,東協,86,49,37,86,49,37,0,0,0,0,0,0,0,0,0
108,私立,技專校院,1069,修平學校財團法人修平科技大學,學士班(日間),香港,港澳,1,1,0,0,0,0,0,0,0,1,1,0,0,0,0
108,私立,技專校院,1069,修平學校財團法人修平科技大學,學士班(日間),越南社會主義共和國,東協,2,0,2,2,0,2,0,0,0,0,0,0,0,0,0
108,私立,技專校院,1069,修平學校財團法人修平科技大學,學士班(日間),澳門,港澳,1,1,0,0,0,0,0,0,0,1,1,0,0,0,0
108,私立,技專校院,1069,修平學校財團法人修平科技大學,碩士班(日間),印度尼西亞共和國,東協,1,1,0,1,1,0,0,0,0,0,0,0,0,0,0
108,私立,技專校院,1070,長庚學校財團法人長庚科技大學,學士班(日間),大陸地區,大陸地區,2,1,1,0,0,0,0,0,0,0,0,0,2,1,1
108,私立,技專校院,1070,長庚學校財團法人長庚科技大學,學士班(日間),香港,港澳,27,11,16,0,0,0,0,0,0,27,11,16,0,0,0
108,私立,技專校院,1070,長庚學校財團法人長庚科技大學,學士班(日間),馬來西亞,東協,1,0,1,0,0,0,1,0,1,0,0,0,0,0,0
108,私立,技專校院,1070,長庚學校財團法人長庚科技大學,學士班(日間),菲律賓共和國,東協,1,0,1,0,0,0,1,0,1,0,0,0,0,0,0
108,私立,技專校院,1070,長庚學校財團法人長庚科技大學,學士班(日間),緬甸,東協,2,0,2,0,0,0,2,0,2,0,0,0,0,0,0
108,私立,技專校院,1070,長庚學校財團法人長庚科技大學,學士班(日間),澳門,港澳,8,3,5,0,0,0,0,0,0,8,3,5,0,0,0
108,私立,技專校院,1071,城市學校財團法人臺北城市科技大學,學士班(日間),大陸地區,大陸地區,3,1,2,0,0,0,0,0,0,0,0,0,3,1,2
108,私立,技專校院,1071,城市學校財團法人臺北城市科技大學,學士班(日間),日本,其他亞洲地區,1,0,1,1,0,1,0,0,0,0,0,0,0,0,0
108,私立,技專校院,1071,城市學校財團法人臺北城市科技大學,學士班(日間),印度尼西亞共和國,東協,1,1,0,1,1,0,0,0,0,0,0,0,0,0,0
108,私立,技專校院,1071,城市學校財團法人臺北城市科技大學,學士班(日間),香港,港澳,17,8,9,0,0,0,0,0,0,17,8,9,0,0,0
108,私立,技專校院,1071,城市學校財團法人臺北城市科技大學,學士班(日間),馬拉威共和國,非洲,3,3,0,3,3,0,0,0,0,0,0,0,0,0,0
108,私立,技專校院,1071,城市學校財團法人臺北城市科技大學,學士班(日間),緬甸,東協,1,0,1,0,0,0,1,0,1,0,0,0,0,0,0
108,私立,技專校院,1071,城市學校財團法人臺北城市科技大學,學士班(日間),澳門,港澳,7,1,6,0,0,0,0,0,0,7,1,6,0,0,0
108,私立,技專校院,1071,城市學校財團法人臺北城市科技大學,學士班(日間),巴西聯邦共和國,中南美洲,1,0,1,0,0,0,1,0,1,0,0,0,0,0,0
108,私立,技專校院,1071,城市學校財團法人臺北城市科技大學,學士班(日間),泰國,東協,1,0,1,0,0,0,1,0,1,0,0,0,0,0,0
108,私立,技專校院,1071,城市學校財團法人臺北城市科技大學,學士班(日間),馬來西亞,東協,38,22,16,21,14,7,17,8,9,0,0,0,0,0,0
108,私立,技專校院,1071,城市學校財團法人臺北城市科技大學,學士班(日間),越南社會主義共和國,東協,150,55,95,108,50,58,42,5,37,0,0,0,0,0,0
108,私立,技專校院,1072,大華學校財團法人敏實科技大學,學士班(日間),印度尼西亞共和國,東協,1,0,1,0,0,0,1,0,1,0,0,0,0,0,0
108,私立,技專校院,1072,大華學校財團法人敏實科技大學,學士班(日間),馬來西亞,東協,36,15,21,36,15,21,0,0,0,0,0,0,0,0,0
108,私立,技專校院,1072,大華學校財團法人敏實科技大學,學士班(日間),澳門,港澳,1,1,0,0,0,0,0,0,0,1,1,0,0,0,0
108,私立,技專校院,1073,醒吾學校財團法人醒吾科技大學,五專,尼加拉瓜,中南美洲,1,0,1,0,0,0,1,0,1,0,0,0,0,0,0
108,私立,技專校院,1073,醒吾學校財團法人醒吾科技大學,學士班(日間),美國,北美洲,1,1,0,1,1,0,0,0,0,0,0,0,0,0,0
108,私立,技專校院,1073,醒吾學校財團法人醒吾科技大學,學士班(日間),烏茲別克共和國,其他亞洲地區,1,0,1,1,0,1,0,0,0,0,0,0,0,0,0
108,私立,技專校院,1073,醒吾學校財團法人醒吾科技大學,學士班(日間),紐西蘭,其他亞洲地區,1,1,0,0,0,0,1,1,0,0,0,0,0,0,0
108,私立,技專校院,1073,醒吾學校財團法人醒吾科技大學,學士班(日間),越南社會主義共和國,東協,394,161,233,391,161,230,3,0,3,0,0,0,0,0,0
108,私立,技專校院,1073,醒吾學校財團法人醒吾科技大學,學士班(日間),澳門,港澳,4,0,4,0,0,0,0,0,0,4,0,4,0,0,0
108,私立,技專校院,1073,醒吾學校財團法人醒吾科技大學,學士班(日間),大陸地區,大陸地區,3,1,2,0,0,0,0,0,0,0,0,0,3,1,2
108,私立,技專校院,1073,醒吾學校財團法人醒吾科技大學,學士班(日間),大韓民國(南韓),其他亞洲地區,1,1,0,0,0,0,1,1,0,0,0,0,0,0,0
108,私立,技專校院,1073,醒吾學校財團法人醒吾科技大學,學士班(日間),日本,其他亞洲地區,4,2,2,4,2,2,0,0,0,0,0,0,0,0,0
108,私立,技專校院,1073,醒吾學校財團法人醒吾科技大學,學士班(日間),印度尼西亞共和國,東協,278,117,161,239,100,139,39,17,22,0,0,0,0,0,0
108,私立,技專校院,1073,醒吾學校財團法人醒吾科技大學,學士班(日間),香港,港澳,10,2,8,0,0,0,0,0,0,10,2,8,0,0,0
108,私立,技專校院,1073,醒吾學校財團法人醒吾科技大學,學士班(日間),馬來西亞,東協,19,8,11,9,4,5,10,4,6,0,0,0,0,0,0
108,私立,技專校院,1073,醒吾學校財團法人醒吾科技大學,碩士班(日間),印度尼西亞共和國,東協,1,1,0,1,1,0,0,0,0,0,0,0,0,0,0
108,私立,技專校院,1073,醒吾學校財團法人醒吾科技大學,碩士班(日間),馬來西亞,東協,3,1,2,2,0,2,1,1,0,0,0,0,0,0,0
108,私立,技專校院,1075,文藻學校財團法人文藻外語大學,五專,印度尼西亞共和國,東協,1,0,1,0,0,0,1,0,1,0,0,0,0,0,0
108,私立,技專校院,1075,文藻學校財團法人文藻外語大學,五專,委內瑞拉共和國,中南美洲,1,0,1,0,0,0,1,0,1,0,0,0,0,0,0
108,私立,技專校院,1075,文藻學校財團法人文藻外語大學,五專,阿根廷,中南美洲,1,1,0,0,0,0,1,1,0,0,0,0,0,0,0
108,私立,技專校院,1075,文藻學校財團法人文藻外語大學,五專,泰國,東協,1,1,0,0,0,0,1,1,0,0,0,0,0,0,0
108,私立,技專校院,1075,文藻學校財團法人文藻外語大學,五專,馬紹爾群島共和國,其他亞洲地區,1,0,1,0,0,0,1,0,1,0,0,0,0,0,0
108,私立,技專校院,1075,文藻學校財團法人文藻外語大學,五專,越南社會主義共和國,東協,2,0,2,0,0,0,2,0,2,0,0,0,0,0,0
108,私立,技專校院,1075,文藻學校財團法人文藻外語大學,五專,大韓民國(南韓),其他亞洲地區,1,1,0,1,1,0,0,0,0,0,0,0,0,0,0
108,私立,技專校院,1075,文藻學校財團法人文藻外語大學,五專,日本,其他亞洲地區,3,0,3,1,0,1,2,0,2,0,0,0,0,0,0
108,私立,技專校院,1075,文藻學校財團法人文藻外語大學,五專,哥斯大黎加共和國,中南美洲,1,0,1,0,0,0,1,0,1,0,0,0,0,0,0
108,私立,技專校院,1075,文藻學校財團法人文藻外語大學,五專,義大利共和國,歐洲,1,0,1,1,0,1,0,0,0,0,0,0,0,0,0
108,私立,技專校院,1075,文藻學校財團法人文藻外語大學,學士班(日間),大韓民國(南韓),其他亞洲地區,3,2,1,3,2,1,0,0,0,0,0,0,0,0,0
108,私立,技專校院,1075,文藻學校財團法人文藻外語大學,學士班(日間),巴西聯邦共和國,中南美洲,4,1,3,4,1,3,0,0,0,0,0,0,0,0,0
108,私立,技專校院,1075,文藻學校財團法人文藻外語大學,學士班(日間),日本,其他亞洲地區,40,12,28,40,12,28,0,0,0,0,0,0,0,0,0
108,私立,技專校院,1075,文藻學校財團法人文藻外語大學,學士班(日間),印度尼西亞共和國,東協,30,4,26,28,4,24,2,0,2,0,0,0,0,0,0
108,私立,技專校院,1075,文藻學校財團法人文藻外語大學,學士班(日間),西班牙王國,歐洲,5,4,1,5,4,1,0,0,0,0,0,0,0,0,0
108,私立,技專校院,1075,文藻學校財團法人文藻外語大學,學士班(日間),波蘭共和國,歐洲,1,1,0,1,1,0,0,0,0,0,0,0,0,0,0
108,私立,技專校院,1075,文藻學校財團法人文藻外語大學,學士班(日間),法國,歐洲,2,1,1,2,1,1,0,0,0,0,0,0,0,0,0
108,私立,技專校院,1075,文藻學校財團法人文藻外語大學,學士班(日間),美國,北美洲,4,0,4,4,0,4,0,0,0,0,0,0,0,0,0
108,私立,技專校院,1075,文藻學校財團法人文藻外語大學,學士班(日間),泰國,東協,2,0,2,1,0,1,1,0,1,0,0,0,0,0,0
108,私立,技專校院,1075,文藻學校財團法人文藻外語大學,學士班(日間),秘魯共和國,中南美洲,2,1,1,1,1,0,1,0,1,0,0,0,0,0,0
108,私立,技專校院,1075,文藻學校財團法人文藻外語大學,學士班(日間),馬來西亞,東協,21,3,18,11,2,9,10,1,9,0,0,0,0,0,0
108,私立,技專校院,1075,文藻學校財團法人文藻外語大學,學士班(日間),馬拉威共和國,非洲,1,0,1,1,0,1,0,0,0,0,0,0,0,0,0
108,私立,技專校院,1075,文藻學校財團法人文藻外語大學,學士班(日間),菲律賓共和國,東協,2,0,2,0,0,0,2,0,2,0,0,0,0,0,0
108,私立,技專校院,1075,文藻學校財團法人文藻外語大學,學士班(日間),義大利共和國,歐洲,3,3,0,3,3,0,0,0,0,0,0,0,0,0,0
108,私立,技專校院,1075,文藻學校財團法人文藻外語大學,學士班(日間),聖文森(及格瑞那丁),中南美洲,1,1,0,1,1,0,0,0,0,0,0,0,0,0,0
108,私立,技專校院,1075,文藻學校財團法人文藻外語大學,學士班(日間),蒙古國,其他亞洲地區,3,1,2,3,1,2,0,0,0,0,0,0,0,0,0
108,私立,技專校院,1075,文藻學校財團法人文藻外語大學,學士班(日間),土耳其共和國,其他亞洲地區,1,1,0,1,1,0,0,0,0,0,0,0,0,0,0
108,私立,技專校院,1075,文藻學校財團法人文藻外語大學,學士班(日間),大陸地區,大陸地區,49,21,28,0,0,0,0,0,0,0,0,0,49,21,28
108,私立,技專校院,1075,文藻學校財團法人文藻外語大學,學士班(日間),尼加拉瓜,中南美洲,1,1,0,1,1,0,0,0,0,0,0,0,0,0,0
108,私立,技專校院,1075,文藻學校財團法人文藻外語大學,學士班(日間),印度,南亞,5,0,5,5,0,5,0,0,0,0,0,0,0,0,0
108,私立,技專校院,1075,文藻學校財團法人文藻外語大學,學士班(日間),奈及利亞聯邦共和國,非洲,1,0,1,1,0,1,0,0,0,0,0,0,0,0,0
108,私立,技專校院,1075,文藻學校財團法人文藻外語大學,學士班(日間),香港,港澳,29,8,21,0,0,0,0,0,0,29,8,21,0,0,0
108,私立,技專校院,1075,文藻學校財團法人文藻外語大學,學士班(日間),越南社會主義共和國,東協,44,11,33,40,9,31,4,2,2,0,0,0,0,0,0
108,私立,技專校院,1075,文藻學校財團法人文藻外語大學,學士班(日間),葡萄牙共和國,歐洲,1,1,0,1,1,0,0,0,0,0,0,0,0,0,0
108,私立,技專校院,1075,文藻學校財團法人文藻外語大學,學士班(日間),德意志聯邦共和國,歐洲,1,1,0,1,1,0,0,0,0,0,0,0,0,0,0
108,私立,技專校院,1075,文藻學校財團法人文藻外語大學,學士班(日間),緬甸,東協,1,1,0,0,0,0,1,1,0,0,0,0,0,0,0
108,私立,技專校院,1075,文藻學校財團法人文藻外語大學,學士班(日間),澳門,港澳,3,2,1,0,0,0,0,0,0,3,2,1,0,0,0
108,私立,技專校院,1075,文藻學校財團法人文藻外語大學,碩士班(日間),大陸地區,大陸地區,3,1,2,0,0,0,0,0,0,0,0,0,3,1,2
108,私立,技專校院,1075,文藻學校財團法人文藻外語大學,碩士班(日間),日本,其他亞洲地區,4,0,4,4,0,4,0,0,0,0,0,0,0,0,0
108,私立,技專校院,1075,文藻學校財團法人文藻外語大學,碩士班(日間),尼加拉瓜,中南美洲,1,0,1,1,0,1,0,0,0,0,0,0,0,0,0
108,私立,技專校院,1075,文藻學校財團法人文藻外語大學,碩士班(日間),印度,南亞,1,1,0,1,1,0,0,0,0,0,0,0,0,0,0
108,私立,技專校院,1075,文藻學校財團法人文藻外語大學,碩士班(日間),西班牙王國,歐洲,1,1,0,1,1,0,0,0,0,0,0,0,0,0,0
108,私立,技專校院,1075,文藻學校財團法人文藻外語大學,碩士班(日間),波蘭共和國,歐洲,1,0,1,1,0,1,0,0,0,0,0,0,0,0,0
108,私立,技專校院,1075,文藻學校財團法人文藻外語大學,碩士班(日間),美國,北美洲,2,2,0,2,2,0,0,0,0,0,0,0,0,0,0
108,私立,技專校院,1075,文藻學校財團法人文藻外語大學,碩士班(日間),越南社會主義共和國,東協,16,5,11,16,5,11,0,0,0,0,0,0,0,0,0
108,私立,技專校院,1075,文藻學校財團法人文藻外語大學,碩士班(日間),大韓民國(南韓),其他亞洲地區,1,1,0,1,1,0,0,0,0,0,0,0,0,0,0
108,私立,技專校院,1075,文藻學校財團法人文藻外語大學,碩士班(日間),印度尼西亞共和國,東協,7,2,5,7,2,5,0,0,0,0,0,0,0,0,0
108,私立,技專校院,1075,文藻學校財團法人文藻外語大學,碩士班(日間),法國,歐洲,2,1,1,2,1,1,0,0,0,0,0,0,0,0,0
108,私立,技專校院,1075,文藻學校財團法人文藻外語大學,碩士班(日間),菲律賓共和國,東協,2,1,1,2,1,1,0,0,0,0,0,0,0,0,0
108,私立,技專校院,1075,文藻學校財團法人文藻外語大學,碩士班(日間),澳大利亞,其他亞洲地區,2,2,0,2,2,0,0,0,0,0,0,0,0,0,0
108,私立,技專校院,1076,華夏學校財團法人華夏科技大學,學士班(日間),馬來西亞,東協,5,1,4,2,0,2,3,1,2,0,0,0,0,0,0
108,私立,技專校院,1076,華夏學校財團法人華夏科技大學,學士班(日間),越南社會主義共和國,東協,59,32,27,58,32,26,1,0,1,0,0,0,0,0,0
108,私立,技專校院,1076,華夏學校財團法人華夏科技大學,學士班(日間),大陸地區,大陸地區,1,1,0,0,0,0,0,0,0,0,0,0,1,1,0
108,私立,技專校院,1076,華夏學校財團法人華夏科技大學,學士班(日間),大韓民國(南韓),其他亞洲地區,1,0,1,1,0,1,0,0,0,0,0,0,0,0,0
108,私立,技專校院,1076,華夏學校財團法人華夏科技大學,學士班(日間),香港,港澳,2,0,2,0,0,0,0,0,0,2,0,2,0,0,0
108,私立,技專校院,1076,華夏學校財團法人華夏科技大學,學士班(日間),緬甸,東協,24,10,14,24,10,14,0,0,0,0,0,0,0,0,0
108,私立,技專校院,1076,華夏學校財團法人華夏科技大學,學士班(日間),澳門,港澳,2,1,1,0,0,0,0,0,0,2,1,1,0,0,0
108,私立,技專校院,1076,華夏學校財團法人華夏科技大學,碩士班(日間),越南社會主義共和國,東協,1,1,0,1,1,0,0,0,0,0,0,0,0,0,0
108,私立,技專校院,1077,慈濟學校財團法人慈濟科技大學,二專(日間),菲律賓共和國,東協,21,9,12,21,9,12,0,0,0,0,0,0,0,0,0
108,私立,技專校院,1077,慈濟學校財團法人慈濟科技大學,五專,印度尼西亞共和國,東協,1,0,1,0,0,0,1,0,1,0,0,0,0,0,0
108,私立,技專校院,1077,慈濟學校財團法人慈濟科技大學,五專,泰國,東協,1,0,1,1,0,1,0,0,0,0,0,0,0,0,0
108,私立,技專校院,1077,慈濟學校財團法人慈濟科技大學,五專,馬來西亞,東協,13,6,7,13,6,7,0,0,0,0,0,0,0,0,0
108,私立,技專校院,1077,慈濟學校財團法人慈濟科技大學,學士班(日間),大韓民國(南韓),其他亞洲地區,2,1,1,2,1,1,0,0,0,0,0,0,0,0,0
108,私立,技專校院,1077,慈濟學校財團法人慈濟科技大學,學士班(日間),尼泊爾聯邦民主共和國,南亞,1,0,1,1,0,1,0,0,0,0,0,0,0,0,0
108,私立,技專校院,1077,慈濟學校財團法人慈濟科技大學,學士班(日間),印度,南亞,1,0,1,1,0,1,0,0,0,0,0,0,0,0,0
108,私立,技專校院,1077,慈濟學校財團法人慈濟科技大學,學士班(日間),香港,港澳,10,5,5,0,0,0,0,0,0,10,5,5,0,0,0
108,私立,技專校院,1077,慈濟學校財團法人慈濟科技大學,學士班(日間),馬來西亞,東協,129,63,66,115,55,60,14,8,6,0,0,0,0,0,0
108,私立,技專校院,1077,慈濟學校財團法人慈濟科技大學,學士班(日間),菲律賓共和國,東協,2,1,1,2,1,1,0,0,0,0,0,0,0,0,0
108,私立,技專校院,1077,慈濟學校財團法人慈濟科技大學,學士班(日間),印度尼西亞共和國,東協,45,30,15,45,30,15,0,0,0,0,0,0,0,0,0
108,私立,技專校院,1077,慈濟學校財團法人慈濟科技大學,學士班(日間),泰國,東協,4,0,4,3,0,3,1,0,1,0,0,0,0,0,0
108,私立,技專校院,1077,慈濟學校財團法人慈濟科技大學,學士班(日間),越南社會主義共和國,東協,2,1,1,2,1,1,0,0,0,0,0,0,0,0,0
108,私立,技專校院,1077,慈濟學校財團法人慈濟科技大學,碩士班(日間),馬來西亞,東協,1,0,1,1,0,1,0,0,0,0,0,0,0,0,0
108,私立,技專校院,1078,致理學校財團法人致理科技大學,學士班(日間),日本,其他亞洲地區,6,2,4,6,2,4,0,0,0,0,0,0,0,0,0
108,私立,技專校院,1078,致理學校財團法人致理科技大學,學士班(日間),泰國,東協,3,1,2,1,1,0,2,0,2,0,0,0,0,0,0
108,私立,技專校院,1078,致理學校財團法人致理科技大學,學士班(日間),越南社會主義共和國,東協,121,33,88,121,33,88,0,0,0,0,0,0,0,0,0
108,私立,技專校院,1078,致理學校財團法人致理科技大學,學士班(日間),大陸地區,大陸地區,17,11,6,0,0,0,0,0,0,0,0,0,17,11,6
108,私立,技專校院,1078,致理學校財團法人致理科技大學,學士班(日間),汶萊和平之國,東協,1,1,0,1,1,0,0,0,0,0,0,0,0,0,0
108,私立,技專校院,1078,致理學校財團法人致理科技大學,學士班(日間),香港,港澳,26,5,21,0,0,0,0,0,0,26,5,21,0,0,0
108,私立,技專校院,1078,致理學校財團法人致理科技大學,學士班(日間),馬來西亞,東協,8,3,5,8,3,5,0,0,0,0,0,0,0,0,0
108,私立,技專校院,1078,致理學校財團法人致理科技大學,碩士班(日間),馬來西亞,東協,1,0,1,0,0,0,1,0,1,0,0,0,0,0,0
108,私立,技專校院,1078,致理學校財團法人致理科技大學,碩士班(日間),越南社會主義共和國,東協,5,2,3,5,2,3,0,0,0,0,0,0,0,0,0
108,私立,一般大學,1079,康寧學校財團法人康寧大學,五專,泰國,東協,1,0,1,1,0,1,0,0,0,0,0,0,0,0,0
108,私立,一般大學,1079,康寧學校財團法人康寧大學,五專,馬來西亞,東協,1,0,1,0,0,0,1,0,1,0,0,0,0,0,0
108,私立,一般大學,1079,康寧學校財團法人康寧大學,學士班(日間),馬來西亞,東協,3,1,2,1,0,1,2,1,1,0,0,0,0,0,0
108,私立,一般大學,1079,康寧學校財團法人康寧大學,學士班(日間),印度尼西亞共和國,東協,1,1,0,0,0,0,1,1,0,0,0,0,0,0,0
108,私立,一般大學,1079,康寧學校財團法人康寧大學,學士班(日間),斯里蘭卡民主社會主義共和國,南亞,25,23,2,25,23,2,0,0,0,0,0,0,0,0,0
108,私立,一般大學,1079,康寧學校財團法人康寧大學,學士班(日間),緬甸,東協,5,1,4,5,1,4,0,0,0,0,0,0,0,0,0
108,私立,一般大學,1079,康寧學校財團法人康寧大學,碩士班(日間),緬甸,東協,1,0,1,1,0,1,0,0,0,0,0,0,0,0,0
108,私立,一般大學,1079,康寧學校財團法人康寧大學,碩士班(日間),越南社會主義共和國,東協,2,0,2,2,0,2,0,0,0,0,0,0,0,0,0
108,私立,技專校院,1080,宏國學校財團法人宏國德霖科技大學,五專,越南社會主義共和國,東協,1,0,1,1,0,1,0,0,0,0,0,0,0,0,0
108,私立,技專校院,1080,宏國學校財團法人宏國德霖科技大學,學士班(日間),越南社會主義共和國,東協,65,29,36,65,29,36,0,0,0,0,0,0,0,0,0
108,私立,技專校院,1080,宏國學校財團法人宏國德霖科技大學,學士班(日間),澳門,港澳,1,1,0,0,0,0,0,0,0,1,1,0,0,0,0
108,私立,技專校院,1080,宏國學校財團法人宏國德霖科技大學,學士班(日間),印度尼西亞共和國,東協,2,1,1,0,0,0,2,1,1,0,0,0,0,0,0
108,私立,技專校院,1080,宏國學校財團法人宏國德霖科技大學,學士班(日間),馬來西亞,東協,2,0,2,0,0,0,2,0,2,0,0,0,0,0,0
108,私立,技專校院,1081,東方學校財團法人東方設計大學,五專,馬來西亞,東協,1,0,1,0,0,0,1,0,1,0,0,0,0,0,0
108,私立,技專校院,1081,東方學校財團法人東方設計大學,學士班(日間),大陸地區,大陸地區,1,1,0,0,0,0,0,0,0,0,0,0,1,1,0
108,私立,技專校院,1081,東方學校財團法人東方設計大學,學士班(日間),印度尼西亞共和國,東協,146,98,48,145,97,48,1,1,0,0,0,0,0,0,0
108,私立,技專校院,1081,東方學校財團法人東方設計大學,學士班(日間),香港,港澳,1,0,1,0,0,0,0,0,0,1,0,1,0,0,0
108,私立,技專校院,1081,東方學校財團法人東方設計大學,學士班(日間),馬來西亞,東協,1,0,1,1,0,1,0,0,0,0,0,0,0,0,0
108,私立,技專校院,1081,東方學校財團法人東方設計大學,學士班(日間),越南社會主義共和國,東協,13,6,7,13,6,7,0,0,0,0,0,0,0,0,0
108,私立,技專校院,1081,東方學校財團法人東方設計大學,學士班(日間),澳門,港澳,3,3,0,0,0,0,0,0,0,3,3,0,0,0,0
108,私立,技專校院,1081,東方學校財團法人東方設計大學,學士班(日間),緬甸,東協,20,12,8,20,12,8,0,0,0,0,0,0,0,0,0
108,私立,技專校院,1081,東方學校財團法人東方設計大學,碩士班(日間),越南社會主義共和國,東協,5,3,2,5,3,2,0,0,0,0,0,0,0,0,0
108,私立,技專校院,1081,東方學校財團法人東方設計大學,博士班,大陸地區,大陸地區,4,2,2,0,0,0,0,0,0,0,0,0,4,2,2
108,私立,技專校院,1082,崇右學校財團法人崇右影藝科技大學,學士班(日間),泰國,東協,1,1,0,0,0,0,1,1,0,0,0,0,0,0,0
108,私立,技專校院,1082,崇右學校財團法人崇右影藝科技大學,學士班(日間),菲律賓共和國,東協,1,1,0,0,0,0,1,1,0,0,0,0,0,0,0
108,私立,技專校院,1082,崇右學校財團法人崇右影藝科技大學,學士班(日間),大陸地區,大陸地區,1,1,0,0,0,0,0,0,0,0,0,0,1,1,0
108,私立,技專校院,1082,崇右學校財團法人崇右影藝科技大學,學士班(日間),印度尼西亞共和國,東協,99,55,44,98,55,43,1,0,1,0,0,0,0,0,0
108,私立,技專校院,1082,崇右學校財團法人崇右影藝科技大學,學士班(日間),香港,港澳,6,4,2,0,0,0,0,0,0,6,4,2,0,0,0
108,私立,技專校院,1082,崇右學校財團法人崇右影藝科技大學,學士班(日間),馬來西亞,東協,7,4,3,6,3,3,1,1,0,0,0,0,0,0,0
108,私立,技專校院,1082,崇右學校財團法人崇右影藝科技大學,學士班(日間),越南社會主義共和國,東協,95,31,64,75,23,52,20,8,12,0,0,0,0,0,0
108,私立,技專校院,1082,崇右學校財團法人崇右影藝科技大學,學士班(日間),緬甸,東協,8,3,5,8,3,5,0,0,0,0,0,0,0,0,0
108,私立,技專校院,1082,崇右學校財團法人崇右影藝科技大學,學士班(日間),澳門,港澳,2,0,2,0,0,0,0,0,0,2,0,2,0,0,0
108,私立,技專校院,1082,崇右學校財團法人崇右影藝科技大學,碩士班(日間),越南社會主義共和國,東協,1,0,1,1,0,1,0,0,0,0,0,0,0,0,0
108,私立,技專校院,1083,台北海洋學校財團法人台北海洋科技大學,五專,越南社會主義共和國,東協,1,1,0,1,1,0,0,0,0,0,0,0,0,0,0
108,私立,技專校院,1083,台北海洋學校財團法人台北海洋科技大學,學士班(日間),日本,其他亞洲地區,4,2,2,4,2,2,0,0,0,0,0,0,0,0,0
108,私立,技專校院,1083,台北海洋學校財團法人台北海洋科技大學,學士班(日間),香港,港澳,6,3,3,0,0,0,0,0,0,6,3,3,0,0,0
108,私立,技專校院,1083,台北海洋學校財團法人台北海洋科技大學,學士班(日間),緬甸,東協,1,0,1,0,0,0,1,0,1,0,0,0,0,0,0
108,私立,技專校院,1083,台北海洋學校財團法人台北海洋科技大學,學士班(日間),大韓民國(南韓),其他亞洲地區,2,0,2,2,0,2,0,0,0,0,0,0,0,0,0
108,私立,技專校院,1083,台北海洋學校財團法人台北海洋科技大學,學士班(日間),印度尼西亞共和國,東協,36,23,13,36,23,13,0,0,0,0,0,0,0,0,0
108,私立,技專校院,1083,台北海洋學校財團法人台北海洋科技大學,學士班(日間),泰國,東協,1,0,1,0,0,0,1,0,1,0,0,0,0,0,0
108,私立,技專校院,1083,台北海洋學校財團法人台北海洋科技大學,學士班(日間),馬來西亞,東協,11,4,7,1,0,1,10,4,6,0,0,0,0,0,0
108,私立,技專校院,1083,台北海洋學校財團法人台北海洋科技大學,學士班(日間),越南社會主義共和國,東協,1,0,1,1,0,1,0,0,0,0,0,0,0,0,0
108,私立,技專校院,1083,台北海洋學校財團法人台北海洋科技大學,學士班(日間),澳門,港澳,4,2,2,0,0,0,0,0,0,4,2,2,0,0,0
108,私立,技專校院,1083,台北海洋學校財團法人台北海洋科技大學,碩士班(日間),菲律賓共和國,東協,5,0,5,5,0,5,0,0,0,0,0,0,0,0,0
108,私立,一般大學,1125,中信學校財團法人中信金融管理學院,學士班(日間),大陸地區,大陸地區,2,1,1,0,0,0,0,0,0,0,0,0,2,1,1
108,私立,一般大學,1125,中信學校財團法人中信金融管理學院,學士班(日間),加拿大,北美洲,1,1,0,1,1,0,0,0,0,0,0,0,0,0,0
108,私立,一般大學,1125,中信學校財團法人中信金融管理學院,學士班(日間),日本,其他亞洲地區,3,2,1,3,2,1,0,0,0,0,0,0,0,0,0
108,私立,一般大學,1125,中信學校財團法人中信金融管理學院,學士班(日間),俄羅斯聯邦,其他亞洲地區,1,1,0,1,1,0,0,0,0,0,0,0,0,0,0
108,私立,一般大學,1125,中信學校財團法人中信金融管理學院,學士班(日間),泰國,東協,1,0,1,1,0,1,0,0,0,0,0,0,0,0,0
108,私立,一般大學,1125,中信學校財團法人中信金融管理學院,碩士班(日間),甘比亞共和國,非洲,1,0,1,1,0,1,0,0,0,0,0,0,0,0,0
108,私立,技專校院,1159,和春技術學院,五專,越南社會主義共和國,東協,7,0,7,7,0,7,0,0,0,0,0,0,0,0,0
108,私立,技專校院,1159,和春技術學院,學士班(日間),馬來西亞,東協,2,2,0,2,2,0,0,0,0,0,0,0,0,0,0
108,私立,技專校院,1159,和春技術學院,學士班(日間),越南社會主義共和國,東協,9,6,3,9,6,3,0,0,0,0,0,0,0,0,0
108,私立,技專校院,1166,亞東技術學院,學士班(日間),約旦哈什米王國,其他亞洲地區,1,1,0,1,1,0,0,0,0,0,0,0,0,0,0
108,私立,技專校院,1166,亞東技術學院,學士班(日間),澳門,港澳,1,1,0,0,0,0,0,0,0,1,1,0,0,0,0
108,私立,技專校院,1168,南亞科技學校財團法人南亞技術學院,學士班(日間),日本,其他亞洲地區,1,1,0,1,1,0,0,0,0,0,0,0,0,0,0
108,私立,技專校院,1168,南亞科技學校財團法人南亞技術學院,學士班(日間),越南社會主義共和國,東協,10,3,7,10,3,7,0,0,0,0,0,0,0,0,0
108,私立,一般大學,1176,稻江科技暨管理學院,學士班(日間),日本,其他亞洲地區,1,1,0,1,1,0,0,0,0,0,0,0,0,0,0
108,私立,技專校院,1182,蘭陽技術學院,學士班(日間),越南社會主義共和國,東協,1,0,1,1,0,1,0,0,0,0,0,0,0,0,0
108,私立,技專校院,1183,黎明技術學院,學士班(日間),大韓民國(南韓),其他亞洲地區,3,0,3,3,0,3,0,0,0,0,0,0,0,0,0
108,私立,技專校院,1183,黎明技術學院,學士班(日間),香港,港澳,2,0,2,0,0,0,0,0,0,2,0,2,0,0,0
108,私立,技專校院,1183,黎明技術學院,學士班(日間),馬來西亞,東協,38,14,24,18,7,11,20,7,13,0,0,0,0,0,0
108,私立,技專校院,1183,黎明技術學院,學士班(日間),越南社會主義共和國,東協,333,269,64,332,269,63,1,0,1,0,0,0,0,0,0
108,私立,技專校院,1183,黎明技術學院,學士班(日間),澳門,港澳,1,0,1,0,0,0,0,0,0,1,0,1,0,0,0
108,私立,技專校院,1183,黎明技術學院,學士班(日間),泰國,東協,1,0,1,0,0,0,1,0,1,0,0,0,0,0,0
108,私立,技專校院,1185,經國管理暨健康學院,學士班(日間),香港,港澳,2,2,0,0,0,0,0,0,0,2,2,0,0,0,0
108,私立,技專校院,1185,經國管理暨健康學院,學士班(日間),馬來西亞,東協,32,28,4,12,10,2,20,18,2,0,0,0,0,0,0
108,私立,技專校院,1185,經國管理暨健康學院,學士班(日間),越南社會主義共和國,東協,246,102,144,246,102,144,0,0,0,0,0,0,0,0,0
108,私立,技專校院,1185,經國管理暨健康學院,學士班(日間),澳門,港澳,3,1,2,0,0,0,0,0,0,3,1,2,0,0,0
108,私立,技專校院,1188,大同技術學院,學士班(日間),巴拉圭,中南美洲,1,0,1,0,0,0,1,0,1,0,0,0,0,0,0
108,私立,技專校院,1188,大同技術學院,學士班(日間),印度尼西亞共和國,東協,19,14,5,19,14,5,0,0,0,0,0,0,0,0,0
108,私立,技專校院,1188,大同技術學院,學士班(日間),馬來西亞,東協,1,0,1,0,0,0,1,0,1,0,0,0,0,0,0
108,私立,技專校院,1188,大同技術學院,學士班(日間),越南社會主義共和國,東協,4,0,4,2,0,2,2,0,2,0,0,0,0,0,0
108,私立,技專校院,1192,臺灣觀光學院,學士班(日間),印度尼西亞共和國,東協,1,1,0,0,0,0,1,1,0,0,0,0,0,0,0
108,私立,技專校院,1192,臺灣觀光學院,學士班(日間),澳門,港澳,2,1,1,0,0,0,0,0,0,2,1,1,0,0,0
108,私立,一般大學,1195,馬偕學校財團法人馬偕醫學院,學士班(日間),大韓民國(南韓),其他亞洲地區,2,1,1,0,0,0,2,1,1,0,0,0,0,0,0
108,私立,一般大學,1195,馬偕學校財團法人馬偕醫學院,學士班(日間),香港,港澳,6,4,2,0,0,0,0,0,0,6,4,2,0,0,0
108,私立,一般大學,1195,馬偕學校財團法人馬偕醫學院,學士班(日間),澳門,港澳,2,1,1,0,0,0,0,0,0,2,1,1,0,0,0
108,私立,一般大學,1196,法鼓學校財團法人法鼓文理學院,學士班(日間),印度尼西亞共和國,東協,1,0,1,1,0,1,0,0,0,0,0,0,0,0,0
108,私立,一般大學,1196,法鼓學校財團法人法鼓文理學院,學士班(日間),泰國,東協,3,3,0,3,3,0,0,0,0,0,0,0,0,0,0
108,私立,一般大學,1196,法鼓學校財團法人法鼓文理學院,學士班(日間),馬來西亞,東協,1,1,0,1,1,0,0,0,0,0,0,0,0,0,0
108,私立,一般大學,1196,法鼓學校財團法人法鼓文理學院,學士班(日間),香港,港澳,3,1,2,0,0,0,0,0,0,3,1,2,0,0,0
108,私立,一般大學,1196,法鼓學校財團法人法鼓文理學院,學士班(日間),越南社會主義共和國,東協,11,5,6,11,5,6,0,0,0,0,0,0,0,0,0
108,私立,一般大學,1196,法鼓學校財團法人法鼓文理學院,碩士班(日間),大陸地區,大陸地區,1,1,0,0,0,0,0,0,0,0,0,0,1,1,0
108,私立,一般大學,1196,法鼓學校財團法人法鼓文理學院,碩士班(日間),香港,港澳,2,2,0,0,0,0,0,0,0,2,2,0,0,0,0
108,私立,一般大學,1196,法鼓學校財團法人法鼓文理學院,碩士班(日間),越南社會主義共和國,東協,7,1,6,7,1,6,0,0,0,0,0,0,0,0,0
108,私立,一般大學,1196,法鼓學校財團法人法鼓文理學院,碩士班(日間),愛爾蘭共和國,歐洲,1,1,0,1,1,0,0,0,0,0,0,0,0,0,0
108,私立,一般大學,1196,法鼓學校財團法人法鼓文理學院,碩士班(日間),新加坡共和國,東協,1,1,0,1,1,0,0,0,0,0,0,0,0,0,0
108,私立,一般大學,1196,法鼓學校財團法人法鼓文理學院,碩士班(日間),瑞士聯邦,歐洲,1,0,1,1,0,1,0,0,0,0,0,0,0,0,0
108,私立,一般大學,1196,法鼓學校財團法人法鼓文理學院,碩士班(日間),德意志聯邦共和國,歐洲,1,1,0,1,1,0,0,0,0,0,0,0,0,0,0
108,私立,一般大學,1196,法鼓學校財團法人法鼓文理學院,碩士班(日間),澳門,港澳,1,0,1,0,0,0,0,0,0,1,0,1,0,0,0
108,私立,一般大學,1196,法鼓學校財團法人法鼓文理學院,碩士班(日間),大韓民國(南韓),其他亞洲地區,3,3,0,3,3,0,0,0,0,0,0,0,0,0,0
108,私立,一般大學,1196,法鼓學校財團法人法鼓文理學院,碩士班(日間),馬來西亞,東協,6,2,4,5,2,3,1,0,1,0,0,0,0,0,0
108,私立,一般大學,1196,法鼓學校財團法人法鼓文理學院,博士班,大陸地區,大陸地區,3,3,0,0,0,0,0,0,0,0,0,0,3,3,0
108,私立,一般大學,1196,法鼓學校財團法人法鼓文理學院,博士班,厄瓜多共和國,中南美洲,1,0,1,0,0,0,1,0,1,0,0,0,0,0,0
108,私立,一般大學,1196,法鼓學校財團法人法鼓文理學院,博士班,香港,港澳,1,1,0,0,0,0,0,0,0,1,1,0,0,0,0
108,私立,一般大學,1196,法鼓學校財團法人法鼓文理學院,博士班,馬來西亞,東協,1,1,0,1,1,0,0,0,0,0,0,0,0,0,0
108,私立,技專校院,1283,仁德醫護管理專科學校,五專,印度尼西亞共和國,東協,1,1,0,1,1,0,0,0,0,0,0,0,0,0,0
108,私立,技專校院,1286,耕莘健康管理專科學校,五專,越南社會主義共和國,東協,1,0,1,0,0,0,1,0,1,0,0,0,0,0,0
108,私立,技專校院,1289,育英醫護管理專科學校,五專,日本,其他亞洲地區,1,0,1,0,0,0,1,0,1,0,0,0,0,0,0
108,私立,技專校院,1292,新生醫護管理專科學校,五專,大韓民國(南韓),其他亞洲地區,1,1,0,0,0,0,1,1,0,0,0,0,0,0,0
108,私立,技專校院,1292,新生醫護管理專科學校,五專,印度尼西亞共和國,東協,1,0,1,0,0,0,1,0,1,0,0,0,0,0,0
108,私立,宗教研修學院,1R02,學校財團法人中華浸信會基督教台灣浸會神學院,碩士班(日間),大韓民國(南韓),其他亞洲地區,1,0,1,1,0,1,0,0,0,0,0,0,0,0,0
108,私立,宗教研修學院,1R02,學校財團法人中華浸信會基督教台灣浸會神學院,碩士班(日間),香港,港澳,1,0,1,0,0,0,0,0,0,1,0,1,0,0,0
108,私立,宗教研修學院,1R03,臺北基督學院,學士班(日間),大韓民國(南韓),其他亞洲地區,1,0,1,1,0,1,0,0,0,0,0,0,0,0,0
108,私立,宗教研修學院,1R03,臺北基督學院,學士班(日間),吉爾吉斯,其他亞洲地區,1,0,1,1,0,1,0,0,0,0,0,0,0,0,0
108,私立,宗教研修學院,1R03,臺北基督學院,學士班(日間),香港,港澳,1,1,0,0,0,0,0,0,0,1,1,0,0,0,0
108,私立,宗教研修學院,1R03,臺北基督學院,學士班(日間),馬來西亞,東協,3,0,3,3,0,3,0,0,0,0,0,0,0,0,0
108,私立,宗教研修學院,1R04,財團法人一貫道天皇基金會一貫道天皇學院,學士班(日間),新加坡共和國,東協,1,0,1,1,0,1,0,0,0,0,0,0,0,0,0
108,私立,宗教研修學院,1R04,財團法人一貫道天皇基金會一貫道天皇學院,碩士班(日間),馬來西亞,東協,1,0,1,1,0,1,0,0,0,0,0,0,0,0,0
108,私立,宗教研修學院,1R05,台神學校財團法人台灣神學研究學院,碩士班(日間),馬來西亞,東協,3,0,3,3,0,3,0,0,0,0,0,0,0,0,0
108,私立,宗教研修學院,1R05,台神學校財團法人台灣神學研究學院,碩士班(日間),緬甸,東協,1,0,1,1,0,1,0,0,0,0,0,0,0,0,0
108,私立,宗教研修學院,1R05,台神學校財團法人台灣神學研究學院,碩士班(日間),新加坡共和國,東協,2,1,1,2,1,1,0,0,0,0,0,0,0,0,0
108,私立,宗教研修學院,1R06,一貫道崇德學院,碩士班(日間),印度尼西亞共和國,東協,1,0,1,0,0,0,1,0,1,0,0,0,0,0,0
108,私立,宗教研修學院,1R06,一貫道崇德學院,碩士班(日間),泰國,東協,1,1,0,1,1,0,0,0,0,0,0,0,0,0,0
108,私立,宗教研修學院,1R06,一貫道崇德學院,碩士班(日間),馬來西亞,東協,5,2,3,3,0,3,2,2,0,0,0,0,0,0,0
108,公立,一般大學,3002,臺北市立大學,學士班(日間),泰國,東協,1,1,0,0,0,0,1,1,0,0,0,0,0,0,0
108,公立,一般大學,3002,臺北市立大學,學士班(日間),智利,中南美洲,1,1,0,1,1,0,0,0,0,0,0,0,0,0,0
108,公立,一般大學,3002,臺北市立大學,學士班(日間),土耳其共和國,其他亞洲地區,1,0,1,1,0,1,0,0,0,0,0,0,0,0,0
108,公立,一般大學,3002,臺北市立大學,學士班(日間),大陸地區,大陸地區,5,4,1,0,0,0,0,0,0,0,0,0,5,4,1
108,公立,一般大學,3002,臺北市立大學,學士班(日間),日本,其他亞洲地區,6,2,4,4,1,3,2,1,1,0,0,0,0,0,0
108,公立,一般大學,3002,臺北市立大學,學士班(日間),印度尼西亞共和國,東協,2,1,1,1,1,0,1,0,1,0,0,0,0,0,0
108,公立,一般大學,3002,臺北市立大學,學士班(日間),法國,歐洲,1,1,0,1,1,0,0,0,0,0,0,0,0,0,0
108,公立,一般大學,3002,臺北市立大學,學士班(日間),香港,港澳,26,16,10,0,0,0,0,0,0,26,16,10,0,0,0
108,公立,一般大學,3002,臺北市立大學,學士班(日間),馬來西亞,東協,49,21,28,4,1,3,45,20,25,0,0,0,0,0,0
108,公立,一般大學,3002,臺北市立大學,學士班(日間),越南社會主義共和國,東協,7,4,3,1,0,1,6,4,2,0,0,0,0,0,0
108,公立,一般大學,3002,臺北市立大學,學士班(日間),緬甸,東協,19,4,15,0,0,0,19,4,15,0,0,0,0,0,0
108,公立,一般大學,3002,臺北市立大學,學士班(日間),澳門,港澳,21,10,11,0,0,0,0,0,0,21,10,11,0,0,0
108,公立,一般大學,3002,臺北市立大學,碩士班(日間),大陸地區,大陸地區,2,1,1,0,0,0,0,0,0,0,0,0,2,1,1
108,公立,一般大學,3002,臺北市立大學,碩士班(日間),印度尼西亞共和國,東協,1,0,1,1,0,1,0,0,0,0,0,0,0,0,0
108,公立,一般大學,3002,臺北市立大學,碩士班(日間),貝里斯,中南美洲,1,1,0,1,1,0,0,0,0,0,0,0,0,0,0
108,公立,一般大學,3002,臺北市立大學,碩士班(日間),南非共和國,非洲,1,0,1,0,0,0,1,0,1,0,0,0,0,0,0
108,公立,一般大學,3002,臺北市立大學,碩士班(日間),香港,港澳,5,2,3,0,0,0,0,0,0,5,2,3,0,0,0
108,公立,一般大學,3002,臺北市立大學,碩士班(日間),馬來西亞,東協,10,6,4,2,0,2,8,6,2,0,0,0,0,0,0
108,公立,一般大學,3002,臺北市立大學,碩士班(日間),越南社會主義共和國,東協,1,1,0,1,1,0,0,0,0,0,0,0,0,0,0
108,公立,一般大學,3002,臺北市立大學,碩士班(日間),澳門,港澳,3,2,1,0,0,0,0,0,0,3,2,1,0,0,0
108,公立,一般大學,3002,臺北市立大學,碩士班(日間),美國,北美洲,1,1,0,1,1,0,0,0,0,0,0,0,0,0,0
108,公立,一般大學,3002,臺北市立大學,碩士班(日間),泰國,東協,1,0,1,1,0,1,0,0,0,0,0,0,0,0,0
108,公立,一般大學,3002,臺北市立大學,博士班,大韓民國(南韓),其他亞洲地區,1,0,1,0,0,0,1,0,1,0,0,0,0,0,0
108,公立,一般大學,3002,臺北市立大學,博士班,泰國,東協,4,2,2,4,2,2,0,0,0,0,0,0,0,0,0
108,公立,一般大學,3002,臺北市立大學,博士班,馬來西亞,東協,1,1,0,0,0,0,1,1,0,0,0,0,0,0,0
108,公立,一般大學,3002,臺北市立大學,博士班,捷克共和國,歐洲,1,1,0,1,1,0,0,0,0,0,0,0,0,0,0
108,公立,一般大學,3002,臺北市立大學,博士班,大陸地區,大陸地區,6,5,1,0,0,0,0,0,0,0,0,0,6,5,1
108,公立,一般大學,3002,臺北市立大學,博士班,日本,其他亞洲地區,1,1,0,1,1,0,0,0,0,0,0,0,0,0,0
108,公立,一般大學,3002,臺北市立大學,博士班,香港,港澳,1,0,1,0,0,0,0,0,0,1,0,1,0,0,0
108,公立,一般大學,3002,臺北市立大學,博士班,越南社會主義共和國,東協,1,0,1,1,0,1,0,0,0,0,0,0,0,0,0
109,公立,一般大學,0001,國立政治大學,學士班(日間),大陸地區,大陸地區,12,1,11,0,0,0,0,0,0,0,0,0,12,1,11
109,公立,一般大學,0001,國立政治大學,學士班(日間),大韓民國(南韓),其他亞洲地區,45,24,21,38,21,17,7,3,4,0,0,0,0,0,0
109,公立,一般大學,0001,國立政治大學,學士班(日間),厄瓜多共和國,中南美洲,1,1,0,0,0,0,1,1,0,0,0,0,0,0,0
109,公立,一般大學,0001,國立政治大學,學士班(日間),巴拿馬共和國,中南美洲,1,1,0,1,1,0,0,0,0,0,0,0,0,0,0
109,公立,一般大學,0001,國立政治大學,學士班(日間),日本,其他亞洲地區,49,19,30,37,13,24,12,6,6,0,0,0,0,0,0
109,公立,一般大學,0001,國立政治大學,學士班(日間),多明尼加共和國,中南美洲,2,1,1,0,0,0,2,1,1,0,0,0,0,0,0
109,公立,一般大學,0001,國立政治大學,學士班(日間),宏都拉斯共和國,中南美洲,15,2,13,15,2,13,0,0,0,0,0,0,0,0,0
109,公立,一般大學,0001,國立政治大學,學士班(日間),貝里斯,中南美洲,5,2,3,5,2,3,0,0,0,0,0,0,0,0,0
109,公立,一般大學,0001,國立政治大學,學士班(日間),南非共和國,非洲,2,1,1,0,0,0,2,1,1,0,0,0,0,0,0
109,公立,一般大學,0001,國立政治大學,學士班(日間),香港,港澳,85,39,46,0,0,0,0,0,0,85,39,46,0,0,0
109,公立,一般大學,0001,國立政治大學,學士班(日間),智利,中南美洲,2,0,2,0,0,0,2,0,2,0,0,0,0,0,0
109,公立,一般大學,0001,國立政治大學,學士班(日間),新加坡共和國,東協,6,1,5,3,0,3,3,1,2,0,0,0,0,0,0
109,公立,一般大學,0001,國立政治大學,學士班(日間),聖文森(及格瑞那丁),中南美洲,2,1,1,2,1,1,0,0,0,0,0,0,0,0,0
109,公立,一般大學,0001,國立政治大學,學士班(日間),蒙古國,其他亞洲地區,1,0,1,1,0,1,0,0,0,0,0,0,0,0,0
109,公立,一般大學,0001,國立政治大學,學士班(日間),緬甸,東協,13,5,8,0,0,0,13,5,8,0,0,0,0,0,0
109,公立,一般大學,0001,國立政治大學,學士班(日間),薩爾瓦多,中南美洲,2,1,1,2,1,1,0,0,0,0,0,0,0,0,0
109,公立,一般大學,0001,國立政治大學,學士班(日間),土耳其共和國,其他亞洲地區,1,0,1,1,0,1,0,0,0,0,0,0,0,0,0
109,公立,一般大學,0001,國立政治大學,學士班(日間),巴拉圭,中南美洲,6,2,4,5,1,4,1,1,0,0,0,0,0,0,0
109,公立,一般大學,0001,國立政治大學,學士班(日間),以色列,其他亞洲地區,1,1,0,1,1,0,0,0,0,0,0,0,0,0,0
109,公立,一般大學,0001,國立政治大學,學士班(日間),加拿大,北美洲,2,1,1,1,1,0,1,0,1,0,0,0,0,0,0
109,公立,一般大學,0001,國立政治大學,學士班(日間),史瓦帝尼王國,非洲,1,0,1,1,0,1,0,0,0,0,0,0,0,0,0
109,公立,一般大學,0001,國立政治大學,學士班(日間),尼加拉瓜,中南美洲,5,3,2,4,2,2,1,1,0,0,0,0,0,0,0
109,公立,一般大學,0001,國立政治大學,學士班(日間),印度尼西亞共和國,東協,66,20,46,11,5,6,55,15,40,0,0,0,0,0,0
109,公立,一般大學,0001,國立政治大學,學士班(日間),法國,歐洲,1,1,0,1,1,0,0,0,0,0,0,0,0,0,0
109,公立,一般大學,0001,國立政治大學,學士班(日間),阿根廷,中南美洲,2,1,1,0,0,0,2,1,1,0,0,0,0,0,0
109,公立,一般大學,0001,國立政治大學,學士班(日間),俄羅斯聯邦,其他亞洲地區,3,2,1,3,2,1,0,0,0,0,0,0,0,0,0
109,公立,一般大學,0001,國立政治大學,學士班(日間),美國,北美洲,5,4,1,4,4,0,1,0,1,0,0,0,0,0,0
109,公立,一般大學,0001,國立政治大學,學士班(日間),泰國,東協,14,3,11,6,1,5,8,2,6,0,0,0,0,0,0
109,公立,一般大學,0001,國立政治大學,學士班(日間),海地共和國,中南美洲,1,1,0,1,1,0,0,0,0,0,0,0,0,0,0
109,公立,一般大學,0001,國立政治大學,學士班(日間),馬來西亞,東協,229,73,156,14,4,10,215,69,146,0,0,0,0,0,0
109,公立,一般大學,0001,國立政治大學,學士班(日間),越南社會主義共和國,東協,35,14,21,11,3,8,24,11,13,0,0,0,0,0,0
109,公立,一般大學,0001,國立政治大學,學士班(日間),聖露西亞,中南美洲,1,0,1,1,0,1,0,0,0,0,0,0,0,0,0
109,公立,一般大學,0001,國立政治大學,學士班(日間),德意志聯邦共和國,歐洲,1,1,0,1,1,0,0,0,0,0,0,0,0,0,0
109,公立,一般大學,0001,國立政治大學,學士班(日間),墨西哥合眾國,中南美洲,2,0,2,1,0,1,1,0,1,0,0,0,0,0,0
109,公立,一般大學,0001,國立政治大學,學士班(日間),澳門,港澳,109,44,65,0,0,0,0,0,0,109,44,65,0,0,0
109,公立,一般大學,0001,國立政治大學,碩士班(日間),土耳其共和國,其他亞洲地區,4,3,1,4,3,1,0,0,0,0,0,0,0,0,0
109,公立,一般大學,0001,國立政治大學,碩士班(日間),大陸地區,大陸地區,221,78,143,0,0,0,0,0,0,0,0,0,221,78,143
109,公立,一般大學,0001,國立政治大學,碩士班(日間),巴西聯邦共和國,中南美洲,2,1,1,1,1,0,1,0,1,0,0,0,0,0,0
109,公立,一般大學,0001,國立政治大學,碩士班(日間),巴拉圭,中南美洲,1,1,0,0,0,0,1,1,0,0,0,0,0,0,0
109,公立,一般大學,0001,國立政治大學,碩士班(日間),加拿大,北美洲,6,6,0,5,5,0,1,1,0,0,0,0,0,0,0
109,公立,一般大學,0001,國立政治大學,碩士班(日間),尼加拉瓜,中南美洲,6,3,3,6,3,3,0,0,0,0,0,0,0,0,0
109,公立,一般大學,0001,國立政治大學,碩士班(日間),瓜地馬拉共和國,中南美洲,6,2,4,6,2,4,0,0,0,0,0,0,0,0,0
109,公立,一般大學,0001,國立政治大學,碩士班(日間),匈牙利共和國,歐洲,2,0,2,2,0,2,0,0,0,0,0,0,0,0,0
109,公立,一般大學,0001,國立政治大學,碩士班(日間),印度尼西亞共和國,東協,6,2,4,5,1,4,1,1,0,0,0,0,0,0,0
109,公立,一般大學,0001,國立政治大學,碩士班(日間),貝里斯,中南美洲,5,3,2,5,3,2,0,0,0,0,0,0,0,0,0
109,公立,一般大學,0001,國立政治大學,碩士班(日間),委內瑞拉共和國,中南美洲,1,1,0,0,0,0,1,1,0,0,0,0,0,0,0
109,公立,一般大學,0001,國立政治大學,碩士班(日間),波蘭共和國,歐洲,4,3,1,4,3,1,0,0,0,0,0,0,0,0,0
109,公立,一般大學,0001,國立政治大學,碩士班(日間),法國,歐洲,3,2,1,3,2,1,0,0,0,0,0,0,0,0,0
109,公立,一般大學,0001,國立政治大學,碩士班(日間),阿根廷,中南美洲,1,1,0,1,1,0,0,0,0,0,0,0,0,0,0
109,公立,一般大學,0001,國立政治大學,碩士班(日間),俄羅斯聯邦,其他亞洲地區,10,1,9,10,1,9,0,0,0,0,0,0,0,0,0
109,公立,一般大學,0001,國立政治大學,碩士班(日間),英國,歐洲,3,2,1,3,2,1,0,0,0,0,0,0,0,0,0
109,公立,一般大學,0001,國立政治大學,碩士班(日間),泰國,東協,20,5,15,19,5,14,1,0,1,0,0,0,0,0,0
109,公立,一般大學,0001,國立政治大學,碩士班(日間),海地共和國,中南美洲,1,1,0,1,1,0,0,0,0,0,0,0,0,0,0
109,公立,一般大學,0001,國立政治大學,碩士班(日間),馬來西亞,東協,69,27,42,25,9,16,44,18,26,0,0,0,0,0,0
109,公立,一般大學,0001,國立政治大學,碩士班(日間),菲律賓共和國,東協,8,2,6,7,2,5,1,0,1,0,0,0,0,0,0
109,公立,一般大學,0001,國立政治大學,碩士班(日間),越南社會主義共和國,東協,9,1,8,8,1,7,1,0,1,0,0,0,0,0,0
109,公立,一般大學,0001,國立政治大學,碩士班(日間),聖露西亞,中南美洲,1,1,0,1,1,0,0,0,0,0,0,0,0,0,0
109,公立,一般大學,0001,國立政治大學,碩士班(日間),墨西哥合眾國,中南美洲,6,3,3,6,3,3,0,0,0,0,0,0,0,0,0
109,公立,一般大學,0001,國立政治大學,碩士班(日間),澳門,港澳,20,12,8,0,0,0,0,0,0,20,12,8,0,0,0
109,公立,一般大學,0001,國立政治大學,碩士班(日間),薩爾瓦多,中南美洲,1,1,0,1,1,0,0,0,0,0,0,0,0,0,0
109,公立,一般大學,0001,國立政治大學,碩士班(日間),大韓民國(南韓),其他亞洲地區,16,5,11,16,5,11,0,0,0,0,0,0,0,0,0
109,公立,一般大學,0001,國立政治大學,碩士班(日間),厄瓜多共和國,中南美洲,1,0,1,1,0,1,0,0,0,0,0,0,0,0,0
109,公立,一般大學,0001,國立政治大學,碩士班(日間),巴拿馬共和國,中南美洲,1,0,1,1,0,1,0,0,0,0,0,0,0,0,0
109,公立,一般大學,0001,國立政治大學,碩士班(日間),日本,其他亞洲地區,14,3,11,13,2,11,1,1,0,0,0,0,0,0,0
109,公立,一般大學,0001,國立政治大學,碩士班(日間),西班牙王國,歐洲,2,2,0,2,2,0,0,0,0,0,0,0,0,0,0
109,公立,一般大學,0001,國立政治大學,碩士班(日間),克羅埃西亞共和國,歐洲,1,0,1,1,0,1,0,0,0,0,0,0,0,0,0
109,公立,一般大學,0001,國立政治大學,碩士班(日間),宏都拉斯共和國,中南美洲,8,5,3,8,5,3,0,0,0,0,0,0,0,0,0
109,公立,一般大學,0001,國立政治大學,碩士班(日間),科索沃共和國,歐洲,1,0,1,1,0,1,0,0,0,0,0,0,0,0,0
109,公立,一般大學,0001,國立政治大學,碩士班(日間),美國,北美洲,26,16,10,25,16,9,1,0,1,0,0,0,0,0,0
109,公立,一般大學,0001,國立政治大學,碩士班(日間),香港,港澳,41,23,18,0,0,0,0,0,0,41,23,18,0,0,0
109,公立,一般大學,0001,國立政治大學,碩士班(日間),秘魯共和國,中南美洲,1,0,1,1,0,1,0,0,0,0,0,0,0,0,0
109,公立,一般大學,0001,國立政治大學,碩士班(日間),紐西蘭,其他亞洲地區,1,1,0,1,1,0,0,0,0,0,0,0,0,0,0
109,公立,一般大學,0001,國立政治大學,碩士班(日間),捷克共和國,歐洲,3,1,2,3,1,2,0,0,0,0,0,0,0,0,0
109,公立,一般大學,0001,國立政治大學,碩士班(日間),斯洛伐克共和國,歐洲,2,2,0,2,2,0,0,0,0,0,0,0,0,0,0
109,公立,一般大學,0001,國立政治大學,碩士班(日間),新加坡共和國,東協,2,1,1,2,1,1,0,0,0,0,0,0,0,0,0
109,公立,一般大學,0001,國立政治大學,碩士班(日間),義大利共和國,歐洲,4,2,2,4,2,2,0,0,0,0,0,0,0,0,0
109,公立,一般大學,0001,國立政治大學,碩士班(日間),聖文森(及格瑞那丁),中南美洲,2,1,1,2,1,1,0,0,0,0,0,0,0,0,0
109,公立,一般大學,0001,國立政治大學,碩士班(日間),聖克里斯多福及尼維斯,中南美洲,2,0,2,2,0,2,0,0,0,0,0,0,0,0,0
109,公立,一般大學,0001,國立政治大學,碩士班(日間),德意志聯邦共和國,歐洲,5,4,1,5,4,1,0,0,0,0,0,0,0,0,0
109,公立,一般大學,0001,國立政治大學,碩士班(日間),緬甸,東協,2,1,1,0,0,0,2,1,1,0,0,0,0,0,0
109,公立,一般大學,0001,國立政治大學,碩士班(日間),澳大利亞,其他亞洲地區,1,1,0,1,1,0,0,0,0,0,0,0,0,0,0
109,公立,一般大學,0001,國立政治大學,博士班,大陸地區,大陸地區,119,52,67,0,0,0,0,0,0,0,0,0,119,52,67
109,公立,一般大學,0001,國立政治大學,博士班,日本,其他亞洲地區,7,6,1,7,6,1,0,0,0,0,0,0,0,0,0
109,公立,一般大學,0001,國立政治大學,博士班,比利時王國,歐洲,1,1,0,1,1,0,0,0,0,0,0,0,0,0,0
109,公立,一般大學,0001,國立政治大學,博士班,加拿大,北美洲,1,1,0,1,1,0,0,0,0,0,0,0,0,0,0
109,公立,一般大學,0001,國立政治大學,博士班,史瓦帝尼王國,非洲,1,1,0,1,1,0,0,0,0,0,0,0,0,0,0
109,公立,一般大學,0001,國立政治大學,博士班,布吉納法索,非洲,1,0,1,1,0,1,0,0,0,0,0,0,0,0,0
109,公立,一般大學,0001,國立政治大學,博士班,白俄羅斯共和國,其他亞洲地區,1,1,0,1,1,0,0,0,0,0,0,0,0,0,0
109,公立,一般大學,0001,國立政治大學,博士班,匈牙利共和國,歐洲,1,1,0,1,1,0,0,0,0,0,0,0,0,0,0
109,公立,一般大學,0001,國立政治大學,博士班,印度尼西亞共和國,東協,9,4,5,9,4,5,0,0,0,0,0,0,0,0,0
109,公立,一般大學,0001,國立政治大學,博士班,多明尼加共和國,中南美洲,1,1,0,1,1,0,0,0,0,0,0,0,0,0,0
109,公立,一般大學,0001,國立政治大學,博士班,西班牙王國,歐洲,2,1,1,2,1,1,0,0,0,0,0,0,0,0,0
109,公立,一般大學,0001,國立政治大學,博士班,坦尚尼亞聯合共和國,非洲,1,1,0,1,1,0,0,0,0,0,0,0,0,0,0
109,公立,一般大學,0001,國立政治大學,博士班,波蘭共和國,歐洲,5,2,3,5,2,3,0,0,0,0,0,0,0,0,0
109,公立,一般大學,0001,國立政治大學,博士班,法國,歐洲,1,0,1,1,0,1,0,0,0,0,0,0,0,0,0
109,公立,一般大學,0001,國立政治大學,博士班,俄羅斯聯邦,其他亞洲地區,2,1,1,2,1,1,0,0,0,0,0,0,0,0,0
109,公立,一般大學,0001,國立政治大學,博士班,南非共和國,非洲,1,0,1,0,0,0,1,0,1,0,0,0,0,0,0
109,公立,一般大學,0001,國立政治大學,博士班,香港,港澳,4,3,1,0,0,0,0,0,0,4,3,1,0,0,0
109,公立,一般大學,0001,國立政治大學,博士班,埃及阿拉伯共和國,非洲,1,0,1,1,0,1,0,0,0,0,0,0,0,0,0
109,公立,一般大學,0001,國立政治大學,博士班,泰國,東協,7,4,3,7,4,3,0,0,0,0,0,0,0,0,0
109,公立,一般大學,0001,國立政治大學,博士班,馬來西亞,東協,10,6,4,3,2,1,7,4,3,0,0,0,0,0,0
109,公立,一般大學,0001,國立政治大學,博士班,越南社會主義共和國,東協,11,4,7,11,4,7,0,0,0,0,0,0,0,0,0
109,公立,一般大學,0001,國立政治大學,博士班,墨西哥合眾國,中南美洲,1,1,0,1,1,0,0,0,0,0,0,0,0,0,0
109,公立,一般大學,0001,國立政治大學,博士班,澳門,港澳,3,3,0,0,0,0,0,0,0,3,3,0,0,0,0
109,公立,一般大學,0001,國立政治大學,博士班,土耳其共和國,其他亞洲地區,1,1,0,1,1,0,0,0,0,0,0,0,0,0,0
109,公立,一般大學,0001,國立政治大學,博士班,大韓民國(南韓),其他亞洲地區,15,8,7,15,8,7,0,0,0,0,0,0,0,0,0
109,公立,一般大學,0001,國立政治大學,博士班,巴西聯邦共和國,中南美洲,3,1,2,3,1,2,0,0,0,0,0,0,0,0,0
109,公立,一般大學,0001,國立政治大學,博士班,巴拉圭,中南美洲,1,1,0,1,1,0,0,0,0,0,0,0,0,0,0
109,公立,一般大學,0001,國立政治大學,博士班,巴基斯坦,南亞,3,3,0,3,3,0,0,0,0,0,0,0,0,0,0
109,公立,一般大學,0001,國立政治大學,博士班,尼加拉瓜,中南美洲,2,1,1,2,1,1,0,0,0,0,0,0,0,0,0
109,公立,一般大學,0001,國立政治大學,博士班,印度,南亞,5,2,3,5,2,3,0,0,0,0,0,0,0,0,0
109,公立,一般大學,0001,國立政治大學,博士班,孟加拉人民共和國,南亞,1,1,0,1,1,0,0,0,0,0,0,0,0,0,0
109,公立,一般大學,0001,國立政治大學,博士班,拉脫維亞共和國,歐洲,1,1,0,1,1,0,0,0,0,0,0,0,0,0,0
109,公立,一般大學,0001,國立政治大學,博士班,美國,北美洲,10,5,5,9,5,4,1,0,1,0,0,0,0,0,0
109,公立,一般大學,0001,國立政治大學,博士班,烏克蘭,其他亞洲地區,1,0,1,1,0,1,0,0,0,0,0,0,0,0,0
109,公立,一般大學,0001,國立政治大學,博士班,紐西蘭,其他亞洲地區,1,1,0,1,1,0,0,0,0,0,0,0,0,0,0
109,公立,一般大學,0001,國立政治大學,博士班,捷克共和國,歐洲,2,0,2,2,0,2,0,0,0,0,0,0,0,0,0
109,公立,一般大學,0001,國立政治大學,博士班,斯里蘭卡民主社會主義共和國,南亞,1,0,1,1,0,1,0,0,0,0,0,0,0,0,0
109,公立,一般大學,0001,國立政治大學,博士班,斯洛伐克共和國,歐洲,1,1,0,1,1,0,0,0,0,0,0,0,0,0,0
109,公立,一般大學,0001,國立政治大學,博士班,菲律賓共和國,東協,3,2,1,3,2,1,0,0,0,0,0,0,0,0,0
109,公立,一般大學,0001,國立政治大學,博士班,新加坡共和國,東協,1,0,1,0,0,0,1,0,1,0,0,0,0,0,0
109,公立,一般大學,0001,國立政治大學,博士班,蒙古國,其他亞洲地區,3,1,2,3,1,2,0,0,0,0,0,0,0,0,0
109,公立,一般大學,0001,國立政治大學,博士班,德意志聯邦共和國,歐洲,2,2,0,2,2,0,0,0,0,0,0,0,0,0,0
109,公立,一般大學,0001,國立政治大學,博士班,澳大利亞,其他亞洲地區,1,1,0,1,1,0,0,0,0,0,0,0,0,0,0
109,公立,一般大學,0002,國立清華大學,學士班(日間),大韓民國(南韓),其他亞洲地區,31,16,15,29,15,14,2,1,1,0,0,0,0,0,0
109,公立,一般大學,0002,國立清華大學,學士班(日間),巴西聯邦共和國,中南美洲,1,0,1,1,0,1,0,0,0,0,0,0,0,0,0
109,公立,一般大學,0002,國立清華大學,學士班(日間),巴拉圭,中南美洲,3,2,1,1,0,1,2,2,0,0,0,0,0,0,0
109,公立,一般大學,0002,國立清華大學,學士班(日間),巴基斯坦,南亞,1,0,1,1,0,1,0,0,0,0,0,0,0,0,0
109,公立,一般大學,0002,國立清華大學,學士班(日間),尼加拉瓜,中南美洲,1,1,0,1,1,0,0,0,0,0,0,0,0,0,0
109,公立,一般大學,0002,國立清華大學,學士班(日間),尼泊爾聯邦民主共和國,南亞,1,1,0,1,1,0,0,0,0,0,0,0,0,0,0
109,公立,一般大學,0002,國立清華大學,學士班(日間),瓜地馬拉共和國,中南美洲,2,1,1,2,1,1,0,0,0,0,0,0,0,0,0
109,公立,一般大學,0002,國立清華大學,學士班(日間),印度,南亞,1,0,1,0,0,0,1,0,1,0,0,0,0,0,0
109,公立,一般大學,0002,國立清華大學,學士班(日間),宏都拉斯共和國,中南美洲,6,5,1,6,5,1,0,0,0,0,0,0,0,0,0
109,公立,一般大學,0002,國立清華大學,學士班(日間),貝里斯,中南美洲,2,1,1,2,1,1,0,0,0,0,0,0,0,0,0
109,公立,一般大學,0002,國立清華大學,學士班(日間),美國,北美洲,1,1,0,1,1,0,0,0,0,0,0,0,0,0,0
109,公立,一般大學,0002,國立清華大學,學士班(日間),香港,港澳,81,44,37,0,0,0,0,0,0,81,44,37,0,0,0
109,公立,一般大學,0002,國立清華大學,學士班(日間),哥斯大黎加共和國,中南美洲,1,0,1,0,0,0,1,0,1,0,0,0,0,0,0
109,公立,一般大學,0002,國立清華大學,學士班(日間),埃及阿拉伯共和國,非洲,1,1,0,1,1,0,0,0,0,0,0,0,0,0,0
109,公立,一般大學,0002,國立清華大學,學士班(日間),海地共和國,中南美洲,8,7,1,8,7,1,0,0,0,0,0,0,0,0,0
109,公立,一般大學,0002,國立清華大學,學士班(日間),烏克蘭,其他亞洲地區,1,0,1,1,0,1,0,0,0,0,0,0,0,0,0
109,公立,一般大學,0002,國立清華大學,學士班(日間),秘魯共和國,中南美洲,1,1,0,0,0,0,1,1,0,0,0,0,0,0,0
109,公立,一般大學,0002,國立清華大學,學士班(日間),菲律賓共和國,東協,4,2,2,1,1,0,3,1,2,0,0,0,0,0,0
109,公立,一般大學,0002,國立清華大學,學士班(日間),越南社會主義共和國,東協,39,13,26,30,7,23,9,6,3,0,0,0,0,0,0
109,公立,一般大學,0002,國立清華大學,學士班(日間),新加坡共和國,東協,2,1,1,1,0,1,1,1,0,0,0,0,0,0,0
109,公立,一般大學,0002,國立清華大學,學士班(日間),聖露西亞,中南美洲,2,0,2,2,0,2,0,0,0,0,0,0,0,0,0
109,公立,一般大學,0002,國立清華大學,學士班(日間),蒙古國,其他亞洲地區,3,2,1,3,2,1,0,0,0,0,0,0,0,0,0
109,公立,一般大學,0002,國立清華大學,學士班(日間),緬甸,東協,19,7,12,0,0,0,19,7,12,0,0,0,0,0,0
109,公立,一般大學,0002,國立清華大學,學士班(日間),澳門,港澳,62,42,20,0,0,0,0,0,0,62,42,20,0,0,0
109,公立,一般大學,0002,國立清華大學,學士班(日間),大陸地區,大陸地區,13,5,8,0,0,0,0,0,0,0,0,0,13,5,8
109,公立,一般大學,0002,國立清華大學,學士班(日間),日本,其他亞洲地區,23,13,10,15,8,7,8,5,3,0,0,0,0,0,0
109,公立,一般大學,0002,國立清華大學,學士班(日間),加拿大,北美洲,2,0,2,0,0,0,2,0,2,0,0,0,0,0,0
109,公立,一般大學,0002,國立清華大學,學士班(日間),史瓦帝尼王國,非洲,1,1,0,1,1,0,0,0,0,0,0,0,0,0,0
109,公立,一般大學,0002,國立清華大學,學士班(日間),印度尼西亞共和國,東協,132,85,47,89,60,29,43,25,18,0,0,0,0,0,0
109,公立,一般大學,0002,國立清華大學,學士班(日間),西班牙王國,歐洲,2,1,1,0,0,0,2,1,1,0,0,0,0,0,0
109,公立,一般大學,0002,國立清華大學,學士班(日間),委內瑞拉共和國,中南美洲,1,1,0,0,0,0,1,1,0,0,0,0,0,0,0
109,公立,一般大學,0002,國立清華大學,學士班(日間),波蘭共和國,歐洲,2,1,1,2,1,1,0,0,0,0,0,0,0,0,0
109,公立,一般大學,0002,國立清華大學,學士班(日間),阿根廷,中南美洲,2,2,0,0,0,0,2,2,0,0,0,0,0,0,0
109,公立,一般大學,0002,國立清華大學,學士班(日間),南非共和國,非洲,1,1,0,0,0,0,1,1,0,0,0,0,0,0,0
109,公立,一般大學,0002,國立清華大學,學士班(日間),泰國,東協,18,12,6,12,10,2,6,2,4,0,0,0,0,0,0
109,公立,一般大學,0002,國立清華大學,學士班(日間),馬來西亞,東協,167,83,84,8,2,6,159,81,78,0,0,0,0,0,0
109,公立,一般大學,0002,國立清華大學,學士班(日間),葉門共和國,其他亞洲地區,1,1,0,1,1,0,0,0,0,0,0,0,0,0,0
109,公立,一般大學,0002,國立清華大學,學士班(日間),墨西哥合眾國,中南美洲,1,1,0,0,0,0,1,1,0,0,0,0,0,0,0
109,公立,一般大學,0002,國立清華大學,碩士班(日間),大陸地區,大陸地區,190,100,90,0,0,0,0,0,0,0,0,0,190,100,90
109,公立,一般大學,0002,國立清華大學,碩士班(日間),日本,其他亞洲地區,2,1,1,1,0,1,1,1,0,0,0,0,0,0,0
109,公立,一般大學,0002,國立清華大學,碩士班(日間),加拿大,北美洲,1,0,1,1,0,1,0,0,0,0,0,0,0,0,0
109,公立,一般大學,0002,國立清華大學,碩士班(日間),史瓦帝尼王國,非洲,4,1,3,4,1,3,0,0,0,0,0,0,0,0,0
109,公立,一般大學,0002,國立清華大學,碩士班(日間),伊朗伊斯蘭共和國,其他亞洲地區,2,1,1,2,1,1,0,0,0,0,0,0,0,0,0
109,公立,一般大學,0002,國立清華大學,碩士班(日間),印度尼西亞共和國,東協,18,12,6,13,8,5,5,4,1,0,0,0,0,0,0
109,公立,一般大學,0002,國立清華大學,碩士班(日間),宏都拉斯共和國,中南美洲,5,3,2,5,3,2,0,0,0,0,0,0,0,0,0
109,公立,一般大學,0002,國立清華大學,碩士班(日間),坦尚尼亞聯合共和國,非洲,1,0,1,1,0,1,0,0,0,0,0,0,0,0,0
109,公立,一般大學,0002,國立清華大學,碩士班(日間),尚比亞共和國,非洲,1,1,0,1,1,0,0,0,0,0,0,0,0,0,0
109,公立,一般大學,0002,國立清華大學,碩士班(日間),波蘭共和國,歐洲,2,1,1,2,1,1,0,0,0,0,0,0,0,0,0
109,公立,一般大學,0002,國立清華大學,碩士班(日間),法國,歐洲,1,1,0,1,1,0,0,0,0,0,0,0,0,0,0
109,公立,一般大學,0002,國立清華大學,碩士班(日間),俄羅斯聯邦,其他亞洲地區,2,1,1,2,1,1,0,0,0,0,0,0,0,0,0
109,公立,一般大學,0002,國立清華大學,碩士班(日間),南非共和國,非洲,2,1,1,0,0,0,2,1,1,0,0,0,0,0,0
109,公立,一般大學,0002,國立清華大學,碩士班(日間),英國,歐洲,4,3,1,4,3,1,0,0,0,0,0,0,0,0,0
109,公立,一般大學,0002,國立清華大學,碩士班(日間),泰國,東協,21,5,16,17,4,13,4,1,3,0,0,0,0,0,0
109,公立,一般大學,0002,國立清華大學,碩士班(日間),烏干達共和國,非洲,1,0,1,1,0,1,0,0,0,0,0,0,0,0,0
109,公立,一般大學,0002,國立清華大學,碩士班(日間),馬來西亞,東協,65,34,31,23,11,12,42,23,19,0,0,0,0,0,0
109,公立,一般大學,0002,國立清華大學,碩士班(日間),斯洛維尼亞共和國,歐洲,1,1,0,1,1,0,0,0,0,0,0,0,0,0,0
109,公立,一般大學,0002,國立清華大學,碩士班(日間),菲律賓共和國,東協,6,2,4,5,2,3,1,0,1,0,0,0,0,0,0
109,公立,一般大學,0002,國立清華大學,碩士班(日間),聖文森(及格瑞那丁),中南美洲,2,2,0,2,2,0,0,0,0,0,0,0,0,0,0
109,公立,一般大學,0002,國立清華大學,碩士班(日間),墨西哥合眾國,中南美洲,1,0,1,1,0,1,0,0,0,0,0,0,0,0,0
109,公立,一般大學,0002,國立清華大學,碩士班(日間),薩爾瓦多,中南美洲,2,2,0,2,2,0,0,0,0,0,0,0,0,0,0
109,公立,一般大學,0002,國立清華大學,碩士班(日間),土耳其共和國,其他亞洲地區,1,0,1,1,0,1,0,0,0,0,0,0,0,0,0
109,公立,一般大學,0002,國立清華大學,碩士班(日間),大韓民國(南韓),其他亞洲地區,2,2,0,2,2,0,0,0,0,0,0,0,0,0,0
109,公立,一般大學,0002,國立清華大學,碩士班(日間),巴拉圭,中南美洲,1,1,0,1,1,0,0,0,0,0,0,0,0,0,0
109,公立,一般大學,0002,國立清華大學,碩士班(日間),巴基斯坦,南亞,1,1,0,1,1,0,0,0,0,0,0,0,0,0,0
109,公立,一般大學,0002,國立清華大學,碩士班(日間),尼加拉瓜,中南美洲,2,1,1,2,1,1,0,0,0,0,0,0,0,0,0
109,公立,一般大學,0002,國立清華大學,碩士班(日間),瓜地馬拉共和國,中南美洲,2,1,1,2,1,1,0,0,0,0,0,0,0,0,0
109,公立,一般大學,0002,國立清華大學,碩士班(日間),印度,南亞,22,16,6,22,16,6,0,0,0,0,0,0,0,0,0
109,公立,一般大學,0002,國立清華大學,碩士班(日間),吐瓦魯,其他亞洲地區,1,1,0,1,1,0,0,0,0,0,0,0,0,0,0
109,公立,一般大學,0002,國立清華大學,碩士班(日間),貝里斯,中南美洲,6,2,4,6,2,4,0,0,0,0,0,0,0,0,0
109,公立,一般大學,0002,國立清華大學,碩士班(日間),美國,北美洲,6,5,1,5,4,1,1,1,0,0,0,0,0,0,0
109,公立,一般大學,0002,國立清華大學,碩士班(日間),香港,港澳,26,20,6,0,0,0,0,0,0,26,20,6,0,0,0
109,公立,一般大學,0002,國立清華大學,碩士班(日間),哥倫比亞共和國,中南美洲,3,2,1,3,2,1,0,0,0,0,0,0,0,0,0
109,公立,一般大學,0002,國立清華大學,碩士班(日間),埃及阿拉伯共和國,非洲,1,0,1,1,0,1,0,0,0,0,0,0,0,0,0
109,公立,一般大學,0002,國立清華大學,碩士班(日間),海地共和國,中南美洲,5,3,2,5,3,2,0,0,0,0,0,0,0,0,0
109,公立,一般大學,0002,國立清華大學,碩士班(日間),烏克蘭,其他亞洲地區,1,0,1,1,0,1,0,0,0,0,0,0,0,0,0
109,公立,一般大學,0002,國立清華大學,碩士班(日間),越南社會主義共和國,東協,48,16,32,46,15,31,2,1,1,0,0,0,0,0,0
109,公立,一般大學,0002,國立清華大學,碩士班(日間),新加坡共和國,東協,2,2,0,1,1,0,1,1,0,0,0,0,0,0,0
109,公立,一般大學,0002,國立清華大學,碩士班(日間),義大利共和國,歐洲,1,1,0,1,1,0,0,0,0,0,0,0,0,0,0
109,公立,一般大學,0002,國立清華大學,碩士班(日間),聖露西亞,中南美洲,4,1,3,4,1,3,0,0,0,0,0,0,0,0,0
109,公立,一般大學,0002,國立清華大學,碩士班(日間),蒙古國,其他亞洲地區,3,1,2,3,1,2,0,0,0,0,0,0,0,0,0
109,公立,一般大學,0002,國立清華大學,碩士班(日間),德意志聯邦共和國,歐洲,1,1,0,1,1,0,0,0,0,0,0,0,0,0,0
109,公立,一般大學,0002,國立清華大學,碩士班(日間),緬甸,東協,1,0,1,0,0,0,1,0,1,0,0,0,0,0,0
109,公立,一般大學,0002,國立清華大學,碩士班(日間),澳門,港澳,11,10,1,0,0,0,0,0,0,11,10,1,0,0,0
109,公立,一般大學,0002,國立清華大學,博士班,厄瓜多共和國,中南美洲,1,1,0,1,1,0,0,0,0,0,0,0,0,0,0
109,公立,一般大學,0002,國立清華大學,博士班,巴西聯邦共和國,中南美洲,1,1,0,1,1,0,0,0,0,0,0,0,0,0,0
109,公立,一般大學,0002,國立清華大學,博士班,巴基斯坦,南亞,13,10,3,13,10,3,0,0,0,0,0,0,0,0,0
109,公立,一般大學,0002,國立清華大學,博士班,日本,其他亞洲地區,2,2,0,2,2,0,0,0,0,0,0,0,0,0,0
109,公立,一般大學,0002,國立清華大學,博士班,以色列,其他亞洲地區,1,1,0,1,1,0,0,0,0,0,0,0,0,0,0
109,公立,一般大學,0002,國立清華大學,博士班,尼泊爾聯邦民主共和國,南亞,3,2,1,3,2,1,0,0,0,0,0,0,0,0,0
109,公立,一般大學,0002,國立清華大學,博士班,俄羅斯聯邦,其他亞洲地區,2,1,1,2,1,1,0,0,0,0,0,0,0,0,0
109,公立,一般大學,0002,國立清華大學,博士班,哈薩克共和國,其他亞洲地區,1,1,0,1,1,0,0,0,0,0,0,0,0,0,0
109,公立,一般大學,0002,國立清華大學,博士班,美國,北美洲,8,7,1,8,7,1,0,0,0,0,0,0,0,0,0
109,公立,一般大學,0002,國立清華大學,博士班,英國,歐洲,2,2,0,2,2,0,0,0,0,0,0,0,0,0,0
109,公立,一般大學,0002,國立清華大學,博士班,泰國,東協,7,4,3,7,4,3,0,0,0,0,0,0,0,0,0
109,公立,一般大學,0002,國立清華大學,博士班,馬來西亞,東協,14,6,8,7,2,5,7,4,3,0,0,0,0,0,0
109,公立,一般大學,0002,國立清華大學,博士班,捷克共和國,歐洲,2,1,1,2,1,1,0,0,0,0,0,0,0,0,0
109,公立,一般大學,0002,國立清華大學,博士班,菲律賓共和國,東協,9,9,0,9,9,0,0,0,0,0,0,0,0,0,0
109,公立,一般大學,0002,國立清華大學,博士班,塞爾維亞共和國,歐洲,1,1,0,1,1,0,0,0,0,0,0,0,0,0,0
109,公立,一般大學,0002,國立清華大學,博士班,新加坡共和國,東協,3,2,1,3,2,1,0,0,0,0,0,0,0,0,0
109,公立,一般大學,0002,國立清華大學,博士班,德意志聯邦共和國,歐洲,2,2,0,2,2,0,0,0,0,0,0,0,0,0,0
109,公立,一般大學,0002,國立清華大學,博士班,土耳其共和國,其他亞洲地區,2,1,1,2,1,1,0,0,0,0,0,0,0,0,0
109,公立,一般大學,0002,國立清華大學,博士班,大陸地區,大陸地區,76,40,36,0,0,0,0,0,0,0,0,0,76,40,36
109,公立,一般大學,0002,國立清華大學,博士班,大韓民國(南韓),其他亞洲地區,1,1,0,1,1,0,0,0,0,0,0,0,0,0,0
109,公立,一般大學,0002,國立清華大學,博士班,伊朗伊斯蘭共和國,其他亞洲地區,8,6,2,8,6,2,0,0,0,0,0,0,0,0,0
109,公立,一般大學,0002,國立清華大學,博士班,印度,南亞,169,121,48,169,121,48,0,0,0,0,0,0,0,0,0
109,公立,一般大學,0002,國立清華大學,博士班,印度尼西亞共和國,東協,18,10,8,18,10,8,0,0,0,0,0,0,0,0,0
109,公立,一般大學,0002,國立清華大學,博士班,多明尼加共和國,中南美洲,1,0,1,1,0,1,0,0,0,0,0,0,0,0,0
109,公立,一般大學,0002,國立清華大學,博士班,衣索比亞聯邦民主共和國,非洲,2,2,0,2,2,0,0,0,0,0,0,0,0,0,0
109,公立,一般大學,0002,國立清華大學,博士班,宏都拉斯共和國,中南美洲,4,4,0,4,4,0,0,0,0,0,0,0,0,0,0
109,公立,一般大學,0002,國立清華大學,博士班,辛巴威共和國,非洲,1,0,1,1,0,1,0,0,0,0,0,0,0,0,0
109,公立,一般大學,0002,國立清華大學,博士班,孟加拉人民共和國,南亞,1,1,0,1,1,0,0,0,0,0,0,0,0,0,0
109,公立,一般大學,0002,國立清華大學,博士班,波士尼亞與赫塞哥維納,歐洲,1,0,1,1,0,1,0,0,0,0,0,0,0,0,0
109,公立,一般大學,0002,國立清華大學,博士班,波蘭共和國,歐洲,1,0,1,1,0,1,0,0,0,0,0,0,0,0,0
109,公立,一般大學,0002,國立清華大學,博士班,香港,港澳,6,5,1,0,0,0,0,0,0,6,5,1,0,0,0
109,公立,一般大學,0002,國立清華大學,博士班,埃及阿拉伯共和國,非洲,8,8,0,8,8,0,0,0,0,0,0,0,0,0,0
109,公立,一般大學,0002,國立清華大學,博士班,海地共和國,中南美洲,1,1,0,1,1,0,0,0,0,0,0,0,0,0,0
109,公立,一般大學,0002,國立清華大學,博士班,烏干達共和國,非洲,1,1,0,1,1,0,0,0,0,0,0,0,0,0,0
109,公立,一般大學,0002,國立清華大學,博士班,秘魯共和國,中南美洲,1,1,0,1,1,0,0,0,0,0,0,0,0,0,0
109,公立,一般大學,0002,國立清華大學,博士班,喀麥隆共和國,非洲,1,1,0,1,1,0,0,0,0,0,0,0,0,0,0
109,公立,一般大學,0002,國立清華大學,博士班,越南社會主義共和國,東協,38,19,19,38,19,19,0,0,0,0,0,0,0,0,0
109,公立,一般大學,0002,國立清華大學,博士班,蒙古國,其他亞洲地區,1,0,1,1,0,1,0,0,0,0,0,0,0,0,0
109,公立,一般大學,0002,國立清華大學,博士班,墨西哥合眾國,中南美洲,1,1,0,1,1,0,0,0,0,0,0,0,0,0,0
109,公立,一般大學,0002,國立清華大學,博士班,澳門,港澳,4,2,2,0,0,0,0,0,0,4,2,2,0,0,0
109,公立,一般大學,0003,國立臺灣大學,學士班(日間),大陸地區,大陸地區,15,5,10,0,0,0,0,0,0,0,0,0,15,5,10
109,公立,一般大學,0003,國立臺灣大學,學士班(日間),大韓民國(南韓),其他亞洲地區,110,46,64,99,40,59,11,6,5,0,0,0,0,0,0
109,公立,一般大學,0003,國立臺灣大學,學士班(日間),巴西聯邦共和國,中南美洲,4,1,3,0,0,0,4,1,3,0,0,0,0,0,0
109,公立,一般大學,0003,國立臺灣大學,學士班(日間),巴拉圭,中南美洲,18,12,6,17,11,6,1,1,0,0,0,0,0,0,0
109,公立,一般大學,0003,國立臺灣大學,學士班(日間),日本,其他亞洲地區,116,44,72,88,36,52,28,8,20,0,0,0,0,0,0
109,公立,一般大學,0003,國立臺灣大學,學士班(日間),比利時王國,歐洲,1,0,1,0,0,0,1,0,1,0,0,0,0,0,0
109,公立,一般大學,0003,國立臺灣大學,學士班(日間),加拿大,北美洲,14,7,7,0,0,0,14,7,7,0,0,0,0,0,0
109,公立,一般大學,0003,國立臺灣大學,學士班(日間),瓜地馬拉共和國,中南美洲,4,2,2,4,2,2,0,0,0,0,0,0,0,0,0
109,公立,一般大學,0003,國立臺灣大學,學士班(日間),白俄羅斯共和國,其他亞洲地區,1,1,0,1,1,0,0,0,0,0,0,0,0,0,0
109,公立,一般大學,0003,國立臺灣大學,學士班(日間),冰島共和國,歐洲,1,1,0,1,1,0,0,0,0,0,0,0,0,0,0
109,公立,一般大學,0003,國立臺灣大學,學士班(日間),印度尼西亞共和國,東協,255,125,130,68,32,36,187,93,94,0,0,0,0,0,0
109,公立,一般大學,0003,國立臺灣大學,學士班(日間),宏都拉斯共和國,中南美洲,24,10,14,23,9,14,1,1,0,0,0,0,0,0,0
109,公立,一般大學,0003,國立臺灣大學,學士班(日間),貝里斯,中南美洲,3,3,0,3,3,0,0,0,0,0,0,0,0,0,0
109,公立,一般大學,0003,國立臺灣大學,學士班(日間),法國,歐洲,1,0,1,0,0,0,1,0,1,0,0,0,0,0,0
109,公立,一般大學,0003,國立臺灣大學,學士班(日間),阿根廷,中南美洲,2,1,1,1,0,1,1,1,0,0,0,0,0,0,0
109,公立,一般大學,0003,國立臺灣大學,學士班(日間),保加利亞共和國,歐洲,1,1,0,1,1,0,0,0,0,0,0,0,0,0,0
109,公立,一般大學,0003,國立臺灣大學,學士班(日間),英國,歐洲,4,2,2,4,2,2,0,0,0,0,0,0,0,0,0
109,公立,一般大學,0003,國立臺灣大學,學士班(日間),香港,港澳,213,117,96,0,0,0,0,0,0,213,117,96,0,0,0
109,公立,一般大學,0003,國立臺灣大學,學士班(日間),泰國,東協,43,16,27,7,2,5,36,14,22,0,0,0,0,0,0
109,公立,一般大學,0003,國立臺灣大學,學士班(日間),馬來西亞,東協,499,231,268,30,10,20,469,221,248,0,0,0,0,0,0
109,公立,一般大學,0003,國立臺灣大學,學士班(日間),菲律賓共和國,東協,14,6,8,3,1,2,11,5,6,0,0,0,0,0,0
109,公立,一般大學,0003,國立臺灣大學,學士班(日間),越南社會主義共和國,東協,43,14,29,7,2,5,36,12,24,0,0,0,0,0,0
109,公立,一般大學,0003,國立臺灣大學,學士班(日間),寮人民民主共和國(寮國),東協,1,0,1,0,0,0,1,0,1,0,0,0,0,0,0
109,公立,一般大學,0003,國立臺灣大學,學士班(日間),緬甸,東協,21,10,11,0,0,0,21,10,11,0,0,0,0,0,0
109,公立,一般大學,0003,國立臺灣大學,學士班(日間),墨西哥合眾國,中南美洲,2,1,1,1,1,0,1,0,1,0,0,0,0,0,0
109,公立,一般大學,0003,國立臺灣大學,學士班(日間),澳門,港澳,215,123,92,0,0,0,0,0,0,215,123,92,0,0,0
109,公立,一般大學,0003,國立臺灣大學,學士班(日間),薩爾瓦多,中南美洲,4,3,1,3,3,0,1,0,1,0,0,0,0,0,0
109,公立,一般大學,0003,國立臺灣大學,學士班(日間),巴拿馬共和國,中南美洲,6,3,3,6,3,3,0,0,0,0,0,0,0,0,0
109,公立,一般大學,0003,國立臺灣大學,學士班(日間),史瓦帝尼王國,非洲,1,1,0,1,1,0,0,0,0,0,0,0,0,0,0
109,公立,一般大學,0003,國立臺灣大學,學士班(日間),尼加拉瓜,中南美洲,2,1,1,1,1,0,1,0,1,0,0,0,0,0,0
109,公立,一般大學,0003,國立臺灣大學,學士班(日間),西班牙王國,歐洲,1,1,0,1,1,0,0,0,0,0,0,0,0,0,0
109,公立,一般大學,0003,國立臺灣大學,學士班(日間),汶萊和平之國,東協,2,0,2,0,0,0,2,0,2,0,0,0,0,0,0
109,公立,一般大學,0003,國立臺灣大學,學士班(日間),帛琉共和國,其他亞洲地區,1,0,1,0,0,0,1,0,1,0,0,0,0,0,0
109,公立,一般大學,0003,國立臺灣大學,學士班(日間),芬蘭共和國,歐洲,2,1,1,2,1,1,0,0,0,0,0,0,0,0,0
109,公立,一般大學,0003,國立臺灣大學,學士班(日間),俄羅斯聯邦,其他亞洲地區,2,2,0,2,2,0,0,0,0,0,0,0,0,0,0
109,公立,一般大學,0003,國立臺灣大學,學士班(日間),美國,北美洲,31,21,10,14,11,3,17,10,7,0,0,0,0,0,0
109,公立,一般大學,0003,國立臺灣大學,學士班(日間),海地共和國,中南美洲,5,5,0,5,5,0,0,0,0,0,0,0,0,0,0
109,公立,一般大學,0003,國立臺灣大學,學士班(日間),斯洛伐克共和國,歐洲,1,1,0,1,1,0,0,0,0,0,0,0,0,0,0
109,公立,一般大學,0003,國立臺灣大學,學士班(日間),智利,中南美洲,3,1,2,0,0,0,3,1,2,0,0,0,0,0,0
109,公立,一般大學,0003,國立臺灣大學,學士班(日間),新加坡共和國,東協,9,1,8,2,0,2,7,1,6,0,0,0,0,0,0
109,公立,一般大學,0003,國立臺灣大學,學士班(日間),義大利共和國,歐洲,1,0,1,0,0,0,1,0,1,0,0,0,0,0,0
109,公立,一般大學,0003,國立臺灣大學,學士班(日間),聖克里斯多福及尼維斯,中南美洲,1,0,1,1,0,1,0,0,0,0,0,0,0,0,0
109,公立,一般大學,0003,國立臺灣大學,學士班(日間),聖露西亞,中南美洲,3,1,2,3,1,2,0,0,0,0,0,0,0,0,0
109,公立,一般大學,0003,國立臺灣大學,學士班(日間),葉門共和國,其他亞洲地區,1,0,1,0,0,0,1,0,1,0,0,0,0,0,0
109,公立,一般大學,0003,國立臺灣大學,學士班(日間),葡萄牙共和國,歐洲,1,1,0,1,1,0,0,0,0,0,0,0,0,0,0
109,公立,一般大學,0003,國立臺灣大學,學士班(日間),蒙古國,其他亞洲地區,6,2,4,6,2,4,0,0,0,0,0,0,0,0,0
109,公立,一般大學,0003,國立臺灣大學,學士班(日間),德意志聯邦共和國,歐洲,2,1,1,2,1,1,0,0,0,0,0,0,0,0,0
109,公立,一般大學,0003,國立臺灣大學,學士班(日間),澳大利亞,其他亞洲地區,1,1,0,1,1,0,0,0,0,0,0,0,0,0,0
109,公立,一般大學,0003,國立臺灣大學,碩士班(日間),巴拿馬共和國,中南美洲,1,1,0,1,1,0,0,0,0,0,0,0,0,0,0
109,公立,一般大學,0003,國立臺灣大學,碩士班(日間),比利時王國,歐洲,1,1,0,1,1,0,0,0,0,0,0,0,0,0,0
109,公立,一般大學,0003,國立臺灣大學,碩士班(日間),牙買加,中南美洲,1,0,1,1,0,1,0,0,0,0,0,0,0,0,0
109,公立,一般大學,0003,國立臺灣大學,碩士班(日間),尼加拉瓜,中南美洲,1,0,1,1,0,1,0,0,0,0,0,0,0,0,0
109,公立,一般大學,0003,國立臺灣大學,碩士班(日間),尼泊爾聯邦民主共和國,南亞,1,1,0,1,1,0,0,0,0,0,0,0,0,0,0
109,公立,一般大學,0003,國立臺灣大學,碩士班(日間),立陶宛共和國,歐洲,1,0,1,1,0,1,0,0,0,0,0,0,0,0,0
109,公立,一般大學,0003,國立臺灣大學,碩士班(日間),西班牙王國,歐洲,5,4,1,4,4,0,1,0,1,0,0,0,0,0,0
109,公立,一般大學,0003,國立臺灣大學,碩士班(日間),希臘共和國,歐洲,1,1,0,1,1,0,0,0,0,0,0,0,0,0,0
109,公立,一般大學,0003,國立臺灣大學,碩士班(日間),奈及利亞聯邦共和國,非洲,1,1,0,1,1,0,0,0,0,0,0,0,0,0,0
109,公立,一般大學,0003,國立臺灣大學,碩士班(日間),芬蘭共和國,歐洲,2,2,0,2,2,0,0,0,0,0,0,0,0,0,0
109,公立,一般大學,0003,國立臺灣大學,碩士班(日間),俄羅斯聯邦,其他亞洲地區,2,1,1,2,1,1,0,0,0,0,0,0,0,0,0
109,公立,一般大學,0003,國立臺灣大學,碩士班(日間),美國,北美洲,58,25,33,54,24,30,4,1,3,0,0,0,0,0,0
109,公立,一般大學,0003,國立臺灣大學,碩士班(日間),迦納共和國,非洲,1,1,0,1,1,0,0,0,0,0,0,0,0,0,0
109,公立,一般大學,0003,國立臺灣大學,碩士班(日間),泰國,東協,35,13,22,31,11,20,4,2,2,0,0,0,0,0,0
109,公立,一般大學,0003,國立臺灣大學,碩士班(日間),海地共和國,中南美洲,6,3,3,6,3,3,0,0,0,0,0,0,0,0,0
109,公立,一般大學,0003,國立臺灣大學,碩士班(日間),紐西蘭,其他亞洲地區,2,2,0,1,1,0,1,1,0,0,0,0,0,0,0
109,公立,一般大學,0003,國立臺灣大學,碩士班(日間),愛爾蘭共和國,歐洲,2,1,1,2,1,1,0,0,0,0,0,0,0,0,0
109,公立,一般大學,0003,國立臺灣大學,碩士班(日間),新加坡共和國,東協,5,2,3,5,2,3,0,0,0,0,0,0,0,0,0
109,公立,一般大學,0003,國立臺灣大學,碩士班(日間),瑞典王國,歐洲,1,0,1,1,0,1,0,0,0,0,0,0,0,0,0
109,公立,一般大學,0003,國立臺灣大學,碩士班(日間),義大利共和國,歐洲,2,1,1,2,1,1,0,0,0,0,0,0,0,0,0
109,公立,一般大學,0003,國立臺灣大學,碩士班(日間),聖克里斯多福及尼維斯,中南美洲,1,1,0,1,1,0,0,0,0,0,0,0,0,0,0
109,公立,一般大學,0003,國立臺灣大學,碩士班(日間),聖露西亞,中南美洲,1,0,1,1,0,1,0,0,0,0,0,0,0,0,0
109,公立,一般大學,0003,國立臺灣大學,碩士班(日間),蒙古國,其他亞洲地區,3,2,1,3,2,1,0,0,0,0,0,0,0,0,0
109,公立,一般大學,0003,國立臺灣大學,碩士班(日間),德意志聯邦共和國,歐洲,8,8,0,8,8,0,0,0,0,0,0,0,0,0,0
109,公立,一般大學,0003,國立臺灣大學,碩士班(日間),澳大利亞,其他亞洲地區,1,1,0,0,0,0,1,1,0,0,0,0,0,0,0
109,公立,一般大學,0003,國立臺灣大學,碩士班(日間),土耳其共和國,其他亞洲地區,3,3,0,3,3,0,0,0,0,0,0,0,0,0,0
109,公立,一般大學,0003,國立臺灣大學,碩士班(日間),大陸地區,大陸地區,361,174,187,0,0,0,0,0,0,0,0,0,361,174,187
109,公立,一般大學,0003,國立臺灣大學,碩士班(日間),大韓民國(南韓),其他亞洲地區,29,10,19,25,9,16,4,1,3,0,0,0,0,0,0
109,公立,一般大學,0003,國立臺灣大學,碩士班(日間),巴拉圭,中南美洲,3,0,3,0,0,0,3,0,3,0,0,0,0,0,0
109,公立,一般大學,0003,國立臺灣大學,碩士班(日間),日本,其他亞洲地區,34,18,16,31,17,14,3,1,2,0,0,0,0,0,0
109,公立,一般大學,0003,國立臺灣大學,碩士班(日間),加拿大,北美洲,13,11,2,8,6,2,5,5,0,0,0,0,0,0,0
109,公立,一般大學,0003,國立臺灣大學,碩士班(日間),布吉納法索,非洲,2,2,0,2,2,0,0,0,0,0,0,0,0,0,0
109,公立,一般大學,0003,國立臺灣大學,碩士班(日間),瓜地馬拉共和國,中南美洲,1,1,0,1,1,0,0,0,0,0,0,0,0,0,0
109,公立,一般大學,0003,國立臺灣大學,碩士班(日間),印度,南亞,26,15,11,26,15,11,0,0,0,0,0,0,0,0,0
109,公立,一般大學,0003,國立臺灣大學,碩士班(日間),印度尼西亞共和國,東協,41,21,20,29,15,14,12,6,6,0,0,0,0,0,0
109,公立,一般大學,0003,國立臺灣大學,碩士班(日間),宏都拉斯共和國,中南美洲,1,1,0,1,1,0,0,0,0,0,0,0,0,0,0
109,公立,一般大學,0003,國立臺灣大學,碩士班(日間),貝里斯,中南美洲,2,1,1,0,0,0,2,1,1,0,0,0,0,0,0
109,公立,一般大學,0003,國立臺灣大學,碩士班(日間),波蘭共和國,歐洲,2,1,1,2,1,1,0,0,0,0,0,0,0,0,0
109,公立,一般大學,0003,國立臺灣大學,碩士班(日間),法國,歐洲,3,1,2,3,1,2,0,0,0,0,0,0,0,0,0
109,公立,一般大學,0003,國立臺灣大學,碩士班(日間),阿根廷,中南美洲,1,1,0,1,1,0,0,0,0,0,0,0,0,0,0
109,公立,一般大學,0003,國立臺灣大學,碩士班(日間),南非共和國,非洲,1,0,1,0,0,0,1,0,1,0,0,0,0,0,0
109,公立,一般大學,0003,國立臺灣大學,碩士班(日間),約旦哈什米王國,其他亞洲地區,1,1,0,1,1,0,0,0,0,0,0,0,0,0,0
109,公立,一般大學,0003,國立臺灣大學,碩士班(日間),英國,歐洲,8,6,2,8,6,2,0,0,0,0,0,0,0,0,0
109,公立,一般大學,0003,國立臺灣大學,碩士班(日間),香港,港澳,74,38,36,0,0,0,0,0,0,74,38,36,0,0,0
109,公立,一般大學,0003,國立臺灣大學,碩士班(日間),哥倫比亞共和國,中南美洲,2,2,0,2,2,0,0,0,0,0,0,0,0,0,0
109,公立,一般大學,0003,國立臺灣大學,碩士班(日間),馬來西亞,東協,163,87,76,45,19,26,118,68,50,0,0,0,0,0,0
109,公立,一般大學,0003,國立臺灣大學,碩士班(日間),荷蘭王國,歐洲,2,1,1,2,1,1,0,0,0,0,0,0,0,0,0
109,公立,一般大學,0003,國立臺灣大學,碩士班(日間),菲律賓共和國,東協,11,6,5,10,5,5,1,1,0,0,0,0,0,0,0
109,公立,一般大學,0003,國立臺灣大學,碩士班(日間),越南社會主義共和國,東協,30,12,18,22,8,14,8,4,4,0,0,0,0,0,0
109,公立,一般大學,0003,國立臺灣大學,碩士班(日間),寮人民民主共和國(寮國),東協,1,0,1,0,0,0,1,0,1,0,0,0,0,0,0
109,公立,一般大學,0003,國立臺灣大學,碩士班(日間),緬甸,東協,2,1,1,2,1,1,0,0,0,0,0,0,0,0,0
109,公立,一般大學,0003,國立臺灣大學,碩士班(日間),墨西哥合眾國,中南美洲,4,3,1,4,3,1,0,0,0,0,0,0,0,0,0
109,公立,一般大學,0003,國立臺灣大學,碩士班(日間),澳門,港澳,46,32,14,0,0,0,0,0,0,46,32,14,0,0,0
109,公立,一般大學,0003,國立臺灣大學,碩士班(日間),薩爾瓦多,中南美洲,1,1,0,0,0,0,1,1,0,0,0,0,0,0,0
109,公立,一般大學,0003,國立臺灣大學,博士班,土耳其共和國,其他亞洲地區,3,2,1,3,2,1,0,0,0,0,0,0,0,0,0
109,公立,一般大學,0003,國立臺灣大學,博士班,大陸地區,大陸地區,77,54,23,0,0,0,0,0,0,0,0,0,77,54,23
109,公立,一般大學,0003,國立臺灣大學,博士班,厄瓜多共和國,中南美洲,1,1,0,1,1,0,0,0,0,0,0,0,0,0,0
109,公立,一般大學,0003,國立臺灣大學,博士班,巴基斯坦,南亞,8,6,2,8,6,2,0,0,0,0,0,0,0,0,0
109,公立,一般大學,0003,國立臺灣大學,博士班,比利時王國,歐洲,1,1,0,1,1,0,0,0,0,0,0,0,0,0,0
109,公立,一般大學,0003,國立臺灣大學,博士班,史瓦帝尼王國,非洲,1,1,0,1,1,0,0,0,0,0,0,0,0,0,0
109,公立,一般大學,0003,國立臺灣大學,博士班,尼泊爾聯邦民主共和國,南亞,3,2,1,3,2,1,0,0,0,0,0,0,0,0,0
109,公立,一般大學,0003,國立臺灣大學,博士班,瓜地馬拉共和國,中南美洲,1,1,0,1,1,0,0,0,0,0,0,0,0,0,0
109,公立,一般大學,0003,國立臺灣大學,博士班,伊朗伊斯蘭共和國,其他亞洲地區,3,3,0,3,3,0,0,0,0,0,0,0,0,0,0
109,公立,一般大學,0003,國立臺灣大學,博士班,印度,南亞,74,48,26,74,48,26,0,0,0,0,0,0,0,0,0
109,公立,一般大學,0003,國立臺灣大學,博士班,衣索比亞聯邦民主共和國,非洲,2,2,0,2,2,0,0,0,0,0,0,0,0,0,0
109,公立,一般大學,0003,國立臺灣大學,博士班,貝里斯,中南美洲,2,1,1,1,1,0,1,0,1,0,0,0,0,0,0
109,公立,一般大學,0003,國立臺灣大學,博士班,奈及利亞聯邦共和國,非洲,1,1,0,1,1,0,0,0,0,0,0,0,0,0,0
109,公立,一般大學,0003,國立臺灣大學,博士班,孟加拉人民共和國,南亞,1,1,0,1,1,0,0,0,0,0,0,0,0,0,0
109,公立,一般大學,0003,國立臺灣大學,博士班,波蘭共和國,歐洲,1,1,0,1,1,0,0,0,0,0,0,0,0,0,0
109,公立,一般大學,0003,國立臺灣大學,博士班,南非共和國,非洲,1,1,0,0,0,0,1,1,0,0,0,0,0,0,0
109,公立,一般大學,0003,國立臺灣大學,博士班,香港,港澳,15,13,2,0,0,0,0,0,0,15,13,2,0,0,0
109,公立,一般大學,0003,國立臺灣大學,博士班,哥倫比亞共和國,中南美洲,3,2,1,3,2,1,0,0,0,0,0,0,0,0,0
109,公立,一般大學,0003,國立臺灣大學,博士班,海地共和國,中南美洲,1,1,0,1,1,0,0,0,0,0,0,0,0,0,0
109,公立,一般大學,0003,國立臺灣大學,博士班,捷克共和國,歐洲,1,1,0,1,1,0,0,0,0,0,0,0,0,0,0
109,公立,一般大學,0003,國立臺灣大學,博士班,斯洛伐克共和國,歐洲,1,1,0,1,1,0,0,0,0,0,0,0,0,0,0
109,公立,一般大學,0003,國立臺灣大學,博士班,斯洛維尼亞共和國,歐洲,1,0,1,1,0,1,0,0,0,0,0,0,0,0,0
109,公立,一般大學,0003,國立臺灣大學,博士班,越南社會主義共和國,東協,29,16,13,29,16,13,0,0,0,0,0,0,0,0,0
109,公立,一般大學,0003,國立臺灣大學,博士班,愛爾蘭共和國,歐洲,1,1,0,1,1,0,0,0,0,0,0,0,0,0,0
109,公立,一般大學,0003,國立臺灣大學,博士班,新加坡共和國,東協,2,2,0,2,2,0,0,0,0,0,0,0,0,0,0
109,公立,一般大學,0003,國立臺灣大學,博士班,瑞士聯邦,歐洲,2,2,0,2,2,0,0,0,0,0,0,0,0,0,0
109,公立,一般大學,0003,國立臺灣大學,博士班,瑞典王國,歐洲,1,1,0,1,1,0,0,0,0,0,0,0,0,0,0
109,公立,一般大學,0003,國立臺灣大學,博士班,葉門共和國,其他亞洲地區,1,1,0,1,1,0,0,0,0,0,0,0,0,0,0
109,公立,一般大學,0003,國立臺灣大學,博士班,蒙古國,其他亞洲地區,5,1,4,5,1,4,0,0,0,0,0,0,0,0,0
109,公立,一般大學,0003,國立臺灣大學,博士班,德意志聯邦共和國,歐洲,8,8,0,8,8,0,0,0,0,0,0,0,0,0,0
109,公立,一般大學,0003,國立臺灣大學,博士班,緬甸,東協,3,1,2,3,1,2,0,0,0,0,0,0,0,0,0
109,公立,一般大學,0003,國立臺灣大學,博士班,澳大利亞,其他亞洲地區,2,2,0,2,2,0,0,0,0,0,0,0,0,0,0
109,公立,一般大學,0003,國立臺灣大學,博士班,澳門,港澳,11,9,2,0,0,0,0,0,0,11,9,2,0,0,0
109,公立,一般大學,0003,國立臺灣大學,博士班,大韓民國(南韓),其他亞洲地區,8,3,5,7,2,5,1,1,0,0,0,0,0,0,0
109,公立,一般大學,0003,國立臺灣大學,博士班,巴西聯邦共和國,中南美洲,1,0,1,1,0,1,0,0,0,0,0,0,0,0,0
109,公立,一般大學,0003,國立臺灣大學,博士班,日本,其他亞洲地區,14,10,4,14,10,4,0,0,0,0,0,0,0,0,0
109,公立,一般大學,0003,國立臺灣大學,博士班,加拿大,北美洲,4,4,0,1,1,0,3,3,0,0,0,0,0,0,0
109,公立,一般大學,0003,國立臺灣大學,博士班,印度尼西亞共和國,東協,25,17,8,24,17,7,1,0,1,0,0,0,0,0,0
109,公立,一般大學,0003,國立臺灣大學,博士班,西班牙王國,歐洲,1,1,0,1,1,0,0,0,0,0,0,0,0,0,0
109,公立,一般大學,0003,國立臺灣大學,博士班,法國,歐洲,5,5,0,5,5,0,0,0,0,0,0,0,0,0,0
109,公立,一般大學,0003,國立臺灣大學,博士班,俄羅斯聯邦,其他亞洲地區,2,0,2,2,0,2,0,0,0,0,0,0,0,0,0
109,公立,一般大學,0003,國立臺灣大學,博士班,約旦哈什米王國,其他亞洲地區,1,1,0,1,1,0,0,0,0,0,0,0,0,0,0
109,公立,一般大學,0003,國立臺灣大學,博士班,美國,北美洲,12,10,2,11,9,2,1,1,0,0,0,0,0,0,0
109,公立,一般大學,0003,國立臺灣大學,博士班,英國,歐洲,1,1,0,1,1,0,0,0,0,0,0,0,0,0,0
109,公立,一般大學,0003,國立臺灣大學,博士班,埃及阿拉伯共和國,非洲,1,1,0,1,1,0,0,0,0,0,0,0,0,0,0
109,公立,一般大學,0003,國立臺灣大學,博士班,泰國,東協,11,9,2,11,9,2,0,0,0,0,0,0,0,0,0
109,公立,一般大學,0003,國立臺灣大學,博士班,馬來西亞,東協,43,28,15,24,16,8,19,12,7,0,0,0,0,0,0
109,公立,一般大學,0003,國立臺灣大學,博士班,荷蘭王國,歐洲,2,2,0,2,2,0,0,0,0,0,0,0,0,0,0
109,公立,一般大學,0003,國立臺灣大學,博士班,斯里蘭卡民主社會主義共和國,南亞,1,1,0,1,1,0,0,0,0,0,0,0,0,0,0
109,公立,一般大學,0003,國立臺灣大學,博士班,菲律賓共和國,東協,7,5,2,7,5,2,0,0,0,0,0,0,0,0,0
109,公立,一般大學,0003,國立臺灣大學,博士班,義大利共和國,歐洲,1,0,1,1,0,1,0,0,0,0,0,0,0,0,0
109,公立,一般大學,0004,國立臺灣師範大學,學士班(日間),大韓民國(南韓),其他亞洲地區,51,20,31,45,19,26,6,1,5,0,0,0,0,0,0
109,公立,一般大學,0004,國立臺灣師範大學,學士班(日間),日本,其他亞洲地區,79,26,53,66,22,44,13,4,9,0,0,0,0,0,0
109,公立,一般大學,0004,國立臺灣師範大學,學士班(日間),印度,南亞,2,1,1,2,1,1,0,0,0,0,0,0,0,0,0
109,公立,一般大學,0004,國立臺灣師範大學,學士班(日間),俄羅斯聯邦,其他亞洲地區,3,2,1,3,2,1,0,0,0,0,0,0,0,0,0
109,公立,一般大學,0004,國立臺灣師範大學,學士班(日間),美國,北美洲,13,5,8,10,5,5,3,0,3,0,0,0,0,0,0
109,公立,一般大學,0004,國立臺灣師範大學,學士班(日間),烏克蘭,其他亞洲地區,1,0,1,1,0,1,0,0,0,0,0,0,0,0,0
109,公立,一般大學,0004,國立臺灣師範大學,學士班(日間),馬拉威共和國,非洲,1,1,0,1,1,0,0,0,0,0,0,0,0,0,0
109,公立,一般大學,0004,國立臺灣師範大學,學士班(日間),智利,中南美洲,1,1,0,0,0,0,1,1,0,0,0,0,0,0,0
109,公立,一般大學,0004,國立臺灣師範大學,學士班(日間),新加坡共和國,東協,4,1,3,3,1,2,1,0,1,0,0,0,0,0,0
109,公立,一般大學,0004,國立臺灣師範大學,學士班(日間),義大利共和國,歐洲,1,1,0,1,1,0,0,0,0,0,0,0,0,0,0
109,公立,一般大學,0004,國立臺灣師範大學,學士班(日間),聖克里斯多福及尼維斯,中南美洲,1,0,1,1,0,1,0,0,0,0,0,0,0,0,0
109,公立,一般大學,0004,國立臺灣師範大學,學士班(日間),葡萄牙共和國,歐洲,1,0,1,1,0,1,0,0,0,0,0,0,0,0,0
109,公立,一般大學,0004,國立臺灣師範大學,學士班(日間),德意志聯邦共和國,歐洲,2,1,1,2,1,1,0,0,0,0,0,0,0,0,0
109,公立,一般大學,0004,國立臺灣師範大學,學士班(日間),澳大利亞,其他亞洲地區,1,1,0,1,1,0,0,0,0,0,0,0,0,0,0
109,公立,一般大學,0004,國立臺灣師範大學,學士班(日間),薩爾瓦多,中南美洲,1,1,0,1,1,0,0,0,0,0,0,0,0,0,0
109,公立,一般大學,0004,國立臺灣師範大學,學士班(日間),大陸地區,大陸地區,14,3,11,0,0,0,0,0,0,0,0,0,14,3,11
109,公立,一般大學,0004,國立臺灣師範大學,學士班(日間),巴西聯邦共和國,中南美洲,1,0,1,0,0,0,1,0,1,0,0,0,0,0,0
109,公立,一般大學,0004,國立臺灣師範大學,學士班(日間),巴拉圭,中南美洲,5,3,2,3,1,2,2,2,0,0,0,0,0,0,0
109,公立,一般大學,0004,國立臺灣師範大學,學士班(日間),加拿大,北美洲,4,1,3,1,0,1,3,1,2,0,0,0,0,0,0
109,公立,一般大學,0004,國立臺灣師範大學,學士班(日間),瓜地馬拉共和國,中南美洲,2,2,0,2,2,0,0,0,0,0,0,0,0,0,0
109,公立,一般大學,0004,國立臺灣師範大學,學士班(日間),印度尼西亞共和國,東協,58,17,41,19,6,13,39,11,28,0,0,0,0,0,0
109,公立,一般大學,0004,國立臺灣師範大學,學士班(日間),克羅埃西亞共和國,歐洲,1,1,0,1,1,0,0,0,0,0,0,0,0,0,0
109,公立,一般大學,0004,國立臺灣師範大學,學士班(日間),宏都拉斯共和國,中南美洲,2,2,0,2,2,0,0,0,0,0,0,0,0,0,0
109,公立,一般大學,0004,國立臺灣師範大學,學士班(日間),波蘭共和國,歐洲,2,1,1,2,1,1,0,0,0,0,0,0,0,0,0
109,公立,一般大學,0004,國立臺灣師範大學,學士班(日間),法國,歐洲,3,1,2,3,1,2,0,0,0,0,0,0,0,0,0
109,公立,一般大學,0004,國立臺灣師範大學,學士班(日間),阿根廷,中南美洲,1,1,0,0,0,0,1,1,0,0,0,0,0,0,0
109,公立,一般大學,0004,國立臺灣師範大學,學士班(日間),柬埔寨王國,東協,1,0,1,1,0,1,0,0,0,0,0,0,0,0,0
109,公立,一般大學,0004,國立臺灣師範大學,學士班(日間),英國,歐洲,1,1,0,1,1,0,0,0,0,0,0,0,0,0,0
109,公立,一般大學,0004,國立臺灣師範大學,學士班(日間),香港,港澳,110,48,62,0,0,0,0,0,0,110,48,62,0,0,0
109,公立,一般大學,0004,國立臺灣師範大學,學士班(日間),哥倫比亞共和國,中南美洲,2,1,1,2,1,1,0,0,0,0,0,0,0,0,0
109,公立,一般大學,0004,國立臺灣師範大學,學士班(日間),泰國,東協,23,8,15,14,6,8,9,2,7,0,0,0,0,0,0
109,公立,一般大學,0004,國立臺灣師範大學,學士班(日間),馬來西亞,東協,190,61,129,14,8,6,176,53,123,0,0,0,0,0,0
109,公立,一般大學,0004,國立臺灣師範大學,學士班(日間),菲律賓共和國,東協,2,0,2,1,0,1,1,0,1,0,0,0,0,0,0
109,公立,一般大學,0004,國立臺灣師範大學,學士班(日間),越南社會主義共和國,東協,97,13,84,68,8,60,29,5,24,0,0,0,0,0,0
109,公立,一般大學,0004,國立臺灣師範大學,學士班(日間),瑞典王國,歐洲,1,0,1,1,0,1,0,0,0,0,0,0,0,0,0
109,公立,一般大學,0004,國立臺灣師範大學,學士班(日間),緬甸,東協,66,15,51,0,0,0,66,15,51,0,0,0,0,0,0
109,公立,一般大學,0004,國立臺灣師範大學,學士班(日間),墨西哥合眾國,中南美洲,1,0,1,1,0,1,0,0,0,0,0,0,0,0,0
109,公立,一般大學,0004,國立臺灣師範大學,學士班(日間),澳門,港澳,144,73,71,0,0,0,0,0,0,144,73,71,0,0,0
109,公立,一般大學,0004,國立臺灣師範大學,碩士班(日間),土耳其共和國,其他亞洲地區,2,0,2,2,0,2,0,0,0,0,0,0,0,0,0
109,公立,一般大學,0004,國立臺灣師範大學,碩士班(日間),大陸地區,大陸地區,85,25,60,0,0,0,0,0,0,0,0,0,85,25,60
109,公立,一般大學,0004,國立臺灣師範大學,碩士班(日間),大韓民國(南韓),其他亞洲地區,16,4,12,15,4,11,1,0,1,0,0,0,0,0,0
109,公立,一般大學,0004,國立臺灣師範大學,碩士班(日間),丹麥王國,歐洲,1,0,1,1,0,1,0,0,0,0,0,0,0,0,0
109,公立,一般大學,0004,國立臺灣師範大學,碩士班(日間),比利時王國,歐洲,3,1,2,3,1,2,0,0,0,0,0,0,0,0,0
109,公立,一般大學,0004,國立臺灣師範大學,碩士班(日間),加拿大,北美洲,3,3,0,3,3,0,0,0,0,0,0,0,0,0,0
109,公立,一般大學,0004,國立臺灣師範大學,碩士班(日間),瓜地馬拉共和國,中南美洲,1,0,1,1,0,1,0,0,0,0,0,0,0,0,0
109,公立,一般大學,0004,國立臺灣師範大學,碩士班(日間),匈牙利共和國,歐洲,1,1,0,1,1,0,0,0,0,0,0,0,0,0,0
109,公立,一般大學,0004,國立臺灣師範大學,碩士班(日間),印度,南亞,3,2,1,3,2,1,0,0,0,0,0,0,0,0,0
109,公立,一般大學,0004,國立臺灣師範大學,碩士班(日間),印度尼西亞共和國,東協,18,4,14,12,4,8,6,0,6,0,0,0,0,0,0
109,公立,一般大學,0004,國立臺灣師範大學,碩士班(日間),宏都拉斯共和國,中南美洲,3,1,2,3,1,2,0,0,0,0,0,0,0,0,0
109,公立,一般大學,0004,國立臺灣師範大學,碩士班(日間),貝里斯,中南美洲,3,0,3,3,0,3,0,0,0,0,0,0,0,0,0
109,公立,一般大學,0004,國立臺灣師範大學,碩士班(日間),波蘭共和國,歐洲,2,2,0,2,2,0,0,0,0,0,0,0,0,0,0
109,公立,一般大學,0004,國立臺灣師範大學,碩士班(日間),法國,歐洲,1,1,0,1,1,0,0,0,0,0,0,0,0,0,0
109,公立,一般大學,0004,國立臺灣師範大學,碩士班(日間),英國,歐洲,2,2,0,2,2,0,0,0,0,0,0,0,0,0,0
109,公立,一般大學,0004,國立臺灣師範大學,碩士班(日間),香港,港澳,47,28,19,0,0,0,0,0,0,47,28,19,0,0,0
109,公立,一般大學,0004,國立臺灣師範大學,碩士班(日間),泰國,東協,16,5,11,15,4,11,1,1,0,0,0,0,0,0,0
109,公立,一般大學,0004,國立臺灣師範大學,碩士班(日間),秘魯共和國,中南美洲,1,1,0,1,1,0,0,0,0,0,0,0,0,0,0
109,公立,一般大學,0004,國立臺灣師範大學,碩士班(日間),馬來西亞,東協,66,21,45,22,6,16,44,15,29,0,0,0,0,0,0
109,公立,一般大學,0004,國立臺灣師範大學,碩士班(日間),菲律賓共和國,東協,5,1,4,4,1,3,1,0,1,0,0,0,0,0,0
109,公立,一般大學,0004,國立臺灣師範大學,碩士班(日間),越南社會主義共和國,東協,43,9,34,43,9,34,0,0,0,0,0,0,0,0,0
109,公立,一般大學,0004,國立臺灣師範大學,碩士班(日間),愛爾蘭共和國,歐洲,1,1,0,1,1,0,0,0,0,0,0,0,0,0,0
109,公立,一般大學,0004,國立臺灣師範大學,碩士班(日間),緬甸,東協,7,0,7,2,0,2,5,0,5,0,0,0,0,0,0
109,公立,一般大學,0004,國立臺灣師範大學,碩士班(日間),墨西哥合眾國,中南美洲,1,1,0,1,1,0,0,0,0,0,0,0,0,0,0
109,公立,一般大學,0004,國立臺灣師範大學,碩士班(日間),澳門,港澳,31,18,13,0,0,0,0,0,0,31,18,13,0,0,0
109,公立,一般大學,0004,國立臺灣師範大學,碩士班(日間),厄瓜多共和國,中南美洲,1,0,1,1,0,1,0,0,0,0,0,0,0,0,0
109,公立,一般大學,0004,國立臺灣師範大學,碩士班(日間),巴西聯邦共和國,中南美洲,2,1,1,1,1,0,1,0,1,0,0,0,0,0,0
109,公立,一般大學,0004,國立臺灣師範大學,碩士班(日間),日本,其他亞洲地區,18,8,10,18,8,10,0,0,0,0,0,0,0,0,0
109,公立,一般大學,0004,國立臺灣師範大學,碩士班(日間),汶萊和平之國,東協,1,1,0,0,0,0,1,1,0,0,0,0,0,0,0
109,公立,一般大學,0004,國立臺灣師範大學,碩士班(日間),俄羅斯聯邦,其他亞洲地區,6,3,3,6,3,3,0,0,0,0,0,0,0,0,0
109,公立,一般大學,0004,國立臺灣師範大學,碩士班(日間),美國,北美洲,27,18,9,26,18,8,1,0,1,0,0,0,0,0,0
109,公立,一般大學,0004,國立臺灣師範大學,碩士班(日間),葡萄牙共和國,歐洲,2,1,1,2,1,1,0,0,0,0,0,0,0,0,0
109,公立,一般大學,0004,國立臺灣師範大學,碩士班(日間),德意志聯邦共和國,歐洲,5,4,1,5,4,1,0,0,0,0,0,0,0,0,0
109,公立,一般大學,0004,國立臺灣師範大學,博士班,大韓民國(南韓),其他亞洲地區,8,3,5,8,3,5,0,0,0,0,0,0,0,0,0
109,公立,一般大學,0004,國立臺灣師範大學,博士班,巴西聯邦共和國,中南美洲,4,2,2,3,2,1,1,0,1,0,0,0,0,0,0
109,公立,一般大學,0004,國立臺灣師範大學,博士班,日本,其他亞洲地區,4,2,2,4,2,2,0,0,0,0,0,0,0,0,0
109,公立,一般大學,0004,國立臺灣師範大學,博士班,加拿大,北美洲,2,1,1,1,1,0,1,0,1,0,0,0,0,0,0
109,公立,一般大學,0004,國立臺灣師範大學,博士班,印度尼西亞共和國,東協,14,4,10,14,4,10,0,0,0,0,0,0,0,0,0
109,公立,一般大學,0004,國立臺灣師範大學,博士班,西班牙王國,歐洲,2,2,0,2,2,0,0,0,0,0,0,0,0,0,0
109,公立,一般大學,0004,國立臺灣師範大學,博士班,肯亞共和國,非洲,1,1,0,1,1,0,0,0,0,0,0,0,0,0,0
109,公立,一般大學,0004,國立臺灣師範大學,博士班,俄羅斯聯邦,其他亞洲地區,4,1,3,4,1,3,0,0,0,0,0,0,0,0,0
109,公立,一般大學,0004,國立臺灣師範大學,博士班,南非共和國,非洲,6,5,1,2,2,0,4,3,1,0,0,0,0,0,0
109,公立,一般大學,0004,國立臺灣師範大學,博士班,英國,歐洲,2,1,1,2,1,1,0,0,0,0,0,0,0,0,0
109,公立,一般大學,0004,國立臺灣師範大學,博士班,泰國,東協,8,3,5,8,3,5,0,0,0,0,0,0,0,0,0
109,公立,一般大學,0004,國立臺灣師範大學,博士班,馬來西亞,東協,14,6,8,9,3,6,5,3,2,0,0,0,0,0,0
109,公立,一般大學,0004,國立臺灣師範大學,博士班,荷蘭王國,歐洲,3,0,3,3,0,3,0,0,0,0,0,0,0,0,0
109,公立,一般大學,0004,國立臺灣師範大學,博士班,菲律賓共和國,東協,11,7,4,11,7,4,0,0,0,0,0,0,0,0,0
109,公立,一般大學,0004,國立臺灣師範大學,博士班,新加坡共和國,東協,1,0,1,1,0,1,0,0,0,0,0,0,0,0,0
109,公立,一般大學,0004,國立臺灣師範大學,博士班,義大利共和國,歐洲,1,1,0,1,1,0,0,0,0,0,0,0,0,0,0
109,公立,一般大學,0004,國立臺灣師範大學,博士班,大陸地區,大陸地區,45,10,35,0,0,0,0,0,0,0,0,0,45,10,35
109,公立,一般大學,0004,國立臺灣師範大學,博士班,丹麥王國,歐洲,2,1,1,2,1,1,0,0,0,0,0,0,0,0,0
109,公立,一般大學,0004,國立臺灣師範大學,博士班,巴基斯坦,南亞,1,1,0,1,1,0,0,0,0,0,0,0,0,0,0
109,公立,一般大學,0004,國立臺灣師範大學,博士班,印度,南亞,10,6,4,10,6,4,0,0,0,0,0,0,0,0,0
109,公立,一般大學,0004,國立臺灣師範大學,博士班,法國,歐洲,4,3,1,4,3,1,0,0,0,0,0,0,0,0,0
109,公立,一般大學,0004,國立臺灣師範大學,博士班,美國,北美洲,5,5,0,5,5,0,0,0,0,0,0,0,0,0,0
109,公立,一般大學,0004,國立臺灣師範大學,博士班,香港,港澳,5,3,2,0,0,0,0,0,0,5,3,2,0,0,0
109,公立,一般大學,0004,國立臺灣師範大學,博士班,越南社會主義共和國,東協,19,7,12,19,7,12,0,0,0,0,0,0,0,0,0
109,公立,一般大學,0004,國立臺灣師範大學,博士班,墨西哥合眾國,中南美洲,1,1,0,1,1,0,0,0,0,0,0,0,0,0,0
109,公立,一般大學,0004,國立臺灣師範大學,博士班,澳門,港澳,2,1,1,0,0,0,0,0,0,2,1,1,0,0,0
109,公立,一般大學,0004,國立臺灣師範大學,博士班,羅馬尼亞,歐洲,1,0,1,1,0,1,0,0,0,0,0,0,0,0,0
109,公立,一般大學,0005,國立成功大學,學士班(日間),巴西聯邦共和國,中南美洲,3,3,0,1,1,0,2,2,0,0,0,0,0,0,0
109,公立,一般大學,0005,國立成功大學,學士班(日間),比利時王國,歐洲,1,1,0,1,1,0,0,0,0,0,0,0,0,0,0
109,公立,一般大學,0005,國立成功大學,學士班(日間),史瓦帝尼王國,非洲,4,1,3,4,1,3,0,0,0,0,0,0,0,0,0
109,公立,一般大學,0005,國立成功大學,學士班(日間),尼加拉瓜,中南美洲,6,5,1,6,5,1,0,0,0,0,0,0,0,0,0
109,公立,一般大學,0005,國立成功大學,學士班(日間),法國,歐洲,1,1,0,1,1,0,0,0,0,0,0,0,0,0,0
109,公立,一般大學,0005,國立成功大學,學士班(日間),俄羅斯聯邦,其他亞洲地區,3,0,3,3,0,3,0,0,0,0,0,0,0,0,0
109,公立,一般大學,0005,國立成功大學,學士班(日間),哈薩克共和國,其他亞洲地區,1,1,0,1,1,0,0,0,0,0,0,0,0,0,0
109,公立,一般大學,0005,國立成功大學,學士班(日間),約旦哈什米王國,其他亞洲地區,1,1,0,1,1,0,0,0,0,0,0,0,0,0,0
109,公立,一般大學,0005,國立成功大學,學士班(日間),美國,北美洲,6,4,2,3,2,1,3,2,1,0,0,0,0,0,0
109,公立,一般大學,0005,國立成功大學,學士班(日間),迦納共和國,非洲,1,1,0,1,1,0,0,0,0,0,0,0,0,0,0
109,公立,一般大學,0005,國立成功大學,學士班(日間),泰國,東協,20,11,9,6,2,4,14,9,5,0,0,0,0,0,0
109,公立,一般大學,0005,國立成功大學,學士班(日間),海地共和國,中南美洲,5,5,0,5,5,0,0,0,0,0,0,0,0,0,0
109,公立,一般大學,0005,國立成功大學,學士班(日間),索羅門群島,其他亞洲地區,1,1,0,1,1,0,0,0,0,0,0,0,0,0,0
109,公立,一般大學,0005,國立成功大學,學士班(日間),紐西蘭,其他亞洲地區,1,1,0,0,0,0,1,1,0,0,0,0,0,0,0
109,公立,一般大學,0005,國立成功大學,學士班(日間),馬紹爾群島共和國,其他亞洲地區,1,0,1,1,0,1,0,0,0,0,0,0,0,0,0
109,公立,一般大學,0005,國立成功大學,學士班(日間),墨西哥合眾國,中南美洲,1,1,0,1,1,0,0,0,0,0,0,0,0,0,0
109,公立,一般大學,0005,國立成功大學,學士班(日間),大陸地區,大陸地區,14,4,10,0,0,0,0,0,0,0,0,0,14,4,10
109,公立,一般大學,0005,國立成功大學,學士班(日間),大韓民國(南韓),其他亞洲地區,8,5,3,7,4,3,1,1,0,0,0,0,0,0,0
109,公立,一般大學,0005,國立成功大學,學士班(日間),巴拉圭,中南美洲,20,12,8,18,11,7,2,1,1,0,0,0,0,0,0
109,公立,一般大學,0005,國立成功大學,學士班(日間),日本,其他亞洲地區,30,13,17,24,8,16,6,5,1,0,0,0,0,0,0
109,公立,一般大學,0005,國立成功大學,學士班(日間),加拿大,北美洲,1,1,0,0,0,0,1,1,0,0,0,0,0,0,0
109,公立,一般大學,0005,國立成功大學,學士班(日間),瓜地馬拉共和國,中南美洲,1,1,0,1,1,0,0,0,0,0,0,0,0,0,0
109,公立,一般大學,0005,國立成功大學,學士班(日間),印度,南亞,2,1,1,2,1,1,0,0,0,0,0,0,0,0,0
109,公立,一般大學,0005,國立成功大學,學士班(日間),印度尼西亞共和國,東協,118,62,56,20,7,13,98,55,43,0,0,0,0,0,0
109,公立,一般大學,0005,國立成功大學,學士班(日間),多明尼加共和國,中南美洲,1,0,1,0,0,0,1,0,1,0,0,0,0,0,0
109,公立,一般大學,0005,國立成功大學,學士班(日間),西班牙王國,歐洲,2,1,1,0,0,0,2,1,1,0,0,0,0,0,0
109,公立,一般大學,0005,國立成功大學,學士班(日間),宏都拉斯共和國,中南美洲,7,6,1,7,6,1,0,0,0,0,0,0,0,0,0
109,公立,一般大學,0005,國立成功大學,學士班(日間),貝里斯,中南美洲,6,4,2,6,4,2,0,0,0,0,0,0,0,0,0
109,公立,一般大學,0005,國立成功大學,學士班(日間),南非共和國,非洲,6,3,3,2,1,1,4,2,2,0,0,0,0,0,0
109,公立,一般大學,0005,國立成功大學,學士班(日間),香港,港澳,129,78,51,0,0,0,0,0,0,129,78,51,0,0,0
109,公立,一般大學,0005,國立成功大學,學士班(日間),哥倫比亞共和國,中南美洲,1,1,0,1,1,0,0,0,0,0,0,0,0,0,0
109,公立,一般大學,0005,國立成功大學,學士班(日間),馬來西亞,東協,342,207,135,67,40,27,275,167,108,0,0,0,0,0,0
109,公立,一般大學,0005,國立成功大學,學士班(日間),菲律賓共和國,東協,7,4,3,2,1,1,5,3,2,0,0,0,0,0,0
109,公立,一般大學,0005,國立成功大學,學士班(日間),越南社會主義共和國,東協,32,14,18,20,9,11,12,5,7,0,0,0,0,0,0
109,公立,一般大學,0005,國立成功大學,學士班(日間),新加坡共和國,東協,2,2,0,0,0,0,2,2,0,0,0,0,0,0,0
109,公立,一般大學,0005,國立成功大學,學士班(日間),聖文森(及格瑞那丁),中南美洲,1,0,1,1,0,1,0,0,0,0,0,0,0,0,0
109,公立,一般大學,0005,國立成功大學,學士班(日間),聖露西亞,中南美洲,7,2,5,7,2,5,0,0,0,0,0,0,0,0,0
109,公立,一般大學,0005,國立成功大學,學士班(日間),蒙古國,其他亞洲地區,8,4,4,8,4,4,0,0,0,0,0,0,0,0,0
109,公立,一般大學,0005,國立成功大學,學士班(日間),緬甸,東協,20,8,12,0,0,0,20,8,12,0,0,0,0,0,0
109,公立,一般大學,0005,國立成功大學,學士班(日間),澳門,港澳,98,74,24,0,0,0,0,0,0,98,74,24,0,0,0
109,公立,一般大學,0005,國立成功大學,學士班(日間),諾魯共和國,其他亞洲地區,1,1,0,1,1,0,0,0,0,0,0,0,0,0,0
109,公立,一般大學,0005,國立成功大學,學士班(日間),薩爾瓦多,中南美洲,5,2,3,4,2,2,1,0,1,0,0,0,0,0,0
109,公立,一般大學,0005,國立成功大學,碩士班(日間),大陸地區,大陸地區,112,54,58,0,0,0,0,0,0,0,0,0,112,54,58
109,公立,一般大學,0005,國立成功大學,碩士班(日間),大韓民國(南韓),其他亞洲地區,1,1,0,1,1,0,0,0,0,0,0,0,0,0,0
109,公立,一般大學,0005,國立成功大學,碩士班(日間),厄瓜多共和國,中南美洲,2,2,0,1,1,0,1,1,0,0,0,0,0,0,0
109,公立,一般大學,0005,國立成功大學,碩士班(日間),巴基斯坦,南亞,3,3,0,3,3,0,0,0,0,0,0,0,0,0,0
109,公立,一般大學,0005,國立成功大學,碩士班(日間),日本,其他亞洲地區,2,0,2,2,0,2,0,0,0,0,0,0,0,0,0
109,公立,一般大學,0005,國立成功大學,碩士班(日間),加拿大,北美洲,3,1,2,0,0,0,3,1,2,0,0,0,0,0,0
109,公立,一般大學,0005,國立成功大學,碩士班(日間),尼泊爾聯邦民主共和國,南亞,1,1,0,1,1,0,0,0,0,0,0,0,0,0,0
109,公立,一般大學,0005,國立成功大學,碩士班(日間),布吉納法索,非洲,1,1,0,1,1,0,0,0,0,0,0,0,0,0,0
109,公立,一般大學,0005,國立成功大學,碩士班(日間),伊拉克共和國,其他亞洲地區,1,1,0,1,1,0,0,0,0,0,0,0,0,0,0
109,公立,一般大學,0005,國立成功大學,碩士班(日間),伊朗伊斯蘭共和國,其他亞洲地區,1,0,1,1,0,1,0,0,0,0,0,0,0,0,0
109,公立,一般大學,0005,國立成功大學,碩士班(日間),印度,南亞,40,30,10,40,30,10,0,0,0,0,0,0,0,0,0
109,公立,一般大學,0005,國立成功大學,碩士班(日間),印度尼西亞共和國,東協,132,70,62,128,66,62,4,4,0,0,0,0,0,0,0
109,公立,一般大學,0005,國立成功大學,碩士班(日間),西班牙王國,歐洲,1,1,0,1,1,0,0,0,0,0,0,0,0,0,0
109,公立,一般大學,0005,國立成功大學,碩士班(日間),宏都拉斯共和國,中南美洲,5,4,1,5,4,1,0,0,0,0,0,0,0,0,0
109,公立,一般大學,0005,國立成功大學,碩士班(日間),貝里斯,中南美洲,9,7,2,9,7,2,0,0,0,0,0,0,0,0,0
109,公立,一般大學,0005,國立成功大學,碩士班(日間),玻利維亞共和國,中南美洲,1,0,1,0,0,0,1,0,1,0,0,0,0,0,0
109,公立,一般大學,0005,國立成功大學,碩士班(日間),英國,歐洲,1,1,0,1,1,0,0,0,0,0,0,0,0,0,0
109,公立,一般大學,0005,國立成功大學,碩士班(日間),香港,港澳,32,16,16,0,0,0,0,0,0,32,16,16,0,0,0
109,公立,一般大學,0005,國立成功大學,碩士班(日間),哥倫比亞共和國,中南美洲,1,0,1,1,0,1,0,0,0,0,0,0,0,0,0
109,公立,一般大學,0005,國立成功大學,碩士班(日間),馬來西亞,東協,80,43,37,32,16,16,48,27,21,0,0,0,0,0,0
109,公立,一般大學,0005,國立成功大學,碩士班(日間),捷克共和國,歐洲,1,1,0,1,1,0,0,0,0,0,0,0,0,0,0
109,公立,一般大學,0005,國立成功大學,碩士班(日間),荷蘭王國,歐洲,2,2,0,2,2,0,0,0,0,0,0,0,0,0,0
109,公立,一般大學,0005,國立成功大學,碩士班(日間),菲律賓共和國,東協,10,7,3,10,7,3,0,0,0,0,0,0,0,0,0
109,公立,一般大學,0005,國立成功大學,碩士班(日間),塞爾維亞共和國,歐洲,2,1,1,2,1,1,0,0,0,0,0,0,0,0,0
109,公立,一般大學,0005,國立成功大學,碩士班(日間),愛沙尼亞共和國,歐洲,1,1,0,1,1,0,0,0,0,0,0,0,0,0,0
109,公立,一般大學,0005,國立成功大學,碩士班(日間),義大利共和國,歐洲,1,1,0,1,1,0,0,0,0,0,0,0,0,0,0
109,公立,一般大學,0005,國立成功大學,碩士班(日間),聖文森(及格瑞那丁),中南美洲,2,1,1,2,1,1,0,0,0,0,0,0,0,0,0
109,公立,一般大學,0005,國立成功大學,碩士班(日間),聖露西亞,中南美洲,1,0,1,1,0,1,0,0,0,0,0,0,0,0,0
109,公立,一般大學,0005,國立成功大學,碩士班(日間),葡萄牙共和國,歐洲,1,1,0,1,1,0,0,0,0,0,0,0,0,0,0
109,公立,一般大學,0005,國立成功大學,碩士班(日間),蒙古國,其他亞洲地區,7,2,5,7,2,5,0,0,0,0,0,0,0,0,0
109,公立,一般大學,0005,國立成功大學,碩士班(日間),摩洛哥王國,非洲,1,1,0,1,1,0,0,0,0,0,0,0,0,0,0
109,公立,一般大學,0005,國立成功大學,碩士班(日間),緬甸,東協,3,1,2,2,1,1,1,0,1,0,0,0,0,0,0
109,公立,一般大學,0005,國立成功大學,碩士班(日間),澳門,港澳,28,14,14,0,0,0,0,0,0,28,14,14,0,0,0
109,公立,一般大學,0005,國立成功大學,碩士班(日間),薩爾瓦多,中南美洲,1,1,0,1,1,0,0,0,0,0,0,0,0,0,0
109,公立,一般大學,0005,國立成功大學,碩士班(日間),土耳其共和國,其他亞洲地區,5,2,3,5,2,3,0,0,0,0,0,0,0,0,0
109,公立,一般大學,0005,國立成功大學,碩士班(日間),史瓦帝尼王國,非洲,6,2,4,6,2,4,0,0,0,0,0,0,0,0,0
109,公立,一般大學,0005,國立成功大學,碩士班(日間),尼加拉瓜,中南美洲,2,2,0,2,2,0,0,0,0,0,0,0,0,0,0
109,公立,一般大學,0005,國立成功大學,碩士班(日間),瓜地馬拉共和國,中南美洲,2,1,1,2,1,1,0,0,0,0,0,0,0,0,0
109,公立,一般大學,0005,國立成功大學,碩士班(日間),孟加拉人民共和國,南亞,1,0,1,1,0,1,0,0,0,0,0,0,0,0,0
109,公立,一般大學,0005,國立成功大學,碩士班(日間),波蘭共和國,歐洲,2,2,0,2,2,0,0,0,0,0,0,0,0,0,0
109,公立,一般大學,0005,國立成功大學,碩士班(日間),法國,歐洲,4,3,1,4,3,1,0,0,0,0,0,0,0,0,0
109,公立,一般大學,0005,國立成功大學,碩士班(日間),俄羅斯聯邦,其他亞洲地區,2,1,1,2,1,1,0,0,0,0,0,0,0,0,0
109,公立,一般大學,0005,國立成功大學,碩士班(日間),柬埔寨王國,東協,2,1,1,2,1,1,0,0,0,0,0,0,0,0,0
109,公立,一般大學,0005,國立成功大學,碩士班(日間),美國,北美洲,10,5,5,7,5,2,3,0,3,0,0,0,0,0,0
109,公立,一般大學,0005,國立成功大學,碩士班(日間),埃及阿拉伯共和國,非洲,1,0,1,1,0,1,0,0,0,0,0,0,0,0,0
109,公立,一般大學,0005,國立成功大學,碩士班(日間),泰國,東協,48,14,34,47,13,34,1,1,0,0,0,0,0,0,0
109,公立,一般大學,0005,國立成功大學,碩士班(日間),海地共和國,中南美洲,5,4,1,5,4,1,0,0,0,0,0,0,0,0,0
109,公立,一般大學,0005,國立成功大學,碩士班(日間),智利,中南美洲,1,1,0,0,0,0,1,1,0,0,0,0,0,0,0
109,公立,一般大學,0005,國立成功大學,碩士班(日間),越南社會主義共和國,東協,117,41,76,115,39,76,2,2,0,0,0,0,0,0,0
109,公立,一般大學,0005,國立成功大學,碩士班(日間),愛爾蘭共和國,歐洲,1,1,0,1,1,0,0,0,0,0,0,0,0,0,0
109,公立,一般大學,0005,國立成功大學,碩士班(日間),瑞典王國,歐洲,1,1,0,1,1,0,0,0,0,0,0,0,0,0,0
109,公立,一般大學,0005,國立成功大學,碩士班(日間),墨西哥合眾國,中南美洲,1,1,0,1,1,0,0,0,0,0,0,0,0,0,0
109,公立,一般大學,0005,國立成功大學,博士班,土耳其共和國,其他亞洲地區,2,1,1,2,1,1,0,0,0,0,0,0,0,0,0
109,公立,一般大學,0005,國立成功大學,博士班,大韓民國(南韓),其他亞洲地區,4,2,2,4,2,2,0,0,0,0,0,0,0,0,0
109,公立,一般大學,0005,國立成功大學,博士班,巴基斯坦,南亞,9,7,2,9,7,2,0,0,0,0,0,0,0,0,0
109,公立,一般大學,0005,國立成功大學,博士班,尼加拉瓜,中南美洲,1,0,1,1,0,1,0,0,0,0,0,0,0,0,0
109,公立,一般大學,0005,國立成功大學,博士班,布吉納法索,非洲,1,0,1,1,0,1,0,0,0,0,0,0,0,0,0
109,公立,一般大學,0005,國立成功大學,博士班,瓜地馬拉共和國,中南美洲,1,1,0,1,1,0,0,0,0,0,0,0,0,0,0
109,公立,一般大學,0005,國立成功大學,博士班,匈牙利共和國,歐洲,1,0,1,1,0,1,0,0,0,0,0,0,0,0,0
109,公立,一般大學,0005,國立成功大學,博士班,印度尼西亞共和國,東協,101,59,42,101,59,42,0,0,0,0,0,0,0,0,0
109,公立,一般大學,0005,國立成功大學,博士班,奈及利亞聯邦共和國,非洲,2,2,0,2,2,0,0,0,0,0,0,0,0,0,0
109,公立,一般大學,0005,國立成功大學,博士班,孟加拉人民共和國,南亞,4,2,2,4,2,2,0,0,0,0,0,0,0,0,0
109,公立,一般大學,0005,國立成功大學,博士班,法國,歐洲,1,1,0,1,1,0,0,0,0,0,0,0,0,0,0
109,公立,一般大學,0005,國立成功大學,博士班,肯亞共和國,非洲,1,1,0,1,1,0,0,0,0,0,0,0,0,0,0
109,公立,一般大學,0005,國立成功大學,博士班,俄羅斯聯邦,其他亞洲地區,2,0,2,2,0,2,0,0,0,0,0,0,0,0,0
109,公立,一般大學,0005,國立成功大學,博士班,英國,歐洲,1,1,0,1,1,0,0,0,0,0,0,0,0,0,0
109,公立,一般大學,0005,國立成功大學,博士班,哥倫比亞共和國,中南美洲,3,2,1,3,2,1,0,0,0,0,0,0,0,0,0
109,公立,一般大學,0005,國立成功大學,博士班,埃及阿拉伯共和國,非洲,1,1,0,1,1,0,0,0,0,0,0,0,0,0,0
109,公立,一般大學,0005,國立成功大學,博士班,泰國,東協,22,9,13,22,9,13,0,0,0,0,0,0,0,0,0
109,公立,一般大學,0005,國立成功大學,博士班,馬來西亞,東協,15,10,5,9,6,3,6,4,2,0,0,0,0,0,0
109,公立,一般大學,0005,國立成功大學,博士班,馬拉威共和國,非洲,1,0,1,1,0,1,0,0,0,0,0,0,0,0,0
109,公立,一般大學,0005,國立成功大學,博士班,喀麥隆共和國,非洲,2,1,1,2,1,1,0,0,0,0,0,0,0,0,0
109,公立,一般大學,0005,國立成功大學,博士班,斯洛伐克共和國,歐洲,1,0,1,1,0,1,0,0,0,0,0,0,0,0,0
109,公立,一般大學,0005,國立成功大學,博士班,菲律賓共和國,東協,15,10,5,15,10,5,0,0,0,0,0,0,0,0,0
109,公立,一般大學,0005,國立成功大學,博士班,越南社會主義共和國,東協,86,48,38,86,48,38,0,0,0,0,0,0,0,0,0
109,公立,一般大學,0005,國立成功大學,博士班,瑞士聯邦,歐洲,1,1,0,1,1,0,0,0,0,0,0,0,0,0,0
109,公立,一般大學,0005,國立成功大學,博士班,蒙古國,其他亞洲地區,1,1,0,1,1,0,0,0,0,0,0,0,0,0,0
109,公立,一般大學,0005,國立成功大學,博士班,澳大利亞,其他亞洲地區,2,1,1,1,1,0,1,0,1,0,0,0,0,0,0
109,公立,一般大學,0005,國立成功大學,博士班,薩爾瓦多,中南美洲,1,1,0,1,1,0,0,0,0,0,0,0,0,0,0
109,公立,一般大學,0005,國立成功大學,博士班,大陸地區,大陸地區,46,24,22,0,0,0,0,0,0,0,0,0,46,24,22
109,公立,一般大學,0005,國立成功大學,博士班,厄瓜多共和國,中南美洲,1,1,0,1,1,0,0,0,0,0,0,0,0,0,0
109,公立,一般大學,0005,國立成功大學,博士班,日本,其他亞洲地區,2,2,0,2,2,0,0,0,0,0,0,0,0,0,0
109,公立,一般大學,0005,國立成功大學,博士班,史瓦帝尼王國,非洲,1,1,0,1,1,0,0,0,0,0,0,0,0,0,0
109,公立,一般大學,0005,國立成功大學,博士班,伊朗伊斯蘭共和國,其他亞洲地區,4,4,0,4,4,0,0,0,0,0,0,0,0,0,0
109,公立,一般大學,0005,國立成功大學,博士班,印度,南亞,48,38,10,48,38,10,0,0,0,0,0,0,0,0,0
109,公立,一般大學,0005,國立成功大學,博士班,衣索比亞聯邦民主共和國,非洲,2,2,0,2,2,0,0,0,0,0,0,0,0,0,0
109,公立,一般大學,0005,國立成功大學,博士班,宏都拉斯共和國,中南美洲,3,3,0,3,3,0,0,0,0,0,0,0,0,0,0
109,公立,一般大學,0005,國立成功大學,博士班,貝里斯,中南美洲,4,2,2,4,2,2,0,0,0,0,0,0,0,0,0
109,公立,一般大學,0005,國立成功大學,博士班,辛巴威共和國,非洲,1,1,0,1,1,0,0,0,0,0,0,0,0,0,0
109,公立,一般大學,0005,國立成功大學,博士班,美國,北美洲,2,2,0,2,2,0,0,0,0,0,0,0,0,0,0
109,公立,一般大學,0005,國立成功大學,博士班,香港,港澳,7,5,2,0,0,0,0,0,0,7,5,2,0,0,0
109,公立,一般大學,0005,國立成功大學,博士班,斯里蘭卡民主社會主義共和國,南亞,1,0,1,1,0,1,0,0,0,0,0,0,0,0,0
109,公立,一般大學,0005,國立成功大學,博士班,智利,中南美洲,1,1,0,1,1,0,0,0,0,0,0,0,0,0,0
109,公立,一般大學,0005,國立成功大學,博士班,葉門共和國,其他亞洲地區,1,1,0,1,1,0,0,0,0,0,0,0,0,0,0
109,公立,一般大學,0005,國立成功大學,博士班,德意志聯邦共和國,歐洲,1,1,0,1,1,0,0,0,0,0,0,0,0,0,0
109,公立,一般大學,0005,國立成功大學,博士班,緬甸,東協,1,0,1,1,0,1,0,0,0,0,0,0,0,0,0
109,公立,一般大學,0005,國立成功大學,博士班,澳門,港澳,1,0,1,0,0,0,0,0,0,1,0,1,0,0,0
109,公立,一般大學,0006,國立中興大學,學士班(日間),日本,其他亞洲地區,21,10,11,18,7,11,3,3,0,0,0,0,0,0,0
109,公立,一般大學,0006,國立中興大學,學士班(日間),加拿大,北美洲,2,1,1,1,0,1,1,1,0,0,0,0,0,0,0
109,公立,一般大學,0006,國立中興大學,學士班(日間),史瓦帝尼王國,非洲,4,2,2,4,2,2,0,0,0,0,0,0,0,0,0
109,公立,一般大學,0006,國立中興大學,學士班(日間),布吉納法索,非洲,1,1,0,1,1,0,0,0,0,0,0,0,0,0,0
109,公立,一般大學,0006,國立中興大學,學士班(日間),印度尼西亞共和國,東協,83,38,45,12,7,5,71,31,40,0,0,0,0,0,0
109,公立,一般大學,0006,國立中興大學,學士班(日間),宏都拉斯共和國,中南美洲,2,1,1,2,1,1,0,0,0,0,0,0,0,0,0
109,公立,一般大學,0006,國立中興大學,學士班(日間),約旦哈什米王國,其他亞洲地區,1,1,0,1,1,0,0,0,0,0,0,0,0,0,0
109,公立,一般大學,0006,國立中興大學,學士班(日間),斯里蘭卡民主社會主義共和國,南亞,1,0,1,1,0,1,0,0,0,0,0,0,0,0,0
109,公立,一般大學,0006,國立中興大學,學士班(日間),大陸地區,大陸地區,14,10,4,0,0,0,0,0,0,0,0,0,14,10,4
109,公立,一般大學,0006,國立中興大學,學士班(日間),大韓民國(南韓),其他亞洲地區,7,5,2,3,2,1,4,3,1,0,0,0,0,0,0
109,公立,一般大學,0006,國立中興大學,學士班(日間),尼加拉瓜,中南美洲,1,1,0,1,1,0,0,0,0,0,0,0,0,0,0
109,公立,一般大學,0006,國立中興大學,學士班(日間),瓜地馬拉共和國,中南美洲,3,3,0,3,3,0,0,0,0,0,0,0,0,0,0
109,公立,一般大學,0006,國立中興大學,學士班(日間),吉里巴斯共和國,其他亞洲地區,2,0,2,2,0,2,0,0,0,0,0,0,0,0,0
109,公立,一般大學,0006,國立中興大學,學士班(日間),貝里斯,中南美洲,2,2,0,2,2,0,0,0,0,0,0,0,0,0,0
109,公立,一般大學,0006,國立中興大學,學士班(日間),帛琉共和國,其他亞洲地區,1,0,1,1,0,1,0,0,0,0,0,0,0,0,0
109,公立,一般大學,0006,國立中興大學,學士班(日間),俄羅斯聯邦,其他亞洲地區,1,1,0,1,1,0,0,0,0,0,0,0,0,0,0
109,公立,一般大學,0006,國立中興大學,學士班(日間),南非共和國,非洲,2,2,0,0,0,0,2,2,0,0,0,0,0,0,0
109,公立,一般大學,0006,國立中興大學,學士班(日間),香港,港澳,73,41,32,0,0,0,0,0,0,73,41,32,0,0,0
109,公立,一般大學,0006,國立中興大學,學士班(日間),哥倫比亞共和國,中南美洲,1,1,0,1,1,0,0,0,0,0,0,0,0,0,0
109,公立,一般大學,0006,國立中興大學,學士班(日間),泰國,東協,4,3,1,3,2,1,1,1,0,0,0,0,0,0,0
109,公立,一般大學,0006,國立中興大學,學士班(日間),海地共和國,中南美洲,8,5,3,8,5,3,0,0,0,0,0,0,0,0,0
109,公立,一般大學,0006,國立中興大學,學士班(日間),馬來西亞,東協,138,76,62,23,13,10,115,63,52,0,0,0,0,0,0
109,公立,一般大學,0006,國立中興大學,學士班(日間),智利,中南美洲,1,1,0,0,0,0,1,1,0,0,0,0,0,0,0
109,公立,一般大學,0006,國立中興大學,學士班(日間),菲律賓共和國,東協,2,1,1,1,0,1,1,1,0,0,0,0,0,0,0
109,公立,一般大學,0006,國立中興大學,學士班(日間),越南社會主義共和國,東協,23,10,13,16,7,9,7,3,4,0,0,0,0,0,0
109,公立,一般大學,0006,國立中興大學,學士班(日間),瑞士聯邦,歐洲,1,1,0,1,1,0,0,0,0,0,0,0,0,0,0
109,公立,一般大學,0006,國立中興大學,學士班(日間),聖文森(及格瑞那丁),中南美洲,3,2,1,3,2,1,0,0,0,0,0,0,0,0,0
109,公立,一般大學,0006,國立中興大學,學士班(日間),聖露西亞,中南美洲,1,1,0,1,1,0,0,0,0,0,0,0,0,0,0
109,公立,一般大學,0006,國立中興大學,學士班(日間),蒙古國,其他亞洲地區,5,2,3,5,2,3,0,0,0,0,0,0,0,0,0
109,公立,一般大學,0006,國立中興大學,學士班(日間),德意志聯邦共和國,歐洲,1,1,0,1,1,0,0,0,0,0,0,0,0,0,0
109,公立,一般大學,0006,國立中興大學,學士班(日間),緬甸,東協,6,1,5,0,0,0,6,1,5,0,0,0,0,0,0
109,公立,一般大學,0006,國立中興大學,學士班(日間),澳門,港澳,30,19,11,0,0,0,0,0,0,30,19,11,0,0,0
109,公立,一般大學,0006,國立中興大學,學士班(日間),薩爾瓦多,中南美洲,1,1,0,1,1,0,0,0,0,0,0,0,0,0,0
109,公立,一般大學,0006,國立中興大學,碩士班(日間),土耳其共和國,其他亞洲地區,6,5,1,6,5,1,0,0,0,0,0,0,0,0,0
109,公立,一般大學,0006,國立中興大學,碩士班(日間),大陸地區,大陸地區,21,11,10,0,0,0,0,0,0,0,0,0,21,11,10
109,公立,一般大學,0006,國立中興大學,碩士班(日間),巴基斯坦,南亞,1,1,0,1,1,0,0,0,0,0,0,0,0,0,0
109,公立,一般大學,0006,國立中興大學,碩士班(日間),尼泊爾聯邦民主共和國,南亞,1,0,1,1,0,1,0,0,0,0,0,0,0,0,0
109,公立,一般大學,0006,國立中興大學,碩士班(日間),瓜地馬拉共和國,中南美洲,1,1,0,1,1,0,0,0,0,0,0,0,0,0,0
109,公立,一般大學,0006,國立中興大學,碩士班(日間),貝里斯,中南美洲,1,0,1,1,0,1,0,0,0,0,0,0,0,0,0
109,公立,一般大學,0006,國立中興大學,碩士班(日間),奈及利亞聯邦共和國,非洲,1,0,1,1,0,1,0,0,0,0,0,0,0,0,0
109,公立,一般大學,0006,國立中興大學,碩士班(日間),孟加拉人民共和國,南亞,1,1,0,1,1,0,0,0,0,0,0,0,0,0,0
109,公立,一般大學,0006,國立中興大學,碩士班(日間),波蘭共和國,歐洲,1,0,1,1,0,1,0,0,0,0,0,0,0,0,0
109,公立,一般大學,0006,國立中興大學,碩士班(日間),香港,港澳,22,14,8,0,0,0,0,0,0,22,14,8,0,0,0
109,公立,一般大學,0006,國立中興大學,碩士班(日間),泰國,東協,13,2,11,12,2,10,1,0,1,0,0,0,0,0,0
109,公立,一般大學,0006,國立中興大學,碩士班(日間),海地共和國,中南美洲,2,2,0,2,2,0,0,0,0,0,0,0,0,0,0
109,公立,一般大學,0006,國立中興大學,碩士班(日間),越南社會主義共和國,東協,26,11,15,23,9,14,3,2,1,0,0,0,0,0,0
109,公立,一般大學,0006,國立中興大學,碩士班(日間),聖露西亞,中南美洲,1,1,0,1,1,0,0,0,0,0,0,0,0,0,0
109,公立,一般大學,0006,國立中興大學,碩士班(日間),蒙古國,其他亞洲地區,1,0,1,1,0,1,0,0,0,0,0,0,0,0,0
109,公立,一般大學,0006,國立中興大學,碩士班(日間),德意志聯邦共和國,歐洲,25,9,16,25,9,16,0,0,0,0,0,0,0,0,0
109,公立,一般大學,0006,國立中興大學,碩士班(日間),緬甸,東協,1,0,1,1,0,1,0,0,0,0,0,0,0,0,0
109,公立,一般大學,0006,國立中興大學,碩士班(日間),墨西哥合眾國,中南美洲,2,1,1,2,1,1,0,0,0,0,0,0,0,0,0
109,公立,一般大學,0006,國立中興大學,碩士班(日間),澳門,港澳,6,3,3,0,0,0,0,0,0,6,3,3,0,0,0
109,公立,一般大學,0006,國立中興大學,碩士班(日間),日本,其他亞洲地區,5,1,4,4,1,3,1,0,1,0,0,0,0,0,0
109,公立,一般大學,0006,國立中興大學,碩士班(日間),史瓦帝尼王國,非洲,4,3,1,4,3,1,0,0,0,0,0,0,0,0,0
109,公立,一般大學,0006,國立中興大學,碩士班(日間),印度,南亞,6,6,0,6,6,0,0,0,0,0,0,0,0,0,0
109,公立,一般大學,0006,國立中興大學,碩士班(日間),印度尼西亞共和國,東協,23,14,9,23,14,9,0,0,0,0,0,0,0,0,0
109,公立,一般大學,0006,國立中興大學,碩士班(日間),保加利亞共和國,歐洲,1,0,1,1,0,1,0,0,0,0,0,0,0,0,0
109,公立,一般大學,0006,國立中興大學,碩士班(日間),美國,北美洲,1,0,1,1,0,1,0,0,0,0,0,0,0,0,0
109,公立,一般大學,0006,國立中興大學,碩士班(日間),馬來西亞,東協,40,25,15,8,4,4,32,21,11,0,0,0,0,0,0
109,公立,一般大學,0006,國立中興大學,碩士班(日間),馬拉威共和國,非洲,1,0,1,1,0,1,0,0,0,0,0,0,0,0,0
109,公立,一般大學,0006,國立中興大學,碩士班(日間),斯里蘭卡民主社會主義共和國,南亞,10,5,5,10,5,5,0,0,0,0,0,0,0,0,0
109,公立,一般大學,0006,國立中興大學,碩士班(日間),菲律賓共和國,東協,2,1,1,2,1,1,0,0,0,0,0,0,0,0,0
109,公立,一般大學,0006,國立中興大學,碩士班(日間),薩爾瓦多,中南美洲,1,0,1,1,0,1,0,0,0,0,0,0,0,0,0
109,公立,一般大學,0006,國立中興大學,博士班,土耳其共和國,其他亞洲地區,2,2,0,2,2,0,0,0,0,0,0,0,0,0,0
109,公立,一般大學,0006,國立中興大學,博士班,大陸地區,大陸地區,8,4,4,0,0,0,0,0,0,0,0,0,8,4,4
109,公立,一般大學,0006,國立中興大學,博士班,大韓民國(南韓),其他亞洲地區,3,2,1,2,1,1,1,1,0,0,0,0,0,0,0
109,公立,一般大學,0006,國立中興大學,博士班,伊朗伊斯蘭共和國,其他亞洲地區,1,1,0,1,1,0,0,0,0,0,0,0,0,0,0
109,公立,一般大學,0006,國立中興大學,博士班,印度,南亞,33,22,11,33,22,11,0,0,0,0,0,0,0,0,0
109,公立,一般大學,0006,國立中興大學,博士班,印度尼西亞共和國,東協,7,3,4,7,3,4,0,0,0,0,0,0,0,0,0
109,公立,一般大學,0006,國立中興大學,博士班,衣索比亞聯邦民主共和國,非洲,6,5,1,6,5,1,0,0,0,0,0,0,0,0,0
109,公立,一般大學,0006,國立中興大學,博士班,貝里斯,中南美洲,1,1,0,1,1,0,0,0,0,0,0,0,0,0,0
109,公立,一般大學,0006,國立中興大學,博士班,南非共和國,非洲,1,1,0,1,1,0,0,0,0,0,0,0,0,0,0
109,公立,一般大學,0006,國立中興大學,博士班,哥倫比亞共和國,中南美洲,1,1,0,1,1,0,0,0,0,0,0,0,0,0,0
109,公立,一般大學,0006,國立中興大學,博士班,埃及阿拉伯共和國,非洲,1,1,0,1,1,0,0,0,0,0,0,0,0,0,0
109,公立,一般大學,0006,國立中興大學,博士班,馬來西亞,東協,11,4,7,7,3,4,4,1,3,0,0,0,0,0,0
109,公立,一般大學,0006,國立中興大學,博士班,荷蘭王國,歐洲,1,1,0,1,1,0,0,0,0,0,0,0,0,0,0
109,公立,一般大學,0006,國立中興大學,博士班,越南社會主義共和國,東協,20,10,10,20,10,10,0,0,0,0,0,0,0,0,0
109,公立,一般大學,0006,國立中興大學,博士班,澳門,港澳,1,0,1,0,0,0,0,0,0,1,0,1,0,0,0
109,公立,一般大學,0006,國立中興大學,博士班,巴基斯坦,南亞,2,1,1,2,1,1,0,0,0,0,0,0,0,0,0
109,公立,一般大學,0006,國立中興大學,博士班,尼泊爾聯邦民主共和國,南亞,5,3,2,5,3,2,0,0,0,0,0,0,0,0,0
109,公立,一般大學,0006,國立中興大學,博士班,甘比亞共和國,非洲,3,3,0,3,3,0,0,0,0,0,0,0,0,0,0
109,公立,一般大學,0006,國立中興大學,博士班,孟加拉人民共和國,南亞,6,4,2,6,4,2,0,0,0,0,0,0,0,0,0
109,公立,一般大學,0006,國立中興大學,博士班,泰國,東協,26,8,18,26,8,18,0,0,0,0,0,0,0,0,0
109,公立,一般大學,0006,國立中興大學,博士班,斯里蘭卡民主社會主義共和國,南亞,3,2,1,3,2,1,0,0,0,0,0,0,0,0,0
109,公立,一般大學,0006,國立中興大學,博士班,菲律賓共和國,東協,11,8,3,11,8,3,0,0,0,0,0,0,0,0,0
109,公立,一般大學,0006,國立中興大學,博士班,德意志聯邦共和國,歐洲,1,1,0,1,1,0,0,0,0,0,0,0,0,0,0
109,公立,一般大學,0007,國立陽明交通大學,學士班(日間),大陸地區,大陸地區,8,4,4,0,0,0,0,0,0,0,0,0,8,4,4
109,公立,一般大學,0007,國立陽明交通大學,學士班(日間),巴西聯邦共和國,中南美洲,1,1,0,1,1,0,0,0,0,0,0,0,0,0,0
109,公立,一般大學,0007,國立陽明交通大學,學士班(日間),巴拉圭,中南美洲,7,4,3,6,3,3,1,1,0,0,0,0,0,0,0
109,公立,一般大學,0007,國立陽明交通大學,學士班(日間),瓜地馬拉共和國,中南美洲,1,1,0,0,0,0,1,1,0,0,0,0,0,0,0
109,公立,一般大學,0007,國立陽明交通大學,學士班(日間),伊朗伊斯蘭共和國,其他亞洲地區,2,0,2,0,0,0,2,0,2,0,0,0,0,0,0
109,公立,一般大學,0007,國立陽明交通大學,學士班(日間),印度尼西亞共和國,東協,78,52,26,29,20,9,49,32,17,0,0,0,0,0,0
109,公立,一般大學,0007,國立陽明交通大學,學士班(日間),哈薩克共和國,其他亞洲地區,1,1,0,1,1,0,0,0,0,0,0,0,0,0,0
109,公立,一般大學,0007,國立陽明交通大學,學士班(日間),泰國,東協,6,5,1,1,1,0,5,4,1,0,0,0,0,0,0
109,公立,一般大學,0007,國立陽明交通大學,學士班(日間),海地共和國,中南美洲,7,6,1,7,6,1,0,0,0,0,0,0,0,0,0
109,公立,一般大學,0007,國立陽明交通大學,學士班(日間),烏茲別克共和國,其他亞洲地區,1,1,0,1,1,0,0,0,0,0,0,0,0,0,0
109,公立,一般大學,0007,國立陽明交通大學,學士班(日間),馬來西亞,東協,134,97,37,18,10,8,116,87,29,0,0,0,0,0,0
109,公立,一般大學,0007,國立陽明交通大學,學士班(日間),菲律賓共和國,東協,2,1,1,2,1,1,0,0,0,0,0,0,0,0,0
109,公立,一般大學,0007,國立陽明交通大學,學士班(日間),越南社會主義共和國,東協,12,5,7,7,3,4,5,2,3,0,0,0,0,0,0
109,公立,一般大學,0007,國立陽明交通大學,學士班(日間),聖露西亞,中南美洲,2,1,1,2,1,1,0,0,0,0,0,0,0,0,0
109,公立,一般大學,0007,國立陽明交通大學,學士班(日間),蒙古國,其他亞洲地區,1,1,0,1,1,0,0,0,0,0,0,0,0,0,0
109,公立,一般大學,0007,國立陽明交通大學,學士班(日間),澳門,港澳,32,28,4,0,0,0,0,0,0,32,28,4,0,0,0
109,公立,一般大學,0007,國立陽明交通大學,學士班(日間),大韓民國(南韓),其他亞洲地區,6,5,1,1,0,1,5,5,0,0,0,0,0,0,0
109,公立,一般大學,0007,國立陽明交通大學,學士班(日間),厄瓜多共和國,中南美洲,1,0,1,0,0,0,1,0,1,0,0,0,0,0,0
109,公立,一般大學,0007,國立陽明交通大學,學士班(日間),日本,其他亞洲地區,5,4,1,4,3,1,1,1,0,0,0,0,0,0,0
109,公立,一般大學,0007,國立陽明交通大學,學士班(日間),印度,南亞,2,1,1,2,1,1,0,0,0,0,0,0,0,0,0
109,公立,一般大學,0007,國立陽明交通大學,學士班(日間),多明尼加共和國,中南美洲,1,1,0,0,0,0,1,1,0,0,0,0,0,0,0
109,公立,一般大學,0007,國立陽明交通大學,學士班(日間),宏都拉斯共和國,中南美洲,2,2,0,2,2,0,0,0,0,0,0,0,0,0,0
109,公立,一般大學,0007,國立陽明交通大學,學士班(日間),美國,北美洲,2,2,0,1,1,0,1,1,0,0,0,0,0,0,0
109,公立,一般大學,0007,國立陽明交通大學,學士班(日間),香港,港澳,43,29,14,0,0,0,0,0,0,43,29,14,0,0,0
109,公立,一般大學,0007,國立陽明交通大學,學士班(日間),烏克蘭,其他亞洲地區,3,2,1,3,2,1,0,0,0,0,0,0,0,0,0
109,公立,一般大學,0007,國立陽明交通大學,學士班(日間),新加坡共和國,東協,3,2,1,1,1,0,2,1,1,0,0,0,0,0,0
109,公立,一般大學,0007,國立陽明交通大學,學士班(日間),聖文森(及格瑞那丁),中南美洲,1,0,1,1,0,1,0,0,0,0,0,0,0,0,0
109,公立,一般大學,0007,國立陽明交通大學,學士班(日間),緬甸,東協,13,7,6,0,0,0,13,7,6,0,0,0,0,0,0
109,公立,一般大學,0007,國立陽明交通大學,碩士班(日間),大韓民國(南韓),其他亞洲地區,1,0,1,1,0,1,0,0,0,0,0,0,0,0,0
109,公立,一般大學,0007,國立陽明交通大學,碩士班(日間),厄瓜多共和國,中南美洲,1,1,0,1,1,0,0,0,0,0,0,0,0,0,0
109,公立,一般大學,0007,國立陽明交通大學,碩士班(日間),巴拿馬共和國,中南美洲,2,2,0,2,2,0,0,0,0,0,0,0,0,0,0
109,公立,一般大學,0007,國立陽明交通大學,碩士班(日間),巴基斯坦,南亞,4,4,0,4,4,0,0,0,0,0,0,0,0,0,0
109,公立,一般大學,0007,國立陽明交通大學,碩士班(日間),日本,其他亞洲地區,6,4,2,6,4,2,0,0,0,0,0,0,0,0,0
109,公立,一般大學,0007,國立陽明交通大學,碩士班(日間),印度,南亞,43,26,17,43,26,17,0,0,0,0,0,0,0,0,0
109,公立,一般大學,0007,國立陽明交通大學,碩士班(日間),俄羅斯聯邦,其他亞洲地區,4,3,1,4,3,1,0,0,0,0,0,0,0,0,0
109,公立,一般大學,0007,國立陽明交通大學,碩士班(日間),哈薩克共和國,其他亞洲地區,1,1,0,1,1,0,0,0,0,0,0,0,0,0,0
109,公立,一般大學,0007,國立陽明交通大學,碩士班(日間),約旦哈什米王國,其他亞洲地區,1,0,1,1,0,1,0,0,0,0,0,0,0,0,0
109,公立,一般大學,0007,國立陽明交通大學,碩士班(日間),美國,北美洲,5,4,1,3,2,1,2,2,0,0,0,0,0,0,0
109,公立,一般大學,0007,國立陽明交通大學,碩士班(日間),烏克蘭,其他亞洲地區,2,2,0,2,2,0,0,0,0,0,0,0,0,0,0
109,公立,一般大學,0007,國立陽明交通大學,碩士班(日間),紐西蘭,其他亞洲地區,1,1,0,0,0,0,1,1,0,0,0,0,0,0,0
109,公立,一般大學,0007,國立陽明交通大學,碩士班(日間),馬來西亞,東協,43,29,14,6,3,3,37,26,11,0,0,0,0,0,0
109,公立,一般大學,0007,國立陽明交通大學,碩士班(日間),菲律賓共和國,東協,4,3,1,4,3,1,0,0,0,0,0,0,0,0,0
109,公立,一般大學,0007,國立陽明交通大學,碩士班(日間),塔吉克共和國,其他亞洲地區,1,1,0,1,1,0,0,0,0,0,0,0,0,0,0
109,公立,一般大學,0007,國立陽明交通大學,碩士班(日間),聖文森(及格瑞那丁),中南美洲,1,1,0,1,1,0,0,0,0,0,0,0,0,0,0
109,公立,一般大學,0007,國立陽明交通大學,碩士班(日間),葉門共和國,其他亞洲地區,1,0,1,0,0,0,1,0,1,0,0,0,0,0,0
109,公立,一般大學,0007,國立陽明交通大學,碩士班(日間),土耳其共和國,其他亞洲地區,2,2,0,2,2,0,0,0,0,0,0,0,0,0,0
109,公立,一般大學,0007,國立陽明交通大學,碩士班(日間),大陸地區,大陸地區,99,62,37,0,0,0,0,0,0,0,0,0,99,62,37
109,公立,一般大學,0007,國立陽明交通大學,碩士班(日間),巴拉圭,中南美洲,1,1,0,0,0,0,1,1,0,0,0,0,0,0,0
109,公立,一般大學,0007,國立陽明交通大學,碩士班(日間),加拿大,北美洲,2,2,0,2,2,0,0,0,0,0,0,0,0,0,0
109,公立,一般大學,0007,國立陽明交通大學,碩士班(日間),尼加拉瓜,中南美洲,2,2,0,2,2,0,0,0,0,0,0,0,0,0,0
109,公立,一般大學,0007,國立陽明交通大學,碩士班(日間),印度尼西亞共和國,東協,36,25,11,27,18,9,9,7,2,0,0,0,0,0,0
109,公立,一般大學,0007,國立陽明交通大學,碩士班(日間),宏都拉斯共和國,中南美洲,1,1,0,1,1,0,0,0,0,0,0,0,0,0,0
109,公立,一般大學,0007,國立陽明交通大學,碩士班(日間),貝里斯,中南美洲,1,1,0,1,1,0,0,0,0,0,0,0,0,0,0
109,公立,一般大學,0007,國立陽明交通大學,碩士班(日間),孟加拉人民共和國,南亞,1,1,0,1,1,0,0,0,0,0,0,0,0,0,0
109,公立,一般大學,0007,國立陽明交通大學,碩士班(日間),波蘭共和國,歐洲,2,1,1,2,1,1,0,0,0,0,0,0,0,0,0
109,公立,一般大學,0007,國立陽明交通大學,碩士班(日間),南非共和國,非洲,1,0,1,1,0,1,0,0,0,0,0,0,0,0,0
109,公立,一般大學,0007,國立陽明交通大學,碩士班(日間),香港,港澳,37,22,15,0,0,0,0,0,0,37,22,15,0,0,0
109,公立,一般大學,0007,國立陽明交通大學,碩士班(日間),哥倫比亞共和國,中南美洲,1,1,0,1,1,0,0,0,0,0,0,0,0,0,0
109,公立,一般大學,0007,國立陽明交通大學,碩士班(日間),泰國,東協,8,3,5,6,2,4,2,1,1,0,0,0,0,0,0
109,公立,一般大學,0007,國立陽明交通大學,碩士班(日間),海地共和國,中南美洲,7,3,4,7,3,4,0,0,0,0,0,0,0,0,0
109,公立,一般大學,0007,國立陽明交通大學,碩士班(日間),越南社會主義共和國,東協,38,16,22,38,16,22,0,0,0,0,0,0,0,0,0
109,公立,一般大學,0007,國立陽明交通大學,碩士班(日間),緬甸,東協,1,1,0,0,0,0,1,1,0,0,0,0,0,0,0
109,公立,一般大學,0007,國立陽明交通大學,碩士班(日間),澳門,港澳,17,11,6,0,0,0,0,0,0,17,11,6,0,0,0
109,公立,一般大學,0007,國立陽明交通大學,碩士班(日間),薩爾瓦多,中南美洲,1,1,0,1,1,0,0,0,0,0,0,0,0,0,0
109,公立,一般大學,0007,國立陽明交通大學,博士班,厄瓜多共和國,中南美洲,2,2,0,2,2,0,0,0,0,0,0,0,0,0,0
109,公立,一般大學,0007,國立陽明交通大學,博士班,巴基斯坦,南亞,15,13,2,15,13,2,0,0,0,0,0,0,0,0,0
109,公立,一般大學,0007,國立陽明交通大學,博士班,尼加拉瓜,中南美洲,1,1,0,1,1,0,0,0,0,0,0,0,0,0,0
109,公立,一般大學,0007,國立陽明交通大學,博士班,瓜地馬拉共和國,中南美洲,1,1,0,1,1,0,0,0,0,0,0,0,0,0,0
109,公立,一般大學,0007,國立陽明交通大學,博士班,甘比亞共和國,非洲,3,2,1,3,2,1,0,0,0,0,0,0,0,0,0
109,公立,一般大學,0007,國立陽明交通大學,博士班,印度,南亞,141,112,29,141,112,29,0,0,0,0,0,0,0,0,0
109,公立,一般大學,0007,國立陽明交通大學,博士班,衣索比亞聯邦民主共和國,非洲,14,14,0,14,14,0,0,0,0,0,0,0,0,0,0
109,公立,一般大學,0007,國立陽明交通大學,博士班,西班牙王國,歐洲,1,1,0,1,1,0,0,0,0,0,0,0,0,0,0
109,公立,一般大學,0007,國立陽明交通大學,博士班,汶萊和平之國,東協,1,1,0,1,1,0,0,0,0,0,0,0,0,0,0
109,公立,一般大學,0007,國立陽明交通大學,博士班,孟加拉人民共和國,南亞,1,1,0,1,1,0,0,0,0,0,0,0,0,0,0
109,公立,一般大學,0007,國立陽明交通大學,博士班,哈薩克共和國,其他亞洲地區,1,1,0,1,1,0,0,0,0,0,0,0,0,0,0
109,公立,一般大學,0007,國立陽明交通大學,博士班,美國,北美洲,2,2,0,2,2,0,0,0,0,0,0,0,0,0,0
109,公立,一般大學,0007,國立陽明交通大學,博士班,海地共和國,中南美洲,1,1,0,1,1,0,0,0,0,0,0,0,0,0,0
109,公立,一般大學,0007,國立陽明交通大學,博士班,烏克蘭,其他亞洲地區,2,1,1,2,1,1,0,0,0,0,0,0,0,0,0
109,公立,一般大學,0007,國立陽明交通大學,博士班,索羅門群島,其他亞洲地區,1,1,0,1,1,0,0,0,0,0,0,0,0,0,0
109,公立,一般大學,0007,國立陽明交通大學,博士班,聖克里斯多福及尼維斯,中南美洲,1,1,0,1,1,0,0,0,0,0,0,0,0,0,0
109,公立,一般大學,0007,國立陽明交通大學,博士班,葉門共和國,其他亞洲地區,1,1,0,1,1,0,0,0,0,0,0,0,0,0,0
109,公立,一般大學,0007,國立陽明交通大學,博士班,蒙古國,其他亞洲地區,1,0,1,1,0,1,0,0,0,0,0,0,0,0,0
109,公立,一般大學,0007,國立陽明交通大學,博士班,德意志聯邦共和國,歐洲,3,2,1,3,2,1,0,0,0,0,0,0,0,0,0
109,公立,一般大學,0007,國立陽明交通大學,博士班,大陸地區,大陸地區,38,20,18,0,0,0,0,0,0,0,0,0,38,20,18
109,公立,一般大學,0007,國立陽明交通大學,博士班,大韓民國(南韓),其他亞洲地區,2,2,0,2,2,0,0,0,0,0,0,0,0,0,0
109,公立,一般大學,0007,國立陽明交通大學,博士班,巴勒斯坦,其他亞洲地區,3,3,0,3,3,0,0,0,0,0,0,0,0,0,0
109,公立,一般大學,0007,國立陽明交通大學,博士班,日本,其他亞洲地區,1,1,0,1,1,0,0,0,0,0,0,0,0,0,0
109,公立,一般大學,0007,國立陽明交通大學,博士班,伊朗伊斯蘭共和國,其他亞洲地區,3,2,1,3,2,1,0,0,0,0,0,0,0,0,0
109,公立,一般大學,0007,國立陽明交通大學,博士班,印度尼西亞共和國,東協,39,31,8,39,31,8,0,0,0,0,0,0,0,0,0
109,公立,一般大學,0007,國立陽明交通大學,博士班,波蘭共和國,歐洲,1,0,1,1,0,1,0,0,0,0,0,0,0,0,0
109,公立,一般大學,0007,國立陽明交通大學,博士班,法國,歐洲,1,1,0,1,1,0,0,0,0,0,0,0,0,0,0
109,公立,一般大學,0007,國立陽明交通大學,博士班,南非共和國,非洲,1,1,0,1,1,0,0,0,0,0,0,0,0,0,0
109,公立,一般大學,0007,國立陽明交通大學,博士班,玻利維亞共和國,中南美洲,1,1,0,1,1,0,0,0,0,0,0,0,0,0,0
109,公立,一般大學,0007,國立陽明交通大學,博士班,約旦哈什米王國,其他亞洲地區,2,0,2,2,0,2,0,0,0,0,0,0,0,0,0
109,公立,一般大學,0007,國立陽明交通大學,博士班,香港,港澳,2,1,1,0,0,0,0,0,0,2,1,1,0,0,0
109,公立,一般大學,0007,國立陽明交通大學,博士班,剛果共和國,非洲,1,1,0,1,1,0,0,0,0,0,0,0,0,0,0
109,公立,一般大學,0007,國立陽明交通大學,博士班,哥倫比亞共和國,中南美洲,1,1,0,1,1,0,0,0,0,0,0,0,0,0,0
109,公立,一般大學,0007,國立陽明交通大學,博士班,埃及阿拉伯共和國,非洲,5,5,0,5,5,0,0,0,0,0,0,0,0,0,0
109,公立,一般大學,0007,國立陽明交通大學,博士班,泰國,東協,4,2,2,3,1,2,1,1,0,0,0,0,0,0,0
109,公立,一般大學,0007,國立陽明交通大學,博士班,馬來西亞,東協,17,10,7,10,5,5,7,5,2,0,0,0,0,0,0
109,公立,一般大學,0007,國立陽明交通大學,博士班,菲律賓共和國,東協,7,4,3,7,4,3,0,0,0,0,0,0,0,0,0
109,公立,一般大學,0007,國立陽明交通大學,博士班,越南社會主義共和國,東協,46,27,19,46,27,19,0,0,0,0,0,0,0,0,0
109,公立,一般大學,0007,國立陽明交通大學,博士班,蘇丹共和國,非洲,2,2,0,2,2,0,0,0,0,0,0,0,0,0,0
109,公立,一般大學,0008,國立中央大學,學士班(日間),大韓民國(南韓),其他亞洲地區,2,2,0,2,2,0,0,0,0,0,0,0,0,0,0
109,公立,一般大學,0008,國立中央大學,學士班(日間),日本,其他亞洲地區,4,1,3,4,1,3,0,0,0,0,0,0,0,0,0
109,公立,一般大學,0008,國立中央大學,學士班(日間),大陸地區,大陸地區,11,6,5,0,0,0,0,0,0,0,0,0,11,6,5
109,公立,一般大學,0008,國立中央大學,學士班(日間),加拿大,北美洲,1,0,1,0,0,0,1,0,1,0,0,0,0,0,0
109,公立,一般大學,0008,國立中央大學,學士班(日間),尼加拉瓜,中南美洲,1,1,0,1,1,0,0,0,0,0,0,0,0,0,0
109,公立,一般大學,0008,國立中央大學,學士班(日間),印度尼西亞共和國,東協,27,17,10,1,1,0,26,16,10,0,0,0,0,0,0
109,公立,一般大學,0008,國立中央大學,學士班(日間),南非共和國,非洲,1,0,1,0,0,0,1,0,1,0,0,0,0,0,0
109,公立,一般大學,0008,國立中央大學,學士班(日間),香港,港澳,44,27,17,0,0,0,0,0,0,44,27,17,0,0,0
109,公立,一般大學,0008,國立中央大學,學士班(日間),泰國,東協,1,1,0,0,0,0,1,1,0,0,0,0,0,0,0
109,公立,一般大學,0008,國立中央大學,學士班(日間),馬來西亞,東協,48,25,23,2,0,2,46,25,21,0,0,0,0,0,0
109,公立,一般大學,0008,國立中央大學,學士班(日間),越南社會主義共和國,東協,6,2,4,2,0,2,4,2,2,0,0,0,0,0,0
109,公立,一般大學,0008,國立中央大學,學士班(日間),緬甸,東協,6,4,2,0,0,0,6,4,2,0,0,0,0,0,0
109,公立,一般大學,0008,國立中央大學,學士班(日間),澳門,港澳,20,18,2,0,0,0,0,0,0,20,18,2,0,0,0
109,公立,一般大學,0008,國立中央大學,碩士班(日間),大陸地區,大陸地區,70,45,25,0,0,0,0,0,0,0,0,0,70,45,25
109,公立,一般大學,0008,國立中央大學,碩士班(日間),巴拉圭,中南美洲,1,1,0,1,1,0,0,0,0,0,0,0,0,0,0
109,公立,一般大學,0008,國立中央大學,碩士班(日間),加拿大,北美洲,1,1,0,0,0,0,1,1,0,0,0,0,0,0,0
109,公立,一般大學,0008,國立中央大學,碩士班(日間),印度,南亞,5,4,1,5,4,1,0,0,0,0,0,0,0,0,0
109,公立,一般大學,0008,國立中央大學,碩士班(日間),印度尼西亞共和國,東協,96,49,47,96,49,47,0,0,0,0,0,0,0,0,0
109,公立,一般大學,0008,國立中央大學,碩士班(日間),貝里斯,中南美洲,2,1,1,2,1,1,0,0,0,0,0,0,0,0,0
109,公立,一般大學,0008,國立中央大學,碩士班(日間),香港,港澳,19,11,8,0,0,0,0,0,0,19,11,8,0,0,0
109,公立,一般大學,0008,國立中央大學,碩士班(日間),馬來西亞,東協,17,13,4,4,2,2,13,11,2,0,0,0,0,0,0
109,公立,一般大學,0008,國立中央大學,碩士班(日間),越南社會主義共和國,東協,74,26,48,74,26,48,0,0,0,0,0,0,0,0,0
109,公立,一般大學,0008,國立中央大學,碩士班(日間),澳門,港澳,3,2,1,0,0,0,0,0,0,3,2,1,0,0,0
109,公立,一般大學,0008,國立中央大學,碩士班(日間),巴基斯坦,南亞,4,2,2,4,2,2,0,0,0,0,0,0,0,0,0
109,公立,一般大學,0008,國立中央大學,碩士班(日間),史瓦帝尼王國,非洲,2,1,1,2,1,1,0,0,0,0,0,0,0,0,0
109,公立,一般大學,0008,國立中央大學,碩士班(日間),尼泊爾聯邦民主共和國,南亞,1,1,0,1,1,0,0,0,0,0,0,0,0,0,0
109,公立,一般大學,0008,國立中央大學,碩士班(日間),俄羅斯聯邦,其他亞洲地區,2,1,1,2,1,1,0,0,0,0,0,0,0,0,0
109,公立,一般大學,0008,國立中央大學,碩士班(日間),泰國,東協,3,1,2,3,1,2,0,0,0,0,0,0,0,0,0
109,公立,一般大學,0008,國立中央大學,碩士班(日間),斯里蘭卡民主社會主義共和國,南亞,1,0,1,1,0,1,0,0,0,0,0,0,0,0,0
109,公立,一般大學,0008,國立中央大學,碩士班(日間),菲律賓共和國,東協,12,8,4,12,8,4,0,0,0,0,0,0,0,0,0
109,公立,一般大學,0008,國立中央大學,碩士班(日間),蒙古國,其他亞洲地區,3,2,1,3,2,1,0,0,0,0,0,0,0,0,0
109,公立,一般大學,0008,國立中央大學,博士班,日本,其他亞洲地區,1,1,0,1,1,0,0,0,0,0,0,0,0,0,0
109,公立,一般大學,0008,國立中央大學,博士班,加拿大,北美洲,1,1,0,1,1,0,0,0,0,0,0,0,0,0,0
109,公立,一般大學,0008,國立中央大學,博士班,印度尼西亞共和國,東協,104,60,44,104,60,44,0,0,0,0,0,0,0,0,0
109,公立,一般大學,0008,國立中央大學,博士班,波蘭共和國,歐洲,1,0,1,1,0,1,0,0,0,0,0,0,0,0,0
109,公立,一般大學,0008,國立中央大學,博士班,阿爾巴尼亞共和國,歐洲,1,0,1,1,0,1,0,0,0,0,0,0,0,0,0
109,公立,一般大學,0008,國立中央大學,博士班,俄羅斯聯邦,其他亞洲地區,1,1,0,1,1,0,0,0,0,0,0,0,0,0,0
109,公立,一般大學,0008,國立中央大學,博士班,柬埔寨王國,東協,1,0,1,1,0,1,0,0,0,0,0,0,0,0,0
109,公立,一般大學,0008,國立中央大學,博士班,埃及阿拉伯共和國,非洲,1,1,0,1,1,0,0,0,0,0,0,0,0,0,0
109,公立,一般大學,0008,國立中央大學,博士班,泰國,東協,9,3,6,9,3,6,0,0,0,0,0,0,0,0,0
109,公立,一般大學,0008,國立中央大學,博士班,秘魯共和國,中南美洲,1,1,0,1,1,0,0,0,0,0,0,0,0,0,0
109,公立,一般大學,0008,國立中央大學,博士班,馬來西亞,東協,10,6,4,8,5,3,2,1,1,0,0,0,0,0,0
109,公立,一般大學,0008,國立中央大學,博士班,斯里蘭卡民主社會主義共和國,南亞,3,2,1,3,2,1,0,0,0,0,0,0,0,0,0
109,公立,一般大學,0008,國立中央大學,博士班,菲律賓共和國,東協,8,4,4,8,4,4,0,0,0,0,0,0,0,0,0
109,公立,一般大學,0008,國立中央大學,博士班,大陸地區,大陸地區,22,10,12,0,0,0,0,0,0,0,0,0,22,10,12
109,公立,一般大學,0008,國立中央大學,博士班,巴基斯坦,南亞,10,7,3,10,7,3,0,0,0,0,0,0,0,0,0
109,公立,一般大學,0008,國立中央大學,博士班,尼加拉瓜,中南美洲,1,1,0,1,1,0,0,0,0,0,0,0,0,0,0
109,公立,一般大學,0008,國立中央大學,博士班,尼泊爾聯邦民主共和國,南亞,4,4,0,4,4,0,0,0,0,0,0,0,0,0,0
109,公立,一般大學,0008,國立中央大學,博士班,伊朗伊斯蘭共和國,其他亞洲地區,4,3,1,4,3,1,0,0,0,0,0,0,0,0,0
109,公立,一般大學,0008,國立中央大學,博士班,匈牙利共和國,歐洲,1,1,0,1,1,0,0,0,0,0,0,0,0,0,0
109,公立,一般大學,0008,國立中央大學,博士班,印度,南亞,42,29,13,42,29,13,0,0,0,0,0,0,0,0,0
109,公立,一般大學,0008,國立中央大學,博士班,衣索比亞聯邦民主共和國,非洲,5,5,0,5,5,0,0,0,0,0,0,0,0,0,0
109,公立,一般大學,0008,國立中央大學,博士班,奈及利亞聯邦共和國,非洲,1,1,0,1,1,0,0,0,0,0,0,0,0,0,0
109,公立,一般大學,0008,國立中央大學,博士班,孟加拉人民共和國,南亞,2,1,1,2,1,1,0,0,0,0,0,0,0,0,0
109,公立,一般大學,0008,國立中央大學,博士班,哥倫比亞共和國,中南美洲,1,0,1,1,0,1,0,0,0,0,0,0,0,0,0
109,公立,一般大學,0008,國立中央大學,博士班,海地共和國,中南美洲,3,3,0,3,3,0,0,0,0,0,0,0,0,0,0
109,公立,一般大學,0008,國立中央大學,博士班,喀麥隆共和國,非洲,1,0,1,1,0,1,0,0,0,0,0,0,0,0,0
109,公立,一般大學,0008,國立中央大學,博士班,越南社會主義共和國,東協,121,84,37,121,84,37,0,0,0,0,0,0,0,0,0
109,公立,一般大學,0008,國立中央大學,博士班,葉門共和國,其他亞洲地區,2,2,0,2,2,0,0,0,0,0,0,0,0,0,0
109,公立,一般大學,0008,國立中央大學,博士班,蒙古國,其他亞洲地區,5,2,3,5,2,3,0,0,0,0,0,0,0,0,0
109,公立,一般大學,0008,國立中央大學,博士班,德意志聯邦共和國,歐洲,1,0,1,1,0,1,0,0,0,0,0,0,0,0,0
109,公立,一般大學,0008,國立中央大學,博士班,緬甸,東協,1,0,1,1,0,1,0,0,0,0,0,0,0,0,0
109,公立,一般大學,0009,國立中山大學,學士班(日間),土庫曼,其他亞洲地區,1,0,1,1,0,1,0,0,0,0,0,0,0,0,0
109,公立,一般大學,0009,國立中山大學,學士班(日間),大韓民國(南韓),其他亞洲地區,3,3,0,2,2,0,1,1,0,0,0,0,0,0,0
109,公立,一般大學,0009,國立中山大學,學士班(日間),加拿大,北美洲,1,0,1,1,0,1,0,0,0,0,0,0,0,0,0
109,公立,一般大學,0009,國立中山大學,學士班(日間),印度尼西亞共和國,東協,28,17,11,1,1,0,27,16,11,0,0,0,0,0,0
109,公立,一般大學,0009,國立中山大學,學士班(日間),俄羅斯聯邦,其他亞洲地區,2,0,2,2,0,2,0,0,0,0,0,0,0,0,0
109,公立,一般大學,0009,國立中山大學,學士班(日間),南非共和國,非洲,3,2,1,0,0,0,3,2,1,0,0,0,0,0,0
109,公立,一般大學,0009,國立中山大學,學士班(日間),美國,北美洲,3,2,1,1,1,0,2,1,1,0,0,0,0,0,0
109,公立,一般大學,0009,國立中山大學,學士班(日間),英國,歐洲,1,1,0,0,0,0,1,1,0,0,0,0,0,0,0
109,公立,一般大學,0009,國立中山大學,學士班(日間),泰國,東協,4,2,2,0,0,0,4,2,2,0,0,0,0,0,0
109,公立,一般大學,0009,國立中山大學,學士班(日間),馬來西亞,東協,83,46,37,2,2,0,81,44,37,0,0,0,0,0,0
109,公立,一般大學,0009,國立中山大學,學士班(日間),薩爾瓦多,中南美洲,1,0,1,1,0,1,0,0,0,0,0,0,0,0,0
109,公立,一般大學,0009,國立中山大學,學士班(日間),大陸地區,大陸地區,13,5,8,0,0,0,0,0,0,0,0,0,13,5,8
109,公立,一般大學,0009,國立中山大學,學士班(日間),日本,其他亞洲地區,16,7,9,12,4,8,4,3,1,0,0,0,0,0,0
109,公立,一般大學,0009,國立中山大學,學士班(日間),宏都拉斯共和國,中南美洲,1,0,1,1,0,1,0,0,0,0,0,0,0,0,0
109,公立,一般大學,0009,國立中山大學,學士班(日間),香港,港澳,66,36,30,0,0,0,0,0,0,66,36,30,0,0,0
109,公立,一般大學,0009,國立中山大學,學士班(日間),哥倫比亞共和國,中南美洲,1,1,0,0,0,0,1,1,0,0,0,0,0,0,0
109,公立,一般大學,0009,國立中山大學,學士班(日間),海地共和國,中南美洲,1,1,0,1,1,0,0,0,0,0,0,0,0,0,0
109,公立,一般大學,0009,國立中山大學,學士班(日間),越南社會主義共和國,東協,7,2,5,6,1,5,1,1,0,0,0,0,0,0,0
109,公立,一般大學,0009,國立中山大學,學士班(日間),緬甸,東協,3,2,1,0,0,0,3,2,1,0,0,0,0,0,0
109,公立,一般大學,0009,國立中山大學,學士班(日間),墨西哥合眾國,中南美洲,1,1,0,0,0,0,1,1,0,0,0,0,0,0,0
109,公立,一般大學,0009,國立中山大學,學士班(日間),澳門,港澳,10,9,1,0,0,0,0,0,0,10,9,1,0,0,0
109,公立,一般大學,0009,國立中山大學,碩士班(日間),大陸地區,大陸地區,48,26,22,0,0,0,0,0,0,0,0,0,48,26,22
109,公立,一般大學,0009,國立中山大學,碩士班(日間),巴布亞紐幾內亞獨立國,其他亞洲地區,1,0,1,1,0,1,0,0,0,0,0,0,0,0,0
109,公立,一般大學,0009,國立中山大學,碩士班(日間),日本,其他亞洲地區,1,1,0,0,0,0,1,1,0,0,0,0,0,0,0
109,公立,一般大學,0009,國立中山大學,碩士班(日間),史瓦帝尼王國,非洲,1,1,0,1,1,0,0,0,0,0,0,0,0,0,0
109,公立,一般大學,0009,國立中山大學,碩士班(日間),尼加拉瓜,中南美洲,1,0,1,1,0,1,0,0,0,0,0,0,0,0,0
109,公立,一般大學,0009,國立中山大學,碩士班(日間),伊朗伊斯蘭共和國,其他亞洲地區,1,0,1,1,0,1,0,0,0,0,0,0,0,0,0
109,公立,一般大學,0009,國立中山大學,碩士班(日間),印度,南亞,9,7,2,9,7,2,0,0,0,0,0,0,0,0,0
109,公立,一般大學,0009,國立中山大學,碩士班(日間),西班牙王國,歐洲,3,0,3,3,0,3,0,0,0,0,0,0,0,0,0
109,公立,一般大學,0009,國立中山大學,碩士班(日間),宏都拉斯共和國,中南美洲,2,2,0,2,2,0,0,0,0,0,0,0,0,0,0
109,公立,一般大學,0009,國立中山大學,碩士班(日間),波蘭共和國,歐洲,4,2,2,4,2,2,0,0,0,0,0,0,0,0,0
109,公立,一般大學,0009,國立中山大學,碩士班(日間),香港,港澳,20,14,6,0,0,0,0,0,0,20,14,6,0,0,0
109,公立,一般大學,0009,國立中山大學,碩士班(日間),哥倫比亞共和國,中南美洲,1,0,1,1,0,1,0,0,0,0,0,0,0,0,0
109,公立,一般大學,0009,國立中山大學,碩士班(日間),海地共和國,中南美洲,1,1,0,1,1,0,0,0,0,0,0,0,0,0,0
109,公立,一般大學,0009,國立中山大學,碩士班(日間),斯里蘭卡民主社會主義共和國,南亞,9,5,4,9,5,4,0,0,0,0,0,0,0,0,0
109,公立,一般大學,0009,國立中山大學,碩士班(日間),德意志聯邦共和國,歐洲,4,2,2,4,2,2,0,0,0,0,0,0,0,0,0
109,公立,一般大學,0009,國立中山大學,碩士班(日間),緬甸,東協,1,0,1,1,0,1,0,0,0,0,0,0,0,0,0
109,公立,一般大學,0009,國立中山大學,碩士班(日間),澳門,港澳,4,2,2,0,0,0,0,0,0,4,2,2,0,0,0
109,公立,一般大學,0009,國立中山大學,碩士班(日間),諾魯共和國,其他亞洲地區,1,0,1,1,0,1,0,0,0,0,0,0,0,0,0
109,公立,一般大學,0009,國立中山大學,碩士班(日間),土耳其共和國,其他亞洲地區,1,1,0,1,1,0,0,0,0,0,0,0,0,0,0
109,公立,一般大學,0009,國立中山大學,碩士班(日間),大韓民國(南韓),其他亞洲地區,3,2,1,3,2,1,0,0,0,0,0,0,0,0,0
109,公立,一般大學,0009,國立中山大學,碩士班(日間),巴拉圭,中南美洲,1,1,0,1,1,0,0,0,0,0,0,0,0,0,0
109,公立,一般大學,0009,國立中山大學,碩士班(日間),以色列,其他亞洲地區,1,1,0,1,1,0,0,0,0,0,0,0,0,0,0
109,公立,一般大學,0009,國立中山大學,碩士班(日間),加拿大,北美洲,3,3,0,3,3,0,0,0,0,0,0,0,0,0,0
109,公立,一般大學,0009,國立中山大學,碩士班(日間),白俄羅斯共和國,其他亞洲地區,1,0,1,1,0,1,0,0,0,0,0,0,0,0,0
109,公立,一般大學,0009,國立中山大學,碩士班(日間),匈牙利共和國,歐洲,1,0,1,1,0,1,0,0,0,0,0,0,0,0,0
109,公立,一般大學,0009,國立中山大學,碩士班(日間),印度尼西亞共和國,東協,10,6,4,9,5,4,1,1,0,0,0,0,0,0,0
109,公立,一般大學,0009,國立中山大學,碩士班(日間),多明尼加共和國,中南美洲,1,0,1,1,0,1,0,0,0,0,0,0,0,0,0
109,公立,一般大學,0009,國立中山大學,碩士班(日間),法國,歐洲,8,2,6,8,2,6,0,0,0,0,0,0,0,0,0
109,公立,一般大學,0009,國立中山大學,碩士班(日間),俄羅斯聯邦,其他亞洲地區,8,6,2,8,6,2,0,0,0,0,0,0,0,0,0
109,公立,一般大學,0009,國立中山大學,碩士班(日間),南非共和國,非洲,1,1,0,1,1,0,0,0,0,0,0,0,0,0,0
109,公立,一般大學,0009,國立中山大學,碩士班(日間),美國,北美洲,13,10,3,12,9,3,1,1,0,0,0,0,0,0,0
109,公立,一般大學,0009,國立中山大學,碩士班(日間),英國,歐洲,2,2,0,2,2,0,0,0,0,0,0,0,0,0,0
109,公立,一般大學,0009,國立中山大學,碩士班(日間),埃及阿拉伯共和國,非洲,1,0,1,1,0,1,0,0,0,0,0,0,0,0,0
109,公立,一般大學,0009,國立中山大學,碩士班(日間),泰國,東協,7,4,3,7,4,3,0,0,0,0,0,0,0,0,0
109,公立,一般大學,0009,國立中山大學,碩士班(日間),秘魯共和國,中南美洲,1,0,1,1,0,1,0,0,0,0,0,0,0,0,0
109,公立,一般大學,0009,國立中山大學,碩士班(日間),索羅門群島,其他亞洲地區,1,1,0,1,1,0,0,0,0,0,0,0,0,0,0
109,公立,一般大學,0009,國立中山大學,碩士班(日間),馬來西亞,東協,16,9,7,3,1,2,13,8,5,0,0,0,0,0,0
109,公立,一般大學,0009,國立中山大學,碩士班(日間),捷克共和國,歐洲,4,3,1,4,3,1,0,0,0,0,0,0,0,0,0
109,公立,一般大學,0009,國立中山大學,碩士班(日間),菲律賓共和國,東協,8,5,3,8,5,3,0,0,0,0,0,0,0,0,0
109,公立,一般大學,0009,國立中山大學,碩士班(日間),越南社會主義共和國,東協,17,3,14,16,2,14,1,1,0,0,0,0,0,0,0
109,公立,一般大學,0009,國立中山大學,碩士班(日間),奧地利共和國,歐洲,8,2,6,8,2,6,0,0,0,0,0,0,0,0,0
109,公立,一般大學,0009,國立中山大學,碩士班(日間),蒙古國,其他亞洲地區,1,0,1,1,0,1,0,0,0,0,0,0,0,0,0
109,公立,一般大學,0009,國立中山大學,博士班,大陸地區,大陸地區,13,6,7,0,0,0,0,0,0,0,0,0,13,6,7
109,公立,一般大學,0009,國立中山大學,博士班,大韓民國(南韓),其他亞洲地區,1,0,1,1,0,1,0,0,0,0,0,0,0,0,0
109,公立,一般大學,0009,國立中山大學,博士班,巴基斯坦,南亞,1,1,0,1,1,0,0,0,0,0,0,0,0,0,0
109,公立,一般大學,0009,國立中山大學,博士班,加拿大,北美洲,2,2,0,2,2,0,0,0,0,0,0,0,0,0,0
109,公立,一般大學,0009,國立中山大學,博士班,伊朗伊斯蘭共和國,其他亞洲地區,4,1,3,4,1,3,0,0,0,0,0,0,0,0,0
109,公立,一般大學,0009,國立中山大學,博士班,印度,南亞,34,22,12,34,22,12,0,0,0,0,0,0,0,0,0
109,公立,一般大學,0009,國立中山大學,博士班,南非共和國,非洲,1,1,0,1,1,0,0,0,0,0,0,0,0,0,0
109,公立,一般大學,0009,國立中山大學,博士班,英國,歐洲,1,1,0,1,1,0,0,0,0,0,0,0,0,0,0
109,公立,一般大學,0009,國立中山大學,博士班,香港,港澳,2,1,1,0,0,0,0,0,0,2,1,1,0,0,0
109,公立,一般大學,0009,國立中山大學,博士班,剛果共和國,非洲,1,1,0,1,1,0,0,0,0,0,0,0,0,0,0
109,公立,一般大學,0009,國立中山大學,博士班,烏克蘭,其他亞洲地區,1,0,1,1,0,1,0,0,0,0,0,0,0,0,0
109,公立,一般大學,0009,國立中山大學,博士班,馬來西亞,東協,7,3,4,6,2,4,1,1,0,0,0,0,0,0,0
109,公立,一般大學,0009,國立中山大學,博士班,捷克共和國,歐洲,1,1,0,1,1,0,0,0,0,0,0,0,0,0,0
109,公立,一般大學,0009,國立中山大學,博士班,斯里蘭卡民主社會主義共和國,南亞,7,5,2,7,5,2,0,0,0,0,0,0,0,0,0
109,公立,一般大學,0009,國立中山大學,博士班,新加坡共和國,東協,1,1,0,0,0,0,1,1,0,0,0,0,0,0,0
109,公立,一般大學,0009,國立中山大學,博士班,義大利共和國,歐洲,1,1,0,1,1,0,0,0,0,0,0,0,0,0,0
109,公立,一般大學,0009,國立中山大學,博士班,土耳其共和國,其他亞洲地區,1,1,0,1,1,0,0,0,0,0,0,0,0,0,0
109,公立,一般大學,0009,國立中山大學,博士班,土庫曼,其他亞洲地區,4,1,3,4,1,3,0,0,0,0,0,0,0,0,0
109,公立,一般大學,0009,國立中山大學,博士班,牙買加,中南美洲,1,0,1,1,0,1,0,0,0,0,0,0,0,0,0
109,公立,一般大學,0009,國立中山大學,博士班,印度尼西亞共和國,東協,29,16,13,29,16,13,0,0,0,0,0,0,0,0,0
109,公立,一般大學,0009,國立中山大學,博士班,俄羅斯聯邦,其他亞洲地區,1,1,0,1,1,0,0,0,0,0,0,0,0,0,0
109,公立,一般大學,0009,國立中山大學,博士班,美國,北美洲,5,3,2,4,3,1,1,0,1,0,0,0,0,0,0
109,公立,一般大學,0009,國立中山大學,博士班,哥倫比亞共和國,中南美洲,1,0,1,1,0,1,0,0,0,0,0,0,0,0,0
109,公立,一般大學,0009,國立中山大學,博士班,埃及阿拉伯共和國,非洲,5,4,1,5,4,1,0,0,0,0,0,0,0,0,0
109,公立,一般大學,0009,國立中山大學,博士班,泰國,東協,6,3,3,6,3,3,0,0,0,0,0,0,0,0,0
109,公立,一般大學,0009,國立中山大學,博士班,納米比亞共和國,非洲,1,1,0,1,1,0,0,0,0,0,0,0,0,0,0
109,公立,一般大學,0009,國立中山大學,博士班,菲律賓共和國,東協,21,15,6,21,15,6,0,0,0,0,0,0,0,0,0
109,公立,一般大學,0009,國立中山大學,博士班,越南社會主義共和國,東協,18,10,8,18,10,8,0,0,0,0,0,0,0,0,0
109,公立,一般大學,0009,國立中山大學,博士班,德意志聯邦共和國,歐洲,2,2,0,2,2,0,0,0,0,0,0,0,0,0,0
109,公立,一般大學,0009,國立中山大學,博士班,澳門,港澳,1,1,0,0,0,0,0,0,0,1,1,0,0,0,0
109,公立,一般大學,0012,國立臺灣海洋大學,學士班(日間),巴拿馬共和國,中南美洲,1,0,1,1,0,1,0,0,0,0,0,0,0,0,0
109,公立,一般大學,0012,國立臺灣海洋大學,學士班(日間),瓜地馬拉共和國,中南美洲,1,0,1,1,0,1,0,0,0,0,0,0,0,0,0
109,公立,一般大學,0012,國立臺灣海洋大學,學士班(日間),美國,北美洲,1,1,0,1,1,0,0,0,0,0,0,0,0,0,0
109,公立,一般大學,0012,國立臺灣海洋大學,學士班(日間),香港,港澳,78,61,17,0,0,0,0,0,0,78,61,17,0,0,0
109,公立,一般大學,0012,國立臺灣海洋大學,學士班(日間),越南社會主義共和國,東協,8,4,4,2,1,1,6,3,3,0,0,0,0,0,0
109,公立,一般大學,0012,國立臺灣海洋大學,學士班(日間),緬甸,東協,24,19,5,0,0,0,24,19,5,0,0,0,0,0,0
109,公立,一般大學,0012,國立臺灣海洋大學,學士班(日間),澳門,港澳,20,17,3,0,0,0,0,0,0,20,17,3,0,0,0
109,公立,一般大學,0012,國立臺灣海洋大學,學士班(日間),大陸地區,大陸地區,9,7,2,0,0,0,0,0,0,0,0,0,9,7,2
109,公立,一般大學,0012,國立臺灣海洋大學,學士班(日間),大韓民國(南韓),其他亞洲地區,1,1,0,0,0,0,1,1,0,0,0,0,0,0,0
109,公立,一般大學,0012,國立臺灣海洋大學,學士班(日間),日本,其他亞洲地區,2,1,1,2,1,1,0,0,0,0,0,0,0,0,0
109,公立,一般大學,0012,國立臺灣海洋大學,學士班(日間),印度尼西亞共和國,東協,91,47,44,7,4,3,84,43,41,0,0,0,0,0,0
109,公立,一般大學,0012,國立臺灣海洋大學,學士班(日間),多明尼加共和國,中南美洲,1,0,1,0,0,0,1,0,1,0,0,0,0,0,0
109,公立,一般大學,0012,國立臺灣海洋大學,學士班(日間),俄羅斯聯邦,其他亞洲地區,1,0,1,1,0,1,0,0,0,0,0,0,0,0,0
109,公立,一般大學,0012,國立臺灣海洋大學,學士班(日間),南非共和國,非洲,1,1,0,0,0,0,1,1,0,0,0,0,0,0,0
109,公立,一般大學,0012,國立臺灣海洋大學,學士班(日間),馬來西亞,東協,191,136,55,16,15,1,175,121,54,0,0,0,0,0,0
109,公立,一般大學,0012,國立臺灣海洋大學,學士班(日間),菲律賓共和國,東協,1,1,0,0,0,0,1,1,0,0,0,0,0,0,0
109,公立,一般大學,0012,國立臺灣海洋大學,學士班(日間),新加坡共和國,東協,1,0,1,0,0,0,1,0,1,0,0,0,0,0,0
109,公立,一般大學,0012,國立臺灣海洋大學,碩士班(日間),土耳其共和國,其他亞洲地區,1,1,0,1,1,0,0,0,0,0,0,0,0,0,0
109,公立,一般大學,0012,國立臺灣海洋大學,碩士班(日間),大陸地區,大陸地區,3,1,2,0,0,0,0,0,0,0,0,0,3,1,2
109,公立,一般大學,0012,國立臺灣海洋大學,碩士班(日間),布吉納法索,非洲,1,1,0,1,1,0,0,0,0,0,0,0,0,0,0
109,公立,一般大學,0012,國立臺灣海洋大學,碩士班(日間),印度,南亞,1,1,0,1,1,0,0,0,0,0,0,0,0,0,0
109,公立,一般大學,0012,國立臺灣海洋大學,碩士班(日間),印度尼西亞共和國,東協,17,4,13,11,3,8,6,1,5,0,0,0,0,0,0
109,公立,一般大學,0012,國立臺灣海洋大學,碩士班(日間),宏都拉斯共和國,中南美洲,1,1,0,1,1,0,0,0,0,0,0,0,0,0,0
109,公立,一般大學,0012,國立臺灣海洋大學,碩士班(日間),馬來西亞,東協,19,6,13,6,2,4,13,4,9,0,0,0,0,0,0
109,公立,一般大學,0012,國立臺灣海洋大學,碩士班(日間),斐濟群島共和國,其他亞洲地區,2,0,2,2,0,2,0,0,0,0,0,0,0,0,0
109,公立,一般大學,0012,國立臺灣海洋大學,碩士班(日間),菲律賓共和國,東協,5,4,1,5,4,1,0,0,0,0,0,0,0,0,0
109,公立,一般大學,0012,國立臺灣海洋大學,碩士班(日間),聖文森(及格瑞那丁),中南美洲,1,0,1,1,0,1,0,0,0,0,0,0,0,0,0
109,公立,一般大學,0012,國立臺灣海洋大學,碩士班(日間),澳大利亞,其他亞洲地區,1,1,0,1,1,0,0,0,0,0,0,0,0,0,0
109,公立,一般大學,0012,國立臺灣海洋大學,碩士班(日間),日本,其他亞洲地區,1,1,0,1,1,0,0,0,0,0,0,0,0,0,0
109,公立,一般大學,0012,國立臺灣海洋大學,碩士班(日間),貝里斯,中南美洲,1,0,1,1,0,1,0,0,0,0,0,0,0,0,0
109,公立,一般大學,0012,國立臺灣海洋大學,碩士班(日間),香港,港澳,7,5,2,0,0,0,0,0,0,7,5,2,0,0,0
109,公立,一般大學,0012,國立臺灣海洋大學,碩士班(日間),泰國,東協,1,1,0,1,1,0,0,0,0,0,0,0,0,0,0
109,公立,一般大學,0012,國立臺灣海洋大學,碩士班(日間),海地共和國,中南美洲,2,2,0,2,2,0,0,0,0,0,0,0,0,0,0
109,公立,一般大學,0012,國立臺灣海洋大學,碩士班(日間),越南社會主義共和國,東協,4,2,2,3,1,2,1,1,0,0,0,0,0,0,0
109,公立,一般大學,0012,國立臺灣海洋大學,碩士班(日間),澳門,港澳,3,3,0,0,0,0,0,0,0,3,3,0,0,0,0
109,公立,一般大學,0012,國立臺灣海洋大學,博士班,泰國,東協,1,1,0,1,1,0,0,0,0,0,0,0,0,0,0
109,公立,一般大學,0012,國立臺灣海洋大學,博士班,馬來西亞,東協,3,1,2,2,1,1,1,0,1,0,0,0,0,0,0
109,公立,一般大學,0012,國立臺灣海洋大學,博士班,菲律賓共和國,東協,4,2,2,4,2,2,0,0,0,0,0,0,0,0,0
109,公立,一般大學,0012,國立臺灣海洋大學,博士班,越南社會主義共和國,東協,5,4,1,5,4,1,0,0,0,0,0,0,0,0,0
109,公立,一般大學,0012,國立臺灣海洋大學,博士班,德意志聯邦共和國,歐洲,1,1,0,1,1,0,0,0,0,0,0,0,0,0,0
109,公立,一般大學,0012,國立臺灣海洋大學,博士班,大陸地區,大陸地區,8,4,4,0,0,0,0,0,0,0,0,0,8,4,4
109,公立,一般大學,0012,國立臺灣海洋大學,博士班,大韓民國(南韓),其他亞洲地區,2,0,2,2,0,2,0,0,0,0,0,0,0,0,0
109,公立,一般大學,0012,國立臺灣海洋大學,博士班,加拿大,北美洲,1,1,0,1,1,0,0,0,0,0,0,0,0,0,0
109,公立,一般大學,0012,國立臺灣海洋大學,博士班,印度,南亞,7,3,4,7,3,4,0,0,0,0,0,0,0,0,0
109,公立,一般大學,0012,國立臺灣海洋大學,博士班,印度尼西亞共和國,東協,13,9,4,13,9,4,0,0,0,0,0,0,0,0,0
109,公立,一般大學,0012,國立臺灣海洋大學,博士班,香港,港澳,2,1,1,0,0,0,0,0,0,2,1,1,0,0,0
109,公立,一般大學,0012,國立臺灣海洋大學,博士班,海地共和國,中南美洲,1,1,0,1,1,0,0,0,0,0,0,0,0,0,0
109,公立,一般大學,0013,國立中正大學,學士班(日間),大陸地區,大陸地區,9,5,4,0,0,0,0,0,0,0,0,0,9,5,4
109,公立,一般大學,0013,國立中正大學,學士班(日間),印度尼西亞共和國,東協,38,17,21,1,1,0,37,16,21,0,0,0,0,0,0
109,公立,一般大學,0013,國立中正大學,學士班(日間),香港,港澳,43,34,9,0,0,0,0,0,0,43,34,9,0,0,0
109,公立,一般大學,0013,國立中正大學,學士班(日間),越南社會主義共和國,東協,8,4,4,5,2,3,3,2,1,0,0,0,0,0,0
109,公立,一般大學,0013,國立中正大學,學士班(日間),摩洛哥王國,非洲,1,1,0,1,1,0,0,0,0,0,0,0,0,0,0
109,公立,一般大學,0013,國立中正大學,學士班(日間),緬甸,東協,4,2,2,0,0,0,4,2,2,0,0,0,0,0,0
109,公立,一般大學,0013,國立中正大學,學士班(日間),澳門,港澳,32,24,8,0,0,0,0,0,0,32,24,8,0,0,0
109,公立,一般大學,0013,國立中正大學,學士班(日間),大韓民國(南韓),其他亞洲地區,1,1,0,0,0,0,1,1,0,0,0,0,0,0,0
109,公立,一般大學,0013,國立中正大學,學士班(日間),日本,其他亞洲地區,12,4,8,10,2,8,2,2,0,0,0,0,0,0,0
109,公立,一般大學,0013,國立中正大學,學士班(日間),俄羅斯聯邦,其他亞洲地區,7,1,6,7,1,6,0,0,0,0,0,0,0,0,0
109,公立,一般大學,0013,國立中正大學,學士班(日間),馬來西亞,東協,90,46,44,7,4,3,83,42,41,0,0,0,0,0,0
109,公立,一般大學,0013,國立中正大學,學士班(日間),新加坡共和國,東協,1,0,1,0,0,0,1,0,1,0,0,0,0,0,0
109,公立,一般大學,0013,國立中正大學,碩士班(日間),大韓民國(南韓),其他亞洲地區,1,0,1,1,0,1,0,0,0,0,0,0,0,0,0
109,公立,一般大學,0013,國立中正大學,碩士班(日間),巴基斯坦,南亞,2,2,0,2,2,0,0,0,0,0,0,0,0,0,0
109,公立,一般大學,0013,國立中正大學,碩士班(日間),日本,其他亞洲地區,1,0,1,1,0,1,0,0,0,0,0,0,0,0,0
109,公立,一般大學,0013,國立中正大學,碩士班(日間),印度,南亞,15,12,3,15,12,3,0,0,0,0,0,0,0,0,0
109,公立,一般大學,0013,國立中正大學,碩士班(日間),柬埔寨王國,東協,2,2,0,2,2,0,0,0,0,0,0,0,0,0,0
109,公立,一般大學,0013,國立中正大學,碩士班(日間),美國,北美洲,1,1,0,1,1,0,0,0,0,0,0,0,0,0,0
109,公立,一般大學,0013,國立中正大學,碩士班(日間),馬來西亞,東協,10,4,6,5,1,4,5,3,2,0,0,0,0,0,0
109,公立,一般大學,0013,國立中正大學,碩士班(日間),菲律賓共和國,東協,2,0,2,2,0,2,0,0,0,0,0,0,0,0,0
109,公立,一般大學,0013,國立中正大學,碩士班(日間),大陸地區,大陸地區,6,4,2,0,0,0,0,0,0,0,0,0,6,4,2
109,公立,一般大學,0013,國立中正大學,碩士班(日間),巴西聯邦共和國,中南美洲,1,0,1,1,0,1,0,0,0,0,0,0,0,0,0
109,公立,一般大學,0013,國立中正大學,碩士班(日間),甘比亞共和國,非洲,1,1,0,1,1,0,0,0,0,0,0,0,0,0,0
109,公立,一般大學,0013,國立中正大學,碩士班(日間),印度尼西亞共和國,東協,14,6,8,14,6,8,0,0,0,0,0,0,0,0,0
109,公立,一般大學,0013,國立中正大學,碩士班(日間),宏都拉斯共和國,中南美洲,3,1,2,3,1,2,0,0,0,0,0,0,0,0,0
109,公立,一般大學,0013,國立中正大學,碩士班(日間),貝里斯,中南美洲,3,1,2,3,1,2,0,0,0,0,0,0,0,0,0
109,公立,一般大學,0013,國立中正大學,碩士班(日間),孟加拉人民共和國,南亞,1,1,0,1,1,0,0,0,0,0,0,0,0,0,0
109,公立,一般大學,0013,國立中正大學,碩士班(日間),南非共和國,非洲,2,1,1,2,1,1,0,0,0,0,0,0,0,0,0
109,公立,一般大學,0013,國立中正大學,碩士班(日間),香港,港澳,6,3,3,0,0,0,0,0,0,6,3,3,0,0,0
109,公立,一般大學,0013,國立中正大學,碩士班(日間),哥倫比亞共和國,中南美洲,2,2,0,2,2,0,0,0,0,0,0,0,0,0,0
109,公立,一般大學,0013,國立中正大學,碩士班(日間),泰國,東協,9,3,6,9,3,6,0,0,0,0,0,0,0,0,0
109,公立,一般大學,0013,國立中正大學,碩士班(日間),海地共和國,中南美洲,1,1,0,1,1,0,0,0,0,0,0,0,0,0,0
109,公立,一般大學,0013,國立中正大學,碩士班(日間),烏干達共和國,非洲,1,1,0,1,1,0,0,0,0,0,0,0,0,0,0
109,公立,一般大學,0013,國立中正大學,碩士班(日間),越南社會主義共和國,東協,17,6,11,17,6,11,0,0,0,0,0,0,0,0,0
109,公立,一般大學,0013,國立中正大學,碩士班(日間),聖露西亞,中南美洲,1,1,0,1,1,0,0,0,0,0,0,0,0,0,0
109,公立,一般大學,0013,國立中正大學,碩士班(日間),蒙古國,其他亞洲地區,2,1,1,2,1,1,0,0,0,0,0,0,0,0,0
109,公立,一般大學,0013,國立中正大學,碩士班(日間),緬甸,東協,1,0,1,1,0,1,0,0,0,0,0,0,0,0,0
109,公立,一般大學,0013,國立中正大學,碩士班(日間),墨西哥合眾國,中南美洲,1,0,1,1,0,1,0,0,0,0,0,0,0,0,0
109,公立,一般大學,0013,國立中正大學,碩士班(日間),澳大利亞,其他亞洲地區,1,1,0,1,1,0,0,0,0,0,0,0,0,0,0
109,公立,一般大學,0013,國立中正大學,碩士班(日間),澳門,港澳,1,0,1,0,0,0,0,0,0,1,0,1,0,0,0
109,公立,一般大學,0013,國立中正大學,博士班,巴基斯坦,南亞,3,3,0,3,3,0,0,0,0,0,0,0,0,0,0
109,公立,一般大學,0013,國立中正大學,博士班,甘比亞共和國,非洲,1,1,0,1,1,0,0,0,0,0,0,0,0,0,0
109,公立,一般大學,0013,國立中正大學,博士班,泰國,東協,3,2,1,3,2,1,0,0,0,0,0,0,0,0,0
109,公立,一般大學,0013,國立中正大學,博士班,義大利共和國,歐洲,1,0,1,1,0,1,0,0,0,0,0,0,0,0,0
109,公立,一般大學,0013,國立中正大學,博士班,大陸地區,大陸地區,10,7,3,0,0,0,0,0,0,0,0,0,10,7,3
109,公立,一般大學,0013,國立中正大學,博士班,布吉納法索,非洲,1,1,0,1,1,0,0,0,0,0,0,0,0,0,0
109,公立,一般大學,0013,國立中正大學,博士班,伊朗伊斯蘭共和國,其他亞洲地區,1,1,0,1,1,0,0,0,0,0,0,0,0,0,0
109,公立,一般大學,0013,國立中正大學,博士班,印度,南亞,14,8,6,14,8,6,0,0,0,0,0,0,0,0,0
109,公立,一般大學,0013,國立中正大學,博士班,印度尼西亞共和國,東協,11,6,5,11,6,5,0,0,0,0,0,0,0,0,0
109,公立,一般大學,0013,國立中正大學,博士班,貝里斯,中南美洲,2,1,1,2,1,1,0,0,0,0,0,0,0,0,0
109,公立,一般大學,0013,國立中正大學,博士班,柬埔寨王國,東協,1,1,0,1,1,0,0,0,0,0,0,0,0,0,0
109,公立,一般大學,0013,國立中正大學,博士班,香港,港澳,3,3,0,0,0,0,0,0,0,3,3,0,0,0,0
109,公立,一般大學,0013,國立中正大學,博士班,馬來西亞,東協,7,5,2,5,3,2,2,2,0,0,0,0,0,0,0
109,公立,一般大學,0013,國立中正大學,博士班,越南社會主義共和國,東協,23,12,11,23,12,11,0,0,0,0,0,0,0,0,0
109,公立,一般大學,0013,國立中正大學,博士班,澳門,港澳,3,3,0,0,0,0,0,0,0,3,3,0,0,0,0
109,公立,一般大學,0014,國立高雄師範大學,學士班(日間),日本,其他亞洲地區,5,0,5,3,0,3,2,0,2,0,0,0,0,0,0
109,公立,一般大學,0014,國立高雄師範大學,學士班(日間),印度尼西亞共和國,東協,7,2,5,0,0,0,7,2,5,0,0,0,0,0,0
109,公立,一般大學,0014,國立高雄師範大學,學士班(日間),阿根廷,中南美洲,2,1,1,0,0,0,2,1,1,0,0,0,0,0,0
109,公立,一般大學,0014,國立高雄師範大學,學士班(日間),泰國,東協,1,1,0,1,1,0,0,0,0,0,0,0,0,0,0
109,公立,一般大學,0014,國立高雄師範大學,學士班(日間),越南社會主義共和國,東協,10,0,10,9,0,9,1,0,1,0,0,0,0,0,0
109,公立,一般大學,0014,國立高雄師範大學,學士班(日間),澳門,港澳,31,20,11,0,0,0,0,0,0,31,20,11,0,0,0
109,公立,一般大學,0014,國立高雄師範大學,學士班(日間),大陸地區,大陸地區,10,3,7,0,0,0,0,0,0,0,0,0,10,3,7
109,公立,一般大學,0014,國立高雄師範大學,學士班(日間),美國,北美洲,1,1,0,1,1,0,0,0,0,0,0,0,0,0,0
109,公立,一般大學,0014,國立高雄師範大學,學士班(日間),香港,港澳,10,4,6,0,0,0,0,0,0,10,4,6,0,0,0
109,公立,一般大學,0014,國立高雄師範大學,學士班(日間),馬來西亞,東協,33,11,22,2,1,1,31,10,21,0,0,0,0,0,0
109,公立,一般大學,0014,國立高雄師範大學,碩士班(日間),大韓民國(南韓),其他亞洲地區,1,0,1,1,0,1,0,0,0,0,0,0,0,0,0
109,公立,一般大學,0014,國立高雄師範大學,碩士班(日間),美國,北美洲,2,2,0,2,2,0,0,0,0,0,0,0,0,0,0
109,公立,一般大學,0014,國立高雄師範大學,碩士班(日間),大陸地區,大陸地區,10,5,5,0,0,0,0,0,0,0,0,0,10,5,5
109,公立,一般大學,0014,國立高雄師範大學,碩士班(日間),日本,其他亞洲地區,4,2,2,4,2,2,0,0,0,0,0,0,0,0,0
109,公立,一般大學,0014,國立高雄師範大學,碩士班(日間),加拿大,北美洲,1,0,1,0,0,0,1,0,1,0,0,0,0,0,0
109,公立,一般大學,0014,國立高雄師範大學,碩士班(日間),匈牙利共和國,歐洲,1,1,0,1,1,0,0,0,0,0,0,0,0,0,0
109,公立,一般大學,0014,國立高雄師範大學,碩士班(日間),印度尼西亞共和國,東協,2,2,0,1,1,0,1,1,0,0,0,0,0,0,0
109,公立,一般大學,0014,國立高雄師範大學,碩士班(日間),波蘭共和國,歐洲,1,0,1,1,0,1,0,0,0,0,0,0,0,0,0
109,公立,一般大學,0014,國立高雄師範大學,碩士班(日間),香港,港澳,5,1,4,0,0,0,0,0,0,5,1,4,0,0,0
109,公立,一般大學,0014,國立高雄師範大學,碩士班(日間),埃及阿拉伯共和國,非洲,1,1,0,1,1,0,0,0,0,0,0,0,0,0,0
109,公立,一般大學,0014,國立高雄師範大學,碩士班(日間),泰國,東協,3,1,2,2,0,2,1,1,0,0,0,0,0,0,0
109,公立,一般大學,0014,國立高雄師範大學,碩士班(日間),馬來西亞,東協,9,0,9,2,0,2,7,0,7,0,0,0,0,0,0
109,公立,一般大學,0014,國立高雄師範大學,碩士班(日間),越南社會主義共和國,東協,4,0,4,4,0,4,0,0,0,0,0,0,0,0,0
109,公立,一般大學,0014,國立高雄師範大學,碩士班(日間),澳門,港澳,6,1,5,0,0,0,0,0,0,6,1,5,0,0,0
109,公立,一般大學,0014,國立高雄師範大學,博士班,大陸地區,大陸地區,10,5,5,0,0,0,0,0,0,0,0,0,10,5,5
109,公立,一般大學,0014,國立高雄師範大學,博士班,南非共和國,非洲,1,1,0,1,1,0,0,0,0,0,0,0,0,0,0
109,公立,一般大學,0014,國立高雄師範大學,博士班,越南社會主義共和國,東協,3,2,1,3,2,1,0,0,0,0,0,0,0,0,0
109,公立,一般大學,0014,國立高雄師範大學,博士班,蒙古國,其他亞洲地區,1,0,1,1,0,1,0,0,0,0,0,0,0,0,0
109,公立,一般大學,0014,國立高雄師範大學,博士班,德意志聯邦共和國,歐洲,1,1,0,1,1,0,0,0,0,0,0,0,0,0,0
109,公立,一般大學,0014,國立高雄師範大學,博士班,澳門,港澳,2,2,0,0,0,0,0,0,0,2,2,0,0,0,0
109,公立,一般大學,0014,國立高雄師範大學,博士班,大韓民國(南韓),其他亞洲地區,2,0,2,2,0,2,0,0,0,0,0,0,0,0,0
109,公立,一般大學,0014,國立高雄師範大學,博士班,英國,歐洲,1,1,0,1,1,0,0,0,0,0,0,0,0,0,0
109,公立,一般大學,0015,國立彰化師範大學,學士班(日間),大陸地區,大陸地區,11,6,5,0,0,0,0,0,0,0,0,0,11,6,5
109,公立,一般大學,0015,國立彰化師範大學,學士班(日間),香港,港澳,42,27,15,0,0,0,0,0,0,42,27,15,0,0,0
109,公立,一般大學,0015,國立彰化師範大學,學士班(日間),越南社會主義共和國,東協,13,6,7,8,2,6,5,4,1,0,0,0,0,0,0
109,公立,一般大學,0015,國立彰化師範大學,學士班(日間),澳門,港澳,57,23,34,0,0,0,0,0,0,57,23,34,0,0,0
109,公立,一般大學,0015,國立彰化師範大學,學士班(日間),日本,其他亞洲地區,5,3,2,5,3,2,0,0,0,0,0,0,0,0,0
109,公立,一般大學,0015,國立彰化師範大學,學士班(日間),印度尼西亞共和國,東協,1,0,1,0,0,0,1,0,1,0,0,0,0,0,0
109,公立,一般大學,0015,國立彰化師範大學,學士班(日間),南非共和國,非洲,1,1,0,1,1,0,0,0,0,0,0,0,0,0,0
109,公立,一般大學,0015,國立彰化師範大學,學士班(日間),馬來西亞,東協,117,47,70,11,1,10,106,46,60,0,0,0,0,0,0
109,公立,一般大學,0015,國立彰化師範大學,學士班(日間),菲律賓共和國,東協,2,0,2,0,0,0,2,0,2,0,0,0,0,0,0
109,公立,一般大學,0015,國立彰化師範大學,碩士班(日間),馬來西亞,東協,16,5,11,9,2,7,7,3,4,0,0,0,0,0,0
109,公立,一般大學,0015,國立彰化師範大學,碩士班(日間),菲律賓共和國,東協,1,0,1,0,0,0,1,0,1,0,0,0,0,0,0
109,公立,一般大學,0015,國立彰化師範大學,碩士班(日間),大陸地區,大陸地區,4,0,4,0,0,0,0,0,0,0,0,0,4,0,4
109,公立,一般大學,0015,國立彰化師範大學,碩士班(日間),美國,北美洲,1,1,0,1,1,0,0,0,0,0,0,0,0,0,0
109,公立,一般大學,0015,國立彰化師範大學,碩士班(日間),香港,港澳,4,3,1,0,0,0,0,0,0,4,3,1,0,0,0
109,公立,一般大學,0015,國立彰化師範大學,碩士班(日間),泰國,東協,1,1,0,0,0,0,1,1,0,0,0,0,0,0,0
109,公立,一般大學,0015,國立彰化師範大學,碩士班(日間),新加坡共和國,東協,1,1,0,0,0,0,1,1,0,0,0,0,0,0,0
109,公立,一般大學,0015,國立彰化師範大學,碩士班(日間),澳門,港澳,6,3,3,0,0,0,0,0,0,6,3,3,0,0,0
109,公立,一般大學,0015,國立彰化師範大學,博士班,馬來西亞,東協,3,0,3,2,0,2,1,0,1,0,0,0,0,0,0
109,公立,一般大學,0015,國立彰化師範大學,博士班,大陸地區,大陸地區,15,5,10,0,0,0,0,0,0,0,0,0,15,5,10
109,公立,一般大學,0015,國立彰化師範大學,博士班,印度,南亞,6,5,1,6,5,1,0,0,0,0,0,0,0,0,0
109,公立,一般大學,0015,國立彰化師範大學,博士班,英國,歐洲,1,1,0,1,1,0,0,0,0,0,0,0,0,0,0
109,公立,一般大學,0015,國立彰化師範大學,博士班,香港,港澳,1,1,0,0,0,0,0,0,0,1,1,0,0,0,0
109,公立,一般大學,0015,國立彰化師範大學,博士班,越南社會主義共和國,東協,3,3,0,3,3,0,0,0,0,0,0,0,0,0,0
109,公立,一般大學,0015,國立彰化師範大學,博士班,新加坡共和國,東協,1,1,0,1,1,0,0,0,0,0,0,0,0,0,0
109,公立,一般大學,0015,國立彰化師範大學,博士班,蒙古國,其他亞洲地區,1,0,1,1,0,1,0,0,0,0,0,0,0,0,0
109,公立,一般大學,0016,國立陽明大學,學士班(日間),巴拉圭,中南美洲,3,0,3,2,0,2,1,0,1,0,0,0,0,0,0
109,公立,一般大學,0016,國立陽明大學,學士班(日間),美國,北美洲,7,4,3,2,1,1,5,3,2,0,0,0,0,0,0
109,公立,一般大學,0016,國立陽明大學,學士班(日間),泰國,東協,2,1,1,0,0,0,2,1,1,0,0,0,0,0,0
109,公立,一般大學,0016,國立陽明大學,學士班(日間),菲律賓共和國,東協,2,1,1,2,1,1,0,0,0,0,0,0,0,0,0
109,公立,一般大學,0016,國立陽明大學,學士班(日間),越南社會主義共和國,東協,1,0,1,0,0,0,1,0,1,0,0,0,0,0,0
109,公立,一般大學,0016,國立陽明大學,學士班(日間),大陸地區,大陸地區,10,5,5,0,0,0,0,0,0,0,0,0,10,5,5
109,公立,一般大學,0016,國立陽明大學,學士班(日間),大韓民國(南韓),其他亞洲地區,6,3,3,2,1,1,4,2,2,0,0,0,0,0,0
109,公立,一般大學,0016,國立陽明大學,學士班(日間),日本,其他亞洲地區,4,4,0,3,3,0,1,1,0,0,0,0,0,0,0
109,公立,一般大學,0016,國立陽明大學,學士班(日間),加拿大,北美洲,3,2,1,0,0,0,3,2,1,0,0,0,0,0,0
109,公立,一般大學,0016,國立陽明大學,學士班(日間),印度尼西亞共和國,東協,5,3,2,0,0,0,5,3,2,0,0,0,0,0,0
109,公立,一般大學,0016,國立陽明大學,學士班(日間),英國,歐洲,1,0,1,1,0,1,0,0,0,0,0,0,0,0,0
109,公立,一般大學,0016,國立陽明大學,學士班(日間),香港,港澳,21,6,15,0,0,0,0,0,0,21,6,15,0,0,0
109,公立,一般大學,0016,國立陽明大學,學士班(日間),馬來西亞,東協,61,18,43,2,0,2,59,18,41,0,0,0,0,0,0
109,公立,一般大學,0016,國立陽明大學,學士班(日間),新加坡共和國,東協,3,1,2,0,0,0,3,1,2,0,0,0,0,0,0
109,公立,一般大學,0016,國立陽明大學,學士班(日間),聖露西亞,中南美洲,1,0,1,1,0,1,0,0,0,0,0,0,0,0,0
109,公立,一般大學,0016,國立陽明大學,學士班(日間),蒙古國,其他亞洲地區,1,0,1,1,0,1,0,0,0,0,0,0,0,0,0
109,公立,一般大學,0016,國立陽明大學,學士班(日間),緬甸,東協,1,0,1,0,0,0,1,0,1,0,0,0,0,0,0
109,公立,一般大學,0016,國立陽明大學,學士班(日間),澳門,港澳,10,5,5,0,0,0,0,0,0,10,5,5,0,0,0
109,公立,一般大學,0016,國立陽明大學,碩士班(日間),大陸地區,大陸地區,5,3,2,0,0,0,0,0,0,0,0,0,5,3,2
109,公立,一般大學,0016,國立陽明大學,碩士班(日間),伊朗伊斯蘭共和國,其他亞洲地區,1,0,1,1,0,1,0,0,0,0,0,0,0,0,0
109,公立,一般大學,0016,國立陽明大學,碩士班(日間),宏都拉斯共和國,中南美洲,4,1,3,4,1,3,0,0,0,0,0,0,0,0,0
109,公立,一般大學,0016,國立陽明大學,碩士班(日間),貝里斯,中南美洲,4,1,3,4,1,3,0,0,0,0,0,0,0,0,0
109,公立,一般大學,0016,國立陽明大學,碩士班(日間),奈及利亞聯邦共和國,非洲,1,0,1,1,0,1,0,0,0,0,0,0,0,0,0
109,公立,一般大學,0016,國立陽明大學,碩士班(日間),英國,歐洲,1,0,1,1,0,1,0,0,0,0,0,0,0,0,0
109,公立,一般大學,0016,國立陽明大學,碩士班(日間),香港,港澳,1,1,0,0,0,0,0,0,0,1,1,0,0,0,0
109,公立,一般大學,0016,國立陽明大學,碩士班(日間),馬來西亞,東協,16,8,8,6,2,4,10,6,4,0,0,0,0,0,0
109,公立,一般大學,0016,國立陽明大學,碩士班(日間),馬拉威共和國,非洲,1,0,1,1,0,1,0,0,0,0,0,0,0,0,0
109,公立,一般大學,0016,國立陽明大學,碩士班(日間),聖文森(及格瑞那丁),中南美洲,1,1,0,1,1,0,0,0,0,0,0,0,0,0,0
109,公立,一般大學,0016,國立陽明大學,碩士班(日間),巴拉圭,中南美洲,1,1,0,0,0,0,1,1,0,0,0,0,0,0,0
109,公立,一般大學,0016,國立陽明大學,碩士班(日間),史瓦帝尼王國,非洲,4,1,3,4,1,3,0,0,0,0,0,0,0,0,0
109,公立,一般大學,0016,國立陽明大學,碩士班(日間),瓜地馬拉共和國,中南美洲,2,0,2,2,0,2,0,0,0,0,0,0,0,0,0
109,公立,一般大學,0016,國立陽明大學,碩士班(日間),甘比亞共和國,非洲,1,0,1,1,0,1,0,0,0,0,0,0,0,0,0
109,公立,一般大學,0016,國立陽明大學,碩士班(日間),印度尼西亞共和國,東協,1,1,0,1,1,0,0,0,0,0,0,0,0,0,0
109,公立,一般大學,0016,國立陽明大學,碩士班(日間),埃及阿拉伯共和國,非洲,1,0,1,1,0,1,0,0,0,0,0,0,0,0,0
109,公立,一般大學,0016,國立陽明大學,碩士班(日間),菲律賓共和國,東協,5,3,2,4,2,2,1,1,0,0,0,0,0,0,0
109,公立,一般大學,0016,國立陽明大學,碩士班(日間),越南社會主義共和國,東協,31,11,20,30,10,20,1,1,0,0,0,0,0,0,0
109,公立,一般大學,0016,國立陽明大學,碩士班(日間),摩洛哥王國,非洲,1,1,0,1,1,0,0,0,0,0,0,0,0,0,0
109,公立,一般大學,0016,國立陽明大學,碩士班(日間),澳門,港澳,2,1,1,0,0,0,0,0,0,2,1,1,0,0,0
109,公立,一般大學,0016,國立陽明大學,博士班,巴基斯坦,南亞,1,1,0,1,1,0,0,0,0,0,0,0,0,0,0
109,公立,一般大學,0016,國立陽明大學,博士班,尼泊爾聯邦民主共和國,南亞,2,1,1,2,1,1,0,0,0,0,0,0,0,0,0
109,公立,一般大學,0016,國立陽明大學,博士班,匈牙利共和國,歐洲,1,0,1,1,0,1,0,0,0,0,0,0,0,0,0
109,公立,一般大學,0016,國立陽明大學,博士班,衣索比亞聯邦民主共和國,非洲,2,2,0,2,2,0,0,0,0,0,0,0,0,0,0
109,公立,一般大學,0016,國立陽明大學,博士班,貝里斯,中南美洲,2,0,2,2,0,2,0,0,0,0,0,0,0,0,0
109,公立,一般大學,0016,國立陽明大學,博士班,奈及利亞聯邦共和國,非洲,5,4,1,5,4,1,0,0,0,0,0,0,0,0,0
109,公立,一般大學,0016,國立陽明大學,博士班,孟加拉人民共和國,南亞,2,2,0,2,2,0,0,0,0,0,0,0,0,0,0
109,公立,一般大學,0016,國立陽明大學,博士班,法國,歐洲,1,1,0,1,1,0,0,0,0,0,0,0,0,0,0
109,公立,一般大學,0016,國立陽明大學,博士班,阿富汗伊斯蘭共和國,其他亞洲地區,3,1,2,3,1,2,0,0,0,0,0,0,0,0,0
109,公立,一般大學,0016,國立陽明大學,博士班,馬來西亞,東協,10,6,4,7,5,2,3,1,2,0,0,0,0,0,0
109,公立,一般大學,0016,國立陽明大學,博士班,菲律賓共和國,東協,7,5,2,7,5,2,0,0,0,0,0,0,0,0,0
109,公立,一般大學,0016,國立陽明大學,博士班,越南社會主義共和國,東協,15,5,10,15,5,10,0,0,0,0,0,0,0,0,0
109,公立,一般大學,0016,國立陽明大學,博士班,蒙古國,其他亞洲地區,1,1,0,1,1,0,0,0,0,0,0,0,0,0,0
109,公立,一般大學,0016,國立陽明大學,博士班,澳門,港澳,1,0,1,0,0,0,0,0,0,1,0,1,0,0,0
109,公立,一般大學,0016,國立陽明大學,博士班,大陸地區,大陸地區,1,0,1,0,0,0,0,0,0,0,0,0,1,0,1
109,公立,一般大學,0016,國立陽明大學,博士班,日本,其他亞洲地區,1,0,1,1,0,1,0,0,0,0,0,0,0,0,0
109,公立,一般大學,0016,國立陽明大學,博士班,史瓦帝尼王國,非洲,4,3,1,4,3,1,0,0,0,0,0,0,0,0,0
109,公立,一般大學,0016,國立陽明大學,博士班,布吉納法索,非洲,1,1,0,1,1,0,0,0,0,0,0,0,0,0,0
109,公立,一般大學,0016,國立陽明大學,博士班,印度,南亞,15,11,4,15,11,4,0,0,0,0,0,0,0,0,0
109,公立,一般大學,0016,國立陽明大學,博士班,印度尼西亞共和國,東協,7,1,6,7,1,6,0,0,0,0,0,0,0,0,0
109,公立,一般大學,0016,國立陽明大學,博士班,宏都拉斯共和國,中南美洲,1,0,1,1,0,1,0,0,0,0,0,0,0,0,0
109,公立,一般大學,0016,國立陽明大學,博士班,汶萊和平之國,東協,1,1,0,1,1,0,0,0,0,0,0,0,0,0,0
109,公立,一般大學,0016,國立陽明大學,博士班,香港,港澳,1,0,1,0,0,0,0,0,0,1,0,1,0,0,0
109,公立,一般大學,0016,國立陽明大學,博士班,泰國,東協,3,3,0,3,3,0,0,0,0,0,0,0,0,0,0
109,公立,一般大學,0016,國立陽明大學,博士班,瑞士聯邦,歐洲,1,1,0,1,1,0,0,0,0,0,0,0,0,0,0
109,公立,一般大學,0016,國立陽明大學,博士班,墨西哥合眾國,中南美洲,1,0,1,1,0,1,0,0,0,0,0,0,0,0,0
109,公立,一般大學,0017,國立臺北大學,學士班(日間),厄瓜多共和國,中南美洲,1,0,1,0,0,0,1,0,1,0,0,0,0,0,0
109,公立,一般大學,0017,國立臺北大學,學士班(日間),巴西聯邦共和國,中南美洲,1,0,1,0,0,0,1,0,1,0,0,0,0,0,0
109,公立,一般大學,0017,國立臺北大學,學士班(日間),日本,其他亞洲地區,13,7,6,10,6,4,3,1,2,0,0,0,0,0,0
109,公立,一般大學,0017,國立臺北大學,學士班(日間),俄羅斯聯邦,其他亞洲地區,1,1,0,1,1,0,0,0,0,0,0,0,0,0,0
109,公立,一般大學,0017,國立臺北大學,學士班(日間),泰國,東協,1,1,0,0,0,0,1,1,0,0,0,0,0,0,0
109,公立,一般大學,0017,國立臺北大學,學士班(日間),烏克蘭,其他亞洲地區,1,0,1,1,0,1,0,0,0,0,0,0,0,0,0
109,公立,一般大學,0017,國立臺北大學,學士班(日間),新加坡共和國,東協,2,0,2,0,0,0,2,0,2,0,0,0,0,0,0
109,公立,一般大學,0017,國立臺北大學,學士班(日間),蒙古國,其他亞洲地區,2,0,2,2,0,2,0,0,0,0,0,0,0,0,0
109,公立,一般大學,0017,國立臺北大學,學士班(日間),德意志聯邦共和國,歐洲,1,0,1,1,0,1,0,0,0,0,0,0,0,0,0
109,公立,一般大學,0017,國立臺北大學,學士班(日間),大陸地區,大陸地區,14,6,8,0,0,0,0,0,0,0,0,0,14,6,8
109,公立,一般大學,0017,國立臺北大學,學士班(日間),大韓民國(南韓),其他亞洲地區,3,2,1,1,1,0,2,1,1,0,0,0,0,0,0
109,公立,一般大學,0017,國立臺北大學,學士班(日間),巴拉圭,中南美洲,2,0,2,2,0,2,0,0,0,0,0,0,0,0,0
109,公立,一般大學,0017,國立臺北大學,學士班(日間),瓜地馬拉共和國,中南美洲,1,1,0,1,1,0,0,0,0,0,0,0,0,0,0
109,公立,一般大學,0017,國立臺北大學,學士班(日間),印度尼西亞共和國,東協,26,13,13,2,1,1,24,12,12,0,0,0,0,0,0
109,公立,一般大學,0017,國立臺北大學,學士班(日間),阿根廷,中南美洲,1,0,1,0,0,0,1,0,1,0,0,0,0,0,0
109,公立,一般大學,0017,國立臺北大學,學士班(日間),南非共和國,非洲,1,0,1,0,0,0,1,0,1,0,0,0,0,0,0
109,公立,一般大學,0017,國立臺北大學,學士班(日間),香港,港澳,75,39,36,0,0,0,0,0,0,75,39,36,0,0,0
109,公立,一般大學,0017,國立臺北大學,學士班(日間),秘魯共和國,中南美洲,2,0,2,0,0,0,2,0,2,0,0,0,0,0,0
109,公立,一般大學,0017,國立臺北大學,學士班(日間),馬來西亞,東協,95,50,45,2,2,0,93,48,45,0,0,0,0,0,0
109,公立,一般大學,0017,國立臺北大學,學士班(日間),越南社會主義共和國,東協,13,3,10,3,0,3,10,3,7,0,0,0,0,0,0
109,公立,一般大學,0017,國立臺北大學,學士班(日間),緬甸,東協,48,7,41,0,0,0,48,7,41,0,0,0,0,0,0
109,公立,一般大學,0017,國立臺北大學,學士班(日間),澳門,港澳,36,20,16,0,0,0,0,0,0,36,20,16,0,0,0
109,公立,一般大學,0017,國立臺北大學,碩士班(日間),土耳其共和國,其他亞洲地區,2,1,1,2,1,1,0,0,0,0,0,0,0,0,0
109,公立,一般大學,0017,國立臺北大學,碩士班(日間),大陸地區,大陸地區,21,14,7,0,0,0,0,0,0,0,0,0,21,14,7
109,公立,一般大學,0017,國立臺北大學,碩士班(日間),印度尼西亞共和國,東協,6,3,3,5,3,2,1,0,1,0,0,0,0,0,0
109,公立,一般大學,0017,國立臺北大學,碩士班(日間),香港,港澳,11,9,2,0,0,0,0,0,0,11,9,2,0,0,0
109,公立,一般大學,0017,國立臺北大學,碩士班(日間),馬來西亞,東協,7,5,2,1,0,1,6,5,1,0,0,0,0,0,0
109,公立,一般大學,0017,國立臺北大學,碩士班(日間),莫三比克共和國,非洲,1,0,1,1,0,1,0,0,0,0,0,0,0,0,0
109,公立,一般大學,0017,國立臺北大學,碩士班(日間),菲律賓共和國,東協,2,2,0,2,2,0,0,0,0,0,0,0,0,0,0
109,公立,一般大學,0017,國立臺北大學,碩士班(日間),越南社會主義共和國,東協,10,6,4,10,6,4,0,0,0,0,0,0,0,0,0
109,公立,一般大學,0017,國立臺北大學,碩士班(日間),緬甸,東協,4,0,4,0,0,0,4,0,4,0,0,0,0,0,0
109,公立,一般大學,0017,國立臺北大學,碩士班(日間),澳門,港澳,5,2,3,0,0,0,0,0,0,5,2,3,0,0,0
109,公立,一般大學,0017,國立臺北大學,碩士班(日間),美國,北美洲,1,1,0,1,1,0,0,0,0,0,0,0,0,0,0
109,公立,一般大學,0017,國立臺北大學,碩士班(日間),泰國,東協,4,1,3,4,1,3,0,0,0,0,0,0,0,0,0
109,公立,一般大學,0017,國立臺北大學,碩士班(日間),斯里蘭卡民主社會主義共和國,南亞,2,1,1,2,1,1,0,0,0,0,0,0,0,0,0
109,公立,一般大學,0017,國立臺北大學,碩士班(日間),蒙古國,其他亞洲地區,2,0,2,2,0,2,0,0,0,0,0,0,0,0,0
109,公立,一般大學,0017,國立臺北大學,碩士班(日間),墨西哥合眾國,中南美洲,1,1,0,1,1,0,0,0,0,0,0,0,0,0,0
109,公立,一般大學,0017,國立臺北大學,博士班,俄羅斯聯邦,其他亞洲地區,1,1,0,1,1,0,0,0,0,0,0,0,0,0,0
109,公立,一般大學,0017,國立臺北大學,博士班,馬來西亞,東協,1,1,0,0,0,0,1,1,0,0,0,0,0,0,0
109,公立,一般大學,0017,國立臺北大學,博士班,菲律賓共和國,東協,2,0,2,2,0,2,0,0,0,0,0,0,0,0,0
109,公立,一般大學,0017,國立臺北大學,博士班,大陸地區,大陸地區,18,9,9,0,0,0,0,0,0,0,0,0,18,9,9
109,公立,一般大學,0017,國立臺北大學,博士班,香港,港澳,1,1,0,0,0,0,0,0,0,1,1,0,0,0,0
109,公立,一般大學,0017,國立臺北大學,博士班,德意志聯邦共和國,歐洲,1,1,0,1,1,0,0,0,0,0,0,0,0,0,0
109,公立,一般大學,0017,國立臺北大學,博士班,澳門,港澳,1,1,0,0,0,0,0,0,0,1,1,0,0,0,0
109,公立,一般大學,0018,國立嘉義大學,學士班(日間),巴西聯邦共和國,中南美洲,1,0,1,0,0,0,1,0,1,0,0,0,0,0,0
109,公立,一般大學,0018,國立嘉義大學,學士班(日間),越南社會主義共和國,東協,6,2,4,4,0,4,2,2,0,0,0,0,0,0,0
109,公立,一般大學,0018,國立嘉義大學,學士班(日間),聖露西亞,中南美洲,1,1,0,1,1,0,0,0,0,0,0,0,0,0,0
109,公立,一般大學,0018,國立嘉義大學,學士班(日間),大陸地區,大陸地區,1,1,0,0,0,0,0,0,0,0,0,0,1,1,0
109,公立,一般大學,0018,國立嘉義大學,學士班(日間),日本,其他亞洲地區,6,5,1,5,4,1,1,1,0,0,0,0,0,0,0
109,公立,一般大學,0018,國立嘉義大學,學士班(日間),印度尼西亞共和國,東協,27,7,20,5,2,3,22,5,17,0,0,0,0,0,0
109,公立,一般大學,0018,國立嘉義大學,學士班(日間),南非共和國,非洲,3,2,1,0,0,0,3,2,1,0,0,0,0,0,0
109,公立,一般大學,0018,國立嘉義大學,學士班(日間),香港,港澳,74,33,41,0,0,0,0,0,0,74,33,41,0,0,0
109,公立,一般大學,0018,國立嘉義大學,學士班(日間),馬來西亞,東協,122,46,76,8,1,7,114,45,69,0,0,0,0,0,0
109,公立,一般大學,0018,國立嘉義大學,學士班(日間),新加坡共和國,東協,1,0,1,1,0,1,0,0,0,0,0,0,0,0,0
109,公立,一般大學,0018,國立嘉義大學,學士班(日間),緬甸,東協,1,1,0,0,0,0,1,1,0,0,0,0,0,0,0
109,公立,一般大學,0018,國立嘉義大學,學士班(日間),澳門,港澳,31,22,9,0,0,0,0,0,0,31,22,9,0,0,0
109,公立,一般大學,0018,國立嘉義大學,碩士班(日間),約旦哈什米王國,其他亞洲地區,1,0,1,1,0,1,0,0,0,0,0,0,0,0,0
109,公立,一般大學,0018,國立嘉義大學,碩士班(日間),香港,港澳,8,7,1,0,0,0,0,0,0,8,7,1,0,0,0
109,公立,一般大學,0018,國立嘉義大學,碩士班(日間),馬來西亞,東協,9,4,5,1,1,0,8,3,5,0,0,0,0,0,0
109,公立,一般大學,0018,國立嘉義大學,碩士班(日間),蒙古國,其他亞洲地區,1,0,1,1,0,1,0,0,0,0,0,0,0,0,0
109,公立,一般大學,0018,國立嘉義大學,碩士班(日間),印度尼西亞共和國,東協,20,6,14,19,5,14,1,1,0,0,0,0,0,0,0
109,公立,一般大學,0018,國立嘉義大學,碩士班(日間),泰國,東協,2,0,2,2,0,2,0,0,0,0,0,0,0,0,0
109,公立,一般大學,0018,國立嘉義大學,碩士班(日間),菲律賓共和國,東協,1,1,0,1,1,0,0,0,0,0,0,0,0,0,0
109,公立,一般大學,0018,國立嘉義大學,碩士班(日間),越南社會主義共和國,東協,3,1,2,3,1,2,0,0,0,0,0,0,0,0,0
109,公立,一般大學,0018,國立嘉義大學,碩士班(日間),澳門,港澳,2,0,2,0,0,0,0,0,0,2,0,2,0,0,0
109,公立,一般大學,0018,國立嘉義大學,博士班,土耳其共和國,其他亞洲地區,1,1,0,1,1,0,0,0,0,0,0,0,0,0,0
109,公立,一般大學,0018,國立嘉義大學,博士班,大陸地區,大陸地區,1,0,1,0,0,0,0,0,0,0,0,0,1,0,1
109,公立,一般大學,0018,國立嘉義大學,博士班,秘魯共和國,中南美洲,1,0,1,1,0,1,0,0,0,0,0,0,0,0,0
109,公立,一般大學,0018,國立嘉義大學,博士班,菲律賓共和國,東協,1,0,1,1,0,1,0,0,0,0,0,0,0,0,0
109,公立,一般大學,0018,國立嘉義大學,博士班,澳門,港澳,1,1,0,0,0,0,0,0,0,1,1,0,0,0,0
109,公立,一般大學,0018,國立嘉義大學,博士班,印度尼西亞共和國,東協,6,1,5,6,1,5,0,0,0,0,0,0,0,0,0
109,公立,一般大學,0018,國立嘉義大學,博士班,泰國,東協,2,0,2,2,0,2,0,0,0,0,0,0,0,0,0
109,公立,一般大學,0019,國立高雄大學,學士班(日間),大陸地區,大陸地區,4,2,2,0,0,0,0,0,0,0,0,0,4,2,2
109,公立,一般大學,0019,國立高雄大學,學士班(日間),大韓民國(南韓),其他亞洲地區,1,0,1,1,0,1,0,0,0,0,0,0,0,0,0
109,公立,一般大學,0019,國立高雄大學,學士班(日間),日本,其他亞洲地區,14,6,8,14,6,8,0,0,0,0,0,0,0,0,0
109,公立,一般大學,0019,國立高雄大學,學士班(日間),香港,港澳,21,13,8,0,0,0,0,0,0,21,13,8,0,0,0
109,公立,一般大學,0019,國立高雄大學,學士班(日間),緬甸,東協,2,0,2,0,0,0,2,0,2,0,0,0,0,0,0
109,公立,一般大學,0019,國立高雄大學,學士班(日間),巴拉圭,中南美洲,1,1,0,1,1,0,0,0,0,0,0,0,0,0,0
109,公立,一般大學,0019,國立高雄大學,學士班(日間),瓜地馬拉共和國,中南美洲,1,0,1,1,0,1,0,0,0,0,0,0,0,0,0
109,公立,一般大學,0019,國立高雄大學,學士班(日間),印度尼西亞共和國,東協,66,42,24,8,6,2,58,36,22,0,0,0,0,0,0
109,公立,一般大學,0019,國立高雄大學,學士班(日間),美國,北美洲,1,1,0,1,1,0,0,0,0,0,0,0,0,0,0
109,公立,一般大學,0019,國立高雄大學,學士班(日間),泰國,東協,1,0,1,0,0,0,1,0,1,0,0,0,0,0,0
109,公立,一般大學,0019,國立高雄大學,學士班(日間),馬來西亞,東協,36,17,19,0,0,0,36,17,19,0,0,0,0,0,0
109,公立,一般大學,0019,國立高雄大學,學士班(日間),菲律賓共和國,東協,1,1,0,1,1,0,0,0,0,0,0,0,0,0,0
109,公立,一般大學,0019,國立高雄大學,學士班(日間),越南社會主義共和國,東協,11,3,8,8,2,6,3,1,2,0,0,0,0,0,0
109,公立,一般大學,0019,國立高雄大學,學士班(日間),聖露西亞,中南美洲,2,1,1,2,1,1,0,0,0,0,0,0,0,0,0
109,公立,一般大學,0019,國立高雄大學,學士班(日間),澳門,港澳,16,10,6,0,0,0,0,0,0,16,10,6,0,0,0
109,公立,一般大學,0019,國立高雄大學,碩士班(日間),土耳其共和國,其他亞洲地區,2,1,1,2,1,1,0,0,0,0,0,0,0,0,0
109,公立,一般大學,0019,國立高雄大學,碩士班(日間),印度尼西亞共和國,東協,2,2,0,2,2,0,0,0,0,0,0,0,0,0,0
109,公立,一般大學,0019,國立高雄大學,碩士班(日間),俄羅斯聯邦,其他亞洲地區,1,1,0,1,1,0,0,0,0,0,0,0,0,0,0
109,公立,一般大學,0019,國立高雄大學,碩士班(日間),哥倫比亞共和國,中南美洲,3,1,2,3,1,2,0,0,0,0,0,0,0,0,0
109,公立,一般大學,0019,國立高雄大學,碩士班(日間),泰國,東協,2,0,2,2,0,2,0,0,0,0,0,0,0,0,0
109,公立,一般大學,0019,國立高雄大學,碩士班(日間),馬來西亞,東協,1,1,0,0,0,0,1,1,0,0,0,0,0,0,0
109,公立,一般大學,0019,國立高雄大學,碩士班(日間),菲律賓共和國,東協,1,0,1,1,0,1,0,0,0,0,0,0,0,0,0
109,公立,一般大學,0019,國立高雄大學,碩士班(日間),越南社會主義共和國,東協,8,1,7,8,1,7,0,0,0,0,0,0,0,0,0
109,公立,一般大學,0019,國立高雄大學,碩士班(日間),蒙古國,其他亞洲地區,1,0,1,1,0,1,0,0,0,0,0,0,0,0,0
109,公立,一般大學,0019,國立高雄大學,碩士班(日間),大陸地區,大陸地區,1,1,0,0,0,0,0,0,0,0,0,0,1,1,0
109,公立,一般大學,0019,國立高雄大學,碩士班(日間),大韓民國(南韓),其他亞洲地區,1,0,1,1,0,1,0,0,0,0,0,0,0,0,0
109,公立,一般大學,0019,國立高雄大學,碩士班(日間),日本,其他亞洲地區,1,0,1,1,0,1,0,0,0,0,0,0,0,0,0
109,公立,一般大學,0019,國立高雄大學,碩士班(日間),香港,港澳,3,2,1,0,0,0,0,0,0,3,2,1,0,0,0
109,公立,一般大學,0019,國立高雄大學,博士班,大陸地區,大陸地區,2,1,1,0,0,0,0,0,0,0,0,0,2,1,1
109,公立,一般大學,0020,國立東華大學,學士班(日間),大韓民國(南韓),其他亞洲地區,1,1,0,0,0,0,1,1,0,0,0,0,0,0,0
109,公立,一般大學,0020,國立東華大學,學士班(日間),巴西聯邦共和國,中南美洲,1,1,0,0,0,0,1,1,0,0,0,0,0,0,0
109,公立,一般大學,0020,國立東華大學,學士班(日間),巴拉圭,中南美洲,1,1,0,1,1,0,0,0,0,0,0,0,0,0,0
109,公立,一般大學,0020,國立東華大學,學士班(日間),史瓦帝尼王國,非洲,12,8,4,12,8,4,0,0,0,0,0,0,0,0,0
109,公立,一般大學,0020,國立東華大學,學士班(日間),瓜地馬拉共和國,中南美洲,2,1,1,2,1,1,0,0,0,0,0,0,0,0,0
109,公立,一般大學,0020,國立東華大學,學士班(日間),吉爾吉斯,其他亞洲地區,17,15,2,17,15,2,0,0,0,0,0,0,0,0,0
109,公立,一般大學,0020,國立東華大學,學士班(日間),吐瓦魯,其他亞洲地區,2,2,0,2,2,0,0,0,0,0,0,0,0,0,0
109,公立,一般大學,0020,國立東華大學,學士班(日間),多明尼加共和國,中南美洲,1,1,0,1,1,0,0,0,0,0,0,0,0,0,0
109,公立,一般大學,0020,國立東華大學,學士班(日間),美國,北美洲,5,5,0,3,3,0,2,2,0,0,0,0,0,0,0
109,公立,一般大學,0020,國立東華大學,學士班(日間),泰國,東協,10,6,4,9,6,3,1,0,1,0,0,0,0,0,0
109,公立,一般大學,0020,國立東華大學,學士班(日間),烏克蘭,其他亞洲地區,1,1,0,1,1,0,0,0,0,0,0,0,0,0,0
109,公立,一般大學,0020,國立東華大學,學士班(日間),馬來西亞,東協,160,76,84,3,1,2,157,75,82,0,0,0,0,0,0
109,公立,一般大學,0020,國立東華大學,學士班(日間),菲律賓共和國,東協,1,1,0,0,0,0,1,1,0,0,0,0,0,0,0
109,公立,一般大學,0020,國立東華大學,學士班(日間),越南社會主義共和國,東協,13,3,10,11,1,10,2,2,0,0,0,0,0,0,0
109,公立,一般大學,0020,國立東華大學,學士班(日間),聖克里斯多福及尼維斯,中南美洲,9,5,4,9,5,4,0,0,0,0,0,0,0,0,0
109,公立,一般大學,0020,國立東華大學,學士班(日間),蒙古國,其他亞洲地區,11,5,6,11,5,6,0,0,0,0,0,0,0,0,0
109,公立,一般大學,0020,國立東華大學,學士班(日間),澳門,港澳,38,15,23,0,0,0,0,0,0,38,15,23,0,0,0
109,公立,一般大學,0020,國立東華大學,學士班(日間),薩爾瓦多,中南美洲,2,2,0,1,1,0,1,1,0,0,0,0,0,0,0
109,公立,一般大學,0020,國立東華大學,學士班(日間),大陸地區,大陸地區,15,9,6,0,0,0,0,0,0,0,0,0,15,9,6
109,公立,一般大學,0020,國立東華大學,學士班(日間),日本,其他亞洲地區,6,1,5,5,1,4,1,0,1,0,0,0,0,0,0
109,公立,一般大學,0020,國立東華大學,學士班(日間),甘比亞共和國,非洲,1,1,0,1,1,0,0,0,0,0,0,0,0,0,0
109,公立,一般大學,0020,國立東華大學,學士班(日間),印度,南亞,1,1,0,1,1,0,0,0,0,0,0,0,0,0,0
109,公立,一般大學,0020,國立東華大學,學士班(日間),印度尼西亞共和國,東協,60,28,32,24,13,11,36,15,21,0,0,0,0,0,0
109,公立,一般大學,0020,國立東華大學,學士班(日間),宏都拉斯共和國,中南美洲,8,5,3,8,5,3,0,0,0,0,0,0,0,0,0
109,公立,一般大學,0020,國立東華大學,學士班(日間),貝里斯,中南美洲,9,7,2,9,7,2,0,0,0,0,0,0,0,0,0
109,公立,一般大學,0020,國立東華大學,學士班(日間),南非共和國,非洲,1,0,1,1,0,1,0,0,0,0,0,0,0,0,0
109,公立,一般大學,0020,國立東華大學,學士班(日間),查德共和國,非洲,1,1,0,1,1,0,0,0,0,0,0,0,0,0,0
109,公立,一般大學,0020,國立東華大學,學士班(日間),香港,港澳,111,58,53,0,0,0,0,0,0,111,58,53,0,0,0
109,公立,一般大學,0020,國立東華大學,學士班(日間),哥斯大黎加共和國,中南美洲,1,0,1,0,0,0,1,0,1,0,0,0,0,0,0
109,公立,一般大學,0020,國立東華大學,學士班(日間),秘魯共和國,中南美洲,1,0,1,1,0,1,0,0,0,0,0,0,0,0,0
109,公立,一般大學,0020,國立東華大學,學士班(日間),象牙海岸共和國,非洲,1,1,0,1,1,0,0,0,0,0,0,0,0,0,0
109,公立,一般大學,0020,國立東華大學,學士班(日間),聖文森(及格瑞那丁),中南美洲,10,6,4,10,6,4,0,0,0,0,0,0,0,0,0
109,公立,一般大學,0020,國立東華大學,學士班(日間),緬甸,東協,2,1,1,0,0,0,2,1,1,0,0,0,0,0,0
109,公立,一般大學,0020,國立東華大學,學士班(日間),諾魯共和國,其他亞洲地區,1,0,1,1,0,1,0,0,0,0,0,0,0,0,0
109,公立,一般大學,0020,國立東華大學,碩士班(日間),甘比亞共和國,非洲,1,0,1,1,0,1,0,0,0,0,0,0,0,0,0
109,公立,一般大學,0020,國立東華大學,碩士班(日間),印度,南亞,7,4,3,7,4,3,0,0,0,0,0,0,0,0,0
109,公立,一般大學,0020,國立東華大學,碩士班(日間),印度尼西亞共和國,東協,30,14,16,28,14,14,2,0,2,0,0,0,0,0,0
109,公立,一般大學,0020,國立東華大學,碩士班(日間),美國,北美洲,5,4,1,5,4,1,0,0,0,0,0,0,0,0,0
109,公立,一般大學,0020,國立東華大學,碩士班(日間),香港,港澳,13,9,4,0,0,0,0,0,0,13,9,4,0,0,0
109,公立,一般大學,0020,國立東華大學,碩士班(日間),馬拉威共和國,非洲,11,9,2,11,9,2,0,0,0,0,0,0,0,0,0
109,公立,一般大學,0020,國立東華大學,碩士班(日間),斯里蘭卡民主社會主義共和國,南亞,1,0,1,1,0,1,0,0,0,0,0,0,0,0,0
109,公立,一般大學,0020,國立東華大學,碩士班(日間),新加坡共和國,東協,2,1,1,1,0,1,1,1,0,0,0,0,0,0,0
109,公立,一般大學,0020,國立東華大學,碩士班(日間),葡萄牙共和國,歐洲,1,1,0,1,1,0,0,0,0,0,0,0,0,0,0
109,公立,一般大學,0020,國立東華大學,碩士班(日間),緬甸,東協,1,1,0,0,0,0,1,1,0,0,0,0,0,0,0
109,公立,一般大學,0020,國立東華大學,碩士班(日間),土耳其共和國,其他亞洲地區,1,1,0,1,1,0,0,0,0,0,0,0,0,0,0
109,公立,一般大學,0020,國立東華大學,碩士班(日間),土庫曼,其他亞洲地區,1,1,0,1,1,0,0,0,0,0,0,0,0,0,0
109,公立,一般大學,0020,國立東華大學,碩士班(日間),大陸地區,大陸地區,2,1,1,0,0,0,0,0,0,0,0,0,2,1,1
109,公立,一般大學,0020,國立東華大學,碩士班(日間),史瓦帝尼王國,非洲,4,3,1,4,3,1,0,0,0,0,0,0,0,0,0
109,公立,一般大學,0020,國立東華大學,碩士班(日間),瓜地馬拉共和國,中南美洲,1,1,0,1,1,0,0,0,0,0,0,0,0,0,0
109,公立,一般大學,0020,國立東華大學,碩士班(日間),匈牙利共和國,歐洲,1,0,1,1,0,1,0,0,0,0,0,0,0,0,0
109,公立,一般大學,0020,國立東華大學,碩士班(日間),吉爾吉斯,其他亞洲地區,1,0,1,1,0,1,0,0,0,0,0,0,0,0,0
109,公立,一般大學,0020,國立東華大學,碩士班(日間),貝里斯,中南美洲,3,2,1,3,2,1,0,0,0,0,0,0,0,0,0
109,公立,一般大學,0020,國立東華大學,碩士班(日間),法國,歐洲,1,0,1,1,0,1,0,0,0,0,0,0,0,0,0
109,公立,一般大學,0020,國立東華大學,碩士班(日間),俄羅斯聯邦,其他亞洲地區,2,0,2,2,0,2,0,0,0,0,0,0,0,0,0
109,公立,一般大學,0020,國立東華大學,碩士班(日間),英國,歐洲,1,1,0,1,1,0,0,0,0,0,0,0,0,0,0
109,公立,一般大學,0020,國立東華大學,碩士班(日間),泰國,東協,10,5,5,10,5,5,0,0,0,0,0,0,0,0,0
109,公立,一般大學,0020,國立東華大學,碩士班(日間),索羅門群島,其他亞洲地區,1,1,0,1,1,0,0,0,0,0,0,0,0,0,0
109,公立,一般大學,0020,國立東華大學,碩士班(日間),馬來西亞,東協,29,12,17,10,3,7,19,9,10,0,0,0,0,0,0
109,公立,一般大學,0020,國立東華大學,碩士班(日間),斯洛伐克共和國,歐洲,1,0,1,1,0,1,0,0,0,0,0,0,0,0,0
109,公立,一般大學,0020,國立東華大學,碩士班(日間),菲律賓共和國,東協,1,1,0,1,1,0,0,0,0,0,0,0,0,0,0
109,公立,一般大學,0020,國立東華大學,碩士班(日間),越南社會主義共和國,東協,21,2,19,21,2,19,0,0,0,0,0,0,0,0,0
109,公立,一般大學,0020,國立東華大學,碩士班(日間),聖克里斯多福及尼維斯,中南美洲,2,1,1,2,1,1,0,0,0,0,0,0,0,0,0
109,公立,一般大學,0020,國立東華大學,碩士班(日間),蒙古國,其他亞洲地區,15,4,11,15,4,11,0,0,0,0,0,0,0,0,0
109,公立,一般大學,0020,國立東華大學,碩士班(日間),澳門,港澳,5,3,2,0,0,0,0,0,0,5,3,2,0,0,0
109,公立,一般大學,0020,國立東華大學,博士班,印度,南亞,29,21,8,29,21,8,0,0,0,0,0,0,0,0,0
109,公立,一般大學,0020,國立東華大學,博士班,俄羅斯聯邦,其他亞洲地區,2,1,1,2,1,1,0,0,0,0,0,0,0,0,0
109,公立,一般大學,0020,國立東華大學,博士班,美國,北美洲,1,1,0,1,1,0,0,0,0,0,0,0,0,0,0
109,公立,一般大學,0020,國立東華大學,博士班,馬拉威共和國,非洲,3,3,0,3,3,0,0,0,0,0,0,0,0,0,0
109,公立,一般大學,0020,國立東華大學,博士班,菲律賓共和國,東協,4,3,1,4,3,1,0,0,0,0,0,0,0,0,0
109,公立,一般大學,0020,國立東華大學,博士班,聖文森(及格瑞那丁),中南美洲,1,1,0,1,1,0,0,0,0,0,0,0,0,0,0
109,公立,一般大學,0020,國立東華大學,博士班,蒙古國,其他亞洲地區,3,3,0,3,3,0,0,0,0,0,0,0,0,0,0
109,公立,一般大學,0020,國立東華大學,博士班,土耳其共和國,其他亞洲地區,1,1,0,1,1,0,0,0,0,0,0,0,0,0,0
109,公立,一般大學,0020,國立東華大學,博士班,大陸地區,大陸地區,10,4,6,0,0,0,0,0,0,0,0,0,10,4,6
109,公立,一般大學,0020,國立東華大學,博士班,加拿大,北美洲,2,0,2,2,0,2,0,0,0,0,0,0,0,0,0
109,公立,一般大學,0020,國立東華大學,博士班,印度尼西亞共和國,東協,32,20,12,32,20,12,0,0,0,0,0,0,0,0,0
109,公立,一般大學,0020,國立東華大學,博士班,法國,歐洲,1,0,1,1,0,1,0,0,0,0,0,0,0,0,0
109,公立,一般大學,0020,國立東華大學,博士班,英國,歐洲,2,2,0,2,2,0,0,0,0,0,0,0,0,0,0
109,公立,一般大學,0020,國立東華大學,博士班,泰國,東協,9,3,6,9,3,6,0,0,0,0,0,0,0,0,0
109,公立,一般大學,0020,國立東華大學,博士班,馬來西亞,東協,1,1,0,0,0,0,1,1,0,0,0,0,0,0,0
109,公立,一般大學,0020,國立東華大學,博士班,越南社會主義共和國,東協,14,6,8,14,6,8,0,0,0,0,0,0,0,0,0
109,公立,一般大學,0021,國立暨南國際大學,學士班(日間),瓜地馬拉共和國,中南美洲,1,0,1,0,0,0,1,0,1,0,0,0,0,0,0
109,公立,一般大學,0021,國立暨南國際大學,學士班(日間),貝里斯,中南美洲,1,0,1,0,0,0,1,0,1,0,0,0,0,0,0
109,公立,一般大學,0021,國立暨南國際大學,學士班(日間),美國,北美洲,1,1,0,0,0,0,1,1,0,0,0,0,0,0,0
109,公立,一般大學,0021,國立暨南國際大學,學士班(日間),香港,港澳,133,71,62,0,0,0,0,0,0,133,71,62,0,0,0
109,公立,一般大學,0021,國立暨南國際大學,學士班(日間),越南社會主義共和國,東協,10,3,7,2,0,2,8,3,5,0,0,0,0,0,0
109,公立,一般大學,0021,國立暨南國際大學,學士班(日間),緬甸,東協,12,3,9,0,0,0,12,3,9,0,0,0,0,0,0
109,公立,一般大學,0021,國立暨南國際大學,學士班(日間),澳門,港澳,55,33,22,0,0,0,0,0,0,55,33,22,0,0,0
109,公立,一般大學,0021,國立暨南國際大學,學士班(日間),巴西聯邦共和國,中南美洲,1,0,1,0,0,0,1,0,1,0,0,0,0,0,0
109,公立,一般大學,0021,國立暨南國際大學,學士班(日間),日本,其他亞洲地區,4,1,3,3,0,3,1,1,0,0,0,0,0,0,0
109,公立,一般大學,0021,國立暨南國際大學,學士班(日間),印度尼西亞共和國,東協,56,29,27,0,0,0,56,29,27,0,0,0,0,0,0
109,公立,一般大學,0021,國立暨南國際大學,學士班(日間),南非共和國,非洲,2,0,2,0,0,0,2,0,2,0,0,0,0,0,0
109,公立,一般大學,0021,國立暨南國際大學,學士班(日間),柬埔寨王國,東協,1,1,0,0,0,0,1,1,0,0,0,0,0,0,0
109,公立,一般大學,0021,國立暨南國際大學,學士班(日間),泰國,東協,3,0,3,0,0,0,3,0,3,0,0,0,0,0,0
109,公立,一般大學,0021,國立暨南國際大學,學士班(日間),馬來西亞,東協,178,75,103,4,1,3,174,74,100,0,0,0,0,0,0
109,公立,一般大學,0021,國立暨南國際大學,學士班(日間),葡萄牙共和國,歐洲,1,0,1,1,0,1,0,0,0,0,0,0,0,0,0
109,公立,一般大學,0021,國立暨南國際大學,碩士班(日間),日本,其他亞洲地區,1,1,0,1,1,0,0,0,0,0,0,0,0,0,0
109,公立,一般大學,0021,國立暨南國際大學,碩士班(日間),印度尼西亞共和國,東協,1,1,0,0,0,0,1,1,0,0,0,0,0,0,0
109,公立,一般大學,0021,國立暨南國際大學,碩士班(日間),俄羅斯聯邦,其他亞洲地區,1,0,1,1,0,1,0,0,0,0,0,0,0,0,0
109,公立,一般大學,0021,國立暨南國際大學,碩士班(日間),烏克蘭,其他亞洲地區,1,1,0,1,1,0,0,0,0,0,0,0,0,0,0
109,公立,一般大學,0021,國立暨南國際大學,碩士班(日間),馬來西亞,東協,16,10,6,1,0,1,15,10,5,0,0,0,0,0,0
109,公立,一般大學,0021,國立暨南國際大學,碩士班(日間),大陸地區,大陸地區,2,1,1,0,0,0,0,0,0,0,0,0,2,1,1
109,公立,一般大學,0021,國立暨南國際大學,碩士班(日間),香港,港澳,12,9,3,0,0,0,0,0,0,12,9,3,0,0,0
109,公立,一般大學,0021,國立暨南國際大學,碩士班(日間),越南社會主義共和國,東協,5,2,3,5,2,3,0,0,0,0,0,0,0,0,0
109,公立,一般大學,0021,國立暨南國際大學,碩士班(日間),蒙古國,其他亞洲地區,1,0,1,1,0,1,0,0,0,0,0,0,0,0,0
109,公立,一般大學,0021,國立暨南國際大學,碩士班(日間),緬甸,東協,13,4,9,13,4,9,0,0,0,0,0,0,0,0,0
109,公立,一般大學,0021,國立暨南國際大學,碩士班(日間),澳門,港澳,4,2,2,0,0,0,0,0,0,4,2,2,0,0,0
109,公立,一般大學,0021,國立暨南國際大學,博士班,美國,北美洲,1,1,0,1,1,0,0,0,0,0,0,0,0,0,0
109,公立,一般大學,0021,國立暨南國際大學,博士班,泰國,東協,1,0,1,1,0,1,0,0,0,0,0,0,0,0,0
109,公立,一般大學,0021,國立暨南國際大學,博士班,大陸地區,大陸地區,10,4,6,0,0,0,0,0,0,0,0,0,10,4,6
109,公立,一般大學,0021,國立暨南國際大學,博士班,印度,南亞,1,1,0,1,1,0,0,0,0,0,0,0,0,0,0
109,公立,一般大學,0021,國立暨南國際大學,博士班,香港,港澳,5,4,1,0,0,0,0,0,0,5,4,1,0,0,0
109,公立,一般大學,0021,國立暨南國際大學,博士班,馬來西亞,東協,6,6,0,5,5,0,1,1,0,0,0,0,0,0,0
109,公立,一般大學,0021,國立暨南國際大學,博士班,越南社會主義共和國,東協,22,11,11,22,11,11,0,0,0,0,0,0,0,0,0
109,公立,一般大學,0021,國立暨南國際大學,博士班,緬甸,東協,5,0,5,4,0,4,1,0,1,0,0,0,0,0,0
109,公立,一般大學,0021,國立暨南國際大學,博士班,澳門,港澳,1,0,1,0,0,0,0,0,0,1,0,1,0,0,0
109,公立,技專校院,0022,國立臺灣科技大學,學士班(日間),大陸地區,大陸地區,46,29,17,0,0,0,0,0,0,0,0,0,46,29,17
109,公立,技專校院,0022,國立臺灣科技大學,學士班(日間),厄瓜多共和國,中南美洲,1,1,0,0,0,0,1,1,0,0,0,0,0,0,0
109,公立,技專校院,0022,國立臺灣科技大學,學士班(日間),巴布亞紐幾內亞獨立國,其他亞洲地區,2,2,0,2,2,0,0,0,0,0,0,0,0,0,0
109,公立,技專校院,0022,國立臺灣科技大學,學士班(日間),日本,其他亞洲地區,7,3,4,4,2,2,3,1,2,0,0,0,0,0,0
109,公立,技專校院,0022,國立臺灣科技大學,學士班(日間),印度尼西亞共和國,東協,206,129,77,93,59,34,113,70,43,0,0,0,0,0,0
109,公立,技專校院,0022,國立臺灣科技大學,學士班(日間),西班牙王國,歐洲,1,1,0,1,1,0,0,0,0,0,0,0,0,0,0
109,公立,技專校院,0022,國立臺灣科技大學,學士班(日間),宏都拉斯共和國,中南美洲,4,3,1,4,3,1,0,0,0,0,0,0,0,0,0
109,公立,技專校院,0022,國立臺灣科技大學,學士班(日間),約旦哈什米王國,其他亞洲地區,1,1,0,0,0,0,1,1,0,0,0,0,0,0,0
109,公立,技專校院,0022,國立臺灣科技大學,學士班(日間),美國,北美洲,4,3,1,0,0,0,4,3,1,0,0,0,0,0,0
109,公立,技專校院,0022,國立臺灣科技大學,學士班(日間),香港,港澳,39,26,13,0,0,0,0,0,0,39,26,13,0,0,0
109,公立,技專校院,0022,國立臺灣科技大學,學士班(日間),海地共和國,中南美洲,2,1,1,2,1,1,0,0,0,0,0,0,0,0,0
109,公立,技專校院,0022,國立臺灣科技大學,學士班(日間),新加坡共和國,東協,3,1,2,0,0,0,3,1,2,0,0,0,0,0,0
109,公立,技專校院,0022,國立臺灣科技大學,學士班(日間),緬甸,東協,22,14,8,0,0,0,22,14,8,0,0,0,0,0,0
109,公立,技專校院,0022,國立臺灣科技大學,學士班(日間),澳門,港澳,36,28,8,0,0,0,0,0,0,36,28,8,0,0,0
109,公立,技專校院,0022,國立臺灣科技大學,學士班(日間),土耳其共和國,其他亞洲地區,1,1,0,1,1,0,0,0,0,0,0,0,0,0,0
109,公立,技專校院,0022,國立臺灣科技大學,學士班(日間),大韓民國(南韓),其他亞洲地區,3,2,1,2,2,0,1,0,1,0,0,0,0,0,0
109,公立,技專校院,0022,國立臺灣科技大學,學士班(日間),巴西聯邦共和國,中南美洲,1,1,0,1,1,0,0,0,0,0,0,0,0,0,0
109,公立,技專校院,0022,國立臺灣科技大學,學士班(日間),巴拉圭,中南美洲,12,7,5,11,6,5,1,1,0,0,0,0,0,0,0
109,公立,技專校院,0022,國立臺灣科技大學,學士班(日間),加拿大,北美洲,1,1,0,0,0,0,1,1,0,0,0,0,0,0,0
109,公立,技專校院,0022,國立臺灣科技大學,學士班(日間),尼加拉瓜,中南美洲,6,4,2,6,4,2,0,0,0,0,0,0,0,0,0
109,公立,技專校院,0022,國立臺灣科技大學,學士班(日間),南非共和國,非洲,1,1,0,0,0,0,1,1,0,0,0,0,0,0,0
109,公立,技專校院,0022,國立臺灣科技大學,學士班(日間),泰國,東協,9,4,5,8,3,5,1,1,0,0,0,0,0,0,0
109,公立,技專校院,0022,國立臺灣科技大學,學士班(日間),馬來西亞,東協,100,74,26,4,2,2,96,72,24,0,0,0,0,0,0
109,公立,技專校院,0022,國立臺灣科技大學,學士班(日間),菲律賓共和國,東協,4,2,2,2,1,1,2,1,1,0,0,0,0,0,0
109,公立,技專校院,0022,國立臺灣科技大學,學士班(日間),越南社會主義共和國,東協,33,21,12,19,15,4,14,6,8,0,0,0,0,0,0
109,公立,技專校院,0022,國立臺灣科技大學,學士班(日間),聖文森(及格瑞那丁),中南美洲,2,1,1,2,1,1,0,0,0,0,0,0,0,0,0
109,公立,技專校院,0022,國立臺灣科技大學,學士班(日間),聖露西亞,中南美洲,3,2,1,3,2,1,0,0,0,0,0,0,0,0,0
109,公立,技專校院,0022,國立臺灣科技大學,學士班(日間),蒙古國,其他亞洲地區,1,1,0,1,1,0,0,0,0,0,0,0,0,0,0
109,公立,技專校院,0022,國立臺灣科技大學,學士班(日間),薩爾瓦多,中南美洲,1,1,0,1,1,0,0,0,0,0,0,0,0,0,0
109,公立,技專校院,0022,國立臺灣科技大學,碩士班(日間),土耳其共和國,其他亞洲地區,1,1,0,1,1,0,0,0,0,0,0,0,0,0,0
109,公立,技專校院,0022,國立臺灣科技大學,碩士班(日間),大韓民國(南韓),其他亞洲地區,1,0,1,1,0,1,0,0,0,0,0,0,0,0,0
109,公立,技專校院,0022,國立臺灣科技大學,碩士班(日間),巴拉圭,中南美洲,4,4,0,4,4,0,0,0,0,0,0,0,0,0,0
109,公立,技專校院,0022,國立臺灣科技大學,碩士班(日間),巴基斯坦,南亞,6,6,0,6,6,0,0,0,0,0,0,0,0,0,0
109,公立,技專校院,0022,國立臺灣科技大學,碩士班(日間),尼加拉瓜,中南美洲,4,3,1,3,3,0,1,0,1,0,0,0,0,0,0
109,公立,技專校院,0022,國立臺灣科技大學,碩士班(日間),衣索比亞聯邦民主共和國,非洲,7,6,1,7,6,1,0,0,0,0,0,0,0,0,0
109,公立,技專校院,0022,國立臺灣科技大學,碩士班(日間),奈及利亞聯邦共和國,非洲,2,2,0,2,2,0,0,0,0,0,0,0,0,0,0
109,公立,技專校院,0022,國立臺灣科技大學,碩士班(日間),拉脫維亞共和國,歐洲,1,0,1,1,0,1,0,0,0,0,0,0,0,0,0
109,公立,技專校院,0022,國立臺灣科技大學,碩士班(日間),法國,歐洲,3,2,1,3,2,1,0,0,0,0,0,0,0,0,0
109,公立,技專校院,0022,國立臺灣科技大學,碩士班(日間),俄羅斯聯邦,其他亞洲地區,5,1,4,5,1,4,0,0,0,0,0,0,0,0,0
109,公立,技專校院,0022,國立臺灣科技大學,碩士班(日間),埃及阿拉伯共和國,非洲,1,0,1,1,0,1,0,0,0,0,0,0,0,0,0
109,公立,技專校院,0022,國立臺灣科技大學,碩士班(日間),泰國,東協,27,7,20,27,7,20,0,0,0,0,0,0,0,0,0
109,公立,技專校院,0022,國立臺灣科技大學,碩士班(日間),烏干達共和國,非洲,1,1,0,1,1,0,0,0,0,0,0,0,0,0,0
109,公立,技專校院,0022,國立臺灣科技大學,碩士班(日間),馬來西亞,東協,16,13,3,3,3,0,13,10,3,0,0,0,0,0,0
109,公立,技專校院,0022,國立臺灣科技大學,碩士班(日間),斯洛伐克共和國,歐洲,1,1,0,1,1,0,0,0,0,0,0,0,0,0,0
109,公立,技專校院,0022,國立臺灣科技大學,碩士班(日間),菲律賓共和國,東協,8,3,5,8,3,5,0,0,0,0,0,0,0,0,0
109,公立,技專校院,0022,國立臺灣科技大學,碩士班(日間),越南社會主義共和國,東協,50,23,27,50,23,27,0,0,0,0,0,0,0,0,0
109,公立,技專校院,0022,國立臺灣科技大學,碩士班(日間),聖克里斯多福及尼維斯,中南美洲,1,0,1,1,0,1,0,0,0,0,0,0,0,0,0
109,公立,技專校院,0022,國立臺灣科技大學,碩士班(日間),聖露西亞,中南美洲,1,1,0,1,1,0,0,0,0,0,0,0,0,0,0
109,公立,技專校院,0022,國立臺灣科技大學,碩士班(日間),蒙古國,其他亞洲地區,4,1,3,4,1,3,0,0,0,0,0,0,0,0,0
109,公立,技專校院,0022,國立臺灣科技大學,碩士班(日間),澳門,港澳,1,1,0,0,0,0,0,0,0,1,1,0,0,0,0
109,公立,技專校院,0022,國立臺灣科技大學,碩士班(日間),大陸地區,大陸地區,73,46,27,0,0,0,0,0,0,0,0,0,73,46,27
109,公立,技專校院,0022,國立臺灣科技大學,碩士班(日間),日本,其他亞洲地區,2,2,0,2,2,0,0,0,0,0,0,0,0,0,0
109,公立,技專校院,0022,國立臺灣科技大學,碩士班(日間),比利時王國,歐洲,1,1,0,1,1,0,0,0,0,0,0,0,0,0,0
109,公立,技專校院,0022,國立臺灣科技大學,碩士班(日間),加拿大,北美洲,1,1,0,0,0,0,1,1,0,0,0,0,0,0,0
109,公立,技專校院,0022,國立臺灣科技大學,碩士班(日間),史瓦帝尼王國,非洲,1,1,0,1,1,0,0,0,0,0,0,0,0,0,0
109,公立,技專校院,0022,國立臺灣科技大學,碩士班(日間),伊朗伊斯蘭共和國,其他亞洲地區,1,1,0,1,1,0,0,0,0,0,0,0,0,0,0
109,公立,技專校院,0022,國立臺灣科技大學,碩士班(日間),印度,南亞,15,12,3,15,12,3,0,0,0,0,0,0,0,0,0
109,公立,技專校院,0022,國立臺灣科技大學,碩士班(日間),印度尼西亞共和國,東協,199,116,83,194,113,81,5,3,2,0,0,0,0,0,0
109,公立,技專校院,0022,國立臺灣科技大學,碩士班(日間),宏都拉斯共和國,中南美洲,2,2,0,2,2,0,0,0,0,0,0,0,0,0,0
109,公立,技專校院,0022,國立臺灣科技大學,碩士班(日間),委內瑞拉共和國,中南美洲,1,1,0,1,1,0,0,0,0,0,0,0,0,0,0
109,公立,技專校院,0022,國立臺灣科技大學,碩士班(日間),波蘭共和國,歐洲,1,1,0,1,1,0,0,0,0,0,0,0,0,0,0
109,公立,技專校院,0022,國立臺灣科技大學,碩士班(日間),肯亞共和國,非洲,2,2,0,2,2,0,0,0,0,0,0,0,0,0,0
109,公立,技專校院,0022,國立臺灣科技大學,碩士班(日間),哈薩克共和國,其他亞洲地區,1,0,1,1,0,1,0,0,0,0,0,0,0,0,0
109,公立,技專校院,0022,國立臺灣科技大學,碩士班(日間),美國,北美洲,5,5,0,4,4,0,1,1,0,0,0,0,0,0,0
109,公立,技專校院,0022,國立臺灣科技大學,碩士班(日間),香港,港澳,8,4,4,0,0,0,0,0,0,8,4,4,0,0,0
109,公立,技專校院,0022,國立臺灣科技大學,碩士班(日間),智利,中南美洲,1,0,1,1,0,1,0,0,0,0,0,0,0,0,0
109,公立,技專校院,0022,國立臺灣科技大學,碩士班(日間),德意志聯邦共和國,歐洲,9,6,3,9,6,3,0,0,0,0,0,0,0,0,0
109,公立,技專校院,0022,國立臺灣科技大學,碩士班(日間),緬甸,東協,1,1,0,1,1,0,0,0,0,0,0,0,0,0,0
109,公立,技專校院,0022,國立臺灣科技大學,碩士班(日間),墨西哥合眾國,中南美洲,5,2,3,5,2,3,0,0,0,0,0,0,0,0,0
109,公立,技專校院,0022,國立臺灣科技大學,博士班,大陸地區,大陸地區,28,16,12,0,0,0,0,0,0,0,0,0,28,16,12
109,公立,技專校院,0022,國立臺灣科技大學,博士班,巴拉圭,中南美洲,1,0,1,1,0,1,0,0,0,0,0,0,0,0,0
109,公立,技專校院,0022,國立臺灣科技大學,博士班,史瓦帝尼王國,非洲,1,1,0,1,1,0,0,0,0,0,0,0,0,0,0
109,公立,技專校院,0022,國立臺灣科技大學,博士班,甘比亞共和國,非洲,1,1,0,1,1,0,0,0,0,0,0,0,0,0,0
109,公立,技專校院,0022,國立臺灣科技大學,博士班,伊朗伊斯蘭共和國,其他亞洲地區,4,4,0,4,4,0,0,0,0,0,0,0,0,0,0
109,公立,技專校院,0022,國立臺灣科技大學,博士班,印度尼西亞共和國,東協,122,81,41,122,81,41,0,0,0,0,0,0,0,0,0
109,公立,技專校院,0022,國立臺灣科技大學,博士班,衣索比亞聯邦民主共和國,非洲,107,103,4,107,103,4,0,0,0,0,0,0,0,0,0
109,公立,技專校院,0022,國立臺灣科技大學,博士班,貝里斯,中南美洲,1,1,0,1,1,0,0,0,0,0,0,0,0,0,0
109,公立,技專校院,0022,國立臺灣科技大學,博士班,委內瑞拉共和國,中南美洲,2,2,0,2,2,0,0,0,0,0,0,0,0,0,0
109,公立,技專校院,0022,國立臺灣科技大學,博士班,肯亞共和國,非洲,9,9,0,9,9,0,0,0,0,0,0,0,0,0,0
109,公立,技專校院,0022,國立臺灣科技大學,博士班,俄羅斯聯邦,其他亞洲地區,4,0,4,4,0,4,0,0,0,0,0,0,0,0,0
109,公立,技專校院,0022,國立臺灣科技大學,博士班,泰國,東協,13,7,6,13,7,6,0,0,0,0,0,0,0,0,0
109,公立,技專校院,0022,國立臺灣科技大學,博士班,荷蘭王國,歐洲,1,1,0,1,1,0,0,0,0,0,0,0,0,0,0
109,公立,技專校院,0022,國立臺灣科技大學,博士班,菲律賓共和國,東協,7,5,2,7,5,2,0,0,0,0,0,0,0,0,0
109,公立,技專校院,0022,國立臺灣科技大學,博士班,越南社會主義共和國,東協,38,22,16,38,22,16,0,0,0,0,0,0,0,0,0
109,公立,技專校院,0022,國立臺灣科技大學,博士班,墨西哥合眾國,中南美洲,3,3,0,3,3,0,0,0,0,0,0,0,0,0,0
109,公立,技專校院,0022,國立臺灣科技大學,博士班,巴拿馬共和國,中南美洲,1,1,0,1,1,0,0,0,0,0,0,0,0,0,0
109,公立,技專校院,0022,國立臺灣科技大學,博士班,巴基斯坦,南亞,12,12,0,12,12,0,0,0,0,0,0,0,0,0,0
109,公立,技專校院,0022,國立臺灣科技大學,博士班,日本,其他亞洲地區,1,1,0,1,1,0,0,0,0,0,0,0,0,0,0
109,公立,技專校院,0022,國立臺灣科技大學,博士班,伊拉克共和國,其他亞洲地區,1,1,0,1,1,0,0,0,0,0,0,0,0,0,0
109,公立,技專校院,0022,國立臺灣科技大學,博士班,印度,南亞,47,34,13,47,34,13,0,0,0,0,0,0,0,0,0
109,公立,技專校院,0022,國立臺灣科技大學,博士班,西班牙王國,歐洲,1,1,0,1,1,0,0,0,0,0,0,0,0,0,0
109,公立,技專校院,0022,國立臺灣科技大學,博士班,辛巴威共和國,非洲,1,1,0,1,1,0,0,0,0,0,0,0,0,0,0
109,公立,技專校院,0022,國立臺灣科技大學,博士班,美國,北美洲,2,1,1,2,1,1,0,0,0,0,0,0,0,0,0
109,公立,技專校院,0022,國立臺灣科技大學,博士班,海地共和國,中南美洲,1,1,0,1,1,0,0,0,0,0,0,0,0,0,0
109,公立,技專校院,0022,國立臺灣科技大學,博士班,馬來西亞,東協,2,2,0,0,0,0,2,2,0,0,0,0,0,0,0
109,公立,技專校院,0022,國立臺灣科技大學,博士班,捷克共和國,歐洲,1,1,0,1,1,0,0,0,0,0,0,0,0,0,0
109,公立,技專校院,0022,國立臺灣科技大學,博士班,義大利共和國,歐洲,1,1,0,1,1,0,0,0,0,0,0,0,0,0,0
109,公立,技專校院,0022,國立臺灣科技大學,博士班,聖露西亞,中南美洲,1,0,1,1,0,1,0,0,0,0,0,0,0,0,0
109,公立,技專校院,0022,國立臺灣科技大學,博士班,葡萄牙共和國,歐洲,1,0,1,1,0,1,0,0,0,0,0,0,0,0,0
109,公立,技專校院,0022,國立臺灣科技大學,博士班,蒙古國,其他亞洲地區,2,0,2,2,0,2,0,0,0,0,0,0,0,0,0
109,公立,技專校院,0022,國立臺灣科技大學,博士班,德意志聯邦共和國,歐洲,2,2,0,2,2,0,0,0,0,0,0,0,0,0,0
109,公立,技專校院,0022,國立臺灣科技大學,博士班,澳大利亞,其他亞洲地區,1,1,0,1,1,0,0,0,0,0,0,0,0,0,0
109,公立,技專校院,0023,國立雲林科技大學,學士班(日間),大陸地區,大陸地區,52,20,32,0,0,0,0,0,0,0,0,0,52,20,32
109,公立,技專校院,0023,國立雲林科技大學,學士班(日間),日本,其他亞洲地區,9,6,3,9,6,3,0,0,0,0,0,0,0,0,0
109,公立,技專校院,0023,國立雲林科技大學,學士班(日間),美國,北美洲,2,1,1,0,0,0,2,1,1,0,0,0,0,0,0
109,公立,技專校院,0023,國立雲林科技大學,學士班(日間),香港,港澳,54,28,26,0,0,0,0,0,0,54,28,26,0,0,0
109,公立,技專校院,0023,國立雲林科技大學,學士班(日間),馬來西亞,東協,124,72,52,16,8,8,108,64,44,0,0,0,0,0,0
109,公立,技專校院,0023,國立雲林科技大學,學士班(日間),緬甸,東協,3,1,2,0,0,0,3,1,2,0,0,0,0,0,0
109,公立,技專校院,0023,國立雲林科技大學,學士班(日間),印度尼西亞共和國,東協,39,17,22,8,1,7,31,16,15,0,0,0,0,0,0
109,公立,技專校院,0023,國立雲林科技大學,學士班(日間),阿根廷,中南美洲,1,1,0,0,0,0,1,1,0,0,0,0,0,0,0
109,公立,技專校院,0023,國立雲林科技大學,學士班(日間),越南社會主義共和國,東協,17,9,8,5,1,4,12,8,4,0,0,0,0,0,0
109,公立,技專校院,0023,國立雲林科技大學,學士班(日間),澳門,港澳,15,3,12,0,0,0,0,0,0,15,3,12,0,0,0
109,公立,技專校院,0023,國立雲林科技大學,碩士班(日間),大陸地區,大陸地區,20,14,6,0,0,0,0,0,0,0,0,0,20,14,6
109,公立,技專校院,0023,國立雲林科技大學,碩士班(日間),印度尼西亞共和國,東協,42,17,25,42,17,25,0,0,0,0,0,0,0,0,0
109,公立,技專校院,0023,國立雲林科技大學,碩士班(日間),香港,港澳,4,1,3,0,0,0,0,0,0,4,1,3,0,0,0
109,公立,技專校院,0023,國立雲林科技大學,碩士班(日間),泰國,東協,4,1,3,4,1,3,0,0,0,0,0,0,0,0,0
109,公立,技專校院,0023,國立雲林科技大學,碩士班(日間),烏干達共和國,非洲,1,0,1,1,0,1,0,0,0,0,0,0,0,0,0
109,公立,技專校院,0023,國立雲林科技大學,碩士班(日間),馬來西亞,東協,4,2,2,4,2,2,0,0,0,0,0,0,0,0,0
109,公立,技專校院,0023,國立雲林科技大學,碩士班(日間),越南社會主義共和國,東協,9,1,8,9,1,8,0,0,0,0,0,0,0,0,0
109,公立,技專校院,0023,國立雲林科技大學,碩士班(日間),印度,南亞,3,3,0,3,3,0,0,0,0,0,0,0,0,0,0
109,公立,技專校院,0023,國立雲林科技大學,碩士班(日間),美國,北美洲,1,1,0,1,1,0,0,0,0,0,0,0,0,0,0
109,公立,技專校院,0023,國立雲林科技大學,博士班,大陸地區,大陸地區,27,13,14,0,0,0,0,0,0,0,0,0,27,13,14
109,公立,技專校院,0023,國立雲林科技大學,博士班,伊拉克共和國,其他亞洲地區,1,1,0,1,1,0,0,0,0,0,0,0,0,0,0
109,公立,技專校院,0023,國立雲林科技大學,博士班,印度尼西亞共和國,東協,31,14,17,31,14,17,0,0,0,0,0,0,0,0,0
109,公立,技專校院,0023,國立雲林科技大學,博士班,俄羅斯聯邦,其他亞洲地區,1,0,1,1,0,1,0,0,0,0,0,0,0,0,0
109,公立,技專校院,0023,國立雲林科技大學,博士班,烏干達共和國,非洲,1,1,0,1,1,0,0,0,0,0,0,0,0,0,0
109,公立,技專校院,0023,國立雲林科技大學,博士班,馬來西亞,東協,1,1,0,1,1,0,0,0,0,0,0,0,0,0,0
109,公立,技專校院,0023,國立雲林科技大學,博士班,巴基斯坦,南亞,1,1,0,1,1,0,0,0,0,0,0,0,0,0,0
109,公立,技專校院,0023,國立雲林科技大學,博士班,辛巴威共和國,非洲,1,0,1,1,0,1,0,0,0,0,0,0,0,0,0
109,公立,技專校院,0023,國立雲林科技大學,博士班,奈及利亞聯邦共和國,非洲,1,1,0,1,1,0,0,0,0,0,0,0,0,0,0
109,公立,技專校院,0023,國立雲林科技大學,博士班,孟加拉人民共和國,南亞,1,1,0,1,1,0,0,0,0,0,0,0,0,0,0
109,公立,技專校院,0023,國立雲林科技大學,博士班,迦納共和國,非洲,1,1,0,1,1,0,0,0,0,0,0,0,0,0,0
109,公立,技專校院,0023,國立雲林科技大學,博士班,越南社會主義共和國,東協,7,2,5,7,2,5,0,0,0,0,0,0,0,0,0
109,公立,技專校院,0023,國立雲林科技大學,博士班,德意志聯邦共和國,歐洲,1,0,1,1,0,1,0,0,0,0,0,0,0,0,0
109,公立,技專校院,0024,國立屏東科技大學,學士班(日間),大韓民國(南韓),其他亞洲地區,2,2,0,0,0,0,2,2,0,0,0,0,0,0,0
109,公立,技專校院,0024,國立屏東科技大學,學士班(日間),日本,其他亞洲地區,3,0,3,2,0,2,1,0,1,0,0,0,0,0,0
109,公立,技專校院,0024,國立屏東科技大學,學士班(日間),尼泊爾聯邦民主共和國,南亞,26,8,18,26,8,18,0,0,0,0,0,0,0,0,0
109,公立,技專校院,0024,國立屏東科技大學,學士班(日間),甘比亞共和國,非洲,2,1,1,2,1,1,0,0,0,0,0,0,0,0,0
109,公立,技專校院,0024,國立屏東科技大學,學士班(日間),印度,南亞,5,5,0,5,5,0,0,0,0,0,0,0,0,0,0
109,公立,技專校院,0024,國立屏東科技大學,學士班(日間),宏都拉斯共和國,中南美洲,5,2,3,5,2,3,0,0,0,0,0,0,0,0,0
109,公立,技專校院,0024,國立屏東科技大學,學士班(日間),汶萊和平之國,東協,2,1,1,1,0,1,1,1,0,0,0,0,0,0,0
109,公立,技專校院,0024,國立屏東科技大學,學士班(日間),美國,北美洲,1,0,1,0,0,0,1,0,1,0,0,0,0,0,0
109,公立,技專校院,0024,國立屏東科技大學,學士班(日間),馬拉威共和國,非洲,2,2,0,2,2,0,0,0,0,0,0,0,0,0,0
109,公立,技專校院,0024,國立屏東科技大學,學士班(日間),新加坡共和國,東協,2,0,2,2,0,2,0,0,0,0,0,0,0,0,0
109,公立,技專校院,0024,國立屏東科技大學,學士班(日間),聖文森(及格瑞那丁),中南美洲,1,0,1,1,0,1,0,0,0,0,0,0,0,0,0
109,公立,技專校院,0024,國立屏東科技大學,學士班(日間),聖克里斯多福及尼維斯,中南美洲,1,1,0,1,1,0,0,0,0,0,0,0,0,0,0
109,公立,技專校院,0024,國立屏東科技大學,學士班(日間),大陸地區,大陸地區,4,2,2,0,0,0,0,0,0,0,0,0,4,2,2
109,公立,技專校院,0024,國立屏東科技大學,學士班(日間),巴布亞紐幾內亞獨立國,其他亞洲地區,1,0,1,1,0,1,0,0,0,0,0,0,0,0,0
109,公立,技專校院,0024,國立屏東科技大學,學士班(日間),史瓦帝尼王國,非洲,3,2,1,3,2,1,0,0,0,0,0,0,0,0,0
109,公立,技專校院,0024,國立屏東科技大學,學士班(日間),瓜地馬拉共和國,中南美洲,3,3,0,3,3,0,0,0,0,0,0,0,0,0,0
109,公立,技專校院,0024,國立屏東科技大學,學士班(日間),印度尼西亞共和國,東協,14,6,8,8,5,3,6,1,5,0,0,0,0,0,0
109,公立,技專校院,0024,國立屏東科技大學,學士班(日間),吐瓦魯,其他亞洲地區,2,1,1,2,1,1,0,0,0,0,0,0,0,0,0
109,公立,技專校院,0024,國立屏東科技大學,學士班(日間),貝里斯,中南美洲,7,3,4,7,3,4,0,0,0,0,0,0,0,0,0
109,公立,技專校院,0024,國立屏東科技大學,學士班(日間),帛琉共和國,其他亞洲地區,3,0,3,3,0,3,0,0,0,0,0,0,0,0,0
109,公立,技專校院,0024,國立屏東科技大學,學士班(日間),英國,歐洲,1,1,0,1,1,0,0,0,0,0,0,0,0,0,0
109,公立,技專校院,0024,國立屏東科技大學,學士班(日間),香港,港澳,36,22,14,0,0,0,0,0,0,36,22,14,0,0,0
109,公立,技專校院,0024,國立屏東科技大學,學士班(日間),泰國,東協,2,2,0,1,1,0,1,1,0,0,0,0,0,0,0
109,公立,技專校院,0024,國立屏東科技大學,學士班(日間),海地共和國,中南美洲,3,2,1,3,2,1,0,0,0,0,0,0,0,0,0
109,公立,技專校院,0024,國立屏東科技大學,學士班(日間),馬來西亞,東協,141,87,54,21,20,1,120,67,53,0,0,0,0,0,0
109,公立,技專校院,0024,國立屏東科技大學,學士班(日間),馬紹爾群島共和國,其他亞洲地區,1,1,0,1,1,0,0,0,0,0,0,0,0,0,0
109,公立,技專校院,0024,國立屏東科技大學,學士班(日間),越南社會主義共和國,東協,5,1,4,4,0,4,1,1,0,0,0,0,0,0,0
109,公立,技專校院,0024,國立屏東科技大學,學士班(日間),聖露西亞,中南美洲,2,1,1,2,1,1,0,0,0,0,0,0,0,0,0
109,公立,技專校院,0024,國立屏東科技大學,學士班(日間),蒙古國,其他亞洲地區,1,0,1,1,0,1,0,0,0,0,0,0,0,0,0
109,公立,技專校院,0024,國立屏東科技大學,學士班(日間),緬甸,東協,3,1,2,0,0,0,3,1,2,0,0,0,0,0,0
109,公立,技專校院,0024,國立屏東科技大學,學士班(日間),澳門,港澳,20,9,11,0,0,0,0,0,0,20,9,11,0,0,0
109,公立,技專校院,0024,國立屏東科技大學,碩士班(日間),巴布亞紐幾內亞獨立國,其他亞洲地區,1,1,0,1,1,0,0,0,0,0,0,0,0,0,0
109,公立,技專校院,0024,國立屏東科技大學,碩士班(日間),巴基斯坦,南亞,2,2,0,2,2,0,0,0,0,0,0,0,0,0,0
109,公立,技專校院,0024,國立屏東科技大學,碩士班(日間),史瓦帝尼王國,非洲,8,3,5,8,3,5,0,0,0,0,0,0,0,0,0
109,公立,技專校院,0024,國立屏東科技大學,碩士班(日間),尼加拉瓜,中南美洲,1,1,0,1,1,0,0,0,0,0,0,0,0,0,0
109,公立,技專校院,0024,國立屏東科技大學,碩士班(日間),甘比亞共和國,非洲,1,0,1,1,0,1,0,0,0,0,0,0,0,0,0
109,公立,技專校院,0024,國立屏東科技大學,碩士班(日間),印度尼西亞共和國,東協,23,7,16,21,6,15,2,1,1,0,0,0,0,0,0
109,公立,技專校院,0024,國立屏東科技大學,碩士班(日間),宏都拉斯共和國,中南美洲,2,1,1,2,1,1,0,0,0,0,0,0,0,0,0
109,公立,技專校院,0024,國立屏東科技大學,碩士班(日間),貝里斯,中南美洲,5,3,2,5,3,2,0,0,0,0,0,0,0,0,0
109,公立,技專校院,0024,國立屏東科技大學,碩士班(日間),香港,港澳,10,6,4,0,0,0,0,0,0,10,6,4,0,0,0
109,公立,技專校院,0024,國立屏東科技大學,碩士班(日間),泰國,東協,5,2,3,5,2,3,0,0,0,0,0,0,0,0,0
109,公立,技專校院,0024,國立屏東科技大學,碩士班(日間),海地共和國,中南美洲,3,2,1,3,2,1,0,0,0,0,0,0,0,0,0
109,公立,技專校院,0024,國立屏東科技大學,碩士班(日間),斐濟群島共和國,其他亞洲地區,1,0,1,1,0,1,0,0,0,0,0,0,0,0,0
109,公立,技專校院,0024,國立屏東科技大學,碩士班(日間),越南社會主義共和國,東協,21,6,15,21,6,15,0,0,0,0,0,0,0,0,0
109,公立,技專校院,0024,國立屏東科技大學,碩士班(日間),聖文森(及格瑞那丁),中南美洲,2,1,1,2,1,1,0,0,0,0,0,0,0,0,0
109,公立,技專校院,0024,國立屏東科技大學,碩士班(日間),蒙古國,其他亞洲地區,3,0,3,3,0,3,0,0,0,0,0,0,0,0,0
109,公立,技專校院,0024,國立屏東科技大學,碩士班(日間),緬甸,東協,1,0,1,0,0,0,1,0,1,0,0,0,0,0,0
109,公立,技專校院,0024,國立屏東科技大學,碩士班(日間),澳門,港澳,1,1,0,0,0,0,0,0,0,1,1,0,0,0,0
109,公立,技專校院,0024,國立屏東科技大學,碩士班(日間),日本,其他亞洲地區,1,0,1,1,0,1,0,0,0,0,0,0,0,0,0
109,公立,技專校院,0024,國立屏東科技大學,碩士班(日間),尼泊爾聯邦民主共和國,南亞,5,2,3,5,2,3,0,0,0,0,0,0,0,0,0
109,公立,技專校院,0024,國立屏東科技大學,碩士班(日間),印度,南亞,1,1,0,1,1,0,0,0,0,0,0,0,0,0,0
109,公立,技專校院,0024,國立屏東科技大學,碩士班(日間),馬來西亞,東協,16,11,5,6,5,1,10,6,4,0,0,0,0,0,0
109,公立,技專校院,0024,國立屏東科技大學,碩士班(日間),聖克里斯多福及尼維斯,中南美洲,2,1,1,2,1,1,0,0,0,0,0,0,0,0,0
109,公立,技專校院,0024,國立屏東科技大學,碩士班(日間),薩爾瓦多,中南美洲,2,1,1,2,1,1,0,0,0,0,0,0,0,0,0
109,公立,技專校院,0024,國立屏東科技大學,博士班,巴布亞紐幾內亞獨立國,其他亞洲地區,1,1,0,1,1,0,0,0,0,0,0,0,0,0,0
109,公立,技專校院,0024,國立屏東科技大學,博士班,印度,南亞,7,4,3,7,4,3,0,0,0,0,0,0,0,0,0
109,公立,技專校院,0024,國立屏東科技大學,博士班,印度尼西亞共和國,東協,22,13,9,22,13,9,0,0,0,0,0,0,0,0,0
109,公立,技專校院,0024,國立屏東科技大學,博士班,貝里斯,中南美洲,1,1,0,1,1,0,0,0,0,0,0,0,0,0,0
109,公立,技專校院,0024,國立屏東科技大學,博士班,辛巴威共和國,非洲,1,1,0,1,1,0,0,0,0,0,0,0,0,0,0
109,公立,技專校院,0024,國立屏東科技大學,博士班,南非共和國,非洲,1,0,1,1,0,1,0,0,0,0,0,0,0,0,0
109,公立,技專校院,0024,國立屏東科技大學,博士班,柬埔寨王國,東協,1,1,0,1,1,0,0,0,0,0,0,0,0,0,0
109,公立,技專校院,0024,國立屏東科技大學,博士班,英國,歐洲,2,2,0,2,2,0,0,0,0,0,0,0,0,0,0
109,公立,技專校院,0024,國立屏東科技大學,博士班,香港,港澳,1,1,0,0,0,0,0,0,0,1,1,0,0,0,0
109,公立,技專校院,0024,國立屏東科技大學,博士班,馬來西亞,東協,1,1,0,0,0,0,1,1,0,0,0,0,0,0,0
109,公立,技專校院,0024,國立屏東科技大學,博士班,越南社會主義共和國,東協,19,11,8,19,11,8,0,0,0,0,0,0,0,0,0
109,公立,技專校院,0024,國立屏東科技大學,博士班,寮人民民主共和國(寮國),東協,1,0,1,1,0,1,0,0,0,0,0,0,0,0,0
109,公立,技專校院,0024,國立屏東科技大學,博士班,史瓦帝尼王國,非洲,3,3,0,3,3,0,0,0,0,0,0,0,0,0,0
109,公立,技專校院,0024,國立屏東科技大學,博士班,尼泊爾聯邦民主共和國,南亞,3,2,1,3,2,1,0,0,0,0,0,0,0,0,0
109,公立,技專校院,0024,國立屏東科技大學,博士班,甘比亞共和國,非洲,2,2,0,2,2,0,0,0,0,0,0,0,0,0,0
109,公立,技專校院,0024,國立屏東科技大學,博士班,泰國,東協,29,12,17,29,12,17,0,0,0,0,0,0,0,0,0
109,公立,技專校院,0024,國立屏東科技大學,博士班,索羅門群島,其他亞洲地區,2,1,1,2,1,1,0,0,0,0,0,0,0,0,0
109,公立,技專校院,0024,國立屏東科技大學,博士班,捷克共和國,歐洲,1,1,0,1,1,0,0,0,0,0,0,0,0,0,0
109,公立,技專校院,0024,國立屏東科技大學,博士班,蒙古國,其他亞洲地區,3,0,3,3,0,3,0,0,0,0,0,0,0,0,0
109,公立,技專校院,0025,國立臺北科技大學,五專,泰國,東協,1,1,0,0,0,0,1,1,0,0,0,0,0,0,0
109,公立,技專校院,0025,國立臺北科技大學,五專,印度尼西亞共和國,東協,1,1,0,0,0,0,1,1,0,0,0,0,0,0,0
109,公立,技專校院,0025,國立臺北科技大學,學士班(日間),大韓民國(南韓),其他亞洲地區,7,1,6,4,1,3,3,0,3,0,0,0,0,0,0
109,公立,技專校院,0025,國立臺北科技大學,學士班(日間),巴拿馬共和國,中南美洲,4,2,2,4,2,2,0,0,0,0,0,0,0,0,0
109,公立,技專校院,0025,國立臺北科技大學,學士班(日間),日本,其他亞洲地區,10,4,6,6,3,3,4,1,3,0,0,0,0,0,0
109,公立,技專校院,0025,國立臺北科技大學,學士班(日間),西班牙王國,歐洲,1,1,0,1,1,0,0,0,0,0,0,0,0,0,0
109,公立,技專校院,0025,國立臺北科技大學,學士班(日間),宏都拉斯共和國,中南美洲,9,6,3,9,6,3,0,0,0,0,0,0,0,0,0
109,公立,技專校院,0025,國立臺北科技大學,學士班(日間),奈及利亞聯邦共和國,非洲,1,1,0,1,1,0,0,0,0,0,0,0,0,0,0
109,公立,技專校院,0025,國立臺北科技大學,學士班(日間),帛琉共和國,其他亞洲地區,2,2,0,2,2,0,0,0,0,0,0,0,0,0,0
109,公立,技專校院,0025,國立臺北科技大學,學士班(日間),約旦哈什米王國,其他亞洲地區,1,1,0,1,1,0,0,0,0,0,0,0,0,0,0
109,公立,技專校院,0025,國立臺北科技大學,學士班(日間),美國,北美洲,2,1,1,1,1,0,1,0,1,0,0,0,0,0,0
109,公立,技專校院,0025,國立臺北科技大學,學士班(日間),香港,港澳,130,80,50,0,0,0,0,0,0,130,80,50,0,0,0
109,公立,技專校院,0025,國立臺北科技大學,學士班(日間),海地共和國,中南美洲,4,4,0,4,4,0,0,0,0,0,0,0,0,0,0
109,公立,技專校院,0025,國立臺北科技大學,學士班(日間),馬來西亞,東協,134,93,41,23,15,8,111,78,33,0,0,0,0,0,0
109,公立,技專校院,0025,國立臺北科技大學,學士班(日間),馬拉威共和國,非洲,1,1,0,1,1,0,0,0,0,0,0,0,0,0,0
109,公立,技專校院,0025,國立臺北科技大學,學士班(日間),新加坡共和國,東協,1,0,1,1,0,1,0,0,0,0,0,0,0,0,0
109,公立,技專校院,0025,國立臺北科技大學,學士班(日間),聖文森(及格瑞那丁),中南美洲,6,4,2,6,4,2,0,0,0,0,0,0,0,0,0
109,公立,技專校院,0025,國立臺北科技大學,學士班(日間),聖克里斯多福及尼維斯,中南美洲,2,1,1,2,1,1,0,0,0,0,0,0,0,0,0
109,公立,技專校院,0025,國立臺北科技大學,學士班(日間),聖露西亞,中南美洲,3,1,2,3,1,2,0,0,0,0,0,0,0,0,0
109,公立,技專校院,0025,國立臺北科技大學,學士班(日間),緬甸,東協,31,20,11,0,0,0,31,20,11,0,0,0,0,0,0
109,公立,技專校院,0025,國立臺北科技大學,學士班(日間),大陸地區,大陸地區,78,36,42,0,0,0,0,0,0,0,0,0,78,36,42
109,公立,技專校院,0025,國立臺北科技大學,學士班(日間),巴西聯邦共和國,中南美洲,2,1,1,0,0,0,2,1,1,0,0,0,0,0,0
109,公立,技專校院,0025,國立臺北科技大學,學士班(日間),巴拉圭,中南美洲,16,8,8,16,8,8,0,0,0,0,0,0,0,0,0
109,公立,技專校院,0025,國立臺北科技大學,學士班(日間),加拿大,北美洲,3,3,0,1,1,0,2,2,0,0,0,0,0,0,0
109,公立,技專校院,0025,國立臺北科技大學,學士班(日間),史瓦帝尼王國,非洲,1,0,1,1,0,1,0,0,0,0,0,0,0,0,0
109,公立,技專校院,0025,國立臺北科技大學,學士班(日間),尼加拉瓜,中南美洲,5,4,1,5,4,1,0,0,0,0,0,0,0,0,0
109,公立,技專校院,0025,國立臺北科技大學,學士班(日間),瓜地馬拉共和國,中南美洲,4,1,3,3,1,2,1,0,1,0,0,0,0,0,0
109,公立,技專校院,0025,國立臺北科技大學,學士班(日間),伊朗伊斯蘭共和國,其他亞洲地區,1,0,1,0,0,0,1,0,1,0,0,0,0,0,0
109,公立,技專校院,0025,國立臺北科技大學,學士班(日間),印度尼西亞共和國,東協,69,36,33,16,9,7,53,27,26,0,0,0,0,0,0
109,公立,技專校院,0025,國立臺北科技大學,學士班(日間),貝里斯,中南美洲,2,0,2,2,0,2,0,0,0,0,0,0,0,0,0
109,公立,技專校院,0025,國立臺北科技大學,學士班(日間),委內瑞拉共和國,中南美洲,1,0,1,0,0,0,1,0,1,0,0,0,0,0,0
109,公立,技專校院,0025,國立臺北科技大學,學士班(日間),阿根廷,中南美洲,1,0,1,0,0,0,1,0,1,0,0,0,0,0,0
109,公立,技專校院,0025,國立臺北科技大學,學士班(日間),泰國,東協,16,8,8,11,6,5,5,2,3,0,0,0,0,0,0
109,公立,技專校院,0025,國立臺北科技大學,學士班(日間),馬紹爾群島共和國,其他亞洲地區,3,3,0,3,3,0,0,0,0,0,0,0,0,0,0
109,公立,技專校院,0025,國立臺北科技大學,學士班(日間),菲律賓共和國,東協,2,2,0,2,2,0,0,0,0,0,0,0,0,0,0
109,公立,技專校院,0025,國立臺北科技大學,學士班(日間),越南社會主義共和國,東協,38,17,21,19,6,13,19,11,8,0,0,0,0,0,0
109,公立,技專校院,0025,國立臺北科技大學,學士班(日間),葉門共和國,其他亞洲地區,1,1,0,1,1,0,0,0,0,0,0,0,0,0,0
109,公立,技專校院,0025,國立臺北科技大學,學士班(日間),澳門,港澳,37,23,14,0,0,0,0,0,0,37,23,14,0,0,0
109,公立,技專校院,0025,國立臺北科技大學,碩士班(日間),土耳其共和國,其他亞洲地區,1,1,0,1,1,0,0,0,0,0,0,0,0,0,0
109,公立,技專校院,0025,國立臺北科技大學,碩士班(日間),大陸地區,大陸地區,48,34,14,0,0,0,0,0,0,0,0,0,48,34,14
109,公立,技專校院,0025,國立臺北科技大學,碩士班(日間),巴拉圭,中南美洲,3,1,2,3,1,2,0,0,0,0,0,0,0,0,0
109,公立,技專校院,0025,國立臺北科技大學,碩士班(日間),比利時王國,歐洲,1,0,1,1,0,1,0,0,0,0,0,0,0,0,0
109,公立,技專校院,0025,國立臺北科技大學,碩士班(日間),加拿大,北美洲,2,1,1,0,0,0,2,1,1,0,0,0,0,0,0
109,公立,技專校院,0025,國立臺北科技大學,碩士班(日間),史瓦帝尼王國,非洲,2,2,0,2,2,0,0,0,0,0,0,0,0,0,0
109,公立,技專校院,0025,國立臺北科技大學,碩士班(日間),尼加拉瓜,中南美洲,2,2,0,2,2,0,0,0,0,0,0,0,0,0,0
109,公立,技專校院,0025,國立臺北科技大學,碩士班(日間),瓜地馬拉共和國,中南美洲,2,2,0,2,2,0,0,0,0,0,0,0,0,0,0
109,公立,技專校院,0025,國立臺北科技大學,碩士班(日間),甘比亞共和國,非洲,1,1,0,1,1,0,0,0,0,0,0,0,0,0,0
109,公立,技專校院,0025,國立臺北科技大學,碩士班(日間),伊朗伊斯蘭共和國,其他亞洲地區,1,0,1,1,0,1,0,0,0,0,0,0,0,0,0
109,公立,技專校院,0025,國立臺北科技大學,碩士班(日間),印度尼西亞共和國,東協,23,12,11,22,12,10,1,0,1,0,0,0,0,0,0
109,公立,技專校院,0025,國立臺北科技大學,碩士班(日間),衣索比亞聯邦民主共和國,非洲,2,2,0,2,2,0,0,0,0,0,0,0,0,0,0
109,公立,技專校院,0025,國立臺北科技大學,碩士班(日間),宏都拉斯共和國,中南美洲,2,2,0,2,2,0,0,0,0,0,0,0,0,0,0
109,公立,技專校院,0025,國立臺北科技大學,碩士班(日間),波蘭共和國,歐洲,2,1,1,2,1,1,0,0,0,0,0,0,0,0,0
109,公立,技專校院,0025,國立臺北科技大學,碩士班(日間),香港,港澳,9,6,3,0,0,0,0,0,0,9,6,3,0,0,0
109,公立,技專校院,0025,國立臺北科技大學,碩士班(日間),哥倫比亞共和國,中南美洲,1,1,0,1,1,0,0,0,0,0,0,0,0,0,0
109,公立,技專校院,0025,國立臺北科技大學,碩士班(日間),泰國,東協,32,16,16,31,15,16,1,1,0,0,0,0,0,0,0
109,公立,技專校院,0025,國立臺北科技大學,碩士班(日間),秘魯共和國,中南美洲,1,0,1,1,0,1,0,0,0,0,0,0,0,0,0
109,公立,技專校院,0025,國立臺北科技大學,碩士班(日間),馬來西亞,東協,8,7,1,4,3,1,4,4,0,0,0,0,0,0,0
109,公立,技專校院,0025,國立臺北科技大學,碩士班(日間),越南社會主義共和國,東協,43,16,27,43,16,27,0,0,0,0,0,0,0,0,0
109,公立,技專校院,0025,國立臺北科技大學,碩士班(日間),奧地利共和國,歐洲,1,1,0,1,1,0,0,0,0,0,0,0,0,0,0
109,公立,技專校院,0025,國立臺北科技大學,碩士班(日間),摩洛哥王國,非洲,1,0,1,1,0,1,0,0,0,0,0,0,0,0,0
109,公立,技專校院,0025,國立臺北科技大學,碩士班(日間),緬甸,東協,1,1,0,1,1,0,0,0,0,0,0,0,0,0,0
109,公立,技專校院,0025,國立臺北科技大學,碩士班(日間),澳門,港澳,1,0,1,0,0,0,0,0,0,1,0,1,0,0,0
109,公立,技專校院,0025,國立臺北科技大學,碩士班(日間),大韓民國(南韓),其他亞洲地區,1,0,1,1,0,1,0,0,0,0,0,0,0,0,0
109,公立,技專校院,0025,國立臺北科技大學,碩士班(日間),厄瓜多共和國,中南美洲,1,1,0,1,1,0,0,0,0,0,0,0,0,0,0
109,公立,技專校院,0025,國立臺北科技大學,碩士班(日間),尼泊爾聯邦民主共和國,南亞,1,1,0,1,1,0,0,0,0,0,0,0,0,0,0
109,公立,技專校院,0025,國立臺北科技大學,碩士班(日間),布吉納法索,非洲,2,2,0,2,2,0,0,0,0,0,0,0,0,0,0
109,公立,技專校院,0025,國立臺北科技大學,碩士班(日間),伊拉克共和國,其他亞洲地區,1,1,0,1,1,0,0,0,0,0,0,0,0,0,0
109,公立,技專校院,0025,國立臺北科技大學,碩士班(日間),印度,南亞,29,24,5,29,24,5,0,0,0,0,0,0,0,0,0
109,公立,技專校院,0025,國立臺北科技大學,碩士班(日間),西班牙王國,歐洲,1,1,0,1,1,0,0,0,0,0,0,0,0,0,0
109,公立,技專校院,0025,國立臺北科技大學,碩士班(日間),俄羅斯聯邦,其他亞洲地區,3,1,2,3,1,2,0,0,0,0,0,0,0,0,0
109,公立,技專校院,0025,國立臺北科技大學,碩士班(日間),美國,北美洲,1,1,0,1,1,0,0,0,0,0,0,0,0,0,0
109,公立,技專校院,0025,國立臺北科技大學,碩士班(日間),斯洛伐克共和國,歐洲,1,1,0,1,1,0,0,0,0,0,0,0,0,0,0
109,公立,技專校院,0025,國立臺北科技大學,碩士班(日間),菲律賓共和國,東協,3,1,2,3,1,2,0,0,0,0,0,0,0,0,0
109,公立,技專校院,0025,國立臺北科技大學,碩士班(日間),聖文森(及格瑞那丁),中南美洲,1,1,0,1,1,0,0,0,0,0,0,0,0,0,0
109,公立,技專校院,0025,國立臺北科技大學,碩士班(日間),聖露西亞,中南美洲,1,1,0,1,1,0,0,0,0,0,0,0,0,0,0
109,公立,技專校院,0025,國立臺北科技大學,碩士班(日間),蒙古國,其他亞洲地區,8,3,5,8,3,5,0,0,0,0,0,0,0,0,0
109,公立,技專校院,0025,國立臺北科技大學,碩士班(日間),德意志聯邦共和國,歐洲,2,1,1,2,1,1,0,0,0,0,0,0,0,0,0
109,公立,技專校院,0025,國立臺北科技大學,博士班,日本,其他亞洲地區,1,1,0,1,1,0,0,0,0,0,0,0,0,0,0
109,公立,技專校院,0025,國立臺北科技大學,博士班,布吉納法索,非洲,3,3,0,3,3,0,0,0,0,0,0,0,0,0,0
109,公立,技專校院,0025,國立臺北科技大學,博士班,印度尼西亞共和國,東協,5,5,0,4,4,0,1,1,0,0,0,0,0,0,0
109,公立,技專校院,0025,國立臺北科技大學,博士班,西班牙王國,歐洲,1,1,0,1,1,0,0,0,0,0,0,0,0,0,0
109,公立,技專校院,0025,國立臺北科技大學,博士班,俄羅斯聯邦,其他亞洲地區,1,1,0,1,1,0,0,0,0,0,0,0,0,0,0
109,公立,技專校院,0025,國立臺北科技大學,博士班,馬來西亞,東協,1,1,0,1,1,0,0,0,0,0,0,0,0,0,0
109,公立,技專校院,0025,國立臺北科技大學,博士班,聖文森(及格瑞那丁),中南美洲,1,1,0,1,1,0,0,0,0,0,0,0,0,0,0
109,公立,技專校院,0025,國立臺北科技大學,博士班,葡萄牙共和國,歐洲,1,1,0,1,1,0,0,0,0,0,0,0,0,0,0
109,公立,技專校院,0025,國立臺北科技大學,博士班,大陸地區,大陸地區,28,21,7,0,0,0,0,0,0,0,0,0,28,21,7
109,公立,技專校院,0025,國立臺北科技大學,博士班,厄瓜多共和國,中南美洲,1,1,0,1,1,0,0,0,0,0,0,0,0,0,0
109,公立,技專校院,0025,國立臺北科技大學,博士班,尼加拉瓜,中南美洲,2,2,0,2,2,0,0,0,0,0,0,0,0,0,0
109,公立,技專校院,0025,國立臺北科技大學,博士班,瓜地馬拉共和國,中南美洲,1,0,1,1,0,1,0,0,0,0,0,0,0,0,0
109,公立,技專校院,0025,國立臺北科技大學,博士班,甘比亞共和國,非洲,1,1,0,1,1,0,0,0,0,0,0,0,0,0,0
109,公立,技專校院,0025,國立臺北科技大學,博士班,印度,南亞,61,46,15,61,46,15,0,0,0,0,0,0,0,0,0
109,公立,技專校院,0025,國立臺北科技大學,博士班,衣索比亞聯邦民主共和國,非洲,7,7,0,7,7,0,0,0,0,0,0,0,0,0,0
109,公立,技專校院,0025,國立臺北科技大學,博士班,貝里斯,中南美洲,1,1,0,1,1,0,0,0,0,0,0,0,0,0,0
109,公立,技專校院,0025,國立臺北科技大學,博士班,坦尚尼亞聯合共和國,非洲,1,1,0,1,1,0,0,0,0,0,0,0,0,0,0
109,公立,技專校院,0025,國立臺北科技大學,博士班,法國,歐洲,1,1,0,1,1,0,0,0,0,0,0,0,0,0,0
109,公立,技專校院,0025,國立臺北科技大學,博士班,香港,港澳,1,0,1,0,0,0,0,0,0,1,0,1,0,0,0
109,公立,技專校院,0025,國立臺北科技大學,博士班,埃及阿拉伯共和國,非洲,1,1,0,1,1,0,0,0,0,0,0,0,0,0,0
109,公立,技專校院,0025,國立臺北科技大學,博士班,泰國,東協,5,0,5,5,0,5,0,0,0,0,0,0,0,0,0
109,公立,技專校院,0025,國立臺北科技大學,博士班,越南社會主義共和國,東協,22,13,9,22,13,9,0,0,0,0,0,0,0,0,0
109,公立,一般大學,0028,國立臺北藝術大學,學士班(日間),大陸地區,大陸地區,9,0,9,0,0,0,0,0,0,0,0,0,9,0,9
109,公立,一般大學,0028,國立臺北藝術大學,學士班(日間),日本,其他亞洲地區,2,1,1,2,1,1,0,0,0,0,0,0,0,0,0
109,公立,一般大學,0028,國立臺北藝術大學,學士班(日間),加拿大,北美洲,1,1,0,1,1,0,0,0,0,0,0,0,0,0,0
109,公立,一般大學,0028,國立臺北藝術大學,學士班(日間),法國,歐洲,1,0,1,1,0,1,0,0,0,0,0,0,0,0,0
109,公立,一般大學,0028,國立臺北藝術大學,學士班(日間),香港,港澳,45,12,33,0,0,0,0,0,0,45,12,33,0,0,0
109,公立,一般大學,0028,國立臺北藝術大學,學士班(日間),馬來西亞,東協,30,15,15,14,7,7,16,8,8,0,0,0,0,0,0
109,公立,一般大學,0028,國立臺北藝術大學,學士班(日間),瑞士聯邦,歐洲,1,1,0,1,1,0,0,0,0,0,0,0,0,0,0
109,公立,一般大學,0028,國立臺北藝術大學,學士班(日間),巴西聯邦共和國,中南美洲,1,0,1,1,0,1,0,0,0,0,0,0,0,0,0
109,公立,一般大學,0028,國立臺北藝術大學,學士班(日間),巴拿馬共和國,中南美洲,1,0,1,1,0,1,0,0,0,0,0,0,0,0,0
109,公立,一般大學,0028,國立臺北藝術大學,學士班(日間),瓜地馬拉共和國,中南美洲,1,0,1,1,0,1,0,0,0,0,0,0,0,0,0
109,公立,一般大學,0028,國立臺北藝術大學,學士班(日間),美國,北美洲,3,3,0,3,3,0,0,0,0,0,0,0,0,0,0
109,公立,一般大學,0028,國立臺北藝術大學,學士班(日間),秘魯共和國,中南美洲,1,0,1,1,0,1,0,0,0,0,0,0,0,0,0
109,公立,一般大學,0028,國立臺北藝術大學,學士班(日間),愛沙尼亞共和國,歐洲,1,0,1,1,0,1,0,0,0,0,0,0,0,0,0
109,公立,一般大學,0028,國立臺北藝術大學,學士班(日間),新加坡共和國,東協,5,2,3,5,2,3,0,0,0,0,0,0,0,0,0
109,公立,一般大學,0028,國立臺北藝術大學,學士班(日間),澳門,港澳,10,4,6,0,0,0,0,0,0,10,4,6,0,0,0
109,公立,一般大學,0028,國立臺北藝術大學,碩士班(日間),尼加拉瓜,中南美洲,1,0,1,1,0,1,0,0,0,0,0,0,0,0,0
109,公立,一般大學,0028,國立臺北藝術大學,碩士班(日間),瓜地馬拉共和國,中南美洲,1,0,1,1,0,1,0,0,0,0,0,0,0,0,0
109,公立,一般大學,0028,國立臺北藝術大學,碩士班(日間),貝里斯,中南美洲,1,0,1,1,0,1,0,0,0,0,0,0,0,0,0
109,公立,一般大學,0028,國立臺北藝術大學,碩士班(日間),美國,北美洲,2,2,0,2,2,0,0,0,0,0,0,0,0,0,0
109,公立,一般大學,0028,國立臺北藝術大學,碩士班(日間),新加坡共和國,東協,2,1,1,2,1,1,0,0,0,0,0,0,0,0,0
109,公立,一般大學,0028,國立臺北藝術大學,碩士班(日間),緬甸,東協,1,1,0,0,0,0,1,1,0,0,0,0,0,0,0
109,公立,一般大學,0028,國立臺北藝術大學,碩士班(日間),大陸地區,大陸地區,32,16,16,0,0,0,0,0,0,0,0,0,32,16,16
109,公立,一般大學,0028,國立臺北藝術大學,碩士班(日間),日本,其他亞洲地區,7,1,6,7,1,6,0,0,0,0,0,0,0,0,0
109,公立,一般大學,0028,國立臺北藝術大學,碩士班(日間),比利時王國,歐洲,1,0,1,1,0,1,0,0,0,0,0,0,0,0,0
109,公立,一般大學,0028,國立臺北藝術大學,碩士班(日間),加拿大,北美洲,2,1,1,2,1,1,0,0,0,0,0,0,0,0,0
109,公立,一般大學,0028,國立臺北藝術大學,碩士班(日間),宏都拉斯共和國,中南美洲,1,1,0,1,1,0,0,0,0,0,0,0,0,0,0
109,公立,一般大學,0028,國立臺北藝術大學,碩士班(日間),法國,歐洲,1,0,1,1,0,1,0,0,0,0,0,0,0,0,0
109,公立,一般大學,0028,國立臺北藝術大學,碩士班(日間),香港,港澳,21,8,13,0,0,0,0,0,0,21,8,13,0,0,0
109,公立,一般大學,0028,國立臺北藝術大學,碩士班(日間),泰國,東協,3,0,3,3,0,3,0,0,0,0,0,0,0,0,0
109,公立,一般大學,0028,國立臺北藝術大學,碩士班(日間),馬來西亞,東協,18,10,8,9,7,2,9,3,6,0,0,0,0,0,0
109,公立,一般大學,0028,國立臺北藝術大學,碩士班(日間),菲律賓共和國,東協,3,1,2,3,1,2,0,0,0,0,0,0,0,0,0
109,公立,一般大學,0028,國立臺北藝術大學,碩士班(日間),澳門,港澳,13,8,5,0,0,0,0,0,0,13,8,5,0,0,0
109,公立,一般大學,0028,國立臺北藝術大學,博士班,大陸地區,大陸地區,10,5,5,0,0,0,0,0,0,0,0,0,10,5,5
109,公立,一般大學,0028,國立臺北藝術大學,博士班,印度尼西亞共和國,東協,1,0,1,1,0,1,0,0,0,0,0,0,0,0,0
109,公立,一般大學,0028,國立臺北藝術大學,博士班,香港,港澳,1,0,1,0,0,0,0,0,0,1,0,1,0,0,0
109,公立,一般大學,0028,國立臺北藝術大學,博士班,馬來西亞,東協,2,1,1,1,0,1,1,1,0,0,0,0,0,0,0
109,公立,一般大學,0029,國立臺灣藝術大學,學士班(日間),大陸地區,大陸地區,12,5,7,0,0,0,0,0,0,0,0,0,12,5,7
109,公立,一般大學,0029,國立臺灣藝術大學,學士班(日間),大韓民國(南韓),其他亞洲地區,3,1,2,3,1,2,0,0,0,0,0,0,0,0,0
109,公立,一般大學,0029,國立臺灣藝術大學,學士班(日間),瓜地馬拉共和國,中南美洲,1,0,1,1,0,1,0,0,0,0,0,0,0,0,0
109,公立,一般大學,0029,國立臺灣藝術大學,學士班(日間),印度尼西亞共和國,東協,3,1,2,0,0,0,3,1,2,0,0,0,0,0,0
109,公立,一般大學,0029,國立臺灣藝術大學,學士班(日間),宏都拉斯共和國,中南美洲,1,0,1,1,0,1,0,0,0,0,0,0,0,0,0
109,公立,一般大學,0029,國立臺灣藝術大學,學士班(日間),阿根廷,中南美洲,1,1,0,0,0,0,1,1,0,0,0,0,0,0,0
109,公立,一般大學,0029,國立臺灣藝術大學,學士班(日間),香港,港澳,51,15,36,0,0,0,0,0,0,51,15,36,0,0,0
109,公立,一般大學,0029,國立臺灣藝術大學,學士班(日間),越南社會主義共和國,東協,1,0,1,1,0,1,0,0,0,0,0,0,0,0,0
109,公立,一般大學,0029,國立臺灣藝術大學,學士班(日間),新加坡共和國,東協,3,0,3,3,0,3,0,0,0,0,0,0,0,0,0
109,公立,一般大學,0029,國立臺灣藝術大學,學士班(日間),澳門,港澳,19,11,8,0,0,0,0,0,0,19,11,8,0,0,0
109,公立,一般大學,0029,國立臺灣藝術大學,學士班(日間),日本,其他亞洲地區,6,1,5,6,1,5,0,0,0,0,0,0,0,0,0
109,公立,一般大學,0029,國立臺灣藝術大學,學士班(日間),玻利維亞共和國,中南美洲,1,0,1,1,0,1,0,0,0,0,0,0,0,0,0
109,公立,一般大學,0029,國立臺灣藝術大學,學士班(日間),美國,北美洲,1,0,1,0,0,0,1,0,1,0,0,0,0,0,0
109,公立,一般大學,0029,國立臺灣藝術大學,學士班(日間),馬來西亞,東協,64,24,40,27,9,18,37,15,22,0,0,0,0,0,0
109,公立,一般大學,0029,國立臺灣藝術大學,碩士班(日間),美國,北美洲,1,0,1,1,0,1,0,0,0,0,0,0,0,0,0
109,公立,一般大學,0029,國立臺灣藝術大學,碩士班(日間),泰國,東協,1,0,1,0,0,0,1,0,1,0,0,0,0,0,0
109,公立,一般大學,0029,國立臺灣藝術大學,碩士班(日間),馬來西亞,東協,6,3,3,1,0,1,5,3,2,0,0,0,0,0,0
109,公立,一般大學,0029,國立臺灣藝術大學,碩士班(日間),義大利共和國,歐洲,1,1,0,1,1,0,0,0,0,0,0,0,0,0,0
109,公立,一般大學,0029,國立臺灣藝術大學,碩士班(日間),大陸地區,大陸地區,18,9,9,0,0,0,0,0,0,0,0,0,18,9,9
109,公立,一般大學,0029,國立臺灣藝術大學,碩士班(日間),大韓民國(南韓),其他亞洲地區,1,0,1,1,0,1,0,0,0,0,0,0,0,0,0
109,公立,一般大學,0029,國立臺灣藝術大學,碩士班(日間),日本,其他亞洲地區,4,0,4,4,0,4,0,0,0,0,0,0,0,0,0
109,公立,一般大學,0029,國立臺灣藝術大學,碩士班(日間),印度尼西亞共和國,東協,1,0,1,1,0,1,0,0,0,0,0,0,0,0,0
109,公立,一般大學,0029,國立臺灣藝術大學,碩士班(日間),香港,港澳,16,6,10,0,0,0,0,0,0,16,6,10,0,0,0
109,公立,一般大學,0029,國立臺灣藝術大學,碩士班(日間),越南社會主義共和國,東協,1,0,1,1,0,1,0,0,0,0,0,0,0,0,0
109,公立,一般大學,0029,國立臺灣藝術大學,碩士班(日間),新加坡共和國,東協,2,0,2,2,0,2,0,0,0,0,0,0,0,0,0
109,公立,一般大學,0029,國立臺灣藝術大學,碩士班(日間),澳門,港澳,10,4,6,0,0,0,0,0,0,10,4,6,0,0,0
109,公立,一般大學,0029,國立臺灣藝術大學,博士班,日本,其他亞洲地區,1,1,0,1,1,0,0,0,0,0,0,0,0,0,0
109,公立,一般大學,0029,國立臺灣藝術大學,博士班,法國,歐洲,1,0,1,1,0,1,0,0,0,0,0,0,0,0,0
109,公立,一般大學,0029,國立臺灣藝術大學,博士班,俄羅斯聯邦,其他亞洲地區,1,0,1,1,0,1,0,0,0,0,0,0,0,0,0
109,公立,一般大學,0029,國立臺灣藝術大學,博士班,泰國,東協,1,1,0,0,0,0,1,1,0,0,0,0,0,0,0
109,公立,一般大學,0029,國立臺灣藝術大學,博士班,大陸地區,大陸地區,21,13,8,0,0,0,0,0,0,0,0,0,21,13,8
109,公立,一般大學,0029,國立臺灣藝術大學,博士班,香港,港澳,1,0,1,0,0,0,0,0,0,1,0,1,0,0,0
109,公立,一般大學,0029,國立臺灣藝術大學,博士班,馬來西亞,東協,3,2,1,1,0,1,2,2,0,0,0,0,0,0,0
109,公立,一般大學,0029,國立臺灣藝術大學,博士班,新加坡共和國,東協,1,0,1,1,0,1,0,0,0,0,0,0,0,0,0
109,公立,一般大學,0029,國立臺灣藝術大學,博士班,澳門,港澳,1,1,0,0,0,0,0,0,0,1,1,0,0,0,0
109,公立,一般大學,0030,國立臺東大學,學士班(日間),大韓民國(南韓),其他亞洲地區,2,1,1,2,1,1,0,0,0,0,0,0,0,0,0
109,公立,一般大學,0030,國立臺東大學,學士班(日間),印度尼西亞共和國,東協,3,1,2,0,0,0,3,1,2,0,0,0,0,0,0
109,公立,一般大學,0030,國立臺東大學,學士班(日間),馬來西亞,東協,15,8,7,1,1,0,14,7,7,0,0,0,0,0,0
109,公立,一般大學,0030,國立臺東大學,學士班(日間),日本,其他亞洲地區,2,1,1,2,1,1,0,0,0,0,0,0,0,0,0
109,公立,一般大學,0030,國立臺東大學,學士班(日間),香港,港澳,11,6,5,0,0,0,0,0,0,11,6,5,0,0,0
109,公立,一般大學,0030,國立臺東大學,學士班(日間),越南社會主義共和國,東協,2,1,1,2,1,1,0,0,0,0,0,0,0,0,0
109,公立,一般大學,0030,國立臺東大學,學士班(日間),緬甸,東協,2,1,1,0,0,0,2,1,1,0,0,0,0,0,0
109,公立,一般大學,0030,國立臺東大學,學士班(日間),澳門,港澳,6,2,4,0,0,0,0,0,0,6,2,4,0,0,0
109,公立,一般大學,0030,國立臺東大學,碩士班(日間),美國,北美洲,1,1,0,1,1,0,0,0,0,0,0,0,0,0,0
109,公立,一般大學,0030,國立臺東大學,碩士班(日間),香港,港澳,3,2,1,0,0,0,0,0,0,3,2,1,0,0,0
109,公立,一般大學,0030,國立臺東大學,碩士班(日間),澳門,港澳,1,0,1,0,0,0,0,0,0,1,0,1,0,0,0
109,公立,一般大學,0030,國立臺東大學,碩士班(日間),大韓民國(南韓),其他亞洲地區,1,0,1,1,0,1,0,0,0,0,0,0,0,0,0
109,公立,一般大學,0030,國立臺東大學,碩士班(日間),泰國,東協,1,0,1,1,0,1,0,0,0,0,0,0,0,0,0
109,公立,一般大學,0030,國立臺東大學,碩士班(日間),馬來西亞,東協,2,2,0,0,0,0,2,2,0,0,0,0,0,0,0
109,公立,一般大學,0030,國立臺東大學,碩士班(日間),越南社會主義共和國,東協,2,0,2,2,0,2,0,0,0,0,0,0,0,0,0
109,公立,一般大學,0030,國立臺東大學,博士班,大陸地區,大陸地區,4,2,2,0,0,0,0,0,0,0,0,0,4,2,2
109,公立,一般大學,0030,國立臺東大學,博士班,美國,北美洲,1,1,0,1,1,0,0,0,0,0,0,0,0,0,0
109,公立,一般大學,0031,國立宜蘭大學,學士班(日間),日本,其他亞洲地區,2,0,2,1,0,1,1,0,1,0,0,0,0,0,0
109,公立,一般大學,0031,國立宜蘭大學,學士班(日間),美國,北美洲,1,1,0,0,0,0,1,1,0,0,0,0,0,0,0
109,公立,一般大學,0031,國立宜蘭大學,學士班(日間),大陸地區,大陸地區,3,1,2,0,0,0,0,0,0,0,0,0,3,1,2
109,公立,一般大學,0031,國立宜蘭大學,學士班(日間),巴拉圭,中南美洲,1,0,1,1,0,1,0,0,0,0,0,0,0,0,0
109,公立,一般大學,0031,國立宜蘭大學,學士班(日間),印度,南亞,1,1,0,1,1,0,0,0,0,0,0,0,0,0,0
109,公立,一般大學,0031,國立宜蘭大學,學士班(日間),印度尼西亞共和國,東協,6,2,4,0,0,0,6,2,4,0,0,0,0,0,0
109,公立,一般大學,0031,國立宜蘭大學,學士班(日間),多明尼加共和國,中南美洲,1,0,1,0,0,0,1,0,1,0,0,0,0,0,0
109,公立,一般大學,0031,國立宜蘭大學,學士班(日間),阿根廷,中南美洲,1,1,0,0,0,0,1,1,0,0,0,0,0,0,0
109,公立,一般大學,0031,國立宜蘭大學,學士班(日間),香港,港澳,36,24,12,0,0,0,0,0,0,36,24,12,0,0,0
109,公立,一般大學,0031,國立宜蘭大學,學士班(日間),馬來西亞,東協,41,22,19,1,1,0,40,21,19,0,0,0,0,0,0
109,公立,一般大學,0031,國立宜蘭大學,學士班(日間),越南社會主義共和國,東協,2,0,2,2,0,2,0,0,0,0,0,0,0,0,0
109,公立,一般大學,0031,國立宜蘭大學,學士班(日間),聖文森(及格瑞那丁),中南美洲,1,0,1,1,0,1,0,0,0,0,0,0,0,0,0
109,公立,一般大學,0031,國立宜蘭大學,學士班(日間),聖克里斯多福及尼維斯,中南美洲,1,1,0,1,1,0,0,0,0,0,0,0,0,0,0
109,公立,一般大學,0031,國立宜蘭大學,學士班(日間),緬甸,東協,3,1,2,0,0,0,3,1,2,0,0,0,0,0,0
109,公立,一般大學,0031,國立宜蘭大學,學士班(日間),澳門,港澳,5,3,2,0,0,0,0,0,0,5,3,2,0,0,0
109,公立,一般大學,0031,國立宜蘭大學,碩士班(日間),大陸地區,大陸地區,1,0,1,0,0,0,0,0,0,0,0,0,1,0,1
109,公立,一般大學,0031,國立宜蘭大學,碩士班(日間),印度,南亞,3,2,1,3,2,1,0,0,0,0,0,0,0,0,0
109,公立,一般大學,0031,國立宜蘭大學,碩士班(日間),香港,港澳,1,1,0,0,0,0,0,0,0,1,1,0,0,0,0
109,公立,一般大學,0031,國立宜蘭大學,碩士班(日間),馬來西亞,東協,4,3,1,0,0,0,4,3,1,0,0,0,0,0,0
109,公立,一般大學,0031,國立宜蘭大學,碩士班(日間),法國,歐洲,1,0,1,1,0,1,0,0,0,0,0,0,0,0,0
109,公立,一般大學,0031,國立宜蘭大學,碩士班(日間),美國,北美洲,1,1,0,1,1,0,0,0,0,0,0,0,0,0,0
109,公立,一般大學,0031,國立宜蘭大學,博士班,印度,南亞,1,0,1,1,0,1,0,0,0,0,0,0,0,0,0
109,公立,一般大學,0032,國立聯合大學,學士班(日間),印度,南亞,10,6,4,0,0,0,10,6,4,0,0,0,0,0,0
109,公立,一般大學,0032,國立聯合大學,學士班(日間),大陸地區,大陸地區,13,7,6,0,0,0,0,0,0,0,0,0,13,7,6
109,公立,一般大學,0032,國立聯合大學,學士班(日間),印度尼西亞共和國,東協,1,1,0,1,1,0,0,0,0,0,0,0,0,0,0
109,公立,一般大學,0032,國立聯合大學,學士班(日間),香港,港澳,5,3,2,0,0,0,0,0,0,5,3,2,0,0,0
109,公立,一般大學,0032,國立聯合大學,學士班(日間),泰國,東協,1,0,1,0,0,0,1,0,1,0,0,0,0,0,0
109,公立,一般大學,0032,國立聯合大學,學士班(日間),馬來西亞,東協,34,15,19,0,0,0,34,15,19,0,0,0,0,0,0
109,公立,一般大學,0032,國立聯合大學,學士班(日間),緬甸,東協,3,0,3,0,0,0,3,0,3,0,0,0,0,0,0
109,公立,一般大學,0032,國立聯合大學,學士班(日間),澳門,港澳,2,1,1,0,0,0,0,0,0,2,1,1,0,0,0
109,公立,技專校院,0033,國立虎尾科技大學,學士班(日間),大陸地區,大陸地區,11,10,1,0,0,0,0,0,0,0,0,0,11,10,1
109,公立,技專校院,0033,國立虎尾科技大學,學士班(日間),印度尼西亞共和國,東協,3,2,1,1,1,0,2,1,1,0,0,0,0,0,0
109,公立,技專校院,0033,國立虎尾科技大學,學士班(日間),貝里斯,中南美洲,1,1,0,0,0,0,1,1,0,0,0,0,0,0,0
109,公立,技專校院,0033,國立虎尾科技大學,學士班(日間),香港,港澳,10,6,4,0,0,0,0,0,0,10,6,4,0,0,0
109,公立,技專校院,0033,國立虎尾科技大學,學士班(日間),馬來西亞,東協,35,28,7,15,12,3,20,16,4,0,0,0,0,0,0
109,公立,技專校院,0033,國立虎尾科技大學,學士班(日間),越南社會主義共和國,東協,3,2,1,0,0,0,3,2,1,0,0,0,0,0,0
109,公立,技專校院,0033,國立虎尾科技大學,學士班(日間),緬甸,東協,1,1,0,0,0,0,1,1,0,0,0,0,0,0,0
109,公立,技專校院,0033,國立虎尾科技大學,學士班(日間),日本,其他亞洲地區,3,3,0,2,2,0,1,1,0,0,0,0,0,0,0
109,公立,技專校院,0033,國立虎尾科技大學,碩士班(日間),巴基斯坦,南亞,3,3,0,3,3,0,0,0,0,0,0,0,0,0,0
109,公立,技專校院,0033,國立虎尾科技大學,碩士班(日間),泰國,東協,12,1,11,12,1,11,0,0,0,0,0,0,0,0,0
109,公立,技專校院,0033,國立虎尾科技大學,碩士班(日間),印度,南亞,15,15,0,15,15,0,0,0,0,0,0,0,0,0,0
109,公立,技專校院,0033,國立虎尾科技大學,碩士班(日間),印度尼西亞共和國,東協,14,6,8,14,6,8,0,0,0,0,0,0,0,0,0
109,公立,技專校院,0033,國立虎尾科技大學,碩士班(日間),孟加拉人民共和國,南亞,1,1,0,1,1,0,0,0,0,0,0,0,0,0,0
109,公立,技專校院,0033,國立虎尾科技大學,碩士班(日間),越南社會主義共和國,東協,31,12,19,31,12,19,0,0,0,0,0,0,0,0,0
109,公立,技專校院,0033,國立虎尾科技大學,碩士班(日間),蒙古國,其他亞洲地區,11,5,6,11,5,6,0,0,0,0,0,0,0,0,0
109,公立,技專校院,0033,國立虎尾科技大學,博士班,泰國,東協,1,1,0,1,1,0,0,0,0,0,0,0,0,0,0
109,公立,技專校院,0033,國立虎尾科技大學,博士班,越南社會主義共和國,東協,2,2,0,2,2,0,0,0,0,0,0,0,0,0,0
109,公立,技專校院,0033,國立虎尾科技大學,博士班,巴基斯坦,南亞,1,1,0,1,1,0,0,0,0,0,0,0,0,0,0
109,公立,技專校院,0033,國立虎尾科技大學,博士班,印度,南亞,4,3,1,4,3,1,0,0,0,0,0,0,0,0,0
109,公立,技專校院,0033,國立虎尾科技大學,博士班,印度尼西亞共和國,東協,3,3,0,3,3,0,0,0,0,0,0,0,0,0,0
109,公立,一般大學,0035,國立臺南藝術大學,學士班(日間),大陸地區,大陸地區,8,2,6,0,0,0,0,0,0,0,0,0,8,2,6
109,公立,一般大學,0035,國立臺南藝術大學,學士班(日間),印度尼西亞共和國,東協,1,0,1,0,0,0,1,0,1,0,0,0,0,0,0
109,公立,一般大學,0035,國立臺南藝術大學,學士班(日間),香港,港澳,12,2,10,0,0,0,0,0,0,12,2,10,0,0,0
109,公立,一般大學,0035,國立臺南藝術大學,學士班(日間),馬來西亞,東協,14,8,6,5,3,2,9,5,4,0,0,0,0,0,0
109,公立,一般大學,0035,國立臺南藝術大學,學士班(日間),澳門,港澳,2,1,1,0,0,0,0,0,0,2,1,1,0,0,0
109,公立,一般大學,0035,國立臺南藝術大學,碩士班(日間),美國,北美洲,1,0,1,1,0,1,0,0,0,0,0,0,0,0,0
109,公立,一般大學,0035,國立臺南藝術大學,碩士班(日間),大陸地區,大陸地區,1,0,1,0,0,0,0,0,0,0,0,0,1,0,1
109,公立,一般大學,0035,國立臺南藝術大學,碩士班(日間),大韓民國(南韓),其他亞洲地區,4,2,2,4,2,2,0,0,0,0,0,0,0,0,0
109,公立,一般大學,0035,國立臺南藝術大學,碩士班(日間),日本,其他亞洲地區,1,0,1,1,0,1,0,0,0,0,0,0,0,0,0
109,公立,一般大學,0035,國立臺南藝術大學,碩士班(日間),香港,港澳,7,2,5,0,0,0,0,0,0,7,2,5,0,0,0
109,公立,一般大學,0035,國立臺南藝術大學,碩士班(日間),馬來西亞,東協,3,3,0,1,1,0,2,2,0,0,0,0,0,0,0
109,公立,一般大學,0035,國立臺南藝術大學,碩士班(日間),新加坡共和國,東協,2,1,1,2,1,1,0,0,0,0,0,0,0,0,0
109,公立,一般大學,0035,國立臺南藝術大學,碩士班(日間),澳門,港澳,2,0,2,0,0,0,0,0,0,2,0,2,0,0,0
109,公立,一般大學,0035,國立臺南藝術大學,博士班,大陸地區,大陸地區,3,1,2,0,0,0,0,0,0,0,0,0,3,1,2
109,公立,一般大學,0035,國立臺南藝術大學,博士班,日本,其他亞洲地區,2,0,2,2,0,2,0,0,0,0,0,0,0,0,0
109,公立,一般大學,0035,國立臺南藝術大學,博士班,新加坡共和國,東協,1,1,0,1,1,0,0,0,0,0,0,0,0,0,0
109,公立,一般大學,0035,國立臺南藝術大學,博士班,大韓民國(南韓),其他亞洲地區,1,0,1,1,0,1,0,0,0,0,0,0,0,0,0
109,公立,一般大學,0036,國立臺南大學,學士班(日間),大陸地區,大陸地區,9,6,3,0,0,0,0,0,0,0,0,0,9,6,3
109,公立,一般大學,0036,國立臺南大學,學士班(日間),大韓民國(南韓),其他亞洲地區,2,1,1,2,1,1,0,0,0,0,0,0,0,0,0
109,公立,一般大學,0036,國立臺南大學,學士班(日間),日本,其他亞洲地區,7,2,5,6,2,4,1,0,1,0,0,0,0,0,0
109,公立,一般大學,0036,國立臺南大學,學士班(日間),印度尼西亞共和國,東協,9,4,5,4,1,3,5,3,2,0,0,0,0,0,0
109,公立,一般大學,0036,國立臺南大學,學士班(日間),俄羅斯聯邦,其他亞洲地區,1,0,1,1,0,1,0,0,0,0,0,0,0,0,0
109,公立,一般大學,0036,國立臺南大學,學士班(日間),南非共和國,非洲,1,0,1,1,0,1,0,0,0,0,0,0,0,0,0
109,公立,一般大學,0036,國立臺南大學,學士班(日間),馬來西亞,東協,26,14,12,3,1,2,23,13,10,0,0,0,0,0,0
109,公立,一般大學,0036,國立臺南大學,學士班(日間),蒙古國,其他亞洲地區,2,0,2,2,0,2,0,0,0,0,0,0,0,0,0
109,公立,一般大學,0036,國立臺南大學,學士班(日間),香港,港澳,23,7,16,0,0,0,0,0,0,23,7,16,0,0,0
109,公立,一般大學,0036,國立臺南大學,學士班(日間),越南社會主義共和國,東協,8,1,7,8,1,7,0,0,0,0,0,0,0,0,0
109,公立,一般大學,0036,國立臺南大學,學士班(日間),愛爾蘭共和國,歐洲,1,0,1,0,0,0,1,0,1,0,0,0,0,0,0
109,公立,一般大學,0036,國立臺南大學,學士班(日間),緬甸,東協,1,0,1,0,0,0,1,0,1,0,0,0,0,0,0
109,公立,一般大學,0036,國立臺南大學,學士班(日間),澳門,港澳,8,2,6,0,0,0,0,0,0,8,2,6,0,0,0
109,公立,一般大學,0036,國立臺南大學,碩士班(日間),美國,北美洲,2,2,0,2,2,0,0,0,0,0,0,0,0,0,0
109,公立,一般大學,0036,國立臺南大學,碩士班(日間),泰國,東協,4,3,1,4,3,1,0,0,0,0,0,0,0,0,0
109,公立,一般大學,0036,國立臺南大學,碩士班(日間),越南社會主義共和國,東協,1,0,1,1,0,1,0,0,0,0,0,0,0,0,0
109,公立,一般大學,0036,國立臺南大學,碩士班(日間),澳門,港澳,1,0,1,0,0,0,0,0,0,1,0,1,0,0,0
109,公立,一般大學,0036,國立臺南大學,碩士班(日間),加拿大,北美洲,1,1,0,1,1,0,0,0,0,0,0,0,0,0,0
109,公立,一般大學,0036,國立臺南大學,碩士班(日間),伊拉克共和國,其他亞洲地區,2,2,0,2,2,0,0,0,0,0,0,0,0,0,0
109,公立,一般大學,0036,國立臺南大學,碩士班(日間),印度尼西亞共和國,東協,1,1,0,1,1,0,0,0,0,0,0,0,0,0,0
109,公立,一般大學,0036,國立臺南大學,碩士班(日間),香港,港澳,7,2,5,0,0,0,0,0,0,7,2,5,0,0,0
109,公立,一般大學,0036,國立臺南大學,碩士班(日間),馬來西亞,東協,7,2,5,2,0,2,5,2,3,0,0,0,0,0,0
109,公立,一般大學,0036,國立臺南大學,博士班,大陸地區,大陸地區,4,0,4,0,0,0,0,0,0,0,0,0,4,0,4
109,公立,一般大學,0036,國立臺南大學,博士班,大韓民國(南韓),其他亞洲地區,1,1,0,1,1,0,0,0,0,0,0,0,0,0,0
109,公立,一般大學,0036,國立臺南大學,博士班,菲律賓共和國,東協,1,1,0,1,1,0,0,0,0,0,0,0,0,0,0
109,公立,一般大學,0036,國立臺南大學,博士班,越南社會主義共和國,東協,1,0,1,1,0,1,0,0,0,0,0,0,0,0,0
109,公立,一般大學,0037,國立臺北教育大學,學士班(日間),大陸地區,大陸地區,2,0,2,0,0,0,0,0,0,0,0,0,2,0,2
109,公立,一般大學,0037,國立臺北教育大學,學士班(日間),大韓民國(南韓),其他亞洲地區,1,0,1,1,0,1,0,0,0,0,0,0,0,0,0
109,公立,一般大學,0037,國立臺北教育大學,學士班(日間),巴拉圭,中南美洲,1,0,1,1,0,1,0,0,0,0,0,0,0,0,0
109,公立,一般大學,0037,國立臺北教育大學,學士班(日間),瓜地馬拉共和國,中南美洲,1,0,1,1,0,1,0,0,0,0,0,0,0,0,0
109,公立,一般大學,0037,國立臺北教育大學,學士班(日間),俄羅斯聯邦,其他亞洲地區,1,1,0,1,1,0,0,0,0,0,0,0,0,0,0
109,公立,一般大學,0037,國立臺北教育大學,學士班(日間),馬來西亞,東協,39,11,28,8,2,6,31,9,22,0,0,0,0,0,0
109,公立,一般大學,0037,國立臺北教育大學,學士班(日間),菲律賓共和國,東協,1,0,1,0,0,0,1,0,1,0,0,0,0,0,0
109,公立,一般大學,0037,國立臺北教育大學,學士班(日間),越南社會主義共和國,東協,8,1,7,6,0,6,2,1,1,0,0,0,0,0,0
109,公立,一般大學,0037,國立臺北教育大學,學士班(日間),澳門,港澳,30,10,20,0,0,0,0,0,0,30,10,20,0,0,0
109,公立,一般大學,0037,國立臺北教育大學,學士班(日間),日本,其他亞洲地區,3,2,1,1,1,0,2,1,1,0,0,0,0,0,0
109,公立,一般大學,0037,國立臺北教育大學,學士班(日間),印度尼西亞共和國,東協,3,1,2,0,0,0,3,1,2,0,0,0,0,0,0
109,公立,一般大學,0037,國立臺北教育大學,學士班(日間),香港,港澳,27,15,12,0,0,0,0,0,0,27,15,12,0,0,0
109,公立,一般大學,0037,國立臺北教育大學,學士班(日間),新加坡共和國,東協,1,0,1,1,0,1,0,0,0,0,0,0,0,0,0
109,公立,一般大學,0037,國立臺北教育大學,學士班(日間),緬甸,東協,19,5,14,0,0,0,19,5,14,0,0,0,0,0,0
109,公立,一般大學,0037,國立臺北教育大學,碩士班(日間),日本,其他亞洲地區,1,0,1,1,0,1,0,0,0,0,0,0,0,0,0
109,公立,一般大學,0037,國立臺北教育大學,碩士班(日間),加拿大,北美洲,1,0,1,0,0,0,1,0,1,0,0,0,0,0,0
109,公立,一般大學,0037,國立臺北教育大學,碩士班(日間),加彭共和國,非洲,1,0,1,1,0,1,0,0,0,0,0,0,0,0,0
109,公立,一般大學,0037,國立臺北教育大學,碩士班(日間),印度,南亞,1,0,1,1,0,1,0,0,0,0,0,0,0,0,0
109,公立,一般大學,0037,國立臺北教育大學,碩士班(日間),印度尼西亞共和國,東協,3,0,3,2,0,2,1,0,1,0,0,0,0,0,0
109,公立,一般大學,0037,國立臺北教育大學,碩士班(日間),俄羅斯聯邦,其他亞洲地區,2,1,1,2,1,1,0,0,0,0,0,0,0,0,0
109,公立,一般大學,0037,國立臺北教育大學,碩士班(日間),南非共和國,非洲,3,1,2,3,1,2,0,0,0,0,0,0,0,0,0
109,公立,一般大學,0037,國立臺北教育大學,碩士班(日間),美國,北美洲,8,5,3,7,5,2,1,0,1,0,0,0,0,0,0
109,公立,一般大學,0037,國立臺北教育大學,碩士班(日間),英國,歐洲,3,2,1,3,2,1,0,0,0,0,0,0,0,0,0
109,公立,一般大學,0037,國立臺北教育大學,碩士班(日間),馬來西亞,東協,11,3,8,3,1,2,8,2,6,0,0,0,0,0,0
109,公立,一般大學,0037,國立臺北教育大學,碩士班(日間),義大利共和國,歐洲,1,0,1,1,0,1,0,0,0,0,0,0,0,0,0
109,公立,一般大學,0037,國立臺北教育大學,碩士班(日間),大陸地區,大陸地區,3,1,2,0,0,0,0,0,0,0,0,0,3,1,2
109,公立,一般大學,0037,國立臺北教育大學,碩士班(日間),大韓民國(南韓),其他亞洲地區,2,0,2,2,0,2,0,0,0,0,0,0,0,0,0
109,公立,一般大學,0037,國立臺北教育大學,碩士班(日間),瓜地馬拉共和國,中南美洲,1,0,1,1,0,1,0,0,0,0,0,0,0,0,0
109,公立,一般大學,0037,國立臺北教育大學,碩士班(日間),孟加拉人民共和國,南亞,1,0,1,1,0,1,0,0,0,0,0,0,0,0,0
109,公立,一般大學,0037,國立臺北教育大學,碩士班(日間),法國,歐洲,1,0,1,1,0,1,0,0,0,0,0,0,0,0,0
109,公立,一般大學,0037,國立臺北教育大學,碩士班(日間),香港,港澳,7,2,5,0,0,0,0,0,0,7,2,5,0,0,0
109,公立,一般大學,0037,國立臺北教育大學,碩士班(日間),泰國,東協,3,0,3,3,0,3,0,0,0,0,0,0,0,0,0
109,公立,一般大學,0037,國立臺北教育大學,碩士班(日間),越南社會主義共和國,東協,17,1,16,17,1,16,0,0,0,0,0,0,0,0,0
109,公立,一般大學,0037,國立臺北教育大學,碩士班(日間),聖文森(及格瑞那丁),中南美洲,1,0,1,1,0,1,0,0,0,0,0,0,0,0,0
109,公立,一般大學,0037,國立臺北教育大學,碩士班(日間),緬甸,東協,3,0,3,0,0,0,3,0,3,0,0,0,0,0,0
109,公立,一般大學,0037,國立臺北教育大學,碩士班(日間),澳門,港澳,9,4,5,0,0,0,0,0,0,9,4,5,0,0,0
109,公立,一般大學,0037,國立臺北教育大學,博士班,大陸地區,大陸地區,4,4,0,0,0,0,0,0,0,0,0,0,4,4,0
109,公立,一般大學,0037,國立臺北教育大學,博士班,越南社會主義共和國,東協,2,0,2,2,0,2,0,0,0,0,0,0,0,0,0
109,公立,一般大學,0039,國立臺中教育大學,學士班(日間),大陸地區,大陸地區,6,0,6,0,0,0,0,0,0,0,0,0,6,0,6
109,公立,一般大學,0039,國立臺中教育大學,學士班(日間),厄瓜多共和國,中南美洲,1,1,0,0,0,0,1,1,0,0,0,0,0,0,0
109,公立,一般大學,0039,國立臺中教育大學,學士班(日間),馬來西亞,東協,51,18,33,7,3,4,44,15,29,0,0,0,0,0,0
109,公立,一般大學,0039,國立臺中教育大學,學士班(日間),越南社會主義共和國,東協,16,1,15,16,1,15,0,0,0,0,0,0,0,0,0
109,公立,一般大學,0039,國立臺中教育大學,學士班(日間),蒙古國,其他亞洲地區,1,0,1,1,0,1,0,0,0,0,0,0,0,0,0
109,公立,一般大學,0039,國立臺中教育大學,學士班(日間),澳門,港澳,18,6,12,0,0,0,0,0,0,18,6,12,0,0,0
109,公立,一般大學,0039,國立臺中教育大學,學士班(日間),日本,其他亞洲地區,7,3,4,7,3,4,0,0,0,0,0,0,0,0,0
109,公立,一般大學,0039,國立臺中教育大學,學士班(日間),加拿大,北美洲,1,0,1,0,0,0,1,0,1,0,0,0,0,0,0
109,公立,一般大學,0039,國立臺中教育大學,學士班(日間),印度尼西亞共和國,東協,30,13,17,0,0,0,30,13,17,0,0,0,0,0,0
109,公立,一般大學,0039,國立臺中教育大學,學士班(日間),香港,港澳,13,8,5,0,0,0,0,0,0,13,8,5,0,0,0
109,公立,一般大學,0039,國立臺中教育大學,學士班(日間),泰國,東協,2,0,2,1,0,1,1,0,1,0,0,0,0,0,0
109,公立,一般大學,0039,國立臺中教育大學,學士班(日間),緬甸,東協,5,1,4,0,0,0,5,1,4,0,0,0,0,0,0
109,公立,一般大學,0039,國立臺中教育大學,碩士班(日間),泰國,東協,2,1,1,2,1,1,0,0,0,0,0,0,0,0,0
109,公立,一般大學,0039,國立臺中教育大學,碩士班(日間),大韓民國(南韓),其他亞洲地區,1,0,1,1,0,1,0,0,0,0,0,0,0,0,0
109,公立,一般大學,0039,國立臺中教育大學,碩士班(日間),印度,南亞,2,1,1,2,1,1,0,0,0,0,0,0,0,0,0
109,公立,一般大學,0039,國立臺中教育大學,碩士班(日間),俄羅斯聯邦,其他亞洲地區,4,1,3,4,1,3,0,0,0,0,0,0,0,0,0
109,公立,一般大學,0039,國立臺中教育大學,碩士班(日間),香港,港澳,3,2,1,0,0,0,0,0,0,3,2,1,0,0,0
109,公立,一般大學,0039,國立臺中教育大學,碩士班(日間),馬來西亞,東協,7,4,3,3,1,2,4,3,1,0,0,0,0,0,0
109,公立,一般大學,0039,國立臺中教育大學,碩士班(日間),越南社會主義共和國,東協,11,2,9,11,2,9,0,0,0,0,0,0,0,0,0
109,公立,一般大學,0039,國立臺中教育大學,碩士班(日間),蒙古國,其他亞洲地區,5,3,2,5,3,2,0,0,0,0,0,0,0,0,0
109,公立,一般大學,0039,國立臺中教育大學,碩士班(日間),澳門,港澳,1,0,1,0,0,0,0,0,0,1,0,1,0,0,0
109,公立,一般大學,0039,國立臺中教育大學,博士班,大韓民國(南韓),其他亞洲地區,1,0,1,1,0,1,0,0,0,0,0,0,0,0,0
109,公立,一般大學,0039,國立臺中教育大學,博士班,香港,港澳,1,0,1,0,0,0,0,0,0,1,0,1,0,0,0
109,公立,一般大學,0039,國立臺中教育大學,博士班,泰國,東協,1,0,1,1,0,1,0,0,0,0,0,0,0,0,0
109,公立,一般大學,0039,國立臺中教育大學,博士班,越南社會主義共和國,東協,1,1,0,1,1,0,0,0,0,0,0,0,0,0,0
109,公立,技專校院,0042,國立澎湖科技大學,五專,印度尼西亞共和國,東協,1,1,0,0,0,0,1,1,0,0,0,0,0,0,0
109,公立,技專校院,0042,國立澎湖科技大學,學士班(日間),大韓民國(南韓),其他亞洲地區,1,1,0,1,1,0,0,0,0,0,0,0,0,0,0
109,公立,技專校院,0042,國立澎湖科技大學,學士班(日間),葡萄牙共和國,歐洲,1,1,0,1,1,0,0,0,0,0,0,0,0,0,0
109,公立,技專校院,0042,國立澎湖科技大學,學士班(日間),香港,港澳,2,2,0,0,0,0,0,0,0,2,2,0,0,0,0
109,公立,技專校院,0042,國立澎湖科技大學,學士班(日間),馬來西亞,東協,11,4,7,1,0,1,10,4,6,0,0,0,0,0,0
109,公立,技專校院,0042,國立澎湖科技大學,學士班(日間),越南社會主義共和國,東協,1,1,0,1,1,0,0,0,0,0,0,0,0,0,0
109,公立,技專校院,0042,國立澎湖科技大學,學士班(日間),緬甸,東協,1,1,0,0,0,0,1,1,0,0,0,0,0,0,0
109,公立,技專校院,0043,國立勤益科技大學,學士班(日間),日本,其他亞洲地區,1,1,0,1,1,0,0,0,0,0,0,0,0,0,0
109,公立,技專校院,0043,國立勤益科技大學,學士班(日間),泰國,東協,3,1,2,3,1,2,0,0,0,0,0,0,0,0,0
109,公立,技專校院,0043,國立勤益科技大學,學士班(日間),馬來西亞,東協,34,31,3,16,14,2,18,17,1,0,0,0,0,0,0
109,公立,技專校院,0043,國立勤益科技大學,學士班(日間),大陸地區,大陸地區,12,8,4,0,0,0,0,0,0,0,0,0,12,8,4
109,公立,技專校院,0043,國立勤益科技大學,學士班(日間),尼泊爾聯邦民主共和國,南亞,10,8,2,10,8,2,0,0,0,0,0,0,0,0,0
109,公立,技專校院,0043,國立勤益科技大學,學士班(日間),印度尼西亞共和國,東協,57,37,20,56,36,20,1,1,0,0,0,0,0,0,0
109,公立,技專校院,0043,國立勤益科技大學,學士班(日間),柬埔寨王國,東協,1,0,1,1,0,1,0,0,0,0,0,0,0,0,0
109,公立,技專校院,0043,國立勤益科技大學,學士班(日間),香港,港澳,16,13,3,0,0,0,0,0,0,16,13,3,0,0,0
109,公立,技專校院,0043,國立勤益科技大學,學士班(日間),越南社會主義共和國,東協,105,51,54,103,50,53,2,1,1,0,0,0,0,0,0
109,公立,技專校院,0043,國立勤益科技大學,學士班(日間),蒙古國,其他亞洲地區,1,0,1,1,0,1,0,0,0,0,0,0,0,0,0
109,公立,技專校院,0043,國立勤益科技大學,學士班(日間),寮人民民主共和國(寮國),東協,3,2,1,3,2,1,0,0,0,0,0,0,0,0,0
109,公立,技專校院,0043,國立勤益科技大學,學士班(日間),澳門,港澳,2,1,1,0,0,0,0,0,0,2,1,1,0,0,0
109,公立,技專校院,0043,國立勤益科技大學,碩士班(日間),大韓民國(南韓),其他亞洲地區,1,0,1,1,0,1,0,0,0,0,0,0,0,0,0
109,公立,技專校院,0043,國立勤益科技大學,碩士班(日間),印度,南亞,10,9,1,10,9,1,0,0,0,0,0,0,0,0,0
109,公立,技專校院,0043,國立勤益科技大學,碩士班(日間),印度尼西亞共和國,東協,35,16,19,35,16,19,0,0,0,0,0,0,0,0,0
109,公立,技專校院,0043,國立勤益科技大學,碩士班(日間),香港,港澳,2,2,0,0,0,0,0,0,0,2,2,0,0,0,0
109,公立,技專校院,0043,國立勤益科技大學,碩士班(日間),蒙古國,其他亞洲地區,8,2,6,8,2,6,0,0,0,0,0,0,0,0,0
109,公立,技專校院,0043,國立勤益科技大學,碩士班(日間),俄羅斯聯邦,其他亞洲地區,1,1,0,1,1,0,0,0,0,0,0,0,0,0,0
109,公立,技專校院,0043,國立勤益科技大學,碩士班(日間),美國,北美洲,1,1,0,1,1,0,0,0,0,0,0,0,0,0,0
109,公立,技專校院,0043,國立勤益科技大學,碩士班(日間),泰國,東協,6,3,3,6,3,3,0,0,0,0,0,0,0,0,0
109,公立,技專校院,0043,國立勤益科技大學,碩士班(日間),越南社會主義共和國,東協,6,2,4,6,2,4,0,0,0,0,0,0,0,0,0
109,公立,技專校院,0043,國立勤益科技大學,博士班,印度,南亞,1,1,0,1,1,0,0,0,0,0,0,0,0,0,0
109,公立,技專校院,0043,國立勤益科技大學,博士班,印度尼西亞共和國,東協,3,3,0,3,3,0,0,0,0,0,0,0,0,0,0
109,公立,一般大學,0044,國立體育大學,學士班(日間),日本,其他亞洲地區,2,2,0,2,2,0,0,0,0,0,0,0,0,0,0
109,公立,一般大學,0044,國立體育大學,學士班(日間),澳門,港澳,7,5,2,0,0,0,0,0,0,7,5,2,0,0,0
109,公立,一般大學,0044,國立體育大學,學士班(日間),大陸地區,大陸地區,5,3,2,0,0,0,0,0,0,0,0,0,5,3,2
109,公立,一般大學,0044,國立體育大學,學士班(日間),大韓民國(南韓),其他亞洲地區,4,3,1,4,3,1,0,0,0,0,0,0,0,0,0
109,公立,一般大學,0044,國立體育大學,學士班(日間),香港,港澳,15,9,6,0,0,0,0,0,0,15,9,6,0,0,0
109,公立,一般大學,0044,國立體育大學,學士班(日間),馬來西亞,東協,13,9,4,0,0,0,13,9,4,0,0,0,0,0,0
109,公立,一般大學,0044,國立體育大學,學士班(日間),馬拉威共和國,非洲,3,3,0,3,3,0,0,0,0,0,0,0,0,0,0
109,公立,一般大學,0044,國立體育大學,碩士班(日間),大陸地區,大陸地區,3,1,2,0,0,0,0,0,0,0,0,0,3,1,2
109,公立,一般大學,0044,國立體育大學,碩士班(日間),香港,港澳,9,4,5,0,0,0,0,0,0,9,4,5,0,0,0
109,公立,一般大學,0044,國立體育大學,碩士班(日間),馬來西亞,東協,5,5,0,2,2,0,3,3,0,0,0,0,0,0,0
109,公立,一般大學,0044,國立體育大學,碩士班(日間),日本,其他亞洲地區,1,0,1,1,0,1,0,0,0,0,0,0,0,0,0
109,公立,一般大學,0044,國立體育大學,碩士班(日間),澳門,港澳,3,2,1,0,0,0,0,0,0,3,2,1,0,0,0
109,公立,一般大學,0044,國立體育大學,博士班,大陸地區,大陸地區,21,14,7,0,0,0,0,0,0,0,0,0,21,14,7
109,公立,一般大學,0044,國立體育大學,博士班,香港,港澳,1,0,1,0,0,0,0,0,0,1,0,1,0,0,0
109,公立,一般大學,0044,國立體育大學,博士班,蒙古國,其他亞洲地區,1,0,1,1,0,1,0,0,0,0,0,0,0,0,0
109,公立,一般大學,0044,國立體育大學,博士班,大韓民國(南韓),其他亞洲地區,2,2,0,2,2,0,0,0,0,0,0,0,0,0,0
109,公立,一般大學,0044,國立體育大學,博士班,馬來西亞,東協,1,1,0,0,0,0,1,1,0,0,0,0,0,0,0
109,公立,技專校院,0046,國立臺北護理健康大學,學士班(日間),阿根廷,中南美洲,1,1,0,0,0,0,1,1,0,0,0,0,0,0,0
109,公立,技專校院,0046,國立臺北護理健康大學,學士班(日間),香港,港澳,29,16,13,0,0,0,0,0,0,29,16,13,0,0,0
109,公立,技專校院,0046,國立臺北護理健康大學,學士班(日間),泰國,東協,1,0,1,0,0,0,1,0,1,0,0,0,0,0,0
109,公立,技專校院,0046,國立臺北護理健康大學,學士班(日間),馬來西亞,東協,38,6,32,1,0,1,37,6,31,0,0,0,0,0,0
109,公立,技專校院,0046,國立臺北護理健康大學,學士班(日間),越南社會主義共和國,東協,3,1,2,0,0,0,3,1,2,0,0,0,0,0,0
109,公立,技專校院,0046,國立臺北護理健康大學,學士班(日間),緬甸,東協,3,0,3,0,0,0,3,0,3,0,0,0,0,0,0
109,公立,技專校院,0046,國立臺北護理健康大學,學士班(日間),澳門,港澳,23,5,18,0,0,0,0,0,0,23,5,18,0,0,0
109,公立,技專校院,0046,國立臺北護理健康大學,學士班(日間),美國,北美洲,1,1,0,0,0,0,1,1,0,0,0,0,0,0,0
109,公立,技專校院,0046,國立臺北護理健康大學,學士班(日間),菲律賓共和國,東協,1,0,1,0,0,0,1,0,1,0,0,0,0,0,0
109,公立,技專校院,0046,國立臺北護理健康大學,碩士班(日間),史瓦帝尼王國,非洲,3,0,3,3,0,3,0,0,0,0,0,0,0,0,0
109,公立,技專校院,0046,國立臺北護理健康大學,碩士班(日間),甘比亞共和國,非洲,2,1,1,2,1,1,0,0,0,0,0,0,0,0,0
109,公立,技專校院,0046,國立臺北護理健康大學,碩士班(日間),吉爾吉斯,其他亞洲地區,1,0,1,1,0,1,0,0,0,0,0,0,0,0,0
109,公立,技專校院,0046,國立臺北護理健康大學,碩士班(日間),約旦哈什米王國,其他亞洲地區,1,1,0,1,1,0,0,0,0,0,0,0,0,0,0
109,公立,技專校院,0046,國立臺北護理健康大學,碩士班(日間),美國,北美洲,2,1,1,1,0,1,1,1,0,0,0,0,0,0,0
109,公立,技專校院,0046,國立臺北護理健康大學,碩士班(日間),馬拉威共和國,非洲,2,0,2,2,0,2,0,0,0,0,0,0,0,0,0
109,公立,技專校院,0046,國立臺北護理健康大學,碩士班(日間),聖克里斯多福及尼維斯,中南美洲,1,0,1,1,0,1,0,0,0,0,0,0,0,0,0
109,公立,技專校院,0046,國立臺北護理健康大學,碩士班(日間),巴布亞紐幾內亞獨立國,其他亞洲地區,1,0,1,1,0,1,0,0,0,0,0,0,0,0,0
109,公立,技專校院,0046,國立臺北護理健康大學,碩士班(日間),加拿大,北美洲,1,1,0,1,1,0,0,0,0,0,0,0,0,0,0
109,公立,技專校院,0046,國立臺北護理健康大學,碩士班(日間),印度尼西亞共和國,東協,7,3,4,7,3,4,0,0,0,0,0,0,0,0,0
109,公立,技專校院,0046,國立臺北護理健康大學,碩士班(日間),香港,港澳,7,1,6,0,0,0,0,0,0,7,1,6,0,0,0
109,公立,技專校院,0046,國立臺北護理健康大學,碩士班(日間),馬來西亞,東協,7,1,6,1,0,1,6,1,5,0,0,0,0,0,0
109,公立,技專校院,0046,國立臺北護理健康大學,碩士班(日間),菲律賓共和國,東協,1,1,0,1,1,0,0,0,0,0,0,0,0,0,0
109,公立,技專校院,0046,國立臺北護理健康大學,碩士班(日間),越南社會主義共和國,東協,4,0,4,4,0,4,0,0,0,0,0,0,0,0,0
109,公立,技專校院,0046,國立臺北護理健康大學,碩士班(日間),緬甸,東協,1,1,0,0,0,0,1,1,0,0,0,0,0,0,0
109,公立,技專校院,0046,國立臺北護理健康大學,碩士班(日間),澳門,港澳,2,1,1,0,0,0,0,0,0,2,1,1,0,0,0
109,公立,技專校院,0046,國立臺北護理健康大學,博士班,越南社會主義共和國,東協,2,0,2,2,0,2,0,0,0,0,0,0,0,0,0
109,公立,技專校院,0046,國立臺北護理健康大學,博士班,印度尼西亞共和國,東協,13,7,6,13,7,6,0,0,0,0,0,0,0,0,0
109,公立,技專校院,0046,國立臺北護理健康大學,博士班,波蘭共和國,歐洲,1,0,1,1,0,1,0,0,0,0,0,0,0,0,0
109,公立,技專校院,0047,國立高雄餐旅大學,學士班(日間),巴西聯邦共和國,中南美洲,2,0,2,0,0,0,2,0,2,0,0,0,0,0,0
109,公立,技專校院,0047,國立高雄餐旅大學,學士班(日間),日本,其他亞洲地區,15,5,10,13,4,9,2,1,1,0,0,0,0,0,0
109,公立,技專校院,0047,國立高雄餐旅大學,學士班(日間),史瓦帝尼王國,非洲,1,0,1,1,0,1,0,0,0,0,0,0,0,0,0
109,公立,技專校院,0047,國立高雄餐旅大學,學士班(日間),法國,歐洲,1,1,0,1,1,0,0,0,0,0,0,0,0,0,0
109,公立,技專校院,0047,國立高雄餐旅大學,學士班(日間),美國,北美洲,2,1,1,1,0,1,1,1,0,0,0,0,0,0,0
109,公立,技專校院,0047,國立高雄餐旅大學,學士班(日間),泰國,東協,9,4,5,5,1,4,4,3,1,0,0,0,0,0,0
109,公立,技專校院,0047,國立高雄餐旅大學,學士班(日間),菲律賓共和國,東協,3,0,3,2,0,2,1,0,1,0,0,0,0,0,0
109,公立,技專校院,0047,國立高雄餐旅大學,學士班(日間),大陸地區,大陸地區,3,1,2,0,0,0,0,0,0,0,0,0,3,1,2
109,公立,技專校院,0047,國立高雄餐旅大學,學士班(日間),大韓民國(南韓),其他亞洲地區,2,1,1,2,1,1,0,0,0,0,0,0,0,0,0
109,公立,技專校院,0047,國立高雄餐旅大學,學士班(日間),厄瓜多共和國,中南美洲,1,1,0,0,0,0,1,1,0,0,0,0,0,0,0
109,公立,技專校院,0047,國立高雄餐旅大學,學士班(日間),巴拉圭,中南美洲,2,2,0,2,2,0,0,0,0,0,0,0,0,0,0
109,公立,技專校院,0047,國立高雄餐旅大學,學士班(日間),印度尼西亞共和國,東協,107,27,80,57,14,43,50,13,37,0,0,0,0,0,0
109,公立,技專校院,0047,國立高雄餐旅大學,學士班(日間),多明尼加共和國,中南美洲,1,1,0,0,0,0,1,1,0,0,0,0,0,0,0
109,公立,技專校院,0047,國立高雄餐旅大學,學士班(日間),南非共和國,非洲,1,0,1,0,0,0,1,0,1,0,0,0,0,0,0
109,公立,技專校院,0047,國立高雄餐旅大學,學士班(日間),香港,港澳,10,5,5,0,0,0,0,0,0,10,5,5,0,0,0
109,公立,技專校院,0047,國立高雄餐旅大學,學士班(日間),馬來西亞,東協,101,42,59,33,14,19,68,28,40,0,0,0,0,0,0
109,公立,技專校院,0047,國立高雄餐旅大學,學士班(日間),越南社會主義共和國,東協,15,6,9,10,4,6,5,2,3,0,0,0,0,0,0
109,公立,技專校院,0047,國立高雄餐旅大學,學士班(日間),新加坡共和國,東協,1,0,1,1,0,1,0,0,0,0,0,0,0,0,0
109,公立,技專校院,0047,國立高雄餐旅大學,學士班(日間),聖文森(及格瑞那丁),中南美洲,3,0,3,3,0,3,0,0,0,0,0,0,0,0,0
109,公立,技專校院,0047,國立高雄餐旅大學,學士班(日間),聖克里斯多福及尼維斯,中南美洲,1,0,1,1,0,1,0,0,0,0,0,0,0,0,0
109,公立,技專校院,0047,國立高雄餐旅大學,學士班(日間),聖露西亞,中南美洲,1,0,1,1,0,1,0,0,0,0,0,0,0,0,0
109,公立,技專校院,0047,國立高雄餐旅大學,學士班(日間),緬甸,東協,2,0,2,0,0,0,2,0,2,0,0,0,0,0,0
109,公立,技專校院,0047,國立高雄餐旅大學,學士班(日間),澳門,港澳,19,12,7,0,0,0,0,0,0,19,12,7,0,0,0
109,公立,技專校院,0047,國立高雄餐旅大學,學士班(日間),薩爾瓦多,中南美洲,2,2,0,1,1,0,1,1,0,0,0,0,0,0,0
109,公立,技專校院,0047,國立高雄餐旅大學,碩士班(日間),印度尼西亞共和國,東協,9,3,6,8,2,6,1,1,0,0,0,0,0,0,0
109,公立,技專校院,0047,國立高雄餐旅大學,碩士班(日間),南非共和國,非洲,1,0,1,1,0,1,0,0,0,0,0,0,0,0,0
109,公立,技專校院,0047,國立高雄餐旅大學,碩士班(日間),香港,港澳,3,0,3,0,0,0,0,0,0,3,0,3,0,0,0
109,公立,技專校院,0047,國立高雄餐旅大學,碩士班(日間),馬來西亞,東協,2,1,1,2,1,1,0,0,0,0,0,0,0,0,0
109,公立,技專校院,0047,國立高雄餐旅大學,碩士班(日間),越南社會主義共和國,東協,1,1,0,1,1,0,0,0,0,0,0,0,0,0,0
109,公立,技專校院,0047,國立高雄餐旅大學,碩士班(日間),緬甸,東協,2,0,2,1,0,1,1,0,1,0,0,0,0,0,0
109,公立,技專校院,0047,國立高雄餐旅大學,碩士班(日間),美國,北美洲,1,1,0,1,1,0,0,0,0,0,0,0,0,0,0
109,公立,技專校院,0047,國立高雄餐旅大學,碩士班(日間),迦納共和國,非洲,1,1,0,1,1,0,0,0,0,0,0,0,0,0,0
109,公立,技專校院,0047,國立高雄餐旅大學,碩士班(日間),泰國,東協,2,0,2,2,0,2,0,0,0,0,0,0,0,0,0
109,公立,技專校院,0047,國立高雄餐旅大學,碩士班(日間),菲律賓共和國,東協,1,1,0,1,1,0,0,0,0,0,0,0,0,0,0
109,公立,技專校院,0047,國立高雄餐旅大學,博士班,大陸地區,大陸地區,3,0,3,0,0,0,0,0,0,0,0,0,3,0,3
109,公立,技專校院,0047,國立高雄餐旅大學,博士班,印度尼西亞共和國,東協,1,0,1,1,0,1,0,0,0,0,0,0,0,0,0
109,公立,技專校院,0047,國立高雄餐旅大學,博士班,捷克共和國,歐洲,1,1,0,1,1,0,0,0,0,0,0,0,0,0,0
109,公立,技專校院,0047,國立高雄餐旅大學,博士班,菲律賓共和國,東協,1,0,1,1,0,1,0,0,0,0,0,0,0,0,0
109,公立,技專校院,0047,國立高雄餐旅大學,博士班,越南社會主義共和國,東協,4,2,2,4,2,2,0,0,0,0,0,0,0,0,0
109,公立,技專校院,0047,國立高雄餐旅大學,博士班,泰國,東協,1,1,0,1,1,0,0,0,0,0,0,0,0,0,0
109,公立,一般大學,0048,國立金門大學,學士班(日間),阿根廷,中南美洲,1,1,0,0,0,0,1,1,0,0,0,0,0,0,0
109,公立,一般大學,0048,國立金門大學,學士班(日間),迦納共和國,非洲,2,2,0,2,2,0,0,0,0,0,0,0,0,0,0
109,公立,一般大學,0048,國立金門大學,學士班(日間),馬來西亞,東協,14,8,6,0,0,0,14,8,6,0,0,0,0,0,0
109,公立,一般大學,0048,國立金門大學,學士班(日間),大陸地區,大陸地區,60,34,26,0,0,0,0,0,0,0,0,0,60,34,26
109,公立,一般大學,0048,國立金門大學,學士班(日間),大韓民國(南韓),其他亞洲地區,2,1,1,2,1,1,0,0,0,0,0,0,0,0,0
109,公立,一般大學,0048,國立金門大學,學士班(日間),巴布亞紐幾內亞獨立國,其他亞洲地區,1,1,0,0,0,0,1,1,0,0,0,0,0,0,0
109,公立,一般大學,0048,國立金門大學,學士班(日間),印度尼西亞共和國,東協,31,11,20,8,3,5,23,8,15,0,0,0,0,0,0
109,公立,一般大學,0048,國立金門大學,學士班(日間),香港,港澳,9,5,4,0,0,0,0,0,0,9,5,4,0,0,0
109,公立,一般大學,0048,國立金門大學,學士班(日間),澳門,港澳,2,1,1,0,0,0,0,0,0,2,1,1,0,0,0
109,公立,一般大學,0048,國立金門大學,碩士班(日間),大陸地區,大陸地區,11,5,6,0,0,0,0,0,0,0,0,0,11,5,6
109,公立,一般大學,0048,國立金門大學,碩士班(日間),印度尼西亞共和國,東協,13,6,7,9,3,6,4,3,1,0,0,0,0,0,0
109,公立,一般大學,0048,國立金門大學,碩士班(日間),阿根廷,中南美洲,1,1,0,1,1,0,0,0,0,0,0,0,0,0,0
109,公立,一般大學,0048,國立金門大學,碩士班(日間),馬來西亞,東協,2,1,1,0,0,0,2,1,1,0,0,0,0,0,0
109,公立,一般大學,0048,國立金門大學,碩士班(日間),越南社會主義共和國,東協,6,0,6,6,0,6,0,0,0,0,0,0,0,0,0
109,公立,一般大學,0049,國立臺灣體育運動大學,學士班(日間),大陸地區,大陸地區,2,1,1,0,0,0,0,0,0,0,0,0,2,1,1
109,公立,一般大學,0049,國立臺灣體育運動大學,學士班(日間),大韓民國(南韓),其他亞洲地區,7,5,2,7,5,2,0,0,0,0,0,0,0,0,0
109,公立,一般大學,0049,國立臺灣體育運動大學,學士班(日間),巴拉圭,中南美洲,1,1,0,1,1,0,0,0,0,0,0,0,0,0,0
109,公立,一般大學,0049,國立臺灣體育運動大學,學士班(日間),印度尼西亞共和國,東協,1,1,0,0,0,0,1,1,0,0,0,0,0,0,0
109,公立,一般大學,0049,國立臺灣體育運動大學,學士班(日間),香港,港澳,31,16,15,0,0,0,0,0,0,31,16,15,0,0,0
109,公立,一般大學,0049,國立臺灣體育運動大學,學士班(日間),馬來西亞,東協,24,13,11,1,1,0,23,12,11,0,0,0,0,0,0
109,公立,一般大學,0049,國立臺灣體育運動大學,學士班(日間),越南社會主義共和國,東協,1,0,1,0,0,0,1,0,1,0,0,0,0,0,0
109,公立,一般大學,0049,國立臺灣體育運動大學,學士班(日間),緬甸,東協,1,1,0,0,0,0,1,1,0,0,0,0,0,0,0
109,公立,一般大學,0049,國立臺灣體育運動大學,學士班(日間),澳門,港澳,12,10,2,0,0,0,0,0,0,12,10,2,0,0,0
109,公立,一般大學,0049,國立臺灣體育運動大學,學士班(日間),日本,其他亞洲地區,3,1,2,3,1,2,0,0,0,0,0,0,0,0,0
109,公立,一般大學,0049,國立臺灣體育運動大學,碩士班(日間),日本,其他亞洲地區,2,2,0,1,1,0,1,1,0,0,0,0,0,0,0
109,公立,一般大學,0049,國立臺灣體育運動大學,碩士班(日間),大陸地區,大陸地區,2,1,1,0,0,0,0,0,0,0,0,0,2,1,1
109,公立,一般大學,0049,國立臺灣體育運動大學,碩士班(日間),印度尼西亞共和國,東協,1,0,1,0,0,0,1,0,1,0,0,0,0,0,0
109,公立,一般大學,0049,國立臺灣體育運動大學,碩士班(日間),香港,港澳,3,1,2,0,0,0,0,0,0,3,1,2,0,0,0
109,公立,一般大學,0049,國立臺灣體育運動大學,碩士班(日間),馬來西亞,東協,4,2,2,1,0,1,3,2,1,0,0,0,0,0,0
109,公立,一般大學,0049,國立臺灣體育運動大學,碩士班(日間),澳門,港澳,1,1,0,0,0,0,0,0,0,1,1,0,0,0,0
109,公立,一般大學,0049,國立臺灣體育運動大學,博士班,越南社會主義共和國,東協,4,2,2,4,2,2,0,0,0,0,0,0,0,0,0
109,公立,技專校院,0050,國立臺中科技大學,五專,越南社會主義共和國,東協,1,0,1,0,0,0,1,0,1,0,0,0,0,0,0
109,公立,技專校院,0050,國立臺中科技大學,五專,印度尼西亞共和國,東協,2,0,2,0,0,0,2,0,2,0,0,0,0,0,0
109,公立,技專校院,0050,國立臺中科技大學,學士班(日間),大陸地區,大陸地區,14,9,5,0,0,0,0,0,0,0,0,0,14,9,5
109,公立,技專校院,0050,國立臺中科技大學,學士班(日間),印度尼西亞共和國,東協,48,22,26,0,0,0,48,22,26,0,0,0,0,0,0
109,公立,技專校院,0050,國立臺中科技大學,學士班(日間),香港,港澳,25,14,11,0,0,0,0,0,0,25,14,11,0,0,0
109,公立,技專校院,0050,國立臺中科技大學,學士班(日間),馬來西亞,東協,40,29,11,1,1,0,39,28,11,0,0,0,0,0,0
109,公立,技專校院,0050,國立臺中科技大學,學士班(日間),越南社會主義共和國,東協,13,5,8,7,4,3,6,1,5,0,0,0,0,0,0
109,公立,技專校院,0050,國立臺中科技大學,學士班(日間),澳門,港澳,5,3,2,0,0,0,0,0,0,5,3,2,0,0,0
109,公立,技專校院,0050,國立臺中科技大學,學士班(日間),日本,其他亞洲地區,7,4,3,5,4,1,2,0,2,0,0,0,0,0,0
109,公立,技專校院,0050,國立臺中科技大學,學士班(日間),美國,北美洲,1,0,1,0,0,0,1,0,1,0,0,0,0,0,0
109,公立,技專校院,0050,國立臺中科技大學,學士班(日間),泰國,東協,3,1,2,0,0,0,3,1,2,0,0,0,0,0,0
109,公立,技專校院,0050,國立臺中科技大學,學士班(日間),德意志聯邦共和國,歐洲,1,0,1,0,0,0,1,0,1,0,0,0,0,0,0
109,公立,技專校院,0050,國立臺中科技大學,學士班(日間),緬甸,東協,5,1,4,0,0,0,5,1,4,0,0,0,0,0,0
109,公立,技專校院,0050,國立臺中科技大學,碩士班(日間),日本,其他亞洲地區,1,1,0,1,1,0,0,0,0,0,0,0,0,0,0
109,公立,技專校院,0050,國立臺中科技大學,碩士班(日間),大陸地區,大陸地區,5,4,1,0,0,0,0,0,0,0,0,0,5,4,1
109,公立,技專校院,0050,國立臺中科技大學,碩士班(日間),香港,港澳,3,2,1,0,0,0,0,0,0,3,2,1,0,0,0
109,公立,技專校院,0050,國立臺中科技大學,碩士班(日間),馬來西亞,東協,1,1,0,1,1,0,0,0,0,0,0,0,0,0,0
109,公立,技專校院,0051,國立臺北商業大學,五專,緬甸,東協,1,0,1,0,0,0,1,0,1,0,0,0,0,0,0
109,公立,技專校院,0051,國立臺北商業大學,五專,印度尼西亞共和國,東協,4,0,4,0,0,0,4,0,4,0,0,0,0,0,0
109,公立,技專校院,0051,國立臺北商業大學,五專,阿根廷,中南美洲,2,1,1,0,0,0,2,1,1,0,0,0,0,0,0
109,公立,技專校院,0051,國立臺北商業大學,五專,泰國,東協,1,0,1,0,0,0,1,0,1,0,0,0,0,0,0
109,公立,技專校院,0051,國立臺北商業大學,五專,越南社會主義共和國,東協,2,0,2,0,0,0,2,0,2,0,0,0,0,0,0
109,公立,技專校院,0051,國立臺北商業大學,學士班(日間),大陸地區,大陸地區,44,19,25,0,0,0,0,0,0,0,0,0,44,19,25
109,公立,技專校院,0051,國立臺北商業大學,學士班(日間),日本,其他亞洲地區,3,1,2,2,1,1,1,0,1,0,0,0,0,0,0
109,公立,技專校院,0051,國立臺北商業大學,學士班(日間),印度尼西亞共和國,東協,35,16,19,4,1,3,31,15,16,0,0,0,0,0,0
109,公立,技專校院,0051,國立臺北商業大學,學士班(日間),南非共和國,非洲,1,1,0,1,1,0,0,0,0,0,0,0,0,0,0
109,公立,技專校院,0051,國立臺北商業大學,學士班(日間),香港,港澳,5,2,3,0,0,0,0,0,0,5,2,3,0,0,0
109,公立,技專校院,0051,國立臺北商業大學,學士班(日間),馬來西亞,東協,44,23,21,1,0,1,43,23,20,0,0,0,0,0,0
109,公立,技專校院,0051,國立臺北商業大學,學士班(日間),馬拉威共和國,非洲,1,1,0,1,1,0,0,0,0,0,0,0,0,0,0
109,公立,技專校院,0051,國立臺北商業大學,學士班(日間),葉門共和國,其他亞洲地區,1,1,0,0,0,0,1,1,0,0,0,0,0,0,0
109,公立,技專校院,0051,國立臺北商業大學,學士班(日間),緬甸,東協,31,8,23,0,0,0,31,8,23,0,0,0,0,0,0
109,公立,技專校院,0051,國立臺北商業大學,學士班(日間),澳門,港澳,3,2,1,0,0,0,0,0,0,3,2,1,0,0,0
109,公立,技專校院,0051,國立臺北商業大學,學士班(日間),巴西聯邦共和國,中南美洲,1,1,0,1,1,0,0,0,0,0,0,0,0,0,0
109,公立,技專校院,0051,國立臺北商業大學,學士班(日間),阿根廷,中南美洲,2,1,1,0,0,0,2,1,1,0,0,0,0,0,0
109,公立,技專校院,0051,國立臺北商業大學,學士班(日間),泰國,東協,1,0,1,1,0,1,0,0,0,0,0,0,0,0,0
109,公立,技專校院,0051,國立臺北商業大學,學士班(日間),越南社會主義共和國,東協,54,11,43,19,2,17,35,9,26,0,0,0,0,0,0
109,公立,技專校院,0051,國立臺北商業大學,碩士班(日間),馬來西亞,東協,1,0,1,0,0,0,1,0,1,0,0,0,0,0,0
109,公立,技專校院,0051,國立臺北商業大學,碩士班(日間),大陸地區,大陸地區,9,6,3,0,0,0,0,0,0,0,0,0,9,6,3
109,公立,一般大學,0052,國立屏東大學,學士班(日間),大陸地區,大陸地區,14,11,3,0,0,0,0,0,0,0,0,0,14,11,3
109,公立,一般大學,0052,國立屏東大學,學士班(日間),日本,其他亞洲地區,2,2,0,1,1,0,1,1,0,0,0,0,0,0,0
109,公立,一般大學,0052,國立屏東大學,學士班(日間),印度尼西亞共和國,東協,1,0,1,1,0,1,0,0,0,0,0,0,0,0,0
109,公立,一般大學,0052,國立屏東大學,學士班(日間),西班牙王國,歐洲,1,1,0,1,1,0,0,0,0,0,0,0,0,0,0
109,公立,一般大學,0052,國立屏東大學,學士班(日間),香港,港澳,25,10,15,0,0,0,0,0,0,25,10,15,0,0,0
109,公立,一般大學,0052,國立屏東大學,學士班(日間),馬來西亞,東協,48,22,26,2,0,2,46,22,24,0,0,0,0,0,0
109,公立,一般大學,0052,國立屏東大學,學士班(日間),越南社會主義共和國,東協,5,1,4,5,1,4,0,0,0,0,0,0,0,0,0
109,公立,一般大學,0052,國立屏東大學,學士班(日間),聖克里斯多福及尼維斯,中南美洲,1,0,1,1,0,1,0,0,0,0,0,0,0,0,0
109,公立,一般大學,0052,國立屏東大學,學士班(日間),緬甸,東協,1,0,1,0,0,0,1,0,1,0,0,0,0,0,0
109,公立,一般大學,0052,國立屏東大學,學士班(日間),澳門,港澳,20,10,10,0,0,0,0,0,0,20,10,10,0,0,0
109,公立,一般大學,0052,國立屏東大學,學士班(日間),泰國,東協,1,0,1,1,0,1,0,0,0,0,0,0,0,0,0
109,公立,一般大學,0052,國立屏東大學,學士班(日間),奧地利共和國,歐洲,1,1,0,1,1,0,0,0,0,0,0,0,0,0,0
109,公立,一般大學,0052,國立屏東大學,學士班(日間),義大利共和國,歐洲,1,0,1,1,0,1,0,0,0,0,0,0,0,0,0
109,公立,一般大學,0052,國立屏東大學,碩士班(日間),立陶宛共和國,歐洲,1,0,1,1,0,1,0,0,0,0,0,0,0,0,0
109,公立,一般大學,0052,國立屏東大學,碩士班(日間),泰國,東協,13,5,8,13,5,8,0,0,0,0,0,0,0,0,0
109,公立,一般大學,0052,國立屏東大學,碩士班(日間),越南社會主義共和國,東協,2,1,1,2,1,1,0,0,0,0,0,0,0,0,0
109,公立,一般大學,0052,國立屏東大學,碩士班(日間),大陸地區,大陸地區,3,2,1,0,0,0,0,0,0,0,0,0,3,2,1
109,公立,一般大學,0052,國立屏東大學,碩士班(日間),印度尼西亞共和國,東協,2,1,1,0,0,0,2,1,1,0,0,0,0,0,0
109,公立,一般大學,0052,國立屏東大學,碩士班(日間),香港,港澳,2,1,1,0,0,0,0,0,0,2,1,1,0,0,0
109,公立,一般大學,0052,國立屏東大學,碩士班(日間),馬來西亞,東協,11,4,7,7,2,5,4,2,2,0,0,0,0,0,0
109,公立,一般大學,0052,國立屏東大學,碩士班(日間),澳門,港澳,1,1,0,0,0,0,0,0,0,1,1,0,0,0,0
109,公立,一般大學,0052,國立屏東大學,博士班,印度尼西亞共和國,東協,2,2,0,2,2,0,0,0,0,0,0,0,0,0,0
109,公立,技專校院,0053,國立高雄科技大學,學士班(日間),巴西聯邦共和國,中南美洲,1,0,1,0,0,0,1,0,1,0,0,0,0,0,0
109,公立,技專校院,0053,國立高雄科技大學,學士班(日間),日本,其他亞洲地區,15,3,12,15,3,12,0,0,0,0,0,0,0,0,0
109,公立,技專校院,0053,國立高雄科技大學,學士班(日間),尼加拉瓜,中南美洲,1,0,1,1,0,1,0,0,0,0,0,0,0,0,0
109,公立,技專校院,0053,國立高雄科技大學,學士班(日間),大陸地區,大陸地區,32,22,10,0,0,0,0,0,0,0,0,0,32,22,10
109,公立,技專校院,0053,國立高雄科技大學,學士班(日間),印度尼西亞共和國,東協,21,12,9,2,0,2,19,12,7,0,0,0,0,0,0
109,公立,技專校院,0053,國立高雄科技大學,學士班(日間),阿根廷,中南美洲,1,0,1,0,0,0,1,0,1,0,0,0,0,0,0
109,公立,技專校院,0053,國立高雄科技大學,學士班(日間),南非共和國,非洲,1,0,1,1,0,1,0,0,0,0,0,0,0,0,0
109,公立,技專校院,0053,國立高雄科技大學,學士班(日間),香港,港澳,90,55,35,0,0,0,0,0,0,90,55,35,0,0,0
109,公立,技專校院,0053,國立高雄科技大學,學士班(日間),馬來西亞,東協,80,54,26,14,12,2,66,42,24,0,0,0,0,0,0
109,公立,技專校院,0053,國立高雄科技大學,學士班(日間),越南社會主義共和國,東協,27,6,21,21,6,15,6,0,6,0,0,0,0,0,0
109,公立,技專校院,0053,國立高雄科技大學,學士班(日間),新加坡共和國,東協,1,1,0,0,0,0,1,1,0,0,0,0,0,0,0
109,公立,技專校院,0053,國立高雄科技大學,學士班(日間),緬甸,東協,5,3,2,0,0,0,5,3,2,0,0,0,0,0,0
109,公立,技專校院,0053,國立高雄科技大學,學士班(日間),澳門,港澳,5,4,1,0,0,0,0,0,0,5,4,1,0,0,0
109,公立,技專校院,0053,國立高雄科技大學,碩士班(日間),大陸地區,大陸地區,6,6,0,0,0,0,0,0,0,0,0,0,6,6,0
109,公立,技專校院,0053,國立高雄科技大學,碩士班(日間),巴基斯坦,南亞,2,2,0,2,2,0,0,0,0,0,0,0,0,0,0
109,公立,技專校院,0053,國立高雄科技大學,碩士班(日間),印度尼西亞共和國,東協,3,1,2,3,1,2,0,0,0,0,0,0,0,0,0
109,公立,技專校院,0053,國立高雄科技大學,碩士班(日間),多明尼加共和國,中南美洲,2,1,1,2,1,1,0,0,0,0,0,0,0,0,0
109,公立,技專校院,0053,國立高雄科技大學,碩士班(日間),貝里斯,中南美洲,1,1,0,1,1,0,0,0,0,0,0,0,0,0,0
109,公立,技專校院,0053,國立高雄科技大學,碩士班(日間),柬埔寨王國,東協,4,3,1,4,3,1,0,0,0,0,0,0,0,0,0
109,公立,技專校院,0053,國立高雄科技大學,碩士班(日間),香港,港澳,9,6,3,0,0,0,0,0,0,9,6,3,0,0,0
109,公立,技專校院,0053,國立高雄科技大學,碩士班(日間),馬來西亞,東協,6,6,0,2,2,0,4,4,0,0,0,0,0,0,0
109,公立,技專校院,0053,國立高雄科技大學,碩士班(日間),菲律賓共和國,東協,7,7,0,7,7,0,0,0,0,0,0,0,0,0,0
109,公立,技專校院,0053,國立高雄科技大學,碩士班(日間),越南社會主義共和國,東協,89,42,47,89,42,47,0,0,0,0,0,0,0,0,0
109,公立,技專校院,0053,國立高雄科技大學,碩士班(日間),蒙古國,其他亞洲地區,1,1,0,1,1,0,0,0,0,0,0,0,0,0,0
109,公立,技專校院,0053,國立高雄科技大學,碩士班(日間),緬甸,東協,1,1,0,0,0,0,1,1,0,0,0,0,0,0,0
109,公立,技專校院,0053,國立高雄科技大學,碩士班(日間),日本,其他亞洲地區,3,0,3,3,0,3,0,0,0,0,0,0,0,0,0
109,公立,技專校院,0053,國立高雄科技大學,碩士班(日間),法國,歐洲,2,1,1,2,1,1,0,0,0,0,0,0,0,0,0
109,公立,技專校院,0053,國立高雄科技大學,碩士班(日間),美國,北美洲,1,0,1,1,0,1,0,0,0,0,0,0,0,0,0
109,公立,技專校院,0053,國立高雄科技大學,碩士班(日間),泰國,東協,3,1,2,3,1,2,0,0,0,0,0,0,0,0,0
109,公立,技專校院,0053,國立高雄科技大學,碩士班(日間),奧地利共和國,歐洲,1,0,1,1,0,1,0,0,0,0,0,0,0,0,0
109,公立,技專校院,0053,國立高雄科技大學,碩士班(日間),德意志聯邦共和國,歐洲,1,1,0,1,1,0,0,0,0,0,0,0,0,0,0
109,公立,技專校院,0053,國立高雄科技大學,碩士班(日間),墨西哥合眾國,中南美洲,1,0,1,1,0,1,0,0,0,0,0,0,0,0,0
109,公立,技專校院,0053,國立高雄科技大學,博士班,巴基斯坦,南亞,7,6,1,7,6,1,0,0,0,0,0,0,0,0,0
109,公立,技專校院,0053,國立高雄科技大學,博士班,印度尼西亞共和國,東協,6,4,2,6,4,2,0,0,0,0,0,0,0,0,0
109,公立,技專校院,0053,國立高雄科技大學,博士班,玻利維亞共和國,中南美洲,1,1,0,1,1,0,0,0,0,0,0,0,0,0,0
109,公立,技專校院,0053,國立高雄科技大學,博士班,泰國,東協,2,1,1,2,1,1,0,0,0,0,0,0,0,0,0
109,公立,技專校院,0053,國立高雄科技大學,博士班,馬來西亞,東協,2,1,1,2,1,1,0,0,0,0,0,0,0,0,0
109,公立,技專校院,0053,國立高雄科技大學,博士班,菲律賓共和國,東協,4,3,1,4,3,1,0,0,0,0,0,0,0,0,0
109,公立,技專校院,0053,國立高雄科技大學,博士班,大陸地區,大陸地區,4,1,3,0,0,0,0,0,0,0,0,0,4,1,3
109,公立,技專校院,0053,國立高雄科技大學,博士班,伊朗伊斯蘭共和國,其他亞洲地區,2,2,0,2,2,0,0,0,0,0,0,0,0,0,0
109,公立,技專校院,0053,國立高雄科技大學,博士班,印度,南亞,3,2,1,3,2,1,0,0,0,0,0,0,0,0,0
109,公立,技專校院,0053,國立高雄科技大學,博士班,波蘭共和國,歐洲,1,1,0,1,1,0,0,0,0,0,0,0,0,0,0
109,公立,技專校院,0053,國立高雄科技大學,博士班,美國,北美洲,1,1,0,1,1,0,0,0,0,0,0,0,0,0,0
109,公立,技專校院,0053,國立高雄科技大學,博士班,香港,港澳,1,1,0,0,0,0,0,0,0,1,1,0,0,0,0
109,公立,技專校院,0053,國立高雄科技大學,博士班,越南社會主義共和國,東協,56,40,16,56,40,16,0,0,0,0,0,0,0,0,0
109,公立,技專校院,0144,國立臺灣戲曲學院,學士班(日間),大陸地區,大陸地區,9,0,9,0,0,0,0,0,0,0,0,0,9,0,9
109,公立,技專校院,0144,國立臺灣戲曲學院,學士班(日間),香港,港澳,2,0,2,0,0,0,0,0,0,2,0,2,0,0,0
109,公立,技專校院,0144,國立臺灣戲曲學院,學士班(日間),澳門,港澳,2,1,1,0,0,0,0,0,0,2,1,1,0,0,0
109,公立,技專校院,0221,國立臺南護理專科學校,五專,印度尼西亞共和國,東協,1,0,1,0,0,0,1,0,1,0,0,0,0,0,0
109,公立,技專校院,0221,國立臺南護理專科學校,五專,泰國,東協,1,0,1,0,0,0,1,0,1,0,0,0,0,0,0
109,私立,一般大學,1001,東海大學,學士班(日間),日本,其他亞洲地區,61,19,42,61,19,42,0,0,0,0,0,0,0,0,0
109,私立,一般大學,1001,東海大學,學士班(日間),史瓦帝尼王國,非洲,3,1,2,3,1,2,0,0,0,0,0,0,0,0,0
109,私立,一般大學,1001,東海大學,學士班(日間),尼加拉瓜,中南美洲,2,1,1,2,1,1,0,0,0,0,0,0,0,0,0
109,私立,一般大學,1001,東海大學,學士班(日間),吐瓦魯,其他亞洲地區,1,0,1,1,0,1,0,0,0,0,0,0,0,0,0
109,私立,一般大學,1001,東海大學,學士班(日間),貝里斯,中南美洲,3,1,2,3,1,2,0,0,0,0,0,0,0,0,0
109,私立,一般大學,1001,東海大學,學士班(日間),委內瑞拉共和國,中南美洲,1,1,0,0,0,0,1,1,0,0,0,0,0,0,0
109,私立,一般大學,1001,東海大學,學士班(日間),美國,北美洲,2,1,1,2,1,1,0,0,0,0,0,0,0,0,0
109,私立,一般大學,1001,東海大學,學士班(日間),泰國,東協,1,0,1,1,0,1,0,0,0,0,0,0,0,0,0
109,私立,一般大學,1001,東海大學,學士班(日間),葉門共和國,其他亞洲地區,1,1,0,1,1,0,0,0,0,0,0,0,0,0,0
109,私立,一般大學,1001,東海大學,學士班(日間),緬甸,東協,3,2,1,2,1,1,1,1,0,0,0,0,0,0,0
109,私立,一般大學,1001,東海大學,學士班(日間),諾魯共和國,其他亞洲地區,1,0,1,1,0,1,0,0,0,0,0,0,0,0,0
109,私立,一般大學,1001,東海大學,學士班(日間),大陸地區,大陸地區,136,54,82,0,0,0,0,0,0,0,0,0,136,54,82
109,私立,一般大學,1001,東海大學,學士班(日間),大韓民國(南韓),其他亞洲地區,7,0,7,6,0,6,1,0,1,0,0,0,0,0,0
109,私立,一般大學,1001,東海大學,學士班(日間),巴西聯邦共和國,中南美洲,1,1,0,1,1,0,0,0,0,0,0,0,0,0,0
109,私立,一般大學,1001,東海大學,學士班(日間),巴基斯坦,南亞,1,1,0,1,1,0,0,0,0,0,0,0,0,0,0
109,私立,一般大學,1001,東海大學,學士班(日間),加拿大,北美洲,3,3,0,3,3,0,0,0,0,0,0,0,0,0,0
109,私立,一般大學,1001,東海大學,學士班(日間),印度,南亞,1,1,0,1,1,0,0,0,0,0,0,0,0,0,0
109,私立,一般大學,1001,東海大學,學士班(日間),印度尼西亞共和國,東協,181,87,94,168,76,92,13,11,2,0,0,0,0,0,0
109,私立,一般大學,1001,東海大學,學士班(日間),吉爾吉斯,其他亞洲地區,6,4,2,6,4,2,0,0,0,0,0,0,0,0,0
109,私立,一般大學,1001,東海大學,學士班(日間),俄羅斯聯邦,其他亞洲地區,1,0,1,1,0,1,0,0,0,0,0,0,0,0,0
109,私立,一般大學,1001,東海大學,學士班(日間),南非共和國,非洲,1,0,1,1,0,1,0,0,0,0,0,0,0,0,0
109,私立,一般大學,1001,東海大學,學士班(日間),柬埔寨王國,東協,1,1,0,1,1,0,0,0,0,0,0,0,0,0,0
109,私立,一般大學,1001,東海大學,學士班(日間),英國,歐洲,1,0,1,1,0,1,0,0,0,0,0,0,0,0,0
109,私立,一般大學,1001,東海大學,學士班(日間),香港,港澳,168,89,79,0,0,0,0,0,0,168,89,79,0,0,0
109,私立,一般大學,1001,東海大學,學士班(日間),馬來西亞,東協,103,49,54,52,25,27,51,24,27,0,0,0,0,0,0
109,私立,一般大學,1001,東海大學,學士班(日間),荷蘭王國,歐洲,1,1,0,1,1,0,0,0,0,0,0,0,0,0,0
109,私立,一般大學,1001,東海大學,學士班(日間),菲律賓共和國,東協,2,1,1,2,1,1,0,0,0,0,0,0,0,0,0
109,私立,一般大學,1001,東海大學,學士班(日間),越南社會主義共和國,東協,15,5,10,15,5,10,0,0,0,0,0,0,0,0,0
109,私立,一般大學,1001,東海大學,學士班(日間),聖克里斯多福及尼維斯,中南美洲,2,2,0,2,2,0,0,0,0,0,0,0,0,0,0
109,私立,一般大學,1001,東海大學,學士班(日間),聖露西亞,中南美洲,3,2,1,3,2,1,0,0,0,0,0,0,0,0,0
109,私立,一般大學,1001,東海大學,學士班(日間),葡萄牙共和國,歐洲,1,1,0,0,0,0,1,1,0,0,0,0,0,0,0
109,私立,一般大學,1001,東海大學,學士班(日間),蒙古國,其他亞洲地區,10,5,5,10,5,5,0,0,0,0,0,0,0,0,0
109,私立,一般大學,1001,東海大學,學士班(日間),澳門,港澳,39,19,20,0,0,0,0,0,0,39,19,20,0,0,0
109,私立,一般大學,1001,東海大學,學士班(日間),薩爾瓦多,中南美洲,2,0,2,2,0,2,0,0,0,0,0,0,0,0,0
109,私立,一般大學,1001,東海大學,碩士班(日間),土耳其共和國,其他亞洲地區,1,1,0,1,1,0,0,0,0,0,0,0,0,0,0
109,私立,一般大學,1001,東海大學,碩士班(日間),大陸地區,大陸地區,46,23,23,0,0,0,0,0,0,0,0,0,46,23,23
109,私立,一般大學,1001,東海大學,碩士班(日間),大韓民國(南韓),其他亞洲地區,2,0,2,2,0,2,0,0,0,0,0,0,0,0,0
109,私立,一般大學,1001,東海大學,碩士班(日間),厄瓜多共和國,中南美洲,1,0,1,1,0,1,0,0,0,0,0,0,0,0,0
109,私立,一般大學,1001,東海大學,碩士班(日間),巴西聯邦共和國,中南美洲,1,0,1,1,0,1,0,0,0,0,0,0,0,0,0
109,私立,一般大學,1001,東海大學,碩士班(日間),印度,南亞,3,3,0,3,3,0,0,0,0,0,0,0,0,0,0
109,私立,一般大學,1001,東海大學,碩士班(日間),印度尼西亞共和國,東協,17,6,11,16,6,10,1,0,1,0,0,0,0,0,0
109,私立,一般大學,1001,東海大學,碩士班(日間),吉爾吉斯,其他亞洲地區,2,1,1,2,1,1,0,0,0,0,0,0,0,0,0
109,私立,一般大學,1001,東海大學,碩士班(日間),南非共和國,非洲,1,0,1,1,0,1,0,0,0,0,0,0,0,0,0
109,私立,一般大學,1001,東海大學,碩士班(日間),香港,港澳,19,14,5,0,0,0,0,0,0,19,14,5,0,0,0
109,私立,一般大學,1001,東海大學,碩士班(日間),馬來西亞,東協,23,11,12,15,8,7,8,3,5,0,0,0,0,0,0
109,私立,一般大學,1001,東海大學,碩士班(日間),馬拉威共和國,非洲,1,1,0,1,1,0,0,0,0,0,0,0,0,0,0
109,私立,一般大學,1001,東海大學,碩士班(日間),新加坡共和國,東協,1,0,1,1,0,1,0,0,0,0,0,0,0,0,0
109,私立,一般大學,1001,東海大學,碩士班(日間),聖克里斯多福及尼維斯,中南美洲,1,0,1,1,0,1,0,0,0,0,0,0,0,0,0
109,私立,一般大學,1001,東海大學,碩士班(日間),蒙古國,其他亞洲地區,1,1,0,1,1,0,0,0,0,0,0,0,0,0,0
109,私立,一般大學,1001,東海大學,碩士班(日間),澳門,港澳,3,2,1,0,0,0,0,0,0,3,2,1,0,0,0
109,私立,一般大學,1001,東海大學,碩士班(日間),日本,其他亞洲地區,2,0,2,2,0,2,0,0,0,0,0,0,0,0,0
109,私立,一般大學,1001,東海大學,碩士班(日間),西班牙王國,歐洲,1,1,0,1,1,0,0,0,0,0,0,0,0,0,0
109,私立,一般大學,1001,東海大學,碩士班(日間),法國,歐洲,1,0,1,1,0,1,0,0,0,0,0,0,0,0,0
109,私立,一般大學,1001,東海大學,碩士班(日間),保加利亞共和國,歐洲,2,0,2,2,0,2,0,0,0,0,0,0,0,0,0
109,私立,一般大學,1001,東海大學,碩士班(日間),美國,北美洲,2,1,1,2,1,1,0,0,0,0,0,0,0,0,0
109,私立,一般大學,1001,東海大學,碩士班(日間),泰國,東協,3,0,3,3,0,3,0,0,0,0,0,0,0,0,0
109,私立,一般大學,1001,東海大學,碩士班(日間),越南社會主義共和國,東協,1,0,1,1,0,1,0,0,0,0,0,0,0,0,0
109,私立,一般大學,1001,東海大學,碩士班(日間),瑞士聯邦,歐洲,1,0,1,1,0,1,0,0,0,0,0,0,0,0,0
109,私立,一般大學,1001,東海大學,碩士班(日間),墨西哥合眾國,中南美洲,1,1,0,1,1,0,0,0,0,0,0,0,0,0,0
109,私立,一般大學,1001,東海大學,博士班,巴基斯坦,南亞,1,1,0,1,1,0,0,0,0,0,0,0,0,0,0
109,私立,一般大學,1001,東海大學,博士班,白俄羅斯共和國,其他亞洲地區,1,0,1,1,0,1,0,0,0,0,0,0,0,0,0
109,私立,一般大學,1001,東海大學,博士班,印度尼西亞共和國,東協,16,6,10,16,6,10,0,0,0,0,0,0,0,0,0
109,私立,一般大學,1001,東海大學,博士班,馬來西亞,東協,1,1,0,0,0,0,1,1,0,0,0,0,0,0,0
109,私立,一般大學,1001,東海大學,博士班,越南社會主義共和國,東協,2,1,1,2,1,1,0,0,0,0,0,0,0,0,0
109,私立,一般大學,1001,東海大學,博士班,大陸地區,大陸地區,24,8,16,0,0,0,0,0,0,0,0,0,24,8,16
109,私立,一般大學,1001,東海大學,博士班,巴布亞紐幾內亞獨立國,其他亞洲地區,1,1,0,1,1,0,0,0,0,0,0,0,0,0,0
109,私立,一般大學,1001,東海大學,博士班,日本,其他亞洲地區,1,0,1,1,0,1,0,0,0,0,0,0,0,0,0
109,私立,一般大學,1001,東海大學,博士班,印度,南亞,5,3,2,5,3,2,0,0,0,0,0,0,0,0,0
109,私立,一般大學,1001,東海大學,博士班,新加坡共和國,東協,1,0,1,1,0,1,0,0,0,0,0,0,0,0,0
109,私立,一般大學,1001,東海大學,博士班,義大利共和國,歐洲,1,1,0,1,1,0,0,0,0,0,0,0,0,0,0
109,私立,一般大學,1002,輔仁大學,學士班(日間),大韓民國(南韓),其他亞洲地區,30,15,15,27,13,14,3,2,1,0,0,0,0,0,0
109,私立,一般大學,1002,輔仁大學,學士班(日間),巴拿馬共和國,中南美洲,1,0,1,0,0,0,1,0,1,0,0,0,0,0,0
109,私立,一般大學,1002,輔仁大學,學士班(日間),日本,其他亞洲地區,35,12,23,32,10,22,3,2,1,0,0,0,0,0,0
109,私立,一般大學,1002,輔仁大學,學士班(日間),布吉納法索,非洲,1,0,1,1,0,1,0,0,0,0,0,0,0,0,0
109,私立,一般大學,1002,輔仁大學,學士班(日間),奈及利亞聯邦共和國,非洲,2,2,0,2,2,0,0,0,0,0,0,0,0,0,0
109,私立,一般大學,1002,輔仁大學,學士班(日間),美國,北美洲,9,6,3,3,3,0,6,3,3,0,0,0,0,0,0
109,私立,一般大學,1002,輔仁大學,學士班(日間),塞爾維亞共和國,歐洲,1,0,1,1,0,1,0,0,0,0,0,0,0,0,0
109,私立,一般大學,1002,輔仁大學,學士班(日間),新加坡共和國,東協,2,1,1,0,0,0,2,1,1,0,0,0,0,0,0
109,私立,一般大學,1002,輔仁大學,學士班(日間),蒙古國,其他亞洲地區,1,1,0,1,1,0,0,0,0,0,0,0,0,0,0
109,私立,一般大學,1002,輔仁大學,學士班(日間),澳大利亞,其他亞洲地區,1,0,1,1,0,1,0,0,0,0,0,0,0,0,0
109,私立,一般大學,1002,輔仁大學,學士班(日間),大陸地區,大陸地區,151,55,96,0,0,0,0,0,0,0,0,0,151,55,96
109,私立,一般大學,1002,輔仁大學,學士班(日間),巴西聯邦共和國,中南美洲,1,1,0,1,1,0,0,0,0,0,0,0,0,0,0
109,私立,一般大學,1002,輔仁大學,學士班(日間),加拿大,北美洲,2,1,1,0,0,0,2,1,1,0,0,0,0,0,0
109,私立,一般大學,1002,輔仁大學,學士班(日間),史瓦帝尼王國,非洲,2,0,2,1,0,1,1,0,1,0,0,0,0,0,0
109,私立,一般大學,1002,輔仁大學,學士班(日間),印度尼西亞共和國,東協,35,7,28,16,2,14,19,5,14,0,0,0,0,0,0
109,私立,一般大學,1002,輔仁大學,學士班(日間),宏都拉斯共和國,中南美洲,1,0,1,1,0,1,0,0,0,0,0,0,0,0,0
109,私立,一般大學,1002,輔仁大學,學士班(日間),香港,港澳,187,101,86,0,0,0,0,0,0,187,101,86,0,0,0
109,私立,一般大學,1002,輔仁大學,學士班(日間),哥斯大黎加共和國,中南美洲,1,0,1,0,0,0,1,0,1,0,0,0,0,0,0
109,私立,一般大學,1002,輔仁大學,學士班(日間),泰國,東協,8,1,7,6,1,5,2,0,2,0,0,0,0,0,0
109,私立,一般大學,1002,輔仁大學,學士班(日間),馬來西亞,東協,128,47,81,33,12,21,95,35,60,0,0,0,0,0,0
109,私立,一般大學,1002,輔仁大學,學士班(日間),越南社會主義共和國,東協,35,5,30,27,5,22,8,0,8,0,0,0,0,0,0
109,私立,一般大學,1002,輔仁大學,學士班(日間),緬甸,東協,1,1,0,0,0,0,1,1,0,0,0,0,0,0,0
109,私立,一般大學,1002,輔仁大學,學士班(日間),墨西哥合眾國,中南美洲,1,0,1,0,0,0,1,0,1,0,0,0,0,0,0
109,私立,一般大學,1002,輔仁大學,學士班(日間),澳門,港澳,124,83,41,0,0,0,0,0,0,124,83,41,0,0,0
109,私立,一般大學,1002,輔仁大學,碩士班(日間),大陸地區,大陸地區,186,81,105,0,0,0,0,0,0,0,0,0,186,81,105
109,私立,一般大學,1002,輔仁大學,碩士班(日間),大韓民國(南韓),其他亞洲地區,3,3,0,2,2,0,1,1,0,0,0,0,0,0,0
109,私立,一般大學,1002,輔仁大學,碩士班(日間),加拿大,北美洲,1,0,1,1,0,1,0,0,0,0,0,0,0,0,0
109,私立,一般大學,1002,輔仁大學,碩士班(日間),印度,南亞,3,1,2,3,1,2,0,0,0,0,0,0,0,0,0
109,私立,一般大學,1002,輔仁大學,碩士班(日間),印度尼西亞共和國,東協,5,3,2,4,2,2,1,1,0,0,0,0,0,0,0
109,私立,一般大學,1002,輔仁大學,碩士班(日間),法國,歐洲,4,1,3,4,1,3,0,0,0,0,0,0,0,0,0
109,私立,一般大學,1002,輔仁大學,碩士班(日間),香港,港澳,24,12,12,0,0,0,0,0,0,24,12,12,0,0,0
109,私立,一般大學,1002,輔仁大學,碩士班(日間),馬來西亞,東協,20,9,11,8,4,4,12,5,7,0,0,0,0,0,0
109,私立,一般大學,1002,輔仁大學,碩士班(日間),荷蘭王國,歐洲,1,1,0,1,1,0,0,0,0,0,0,0,0,0,0
109,私立,一般大學,1002,輔仁大學,碩士班(日間),越南社會主義共和國,東協,9,2,7,8,2,6,1,0,1,0,0,0,0,0,0
109,私立,一般大學,1002,輔仁大學,碩士班(日間),瑞士聯邦,歐洲,1,0,1,1,0,1,0,0,0,0,0,0,0,0,0
109,私立,一般大學,1002,輔仁大學,碩士班(日間),澳門,港澳,11,4,7,0,0,0,0,0,0,11,4,7,0,0,0
109,私立,一般大學,1002,輔仁大學,碩士班(日間),日本,其他亞洲地區,12,3,9,11,3,8,1,0,1,0,0,0,0,0,0
109,私立,一般大學,1002,輔仁大學,碩士班(日間),西班牙王國,歐洲,1,0,1,1,0,1,0,0,0,0,0,0,0,0,0
109,私立,一般大學,1002,輔仁大學,碩士班(日間),美國,北美洲,2,1,1,2,1,1,0,0,0,0,0,0,0,0,0
109,私立,一般大學,1002,輔仁大學,碩士班(日間),泰國,東協,3,1,2,3,1,2,0,0,0,0,0,0,0,0,0
109,私立,一般大學,1002,輔仁大學,碩士班(日間),菲律賓共和國,東協,3,1,2,3,1,2,0,0,0,0,0,0,0,0,0
109,私立,一般大學,1002,輔仁大學,博士班,大陸地區,大陸地區,50,28,22,0,0,0,0,0,0,0,0,0,50,28,22
109,私立,一般大學,1002,輔仁大學,博士班,日本,其他亞洲地區,2,2,0,2,2,0,0,0,0,0,0,0,0,0,0
109,私立,一般大學,1002,輔仁大學,博士班,加拿大,北美洲,1,1,0,0,0,0,1,1,0,0,0,0,0,0,0
109,私立,一般大學,1002,輔仁大學,博士班,印度,南亞,4,2,2,4,2,2,0,0,0,0,0,0,0,0,0
109,私立,一般大學,1002,輔仁大學,博士班,印度尼西亞共和國,東協,1,0,1,1,0,1,0,0,0,0,0,0,0,0,0
109,私立,一般大學,1002,輔仁大學,博士班,吉里巴斯共和國,其他亞洲地區,1,0,1,1,0,1,0,0,0,0,0,0,0,0,0
109,私立,一般大學,1002,輔仁大學,博士班,波蘭共和國,歐洲,2,1,1,2,1,1,0,0,0,0,0,0,0,0,0
109,私立,一般大學,1002,輔仁大學,博士班,阿根廷,中南美洲,2,1,1,2,1,1,0,0,0,0,0,0,0,0,0
109,私立,一般大學,1002,輔仁大學,博士班,香港,港澳,2,1,1,0,0,0,0,0,0,2,1,1,0,0,0
109,私立,一般大學,1002,輔仁大學,博士班,烏干達共和國,非洲,1,1,0,1,1,0,0,0,0,0,0,0,0,0,0
109,私立,一般大學,1002,輔仁大學,博士班,馬來西亞,東協,5,2,3,2,0,2,3,2,1,0,0,0,0,0,0
109,私立,一般大學,1002,輔仁大學,博士班,菲律賓共和國,東協,2,1,1,2,1,1,0,0,0,0,0,0,0,0,0
109,私立,一般大學,1002,輔仁大學,博士班,比利時王國,歐洲,1,1,0,1,1,0,0,0,0,0,0,0,0,0,0
109,私立,一般大學,1002,輔仁大學,博士班,美國,北美洲,1,1,0,1,1,0,0,0,0,0,0,0,0,0,0
109,私立,一般大學,1002,輔仁大學,博士班,越南社會主義共和國,東協,2,1,1,2,1,1,0,0,0,0,0,0,0,0,0
109,私立,一般大學,1002,輔仁大學,博士班,義大利共和國,歐洲,2,1,1,2,1,1,0,0,0,0,0,0,0,0,0
109,私立,一般大學,1003,東吳大學,學士班(日間),日本,其他亞洲地區,29,13,16,28,12,16,1,1,0,0,0,0,0,0,0
109,私立,一般大學,1003,東吳大學,學士班(日間),奈及利亞聯邦共和國,非洲,1,0,1,0,0,0,1,0,1,0,0,0,0,0,0
109,私立,一般大學,1003,東吳大學,學士班(日間),帛琉共和國,其他亞洲地區,1,0,1,1,0,1,0,0,0,0,0,0,0,0,0
109,私立,一般大學,1003,東吳大學,學士班(日間),美國,北美洲,1,1,0,0,0,0,1,1,0,0,0,0,0,0,0
109,私立,一般大學,1003,東吳大學,學士班(日間),新加坡共和國,東協,1,0,1,1,0,1,0,0,0,0,0,0,0,0,0
109,私立,一般大學,1003,東吳大學,學士班(日間),德意志聯邦共和國,歐洲,1,1,0,1,1,0,0,0,0,0,0,0,0,0,0
109,私立,一般大學,1003,東吳大學,學士班(日間),澳大利亞,其他亞洲地區,1,1,0,0,0,0,1,1,0,0,0,0,0,0,0
109,私立,一般大學,1003,東吳大學,學士班(日間),土耳其共和國,其他亞洲地區,1,1,0,1,1,0,0,0,0,0,0,0,0,0,0
109,私立,一般大學,1003,東吳大學,學士班(日間),大陸地區,大陸地區,78,28,50,0,0,0,0,0,0,0,0,0,78,28,50
109,私立,一般大學,1003,東吳大學,學士班(日間),大韓民國(南韓),其他亞洲地區,15,5,10,11,4,7,4,1,3,0,0,0,0,0,0
109,私立,一般大學,1003,東吳大學,學士班(日間),印度尼西亞共和國,東協,5,2,3,1,1,0,4,1,3,0,0,0,0,0,0
109,私立,一般大學,1003,東吳大學,學士班(日間),香港,港澳,148,76,72,0,0,0,0,0,0,148,76,72,0,0,0
109,私立,一般大學,1003,東吳大學,學士班(日間),哥倫比亞共和國,中南美洲,1,1,0,1,1,0,0,0,0,0,0,0,0,0,0
109,私立,一般大學,1003,東吳大學,學士班(日間),泰國,東協,3,1,2,1,0,1,2,1,1,0,0,0,0,0,0
109,私立,一般大學,1003,東吳大學,學士班(日間),馬來西亞,東協,54,21,33,15,6,9,39,15,24,0,0,0,0,0,0
109,私立,一般大學,1003,東吳大學,學士班(日間),越南社會主義共和國,東協,10,3,7,8,2,6,2,1,1,0,0,0,0,0,0
109,私立,一般大學,1003,東吳大學,學士班(日間),澳門,港澳,72,36,36,0,0,0,0,0,0,72,36,36,0,0,0
109,私立,一般大學,1003,東吳大學,碩士班(日間),大陸地區,大陸地區,56,28,28,0,0,0,0,0,0,0,0,0,56,28,28
109,私立,一般大學,1003,東吳大學,碩士班(日間),印度,南亞,1,1,0,1,1,0,0,0,0,0,0,0,0,0,0
109,私立,一般大學,1003,東吳大學,碩士班(日間),印度尼西亞共和國,東協,1,0,1,1,0,1,0,0,0,0,0,0,0,0,0
109,私立,一般大學,1003,東吳大學,碩士班(日間),波蘭共和國,歐洲,1,1,0,1,1,0,0,0,0,0,0,0,0,0,0
109,私立,一般大學,1003,東吳大學,碩士班(日間),香港,港澳,15,9,6,0,0,0,0,0,0,15,9,6,0,0,0
109,私立,一般大學,1003,東吳大學,碩士班(日間),馬來西亞,東協,9,7,2,5,3,2,4,4,0,0,0,0,0,0,0
109,私立,一般大學,1003,東吳大學,碩士班(日間),越南社會主義共和國,東協,2,2,0,2,2,0,0,0,0,0,0,0,0,0,0
109,私立,一般大學,1003,東吳大學,碩士班(日間),澳門,港澳,2,1,1,0,0,0,0,0,0,2,1,1,0,0,0
109,私立,一般大學,1003,東吳大學,碩士班(日間),日本,其他亞洲地區,6,4,2,6,4,2,0,0,0,0,0,0,0,0,0
109,私立,一般大學,1003,東吳大學,碩士班(日間),奈及利亞聯邦共和國,非洲,1,1,0,1,1,0,0,0,0,0,0,0,0,0,0
109,私立,一般大學,1003,東吳大學,碩士班(日間),俄羅斯聯邦,其他亞洲地區,1,1,0,1,1,0,0,0,0,0,0,0,0,0,0
109,私立,一般大學,1003,東吳大學,碩士班(日間),美國,北美洲,1,0,1,1,0,1,0,0,0,0,0,0,0,0,0
109,私立,一般大學,1003,東吳大學,博士班,日本,其他亞洲地區,13,3,10,13,3,10,0,0,0,0,0,0,0,0,0
109,私立,一般大學,1003,東吳大學,博士班,南非共和國,非洲,1,1,0,0,0,0,1,1,0,0,0,0,0,0,0
109,私立,一般大學,1003,東吳大學,博士班,大陸地區,大陸地區,14,8,6,0,0,0,0,0,0,0,0,0,14,8,6
109,私立,一般大學,1003,東吳大學,博士班,香港,港澳,1,0,1,0,0,0,0,0,0,1,0,1,0,0,0
109,私立,一般大學,1004,中原大學,學士班(日間),大陸地區,大陸地區,133,71,62,0,0,0,0,0,0,0,0,0,133,71,62
109,私立,一般大學,1004,中原大學,學士班(日間),大韓民國(南韓),其他亞洲地區,20,9,11,18,7,11,2,2,0,0,0,0,0,0,0
109,私立,一般大學,1004,中原大學,學士班(日間),巴拿馬共和國,中南美洲,1,1,0,1,1,0,0,0,0,0,0,0,0,0,0
109,私立,一般大學,1004,中原大學,學士班(日間),日本,其他亞洲地區,56,23,33,56,23,33,0,0,0,0,0,0,0,0,0
109,私立,一般大學,1004,中原大學,學士班(日間),印度尼西亞共和國,東協,99,42,57,43,18,25,56,24,32,0,0,0,0,0,0
109,私立,一般大學,1004,中原大學,學士班(日間),香港,港澳,257,162,95,0,0,0,0,0,0,257,162,95,0,0,0
109,私立,一般大學,1004,中原大學,學士班(日間),海地共和國,中南美洲,1,1,0,1,1,0,0,0,0,0,0,0,0,0,0
109,私立,一般大學,1004,中原大學,學士班(日間),新加坡共和國,東協,2,0,2,0,0,0,2,0,2,0,0,0,0,0,0
109,私立,一般大學,1004,中原大學,學士班(日間),聖文森(及格瑞那丁),中南美洲,1,0,1,1,0,1,0,0,0,0,0,0,0,0,0
109,私立,一般大學,1004,中原大學,學士班(日間),聖克里斯多福及尼維斯,中南美洲,2,1,1,2,1,1,0,0,0,0,0,0,0,0,0
109,私立,一般大學,1004,中原大學,學士班(日間),澳門,港澳,79,41,38,0,0,0,0,0,0,79,41,38,0,0,0
109,私立,一般大學,1004,中原大學,學士班(日間),史瓦帝尼王國,非洲,2,1,1,0,0,0,2,1,1,0,0,0,0,0,0
109,私立,一般大學,1004,中原大學,學士班(日間),吉爾吉斯,其他亞洲地區,1,1,0,1,1,0,0,0,0,0,0,0,0,0,0
109,私立,一般大學,1004,中原大學,學士班(日間),奈及利亞聯邦共和國,非洲,1,1,0,1,1,0,0,0,0,0,0,0,0,0,0
109,私立,一般大學,1004,中原大學,學士班(日間),俄羅斯聯邦,其他亞洲地區,1,1,0,1,1,0,0,0,0,0,0,0,0,0,0
109,私立,一般大學,1004,中原大學,學士班(日間),泰國,東協,2,2,0,1,1,0,1,1,0,0,0,0,0,0,0
109,私立,一般大學,1004,中原大學,學士班(日間),馬來西亞,東協,161,81,80,45,23,22,116,58,58,0,0,0,0,0,0
109,私立,一般大學,1004,中原大學,學士班(日間),菲律賓共和國,東協,2,0,2,2,0,2,0,0,0,0,0,0,0,0,0
109,私立,一般大學,1004,中原大學,學士班(日間),越南社會主義共和國,東協,56,15,41,52,13,39,4,2,2,0,0,0,0,0,0
109,私立,一般大學,1004,中原大學,學士班(日間),塞內加爾共和國,非洲,1,1,0,1,1,0,0,0,0,0,0,0,0,0,0
109,私立,一般大學,1004,中原大學,學士班(日間),寮人民民主共和國(寮國),東協,1,1,0,1,1,0,0,0,0,0,0,0,0,0,0
109,私立,一般大學,1004,中原大學,學士班(日間),薩爾瓦多,中南美洲,1,1,0,1,1,0,0,0,0,0,0,0,0,0,0
109,私立,一般大學,1004,中原大學,碩士班(日間),巴基斯坦,南亞,7,6,1,7,6,1,0,0,0,0,0,0,0,0,0
109,私立,一般大學,1004,中原大學,碩士班(日間),美國,北美洲,2,1,1,2,1,1,0,0,0,0,0,0,0,0,0
109,私立,一般大學,1004,中原大學,碩士班(日間),泰國,東協,3,0,3,3,0,3,0,0,0,0,0,0,0,0,0
109,私立,一般大學,1004,中原大學,碩士班(日間),馬來西亞,東協,8,3,5,3,2,1,5,1,4,0,0,0,0,0,0
109,私立,一般大學,1004,中原大學,碩士班(日間),菲律賓共和國,東協,5,2,3,5,2,3,0,0,0,0,0,0,0,0,0
109,私立,一般大學,1004,中原大學,碩士班(日間),越南社會主義共和國,東協,17,8,9,15,7,8,2,1,1,0,0,0,0,0,0
109,私立,一般大學,1004,中原大學,碩士班(日間),大陸地區,大陸地區,25,18,7,0,0,0,0,0,0,0,0,0,25,18,7
109,私立,一般大學,1004,中原大學,碩士班(日間),日本,其他亞洲地區,1,0,1,1,0,1,0,0,0,0,0,0,0,0,0
109,私立,一般大學,1004,中原大學,碩士班(日間),甘比亞共和國,非洲,1,1,0,1,1,0,0,0,0,0,0,0,0,0,0
109,私立,一般大學,1004,中原大學,碩士班(日間),印度,南亞,3,1,2,3,1,2,0,0,0,0,0,0,0,0,0
109,私立,一般大學,1004,中原大學,碩士班(日間),印度尼西亞共和國,東協,53,20,33,52,20,32,1,0,1,0,0,0,0,0,0
109,私立,一般大學,1004,中原大學,碩士班(日間),辛巴威共和國,非洲,1,0,1,1,0,1,0,0,0,0,0,0,0,0,0
109,私立,一般大學,1004,中原大學,碩士班(日間),香港,港澳,10,6,4,0,0,0,0,0,0,10,6,4,0,0,0
109,私立,一般大學,1004,中原大學,碩士班(日間),海地共和國,中南美洲,1,1,0,1,1,0,0,0,0,0,0,0,0,0,0
109,私立,一般大學,1004,中原大學,碩士班(日間),秘魯共和國,中南美洲,1,1,0,1,1,0,0,0,0,0,0,0,0,0,0
109,私立,一般大學,1004,中原大學,碩士班(日間),澳門,港澳,3,3,0,0,0,0,0,0,0,3,3,0,0,0,0
109,私立,一般大學,1004,中原大學,博士班,印度尼西亞共和國,東協,25,19,6,25,19,6,0,0,0,0,0,0,0,0,0
109,私立,一般大學,1004,中原大學,博士班,約旦哈什米王國,其他亞洲地區,1,1,0,1,1,0,0,0,0,0,0,0,0,0,0
109,私立,一般大學,1004,中原大學,博士班,美國,北美洲,1,1,0,1,1,0,0,0,0,0,0,0,0,0,0
109,私立,一般大學,1004,中原大學,博士班,泰國,東協,1,0,1,1,0,1,0,0,0,0,0,0,0,0,0
109,私立,一般大學,1004,中原大學,博士班,越南社會主義共和國,東協,9,8,1,9,8,1,0,0,0,0,0,0,0,0,0
109,私立,一般大學,1004,中原大學,博士班,大陸地區,大陸地區,25,13,12,0,0,0,0,0,0,0,0,0,25,13,12
109,私立,一般大學,1004,中原大學,博士班,大韓民國(南韓),其他亞洲地區,1,0,1,1,0,1,0,0,0,0,0,0,0,0,0
109,私立,一般大學,1004,中原大學,博士班,巴基斯坦,南亞,9,8,1,9,8,1,0,0,0,0,0,0,0,0,0
109,私立,一般大學,1004,中原大學,博士班,伊朗伊斯蘭共和國,其他亞洲地區,1,1,0,1,1,0,0,0,0,0,0,0,0,0,0
109,私立,一般大學,1004,中原大學,博士班,印度,南亞,15,8,7,15,8,7,0,0,0,0,0,0,0,0,0
109,私立,一般大學,1004,中原大學,博士班,海地共和國,中南美洲,2,2,0,2,2,0,0,0,0,0,0,0,0,0,0
109,私立,一般大學,1004,中原大學,博士班,秘魯共和國,中南美洲,1,0,1,1,0,1,0,0,0,0,0,0,0,0,0
109,私立,一般大學,1004,中原大學,博士班,馬來西亞,東協,1,0,1,0,0,0,1,0,1,0,0,0,0,0,0
109,私立,一般大學,1004,中原大學,博士班,菲律賓共和國,東協,12,9,3,12,9,3,0,0,0,0,0,0,0,0,0
109,私立,一般大學,1004,中原大學,博士班,蒙古國,其他亞洲地區,2,1,1,2,1,1,0,0,0,0,0,0,0,0,0
109,私立,一般大學,1005,淡江大學學校財團法人淡江大學,學士班(日間),土耳其共和國,其他亞洲地區,5,4,1,5,4,1,0,0,0,0,0,0,0,0,0
109,私立,一般大學,1005,淡江大學學校財團法人淡江大學,學士班(日間),大陸地區,大陸地區,192,93,99,0,0,0,0,0,0,0,0,0,192,93,99
109,私立,一般大學,1005,淡江大學學校財團法人淡江大學,學士班(日間),巴布亞紐幾內亞獨立國,其他亞洲地區,1,0,1,1,0,1,0,0,0,0,0,0,0,0,0
109,私立,一般大學,1005,淡江大學學校財團法人淡江大學,學士班(日間),巴西聯邦共和國,中南美洲,7,3,4,3,1,2,4,2,2,0,0,0,0,0,0
109,私立,一般大學,1005,淡江大學學校財團法人淡江大學,學士班(日間),巴拉圭,中南美洲,21,10,11,20,10,10,1,0,1,0,0,0,0,0,0
109,私立,一般大學,1005,淡江大學學校財團法人淡江大學,學士班(日間),加拿大,北美洲,4,4,0,3,3,0,1,1,0,0,0,0,0,0,0
109,私立,一般大學,1005,淡江大學學校財團法人淡江大學,學士班(日間),史瓦帝尼王國,非洲,11,8,3,11,8,3,0,0,0,0,0,0,0,0,0
109,私立,一般大學,1005,淡江大學學校財團法人淡江大學,學士班(日間),尼加拉瓜,中南美洲,4,2,2,4,2,2,0,0,0,0,0,0,0,0,0
109,私立,一般大學,1005,淡江大學學校財團法人淡江大學,學士班(日間),瓜地馬拉共和國,中南美洲,6,3,3,5,2,3,1,1,0,0,0,0,0,0,0
109,私立,一般大學,1005,淡江大學學校財團法人淡江大學,學士班(日間),白俄羅斯共和國,其他亞洲地區,1,1,0,1,1,0,0,0,0,0,0,0,0,0,0
109,私立,一般大學,1005,淡江大學學校財團法人淡江大學,學士班(日間),印度尼西亞共和國,東協,296,133,163,181,74,107,115,59,56,0,0,0,0,0,0
109,私立,一般大學,1005,淡江大學學校財團法人淡江大學,學士班(日間),吐瓦魯,其他亞洲地區,7,2,5,7,2,5,0,0,0,0,0,0,0,0,0
109,私立,一般大學,1005,淡江大學學校財團法人淡江大學,學士班(日間),多明尼加共和國,中南美洲,1,1,0,1,1,0,0,0,0,0,0,0,0,0,0
109,私立,一般大學,1005,淡江大學學校財團法人淡江大學,學士班(日間),貝里斯,中南美洲,3,1,2,3,1,2,0,0,0,0,0,0,0,0,0
109,私立,一般大學,1005,淡江大學學校財團法人淡江大學,學士班(日間),帛琉共和國,其他亞洲地區,7,2,5,7,2,5,0,0,0,0,0,0,0,0,0
109,私立,一般大學,1005,淡江大學學校財團法人淡江大學,學士班(日間),波蘭共和國,歐洲,1,0,1,1,0,1,0,0,0,0,0,0,0,0,0
109,私立,一般大學,1005,淡江大學學校財團法人淡江大學,學士班(日間),法國,歐洲,2,2,0,2,2,0,0,0,0,0,0,0,0,0,0
109,私立,一般大學,1005,淡江大學學校財團法人淡江大學,學士班(日間),阿根廷,中南美洲,1,0,1,0,0,0,1,0,1,0,0,0,0,0,0
109,私立,一般大學,1005,淡江大學學校財團法人淡江大學,學士班(日間),南非共和國,非洲,1,0,1,1,0,1,0,0,0,0,0,0,0,0,0
109,私立,一般大學,1005,淡江大學學校財團法人淡江大學,學士班(日間),香港,港澳,361,194,167,0,0,0,0,0,0,361,194,167,0,0,0
109,私立,一般大學,1005,淡江大學學校財團法人淡江大學,學士班(日間),哥倫比亞共和國,中南美洲,1,0,1,1,0,1,0,0,0,0,0,0,0,0,0
109,私立,一般大學,1005,淡江大學學校財團法人淡江大學,學士班(日間),泰國,東協,19,8,11,18,8,10,1,0,1,0,0,0,0,0,0
109,私立,一般大學,1005,淡江大學學校財團法人淡江大學,學士班(日間),海地共和國,中南美洲,12,9,3,12,9,3,0,0,0,0,0,0,0,0,0
109,私立,一般大學,1005,淡江大學學校財團法人淡江大學,學士班(日間),索羅門群島,其他亞洲地區,4,3,1,4,3,1,0,0,0,0,0,0,0,0,0
109,私立,一般大學,1005,淡江大學學校財團法人淡江大學,學士班(日間),馬紹爾群島共和國,其他亞洲地區,12,2,10,12,2,10,0,0,0,0,0,0,0,0,0
109,私立,一般大學,1005,淡江大學學校財團法人淡江大學,學士班(日間),智利,中南美洲,1,0,1,0,0,0,1,0,1,0,0,0,0,0,0
109,私立,一般大學,1005,淡江大學學校財團法人淡江大學,學士班(日間),菲律賓共和國,東協,4,1,3,1,0,1,3,1,2,0,0,0,0,0,0
109,私立,一般大學,1005,淡江大學學校財團法人淡江大學,學士班(日間),越南社會主義共和國,東協,52,20,32,43,15,28,9,5,4,0,0,0,0,0,0
109,私立,一般大學,1005,淡江大學學校財團法人淡江大學,學士班(日間),聖露西亞,中南美洲,2,2,0,2,2,0,0,0,0,0,0,0,0,0,0
109,私立,一般大學,1005,淡江大學學校財團法人淡江大學,學士班(日間),蒙古國,其他亞洲地區,9,4,5,9,4,5,0,0,0,0,0,0,0,0,0
109,私立,一般大學,1005,淡江大學學校財團法人淡江大學,學士班(日間),緬甸,東協,6,4,2,0,0,0,6,4,2,0,0,0,0,0,0
109,私立,一般大學,1005,淡江大學學校財團法人淡江大學,學士班(日間),墨西哥合眾國,中南美洲,2,1,1,2,1,1,0,0,0,0,0,0,0,0,0
109,私立,一般大學,1005,淡江大學學校財團法人淡江大學,學士班(日間),澳門,港澳,118,74,44,0,0,0,0,0,0,118,74,44,0,0,0
109,私立,一般大學,1005,淡江大學學校財團法人淡江大學,學士班(日間),薩爾瓦多,中南美洲,2,1,1,2,1,1,0,0,0,0,0,0,0,0,0
109,私立,一般大學,1005,淡江大學學校財團法人淡江大學,學士班(日間),大韓民國(南韓),其他亞洲地區,28,12,16,22,8,14,6,4,2,0,0,0,0,0,0
109,私立,一般大學,1005,淡江大學學校財團法人淡江大學,學士班(日間),巴拿馬共和國,中南美洲,5,2,3,5,2,3,0,0,0,0,0,0,0,0,0
109,私立,一般大學,1005,淡江大學學校財團法人淡江大學,學士班(日間),日本,其他亞洲地區,87,40,47,76,38,38,11,2,9,0,0,0,0,0,0
109,私立,一般大學,1005,淡江大學學校財團法人淡江大學,學士班(日間),布吉納法索,非洲,2,2,0,2,2,0,0,0,0,0,0,0,0,0,0
109,私立,一般大學,1005,淡江大學學校財團法人淡江大學,學士班(日間),印度,南亞,7,2,5,7,2,5,0,0,0,0,0,0,0,0,0
109,私立,一般大學,1005,淡江大學學校財團法人淡江大學,學士班(日間),宏都拉斯共和國,中南美洲,10,5,5,10,5,5,0,0,0,0,0,0,0,0,0
109,私立,一般大學,1005,淡江大學學校財團法人淡江大學,學士班(日間),俄羅斯聯邦,其他亞洲地區,3,0,3,3,0,3,0,0,0,0,0,0,0,0,0
109,私立,一般大學,1005,淡江大學學校財團法人淡江大學,學士班(日間),柬埔寨王國,東協,1,1,0,1,1,0,0,0,0,0,0,0,0,0,0
109,私立,一般大學,1005,淡江大學學校財團法人淡江大學,學士班(日間),約旦哈什米王國,其他亞洲地區,1,0,1,0,0,0,1,0,1,0,0,0,0,0,0
109,私立,一般大學,1005,淡江大學學校財團法人淡江大學,學士班(日間),美國,北美洲,13,9,4,12,8,4,1,1,0,0,0,0,0,0,0
109,私立,一般大學,1005,淡江大學學校財團法人淡江大學,學士班(日間),英國,歐洲,1,0,1,1,0,1,0,0,0,0,0,0,0,0,0
109,私立,一般大學,1005,淡江大學學校財團法人淡江大學,學士班(日間),哥斯大黎加共和國,中南美洲,1,0,1,0,0,0,1,0,1,0,0,0,0,0,0
109,私立,一般大學,1005,淡江大學學校財團法人淡江大學,學士班(日間),烏克蘭,其他亞洲地區,1,0,1,1,0,1,0,0,0,0,0,0,0,0,0
109,私立,一般大學,1005,淡江大學學校財團法人淡江大學,學士班(日間),秘魯共和國,中南美洲,7,3,4,7,3,4,0,0,0,0,0,0,0,0,0
109,私立,一般大學,1005,淡江大學學校財團法人淡江大學,學士班(日間),馬來西亞,東協,113,51,62,18,7,11,95,44,51,0,0,0,0,0,0
109,私立,一般大學,1005,淡江大學學校財團法人淡江大學,學士班(日間),幾內亞共和國,非洲,1,1,0,1,1,0,0,0,0,0,0,0,0,0,0
109,私立,一般大學,1005,淡江大學學校財團法人淡江大學,學士班(日間),斯里蘭卡民主社會主義共和國,南亞,1,0,1,0,0,0,1,0,1,0,0,0,0,0,0
109,私立,一般大學,1005,淡江大學學校財團法人淡江大學,學士班(日間),新加坡共和國,東協,1,0,1,1,0,1,0,0,0,0,0,0,0,0,0
109,私立,一般大學,1005,淡江大學學校財團法人淡江大學,學士班(日間),義大利共和國,歐洲,1,1,0,1,1,0,0,0,0,0,0,0,0,0,0
109,私立,一般大學,1005,淡江大學學校財團法人淡江大學,學士班(日間),聖文森(及格瑞那丁),中南美洲,7,2,5,7,2,5,0,0,0,0,0,0,0,0,0
109,私立,一般大學,1005,淡江大學學校財團法人淡江大學,學士班(日間),聖克里斯多福及尼維斯,中南美洲,2,0,2,2,0,2,0,0,0,0,0,0,0,0,0
109,私立,一般大學,1005,淡江大學學校財團法人淡江大學,學士班(日間),葡萄牙共和國,歐洲,1,1,0,1,1,0,0,0,0,0,0,0,0,0,0
109,私立,一般大學,1005,淡江大學學校財團法人淡江大學,學士班(日間),德意志聯邦共和國,歐洲,2,1,1,2,1,1,0,0,0,0,0,0,0,0,0
109,私立,一般大學,1005,淡江大學學校財團法人淡江大學,學士班(日間),澳大利亞,其他亞洲地區,1,1,0,1,1,0,0,0,0,0,0,0,0,0,0
109,私立,一般大學,1005,淡江大學學校財團法人淡江大學,學士班(日間),諾魯共和國,其他亞洲地區,4,2,2,4,2,2,0,0,0,0,0,0,0,0,0
109,私立,一般大學,1005,淡江大學學校財團法人淡江大學,碩士班(日間),厄瓜多共和國,中南美洲,1,1,0,1,1,0,0,0,0,0,0,0,0,0,0
109,私立,一般大學,1005,淡江大學學校財團法人淡江大學,碩士班(日間),日本,其他亞洲地區,7,5,2,6,4,2,1,1,0,0,0,0,0,0,0
109,私立,一般大學,1005,淡江大學學校財團法人淡江大學,碩士班(日間),以色列,其他亞洲地區,1,0,1,1,0,1,0,0,0,0,0,0,0,0,0
109,私立,一般大學,1005,淡江大學學校財團法人淡江大學,碩士班(日間),史瓦帝尼王國,非洲,1,0,1,1,0,1,0,0,0,0,0,0,0,0,0
109,私立,一般大學,1005,淡江大學學校財團法人淡江大學,碩士班(日間),布吉納法索,非洲,3,3,0,3,3,0,0,0,0,0,0,0,0,0,0
109,私立,一般大學,1005,淡江大學學校財團法人淡江大學,碩士班(日間),印度,南亞,5,4,1,5,4,1,0,0,0,0,0,0,0,0,0
109,私立,一般大學,1005,淡江大學學校財團法人淡江大學,碩士班(日間),西班牙王國,歐洲,1,1,0,1,1,0,0,0,0,0,0,0,0,0,0
109,私立,一般大學,1005,淡江大學學校財團法人淡江大學,碩士班(日間),沙烏地阿拉伯王國,其他亞洲地區,2,2,0,2,2,0,0,0,0,0,0,0,0,0,0
109,私立,一般大學,1005,淡江大學學校財團法人淡江大學,碩士班(日間),俄羅斯聯邦,其他亞洲地區,2,1,1,2,1,1,0,0,0,0,0,0,0,0,0
109,私立,一般大學,1005,淡江大學學校財團法人淡江大學,碩士班(日間),美國,北美洲,7,4,3,5,3,2,2,1,1,0,0,0,0,0,0
109,私立,一般大學,1005,淡江大學學校財團法人淡江大學,碩士班(日間),英國,歐洲,1,1,0,1,1,0,0,0,0,0,0,0,0,0,0
109,私立,一般大學,1005,淡江大學學校財團法人淡江大學,碩士班(日間),索馬利蘭共和國,非洲,1,1,0,1,1,0,0,0,0,0,0,0,0,0,0
109,私立,一般大學,1005,淡江大學學校財團法人淡江大學,碩士班(日間),馬來西亞,東協,10,4,6,4,1,3,6,3,3,0,0,0,0,0,0
109,私立,一般大學,1005,淡江大學學校財團法人淡江大學,碩士班(日間),菲律賓共和國,東協,1,1,0,1,1,0,0,0,0,0,0,0,0,0,0
109,私立,一般大學,1005,淡江大學學校財團法人淡江大學,碩士班(日間),大陸地區,大陸地區,54,35,19,0,0,0,0,0,0,0,0,0,54,35,19
109,私立,一般大學,1005,淡江大學學校財團法人淡江大學,碩士班(日間),大韓民國(南韓),其他亞洲地區,2,1,1,2,1,1,0,0,0,0,0,0,0,0,0
109,私立,一般大學,1005,淡江大學學校財團法人淡江大學,碩士班(日間),尼加拉瓜,中南美洲,3,0,3,3,0,3,0,0,0,0,0,0,0,0,0
109,私立,一般大學,1005,淡江大學學校財團法人淡江大學,碩士班(日間),瓜地馬拉共和國,中南美洲,1,0,1,1,0,1,0,0,0,0,0,0,0,0,0
109,私立,一般大學,1005,淡江大學學校財團法人淡江大學,碩士班(日間),甘比亞共和國,非洲,1,1,0,1,1,0,0,0,0,0,0,0,0,0,0
109,私立,一般大學,1005,淡江大學學校財團法人淡江大學,碩士班(日間),伊朗伊斯蘭共和國,其他亞洲地區,1,1,0,1,1,0,0,0,0,0,0,0,0,0,0
109,私立,一般大學,1005,淡江大學學校財團法人淡江大學,碩士班(日間),印度尼西亞共和國,東協,8,4,4,6,3,3,2,1,1,0,0,0,0,0,0
109,私立,一般大學,1005,淡江大學學校財團法人淡江大學,碩士班(日間),宏都拉斯共和國,中南美洲,1,1,0,1,1,0,0,0,0,0,0,0,0,0,0
109,私立,一般大學,1005,淡江大學學校財團法人淡江大學,碩士班(日間),法國,歐洲,2,0,2,2,0,2,0,0,0,0,0,0,0,0,0
109,私立,一般大學,1005,淡江大學學校財團法人淡江大學,碩士班(日間),南非共和國,非洲,1,1,0,1,1,0,0,0,0,0,0,0,0,0,0
109,私立,一般大學,1005,淡江大學學校財團法人淡江大學,碩士班(日間),科威特,其他亞洲地區,1,1,0,0,0,0,1,1,0,0,0,0,0,0,0
109,私立,一般大學,1005,淡江大學學校財團法人淡江大學,碩士班(日間),香港,港澳,17,11,6,0,0,0,0,0,0,17,11,6,0,0,0
109,私立,一般大學,1005,淡江大學學校財團法人淡江大學,碩士班(日間),泰國,東協,7,3,4,7,3,4,0,0,0,0,0,0,0,0,0
109,私立,一般大學,1005,淡江大學學校財團法人淡江大學,碩士班(日間),海地共和國,中南美洲,1,0,1,1,0,1,0,0,0,0,0,0,0,0,0
109,私立,一般大學,1005,淡江大學學校財團法人淡江大學,碩士班(日間),索羅門群島,其他亞洲地區,1,1,0,1,1,0,0,0,0,0,0,0,0,0,0
109,私立,一般大學,1005,淡江大學學校財團法人淡江大學,碩士班(日間),越南社會主義共和國,東協,3,1,2,3,1,2,0,0,0,0,0,0,0,0,0
109,私立,一般大學,1005,淡江大學學校財團法人淡江大學,碩士班(日間),瑞典王國,歐洲,1,1,0,1,1,0,0,0,0,0,0,0,0,0,0
109,私立,一般大學,1005,淡江大學學校財團法人淡江大學,碩士班(日間),聖文森(及格瑞那丁),中南美洲,1,0,1,1,0,1,0,0,0,0,0,0,0,0,0
109,私立,一般大學,1005,淡江大學學校財團法人淡江大學,碩士班(日間),蒙古國,其他亞洲地區,3,1,2,3,1,2,0,0,0,0,0,0,0,0,0
109,私立,一般大學,1005,淡江大學學校財團法人淡江大學,碩士班(日間),德意志聯邦共和國,歐洲,1,1,0,1,1,0,0,0,0,0,0,0,0,0,0
109,私立,一般大學,1005,淡江大學學校財團法人淡江大學,碩士班(日間),澳大利亞,其他亞洲地區,1,1,0,1,1,0,0,0,0,0,0,0,0,0,0
109,私立,一般大學,1005,淡江大學學校財團法人淡江大學,碩士班(日間),澳門,港澳,7,5,2,0,0,0,0,0,0,7,5,2,0,0,0
109,私立,一般大學,1005,淡江大學學校財團法人淡江大學,博士班,瓜地馬拉共和國,中南美洲,1,1,0,1,1,0,0,0,0,0,0,0,0,0,0
109,私立,一般大學,1005,淡江大學學校財團法人淡江大學,博士班,美國,北美洲,1,0,1,1,0,1,0,0,0,0,0,0,0,0,0
109,私立,一般大學,1005,淡江大學學校財團法人淡江大學,博士班,義大利共和國,歐洲,1,1,0,1,1,0,0,0,0,0,0,0,0,0,0
109,私立,一般大學,1005,淡江大學學校財團法人淡江大學,博士班,德意志聯邦共和國,歐洲,1,1,0,1,1,0,0,0,0,0,0,0,0,0,0
109,私立,一般大學,1005,淡江大學學校財團法人淡江大學,博士班,土耳其共和國,其他亞洲地區,1,0,1,1,0,1,0,0,0,0,0,0,0,0,0
109,私立,一般大學,1005,淡江大學學校財團法人淡江大學,博士班,大陸地區,大陸地區,16,7,9,0,0,0,0,0,0,0,0,0,16,7,9
109,私立,一般大學,1005,淡江大學學校財團法人淡江大學,博士班,日本,其他亞洲地區,3,2,1,3,2,1,0,0,0,0,0,0,0,0,0
109,私立,一般大學,1005,淡江大學學校財團法人淡江大學,博士班,布吉納法索,非洲,2,1,1,2,1,1,0,0,0,0,0,0,0,0,0
109,私立,一般大學,1005,淡江大學學校財團法人淡江大學,博士班,伊拉克共和國,其他亞洲地區,1,1,0,1,1,0,0,0,0,0,0,0,0,0,0
109,私立,一般大學,1005,淡江大學學校財團法人淡江大學,博士班,匈牙利共和國,歐洲,1,0,1,1,0,1,0,0,0,0,0,0,0,0,0
109,私立,一般大學,1005,淡江大學學校財團法人淡江大學,博士班,印度,南亞,5,3,2,5,3,2,0,0,0,0,0,0,0,0,0
109,私立,一般大學,1005,淡江大學學校財團法人淡江大學,博士班,法國,歐洲,1,0,1,1,0,1,0,0,0,0,0,0,0,0,0
109,私立,一般大學,1005,淡江大學學校財團法人淡江大學,博士班,英國,歐洲,1,1,0,1,1,0,0,0,0,0,0,0,0,0,0
109,私立,一般大學,1005,淡江大學學校財團法人淡江大學,博士班,香港,港澳,1,1,0,0,0,0,0,0,0,1,1,0,0,0,0
109,私立,一般大學,1005,淡江大學學校財團法人淡江大學,博士班,馬來西亞,東協,5,5,0,5,5,0,0,0,0,0,0,0,0,0,0
109,私立,一般大學,1005,淡江大學學校財團法人淡江大學,博士班,菲律賓共和國,東協,1,1,0,1,1,0,0,0,0,0,0,0,0,0,0
109,私立,一般大學,1005,淡江大學學校財團法人淡江大學,博士班,越南社會主義共和國,東協,6,2,4,5,1,4,1,1,0,0,0,0,0,0,0
109,私立,一般大學,1006,中國文化大學,學士班(日間),大陸地區,大陸地區,178,73,105,0,0,0,0,0,0,0,0,0,178,73,105
109,私立,一般大學,1006,中國文化大學,學士班(日間),大韓民國(南韓),其他亞洲地區,34,13,21,31,11,20,3,2,1,0,0,0,0,0,0
109,私立,一般大學,1006,中國文化大學,學士班(日間),日本,其他亞洲地區,73,32,41,70,30,40,3,2,1,0,0,0,0,0,0
109,私立,一般大學,1006,中國文化大學,學士班(日間),加拿大,北美洲,3,2,1,0,0,0,3,2,1,0,0,0,0,0,0
109,私立,一般大學,1006,中國文化大學,學士班(日間),布吉納法索,非洲,1,1,0,1,1,0,0,0,0,0,0,0,0,0,0
109,私立,一般大學,1006,中國文化大學,學士班(日間),印度,南亞,1,0,1,1,0,1,0,0,0,0,0,0,0,0,0
109,私立,一般大學,1006,中國文化大學,學士班(日間),印度尼西亞共和國,東協,58,33,25,38,23,15,20,10,10,0,0,0,0,0,0
109,私立,一般大學,1006,中國文化大學,學士班(日間),委內瑞拉共和國,中南美洲,1,1,0,1,1,0,0,0,0,0,0,0,0,0,0
109,私立,一般大學,1006,中國文化大學,學士班(日間),南非共和國,非洲,2,1,1,0,0,0,2,1,1,0,0,0,0,0,0
109,私立,一般大學,1006,中國文化大學,學士班(日間),香港,港澳,261,130,131,0,0,0,0,0,0,261,130,131,0,0,0
109,私立,一般大學,1006,中國文化大學,學士班(日間),剛果共和國,非洲,2,2,0,2,2,0,0,0,0,0,0,0,0,0,0
109,私立,一般大學,1006,中國文化大學,學士班(日間),烏茲別克共和國,其他亞洲地區,1,1,0,1,1,0,0,0,0,0,0,0,0,0,0
109,私立,一般大學,1006,中國文化大學,學士班(日間),秘魯共和國,中南美洲,1,1,0,1,1,0,0,0,0,0,0,0,0,0,0
109,私立,一般大學,1006,中國文化大學,學士班(日間),馬來西亞,東協,244,118,126,128,65,63,116,53,63,0,0,0,0,0,0
109,私立,一般大學,1006,中國文化大學,學士班(日間),菲律賓共和國,東協,1,1,0,1,1,0,0,0,0,0,0,0,0,0,0
109,私立,一般大學,1006,中國文化大學,學士班(日間),越南社會主義共和國,東協,23,4,19,20,3,17,3,1,2,0,0,0,0,0,0
109,私立,一般大學,1006,中國文化大學,學士班(日間),新加坡共和國,東協,3,0,3,3,0,3,0,0,0,0,0,0,0,0,0
109,私立,一般大學,1006,中國文化大學,學士班(日間),緬甸,東協,1,0,1,0,0,0,1,0,1,0,0,0,0,0,0
109,私立,一般大學,1006,中國文化大學,學士班(日間),黎巴嫩共和國,其他亞洲地區,1,0,1,1,0,1,0,0,0,0,0,0,0,0,0
109,私立,一般大學,1006,中國文化大學,學士班(日間),澳門,港澳,61,35,26,0,0,0,0,0,0,61,35,26,0,0,0
109,私立,一般大學,1006,中國文化大學,學士班(日間),諾魯共和國,其他亞洲地區,1,1,0,1,1,0,0,0,0,0,0,0,0,0,0
109,私立,一般大學,1006,中國文化大學,學士班(日間),巴西聯邦共和國,中南美洲,1,0,1,0,0,0,1,0,1,0,0,0,0,0,0
109,私立,一般大學,1006,中國文化大學,學士班(日間),吐瓦魯,其他亞洲地區,1,0,1,1,0,1,0,0,0,0,0,0,0,0,0
109,私立,一般大學,1006,中國文化大學,學士班(日間),拉脫維亞共和國,歐洲,1,0,1,1,0,1,0,0,0,0,0,0,0,0,0
109,私立,一般大學,1006,中國文化大學,學士班(日間),法國,歐洲,1,0,1,1,0,1,0,0,0,0,0,0,0,0,0
109,私立,一般大學,1006,中國文化大學,學士班(日間),俄羅斯聯邦,其他亞洲地區,1,0,1,1,0,1,0,0,0,0,0,0,0,0,0
109,私立,一般大學,1006,中國文化大學,學士班(日間),查德共和國,非洲,1,1,0,1,1,0,0,0,0,0,0,0,0,0,0
109,私立,一般大學,1006,中國文化大學,學士班(日間),美國,北美洲,8,4,4,6,3,3,2,1,1,0,0,0,0,0,0
109,私立,一般大學,1006,中國文化大學,學士班(日間),泰國,東協,4,1,3,2,1,1,2,0,2,0,0,0,0,0,0
109,私立,一般大學,1006,中國文化大學,學士班(日間),馬紹爾群島共和國,其他亞洲地區,1,0,1,1,0,1,0,0,0,0,0,0,0,0,0
109,私立,一般大學,1006,中國文化大學,學士班(日間),塞爾維亞共和國,歐洲,1,1,0,1,1,0,0,0,0,0,0,0,0,0,0
109,私立,一般大學,1006,中國文化大學,學士班(日間),義大利共和國,歐洲,1,0,1,0,0,0,1,0,1,0,0,0,0,0,0
109,私立,一般大學,1006,中國文化大學,學士班(日間),蒙古國,其他亞洲地區,14,5,9,14,5,9,0,0,0,0,0,0,0,0,0
109,私立,一般大學,1006,中國文化大學,學士班(日間),德意志聯邦共和國,歐洲,1,0,1,1,0,1,0,0,0,0,0,0,0,0,0
109,私立,一般大學,1006,中國文化大學,碩士班(日間),土耳其共和國,其他亞洲地區,1,1,0,1,1,0,0,0,0,0,0,0,0,0,0
109,私立,一般大學,1006,中國文化大學,碩士班(日間),日本,其他亞洲地區,2,2,0,2,2,0,0,0,0,0,0,0,0,0,0
109,私立,一般大學,1006,中國文化大學,碩士班(日間),匈牙利共和國,歐洲,1,1,0,1,1,0,0,0,0,0,0,0,0,0,0
109,私立,一般大學,1006,中國文化大學,碩士班(日間),西班牙王國,歐洲,1,1,0,1,1,0,0,0,0,0,0,0,0,0,0
109,私立,一般大學,1006,中國文化大學,碩士班(日間),奈及利亞聯邦共和國,非洲,1,1,0,1,1,0,0,0,0,0,0,0,0,0,0
109,私立,一般大學,1006,中國文化大學,碩士班(日間),法國,歐洲,1,1,0,1,1,0,0,0,0,0,0,0,0,0,0
109,私立,一般大學,1006,中國文化大學,碩士班(日間),俄羅斯聯邦,其他亞洲地區,1,0,1,1,0,1,0,0,0,0,0,0,0,0,0
109,私立,一般大學,1006,中國文化大學,碩士班(日間),美國,北美洲,3,1,2,3,1,2,0,0,0,0,0,0,0,0,0
109,私立,一般大學,1006,中國文化大學,碩士班(日間),泰國,東協,5,2,3,5,2,3,0,0,0,0,0,0,0,0,0
109,私立,一般大學,1006,中國文化大學,碩士班(日間),大陸地區,大陸地區,43,30,13,0,0,0,0,0,0,0,0,0,43,30,13
109,私立,一般大學,1006,中國文化大學,碩士班(日間),大韓民國(南韓),其他亞洲地區,18,3,15,17,3,14,1,0,1,0,0,0,0,0,0
109,私立,一般大學,1006,中國文化大學,碩士班(日間),印度,南亞,1,1,0,1,1,0,0,0,0,0,0,0,0,0,0
109,私立,一般大學,1006,中國文化大學,碩士班(日間),印度尼西亞共和國,東協,11,7,4,11,7,4,0,0,0,0,0,0,0,0,0
109,私立,一般大學,1006,中國文化大學,碩士班(日間),宏都拉斯共和國,中南美洲,1,1,0,1,1,0,0,0,0,0,0,0,0,0,0
109,私立,一般大學,1006,中國文化大學,碩士班(日間),波蘭共和國,歐洲,1,0,1,1,0,1,0,0,0,0,0,0,0,0,0
109,私立,一般大學,1006,中國文化大學,碩士班(日間),香港,港澳,19,13,6,0,0,0,0,0,0,19,13,6,0,0,0
109,私立,一般大學,1006,中國文化大學,碩士班(日間),馬來西亞,東協,13,6,7,6,1,5,7,5,2,0,0,0,0,0,0
109,私立,一般大學,1006,中國文化大學,碩士班(日間),越南社會主義共和國,東協,16,4,12,16,4,12,0,0,0,0,0,0,0,0,0
109,私立,一般大學,1006,中國文化大學,碩士班(日間),蒙古國,其他亞洲地區,7,3,4,7,3,4,0,0,0,0,0,0,0,0,0
109,私立,一般大學,1006,中國文化大學,碩士班(日間),澳門,港澳,8,4,4,0,0,0,0,0,0,8,4,4,0,0,0
109,私立,一般大學,1006,中國文化大學,碩士班(日間),薩爾瓦多,中南美洲,1,0,1,1,0,1,0,0,0,0,0,0,0,0,0
109,私立,一般大學,1006,中國文化大學,博士班,大陸地區,大陸地區,14,8,6,0,0,0,0,0,0,0,0,0,14,8,6
109,私立,一般大學,1006,中國文化大學,博士班,香港,港澳,2,2,0,0,0,0,0,0,0,2,2,0,0,0,0
109,私立,一般大學,1006,中國文化大學,博士班,土庫曼,其他亞洲地區,1,1,0,1,1,0,0,0,0,0,0,0,0,0,0
109,私立,一般大學,1006,中國文化大學,博士班,波蘭共和國,歐洲,1,1,0,1,1,0,0,0,0,0,0,0,0,0,0
109,私立,一般大學,1006,中國文化大學,博士班,俄羅斯聯邦,其他亞洲地區,1,0,1,1,0,1,0,0,0,0,0,0,0,0,0
109,私立,一般大學,1006,中國文化大學,博士班,美國,北美洲,3,2,1,3,2,1,0,0,0,0,0,0,0,0,0
109,私立,一般大學,1006,中國文化大學,博士班,越南社會主義共和國,東協,6,4,2,6,4,2,0,0,0,0,0,0,0,0,0
109,私立,一般大學,1006,中國文化大學,博士班,蒙古國,其他亞洲地區,2,0,2,2,0,2,0,0,0,0,0,0,0,0,0
109,私立,一般大學,1007,逢甲大學,學士班(日間),大陸地區,大陸地區,172,99,73,0,0,0,0,0,0,0,0,0,172,99,73
109,私立,一般大學,1007,逢甲大學,學士班(日間),巴布亞紐幾內亞獨立國,其他亞洲地區,2,2,0,2,2,0,0,0,0,0,0,0,0,0,0
109,私立,一般大學,1007,逢甲大學,學士班(日間),日本,其他亞洲地區,94,41,53,93,40,53,1,1,0,0,0,0,0,0,0
109,私立,一般大學,1007,逢甲大學,學士班(日間),比利時王國,歐洲,1,1,0,1,1,0,0,0,0,0,0,0,0,0,0
109,私立,一般大學,1007,逢甲大學,學士班(日間),加拿大,北美洲,1,1,0,0,0,0,1,1,0,0,0,0,0,0,0
109,私立,一般大學,1007,逢甲大學,學士班(日間),布吉納法索,非洲,1,1,0,1,1,0,0,0,0,0,0,0,0,0,0
109,私立,一般大學,1007,逢甲大學,學士班(日間),印度尼西亞共和國,東協,144,75,69,123,65,58,21,10,11,0,0,0,0,0,0
109,私立,一般大學,1007,逢甲大學,學士班(日間),克羅埃西亞共和國,歐洲,1,1,0,1,1,0,0,0,0,0,0,0,0,0,0
109,私立,一般大學,1007,逢甲大學,學士班(日間),波蘭共和國,歐洲,1,1,0,1,1,0,0,0,0,0,0,0,0,0,0
109,私立,一般大學,1007,逢甲大學,學士班(日間),法國,歐洲,2,1,1,2,1,1,0,0,0,0,0,0,0,0,0
109,私立,一般大學,1007,逢甲大學,學士班(日間),阿根廷,中南美洲,1,1,0,1,1,0,0,0,0,0,0,0,0,0,0
109,私立,一般大學,1007,逢甲大學,學士班(日間),南非共和國,非洲,8,6,2,4,4,0,4,2,2,0,0,0,0,0,0
109,私立,一般大學,1007,逢甲大學,學士班(日間),泰國,東協,34,14,20,34,14,20,0,0,0,0,0,0,0,0,0
109,私立,一般大學,1007,逢甲大學,學士班(日間),荷蘭王國,歐洲,1,1,0,1,1,0,0,0,0,0,0,0,0,0,0
109,私立,一般大學,1007,逢甲大學,學士班(日間),緬甸,東協,1,1,0,0,0,0,1,1,0,0,0,0,0,0,0
109,私立,一般大學,1007,逢甲大學,學士班(日間),墨西哥合眾國,中南美洲,3,2,1,3,2,1,0,0,0,0,0,0,0,0,0
109,私立,一般大學,1007,逢甲大學,學士班(日間),土耳其共和國,其他亞洲地區,1,1,0,1,1,0,0,0,0,0,0,0,0,0,0
109,私立,一般大學,1007,逢甲大學,學士班(日間),大韓民國(南韓),其他亞洲地區,12,7,5,11,6,5,1,1,0,0,0,0,0,0,0
109,私立,一般大學,1007,逢甲大學,學士班(日間),巴西聯邦共和國,中南美洲,2,2,0,2,2,0,0,0,0,0,0,0,0,0,0
109,私立,一般大學,1007,逢甲大學,學士班(日間),巴拉圭,中南美洲,1,0,1,1,0,1,0,0,0,0,0,0,0,0,0
109,私立,一般大學,1007,逢甲大學,學士班(日間),貝里斯,中南美洲,1,0,1,1,0,1,0,0,0,0,0,0,0,0,0
109,私立,一般大學,1007,逢甲大學,學士班(日間),奈及利亞聯邦共和國,非洲,1,1,0,1,1,0,0,0,0,0,0,0,0,0,0
109,私立,一般大學,1007,逢甲大學,學士班(日間),帛琉共和國,其他亞洲地區,1,1,0,1,1,0,0,0,0,0,0,0,0,0,0
109,私立,一般大學,1007,逢甲大學,學士班(日間),俄羅斯聯邦,其他亞洲地區,1,0,1,1,0,1,0,0,0,0,0,0,0,0,0
109,私立,一般大學,1007,逢甲大學,學士班(日間),美國,北美洲,3,3,0,0,0,0,3,3,0,0,0,0,0,0,0
109,私立,一般大學,1007,逢甲大學,學士班(日間),英國,歐洲,2,2,0,1,1,0,1,1,0,0,0,0,0,0,0
109,私立,一般大學,1007,逢甲大學,學士班(日間),香港,港澳,298,212,86,0,0,0,0,0,0,298,212,86,0,0,0
109,私立,一般大學,1007,逢甲大學,學士班(日間),馬來西亞,東協,220,161,59,98,71,27,122,90,32,0,0,0,0,0,0
109,私立,一般大學,1007,逢甲大學,學士班(日間),智利,中南美洲,1,1,0,0,0,0,1,1,0,0,0,0,0,0,0
109,私立,一般大學,1007,逢甲大學,學士班(日間),越南社會主義共和國,東協,32,7,25,28,7,21,4,0,4,0,0,0,0,0,0
109,私立,一般大學,1007,逢甲大學,學士班(日間),義大利共和國,歐洲,1,1,0,1,1,0,0,0,0,0,0,0,0,0,0
109,私立,一般大學,1007,逢甲大學,學士班(日間),聖露西亞,中南美洲,1,1,0,1,1,0,0,0,0,0,0,0,0,0,0
109,私立,一般大學,1007,逢甲大學,學士班(日間),蒙古國,其他亞洲地區,10,6,4,10,6,4,0,0,0,0,0,0,0,0,0
109,私立,一般大學,1007,逢甲大學,學士班(日間),澳門,港澳,49,41,8,0,0,0,0,0,0,49,41,8,0,0,0
109,私立,一般大學,1007,逢甲大學,碩士班(日間),巴拉圭,中南美洲,1,1,0,1,1,0,0,0,0,0,0,0,0,0,0
109,私立,一般大學,1007,逢甲大學,碩士班(日間),尼加拉瓜,中南美洲,1,0,1,1,0,1,0,0,0,0,0,0,0,0,0
109,私立,一般大學,1007,逢甲大學,碩士班(日間),印度,南亞,1,1,0,1,1,0,0,0,0,0,0,0,0,0,0
109,私立,一般大學,1007,逢甲大學,碩士班(日間),美國,北美洲,2,2,0,2,2,0,0,0,0,0,0,0,0,0,0
109,私立,一般大學,1007,逢甲大學,碩士班(日間),哥倫比亞共和國,中南美洲,1,1,0,1,1,0,0,0,0,0,0,0,0,0,0
109,私立,一般大學,1007,逢甲大學,碩士班(日間),越南社會主義共和國,東協,15,5,10,15,5,10,0,0,0,0,0,0,0,0,0
109,私立,一般大學,1007,逢甲大學,碩士班(日間),葡萄牙共和國,歐洲,1,1,0,1,1,0,0,0,0,0,0,0,0,0,0
109,私立,一般大學,1007,逢甲大學,碩士班(日間),蒙古國,其他亞洲地區,1,1,0,1,1,0,0,0,0,0,0,0,0,0,0
109,私立,一般大學,1007,逢甲大學,碩士班(日間),德意志聯邦共和國,歐洲,1,0,1,1,0,1,0,0,0,0,0,0,0,0,0
109,私立,一般大學,1007,逢甲大學,碩士班(日間),澳門,港澳,4,4,0,0,0,0,0,0,0,4,4,0,0,0,0
109,私立,一般大學,1007,逢甲大學,碩士班(日間),大陸地區,大陸地區,28,16,12,0,0,0,0,0,0,0,0,0,28,16,12
109,私立,一般大學,1007,逢甲大學,碩士班(日間),巴布亞紐幾內亞獨立國,其他亞洲地區,1,1,0,1,1,0,0,0,0,0,0,0,0,0,0
109,私立,一般大學,1007,逢甲大學,碩士班(日間),日本,其他亞洲地區,1,1,0,1,1,0,0,0,0,0,0,0,0,0,0
109,私立,一般大學,1007,逢甲大學,碩士班(日間),匈牙利共和國,歐洲,1,1,0,1,1,0,0,0,0,0,0,0,0,0,0
109,私立,一般大學,1007,逢甲大學,碩士班(日間),印度尼西亞共和國,東協,10,5,5,10,5,5,0,0,0,0,0,0,0,0,0
109,私立,一般大學,1007,逢甲大學,碩士班(日間),香港,港澳,11,9,2,0,0,0,0,0,0,11,9,2,0,0,0
109,私立,一般大學,1007,逢甲大學,碩士班(日間),泰國,東協,17,5,12,17,5,12,0,0,0,0,0,0,0,0,0
109,私立,一般大學,1007,逢甲大學,碩士班(日間),馬來西亞,東協,16,9,7,8,6,2,8,3,5,0,0,0,0,0,0
109,私立,一般大學,1007,逢甲大學,碩士班(日間),墨西哥合眾國,中南美洲,1,0,1,1,0,1,0,0,0,0,0,0,0,0,0
109,私立,一般大學,1007,逢甲大學,博士班,土耳其共和國,其他亞洲地區,1,1,0,1,1,0,0,0,0,0,0,0,0,0,0
109,私立,一般大學,1007,逢甲大學,博士班,大陸地區,大陸地區,19,12,7,0,0,0,0,0,0,0,0,0,19,12,7
109,私立,一般大學,1007,逢甲大學,博士班,印度尼西亞共和國,東協,1,0,1,1,0,1,0,0,0,0,0,0,0,0,0
109,私立,一般大學,1007,逢甲大學,博士班,泰國,東協,6,2,4,6,2,4,0,0,0,0,0,0,0,0,0
109,私立,一般大學,1007,逢甲大學,博士班,秘魯共和國,中南美洲,1,1,0,1,1,0,0,0,0,0,0,0,0,0,0
109,私立,一般大學,1007,逢甲大學,博士班,越南社會主義共和國,東協,34,27,7,34,27,7,0,0,0,0,0,0,0,0,0
109,私立,一般大學,1007,逢甲大學,博士班,蒙古國,其他亞洲地區,1,0,1,1,0,1,0,0,0,0,0,0,0,0,0
109,私立,一般大學,1007,逢甲大學,博士班,布吉納法索,非洲,2,2,0,2,2,0,0,0,0,0,0,0,0,0,0
109,私立,一般大學,1007,逢甲大學,博士班,印度,南亞,4,3,1,4,3,1,0,0,0,0,0,0,0,0,0
109,私立,一般大學,1007,逢甲大學,博士班,美國,北美洲,1,1,0,1,1,0,0,0,0,0,0,0,0,0,0
109,私立,一般大學,1007,逢甲大學,博士班,英國,歐洲,1,1,0,1,1,0,0,0,0,0,0,0,0,0,0
109,私立,一般大學,1007,逢甲大學,博士班,馬來西亞,東協,6,5,1,6,5,1,0,0,0,0,0,0,0,0,0
109,私立,一般大學,1007,逢甲大學,博士班,菲律賓共和國,東協,2,1,1,2,1,1,0,0,0,0,0,0,0,0,0
109,私立,一般大學,1008,靜宜大學,學士班(日間),大陸地區,大陸地區,108,55,53,0,0,0,0,0,0,0,0,0,108,55,53
109,私立,一般大學,1008,靜宜大學,學士班(日間),巴拉圭,中南美洲,1,0,1,0,0,0,1,0,1,0,0,0,0,0,0
109,私立,一般大學,1008,靜宜大學,學士班(日間),日本,其他亞洲地區,59,17,42,59,17,42,0,0,0,0,0,0,0,0,0
109,私立,一般大學,1008,靜宜大學,學士班(日間),史瓦帝尼王國,非洲,8,3,5,8,3,5,0,0,0,0,0,0,0,0,0
109,私立,一般大學,1008,靜宜大學,學士班(日間),印度尼西亞共和國,東協,19,4,15,12,3,9,7,1,6,0,0,0,0,0,0
109,私立,一般大學,1008,靜宜大學,學士班(日間),法國,歐洲,1,1,0,1,1,0,0,0,0,0,0,0,0,0,0
109,私立,一般大學,1008,靜宜大學,學士班(日間),肯亞共和國,非洲,1,0,1,1,0,1,0,0,0,0,0,0,0,0,0
109,私立,一般大學,1008,靜宜大學,學士班(日間),保加利亞共和國,歐洲,1,0,1,1,0,1,0,0,0,0,0,0,0,0,0
109,私立,一般大學,1008,靜宜大學,學士班(日間),香港,港澳,70,35,35,0,0,0,0,0,0,70,35,35,0,0,0
109,私立,一般大學,1008,靜宜大學,學士班(日間),泰國,東協,9,3,6,9,3,6,0,0,0,0,0,0,0,0,0
109,私立,一般大學,1008,靜宜大學,學士班(日間),秘魯共和國,中南美洲,1,1,0,1,1,0,0,0,0,0,0,0,0,0,0
109,私立,一般大學,1008,靜宜大學,學士班(日間),馬來西亞,東協,122,65,57,91,55,36,31,10,21,0,0,0,0,0,0
109,私立,一般大學,1008,靜宜大學,學士班(日間),莫三比克共和國,非洲,1,0,1,1,0,1,0,0,0,0,0,0,0,0,0
109,私立,一般大學,1008,靜宜大學,學士班(日間),菲律賓共和國,東協,1,0,1,0,0,0,1,0,1,0,0,0,0,0,0
109,私立,一般大學,1008,靜宜大學,學士班(日間),越南社會主義共和國,東協,66,17,49,63,16,47,3,1,2,0,0,0,0,0,0
109,私立,一般大學,1008,靜宜大學,學士班(日間),緬甸,東協,1,1,0,0,0,0,1,1,0,0,0,0,0,0,0
109,私立,一般大學,1008,靜宜大學,學士班(日間),墨西哥合眾國,中南美洲,1,1,0,1,1,0,0,0,0,0,0,0,0,0,0
109,私立,一般大學,1008,靜宜大學,學士班(日間),澳門,港澳,17,5,12,0,0,0,0,0,0,17,5,12,0,0,0
109,私立,一般大學,1008,靜宜大學,學士班(日間),大韓民國(南韓),其他亞洲地區,4,1,3,4,1,3,0,0,0,0,0,0,0,0,0
109,私立,一般大學,1008,靜宜大學,學士班(日間),印度,南亞,1,0,1,1,0,1,0,0,0,0,0,0,0,0,0
109,私立,一般大學,1008,靜宜大學,學士班(日間),俄羅斯聯邦,其他亞洲地區,3,2,1,3,2,1,0,0,0,0,0,0,0,0,0
109,私立,一般大學,1008,靜宜大學,學士班(日間),美國,北美洲,3,2,1,3,2,1,0,0,0,0,0,0,0,0,0
109,私立,一般大學,1008,靜宜大學,學士班(日間),智利,中南美洲,1,0,1,1,0,1,0,0,0,0,0,0,0,0,0
109,私立,一般大學,1008,靜宜大學,學士班(日間),葡萄牙共和國,歐洲,1,1,0,1,1,0,0,0,0,0,0,0,0,0,0
109,私立,一般大學,1008,靜宜大學,學士班(日間),蒙古國,其他亞洲地區,5,1,4,5,1,4,0,0,0,0,0,0,0,0,0
109,私立,一般大學,1008,靜宜大學,碩士班(日間),尼加拉瓜,中南美洲,1,0,1,1,0,1,0,0,0,0,0,0,0,0,0
109,私立,一般大學,1008,靜宜大學,碩士班(日間),立陶宛共和國,歐洲,1,0,1,1,0,1,0,0,0,0,0,0,0,0,0
109,私立,一般大學,1008,靜宜大學,碩士班(日間),西班牙王國,歐洲,1,0,1,1,0,1,0,0,0,0,0,0,0,0,0
109,私立,一般大學,1008,靜宜大學,碩士班(日間),芬蘭共和國,歐洲,1,1,0,1,1,0,0,0,0,0,0,0,0,0,0
109,私立,一般大學,1008,靜宜大學,碩士班(日間),俄羅斯聯邦,其他亞洲地區,2,1,1,2,1,1,0,0,0,0,0,0,0,0,0
109,私立,一般大學,1008,靜宜大學,碩士班(日間),美國,北美洲,1,1,0,1,1,0,0,0,0,0,0,0,0,0,0
109,私立,一般大學,1008,靜宜大學,碩士班(日間),智利,中南美洲,1,0,1,0,0,0,1,0,1,0,0,0,0,0,0
109,私立,一般大學,1008,靜宜大學,碩士班(日間),奧地利共和國,歐洲,8,2,6,8,2,6,0,0,0,0,0,0,0,0,0
109,私立,一般大學,1008,靜宜大學,碩士班(日間),蒙古國,其他亞洲地區,3,0,3,3,0,3,0,0,0,0,0,0,0,0,0
109,私立,一般大學,1008,靜宜大學,碩士班(日間),德意志聯邦共和國,歐洲,1,0,1,1,0,1,0,0,0,0,0,0,0,0,0
109,私立,一般大學,1008,靜宜大學,碩士班(日間),土耳其共和國,其他亞洲地區,1,1,0,1,1,0,0,0,0,0,0,0,0,0,0
109,私立,一般大學,1008,靜宜大學,碩士班(日間),大陸地區,大陸地區,11,4,7,0,0,0,0,0,0,0,0,0,11,4,7
109,私立,一般大學,1008,靜宜大學,碩士班(日間),日本,其他亞洲地區,3,2,1,3,2,1,0,0,0,0,0,0,0,0,0
109,私立,一般大學,1008,靜宜大學,碩士班(日間),布吉納法索,非洲,1,0,1,1,0,1,0,0,0,0,0,0,0,0,0
109,私立,一般大學,1008,靜宜大學,碩士班(日間),匈牙利共和國,歐洲,1,1,0,1,1,0,0,0,0,0,0,0,0,0,0
109,私立,一般大學,1008,靜宜大學,碩士班(日間),印度,南亞,2,2,0,2,2,0,0,0,0,0,0,0,0,0,0
109,私立,一般大學,1008,靜宜大學,碩士班(日間),印度尼西亞共和國,東協,16,7,9,15,7,8,1,0,1,0,0,0,0,0,0
109,私立,一般大學,1008,靜宜大學,碩士班(日間),法國,歐洲,4,3,1,4,3,1,0,0,0,0,0,0,0,0,0
109,私立,一般大學,1008,靜宜大學,碩士班(日間),香港,港澳,2,0,2,0,0,0,0,0,0,2,0,2,0,0,0
109,私立,一般大學,1008,靜宜大學,碩士班(日間),泰國,東協,9,2,7,9,2,7,0,0,0,0,0,0,0,0,0
109,私立,一般大學,1008,靜宜大學,碩士班(日間),馬來西亞,東協,6,3,3,6,3,3,0,0,0,0,0,0,0,0,0
109,私立,一般大學,1008,靜宜大學,碩士班(日間),菲律賓共和國,東協,4,2,2,4,2,2,0,0,0,0,0,0,0,0,0
109,私立,一般大學,1008,靜宜大學,碩士班(日間),越南社會主義共和國,東協,22,4,18,22,4,18,0,0,0,0,0,0,0,0,0
109,私立,一般大學,1008,靜宜大學,碩士班(日間),墨西哥合眾國,中南美洲,3,3,0,3,3,0,0,0,0,0,0,0,0,0,0
109,私立,一般大學,1008,靜宜大學,碩士班(日間),澳門,港澳,1,0,1,0,0,0,0,0,0,1,0,1,0,0,0
109,私立,一般大學,1008,靜宜大學,博士班,日本,其他亞洲地區,1,0,1,1,0,1,0,0,0,0,0,0,0,0,0
109,私立,一般大學,1008,靜宜大學,博士班,印度尼西亞共和國,東協,2,1,1,2,1,1,0,0,0,0,0,0,0,0,0
109,私立,一般大學,1008,靜宜大學,博士班,馬來西亞,東協,2,0,2,2,0,2,0,0,0,0,0,0,0,0,0
109,私立,一般大學,1009,長庚大學,學士班(日間),大陸地區,大陸地區,36,21,15,0,0,0,0,0,0,0,0,0,36,21,15
109,私立,一般大學,1009,長庚大學,學士班(日間),加拿大,北美洲,2,1,1,0,0,0,2,1,1,0,0,0,0,0,0
109,私立,一般大學,1009,長庚大學,學士班(日間),香港,港澳,34,20,14,0,0,0,0,0,0,34,20,14,0,0,0
109,私立,一般大學,1009,長庚大學,學士班(日間),越南社會主義共和國,東協,2,1,1,0,0,0,2,1,1,0,0,0,0,0,0
109,私立,一般大學,1009,長庚大學,學士班(日間),新加坡共和國,東協,2,1,1,0,0,0,2,1,1,0,0,0,0,0,0
109,私立,一般大學,1009,長庚大學,學士班(日間),緬甸,東協,2,0,2,0,0,0,2,0,2,0,0,0,0,0,0
109,私立,一般大學,1009,長庚大學,學士班(日間),澳門,港澳,35,14,21,0,0,0,0,0,0,35,14,21,0,0,0
109,私立,一般大學,1009,長庚大學,學士班(日間),大韓民國(南韓),其他亞洲地區,6,3,3,3,2,1,3,1,2,0,0,0,0,0,0
109,私立,一般大學,1009,長庚大學,學士班(日間),日本,其他亞洲地區,1,1,0,0,0,0,1,1,0,0,0,0,0,0,0
109,私立,一般大學,1009,長庚大學,學士班(日間),美國,北美洲,5,4,1,0,0,0,5,4,1,0,0,0,0,0,0
109,私立,一般大學,1009,長庚大學,學士班(日間),馬來西亞,東協,39,15,24,0,0,0,39,15,24,0,0,0,0,0,0
109,私立,一般大學,1009,長庚大學,碩士班(日間),大韓民國(南韓),其他亞洲地區,2,2,0,2,2,0,0,0,0,0,0,0,0,0,0
109,私立,一般大學,1009,長庚大學,碩士班(日間),巴基斯坦,南亞,1,1,0,1,1,0,0,0,0,0,0,0,0,0,0
109,私立,一般大學,1009,長庚大學,碩士班(日間),以色列,其他亞洲地區,1,1,0,1,1,0,0,0,0,0,0,0,0,0,0
109,私立,一般大學,1009,長庚大學,碩士班(日間),印度尼西亞共和國,東協,8,7,1,8,7,1,0,0,0,0,0,0,0,0,0
109,私立,一般大學,1009,長庚大學,碩士班(日間),波蘭共和國,歐洲,1,0,1,1,0,1,0,0,0,0,0,0,0,0,0
109,私立,一般大學,1009,長庚大學,碩士班(日間),阿根廷,中南美洲,2,2,0,2,2,0,0,0,0,0,0,0,0,0,0
109,私立,一般大學,1009,長庚大學,碩士班(日間),美國,北美洲,3,2,1,3,2,1,0,0,0,0,0,0,0,0,0
109,私立,一般大學,1009,長庚大學,碩士班(日間),英國,歐洲,1,1,0,1,1,0,0,0,0,0,0,0,0,0,0
109,私立,一般大學,1009,長庚大學,碩士班(日間),泰國,東協,10,4,6,9,3,6,1,1,0,0,0,0,0,0,0
109,私立,一般大學,1009,長庚大學,碩士班(日間),烏干達共和國,非洲,1,0,1,1,0,1,0,0,0,0,0,0,0,0,0
109,私立,一般大學,1009,長庚大學,碩士班(日間),馬來西亞,東協,5,0,5,1,0,1,4,0,4,0,0,0,0,0,0
109,私立,一般大學,1009,長庚大學,碩士班(日間),菲律賓共和國,東協,1,0,1,1,0,1,0,0,0,0,0,0,0,0,0
109,私立,一般大學,1009,長庚大學,碩士班(日間),義大利共和國,歐洲,1,1,0,1,1,0,0,0,0,0,0,0,0,0,0
109,私立,一般大學,1009,長庚大學,碩士班(日間),墨西哥合眾國,中南美洲,1,0,1,1,0,1,0,0,0,0,0,0,0,0,0
109,私立,一般大學,1009,長庚大學,碩士班(日間),大陸地區,大陸地區,4,4,0,0,0,0,0,0,0,0,0,0,4,4,0
109,私立,一般大學,1009,長庚大學,碩士班(日間),日本,其他亞洲地區,2,2,0,2,2,0,0,0,0,0,0,0,0,0,0
109,私立,一般大學,1009,長庚大學,碩士班(日間),甘比亞共和國,非洲,3,3,0,3,3,0,0,0,0,0,0,0,0,0,0
109,私立,一般大學,1009,長庚大學,碩士班(日間),印度,南亞,8,7,1,8,7,1,0,0,0,0,0,0,0,0,0
109,私立,一般大學,1009,長庚大學,碩士班(日間),香港,港澳,2,2,0,0,0,0,0,0,0,2,2,0,0,0,0
109,私立,一般大學,1009,長庚大學,碩士班(日間),秘魯共和國,中南美洲,2,2,0,2,2,0,0,0,0,0,0,0,0,0,0
109,私立,一般大學,1009,長庚大學,碩士班(日間),納米比亞共和國,非洲,1,0,1,1,0,1,0,0,0,0,0,0,0,0,0
109,私立,一般大學,1009,長庚大學,碩士班(日間),越南社會主義共和國,東協,18,3,15,18,3,15,0,0,0,0,0,0,0,0,0
109,私立,一般大學,1009,長庚大學,碩士班(日間),愛爾蘭共和國,歐洲,1,1,0,1,1,0,0,0,0,0,0,0,0,0,0
109,私立,一般大學,1009,長庚大學,碩士班(日間),新加坡共和國,東協,6,4,2,6,4,2,0,0,0,0,0,0,0,0,0
109,私立,一般大學,1009,長庚大學,碩士班(日間),瑞典王國,歐洲,1,0,1,1,0,1,0,0,0,0,0,0,0,0,0
109,私立,一般大學,1009,長庚大學,碩士班(日間),葡萄牙共和國,歐洲,1,1,0,1,1,0,0,0,0,0,0,0,0,0,0
109,私立,一般大學,1009,長庚大學,碩士班(日間),德意志聯邦共和國,歐洲,2,2,0,2,2,0,0,0,0,0,0,0,0,0,0
109,私立,一般大學,1009,長庚大學,碩士班(日間),澳門,港澳,5,4,1,0,0,0,0,0,0,5,4,1,0,0,0
109,私立,一般大學,1009,長庚大學,博士班,瓜地馬拉共和國,中南美洲,1,0,1,1,0,1,0,0,0,0,0,0,0,0,0
109,私立,一般大學,1009,長庚大學,博士班,甘比亞共和國,非洲,1,1,0,1,1,0,0,0,0,0,0,0,0,0,0
109,私立,一般大學,1009,長庚大學,博士班,奈及利亞聯邦共和國,非洲,1,1,0,1,1,0,0,0,0,0,0,0,0,0,0
109,私立,一般大學,1009,長庚大學,博士班,阿根廷,中南美洲,1,1,0,0,0,0,1,1,0,0,0,0,0,0,0
109,私立,一般大學,1009,長庚大學,博士班,越南社會主義共和國,東協,12,5,7,12,5,7,0,0,0,0,0,0,0,0,0
109,私立,一般大學,1009,長庚大學,博士班,大陸地區,大陸地區,6,5,1,0,0,0,0,0,0,0,0,0,6,5,1
109,私立,一般大學,1009,長庚大學,博士班,巴基斯坦,南亞,2,2,0,2,2,0,0,0,0,0,0,0,0,0,0
109,私立,一般大學,1009,長庚大學,博士班,印度,南亞,30,21,9,30,21,9,0,0,0,0,0,0,0,0,0
109,私立,一般大學,1009,長庚大學,博士班,印度尼西亞共和國,東協,7,5,2,7,5,2,0,0,0,0,0,0,0,0,0
109,私立,一般大學,1009,長庚大學,博士班,沙烏地阿拉伯王國,其他亞洲地區,1,0,1,0,0,0,1,0,1,0,0,0,0,0,0
109,私立,一般大學,1009,長庚大學,博士班,馬來西亞,東協,7,3,4,2,0,2,5,3,2,0,0,0,0,0,0
109,私立,一般大學,1009,長庚大學,博士班,澳門,港澳,1,1,0,0,0,0,0,0,0,1,1,0,0,0,0
109,私立,一般大學,1010,元智大學,學士班(日間),大陸地區,大陸地區,82,41,41,0,0,0,0,0,0,0,0,0,82,41,41
109,私立,一般大學,1010,元智大學,學士班(日間),日本,其他亞洲地區,13,8,5,13,8,5,0,0,0,0,0,0,0,0,0
109,私立,一般大學,1010,元智大學,學士班(日間),印度,南亞,1,1,0,1,1,0,0,0,0,0,0,0,0,0,0
109,私立,一般大學,1010,元智大學,學士班(日間),印度尼西亞共和國,東協,9,5,4,8,4,4,1,1,0,0,0,0,0,0,0
109,私立,一般大學,1010,元智大學,學士班(日間),吉爾吉斯,其他亞洲地區,1,1,0,1,1,0,0,0,0,0,0,0,0,0,0
109,私立,一般大學,1010,元智大學,學士班(日間),宏都拉斯共和國,中南美洲,1,0,1,1,0,1,0,0,0,0,0,0,0,0,0
109,私立,一般大學,1010,元智大學,學士班(日間),孟加拉人民共和國,南亞,1,1,0,1,1,0,0,0,0,0,0,0,0,0,0
109,私立,一般大學,1010,元智大學,學士班(日間),英國,歐洲,1,0,1,1,0,1,0,0,0,0,0,0,0,0,0
109,私立,一般大學,1010,元智大學,學士班(日間),香港,港澳,53,37,16,0,0,0,0,0,0,53,37,16,0,0,0
109,私立,一般大學,1010,元智大學,學士班(日間),海地共和國,中南美洲,5,3,2,5,3,2,0,0,0,0,0,0,0,0,0
109,私立,一般大學,1010,元智大學,學士班(日間),秘魯共和國,中南美洲,2,0,2,2,0,2,0,0,0,0,0,0,0,0,0
109,私立,一般大學,1010,元智大學,學士班(日間),索羅門群島,其他亞洲地區,2,1,1,2,1,1,0,0,0,0,0,0,0,0,0
109,私立,一般大學,1010,元智大學,學士班(日間),馬來西亞,東協,18,7,11,8,2,6,10,5,5,0,0,0,0,0,0
109,私立,一般大學,1010,元智大學,學士班(日間),塔吉克共和國,其他亞洲地區,1,1,0,1,1,0,0,0,0,0,0,0,0,0,0
109,私立,一般大學,1010,元智大學,學士班(日間),聖文森(及格瑞那丁),中南美洲,3,2,1,3,2,1,0,0,0,0,0,0,0,0,0
109,私立,一般大學,1010,元智大學,學士班(日間),蒙古國,其他亞洲地區,7,1,6,7,1,6,0,0,0,0,0,0,0,0,0
109,私立,一般大學,1010,元智大學,學士班(日間),澳門,港澳,6,4,2,0,0,0,0,0,0,6,4,2,0,0,0
109,私立,一般大學,1010,元智大學,學士班(日間),史瓦帝尼王國,非洲,21,8,13,21,8,13,0,0,0,0,0,0,0,0,0
109,私立,一般大學,1010,元智大學,學士班(日間),甘比亞共和國,非洲,7,6,1,7,6,1,0,0,0,0,0,0,0,0,0
109,私立,一般大學,1010,元智大學,學士班(日間),波蘭共和國,歐洲,1,1,0,1,1,0,0,0,0,0,0,0,0,0,0
109,私立,一般大學,1010,元智大學,學士班(日間),突尼西亞共和國,非洲,1,1,0,1,1,0,0,0,0,0,0,0,0,0,0
109,私立,一般大學,1010,元智大學,學士班(日間),美國,北美洲,2,1,1,0,0,0,2,1,1,0,0,0,0,0,0
109,私立,一般大學,1010,元智大學,學士班(日間),泰國,東協,4,0,4,4,0,4,0,0,0,0,0,0,0,0,0
109,私立,一般大學,1010,元智大學,學士班(日間),菲律賓共和國,東協,2,0,2,2,0,2,0,0,0,0,0,0,0,0,0
109,私立,一般大學,1010,元智大學,學士班(日間),越南社會主義共和國,東協,57,17,40,57,17,40,0,0,0,0,0,0,0,0,0
109,私立,一般大學,1010,元智大學,學士班(日間),聖露西亞,中南美洲,5,4,1,5,4,1,0,0,0,0,0,0,0,0,0
109,私立,一般大學,1010,元智大學,學士班(日間),德意志聯邦共和國,歐洲,5,4,1,5,4,1,0,0,0,0,0,0,0,0,0
109,私立,一般大學,1010,元智大學,學士班(日間),墨西哥合眾國,中南美洲,1,0,1,1,0,1,0,0,0,0,0,0,0,0,0
109,私立,一般大學,1010,元智大學,碩士班(日間),土耳其共和國,其他亞洲地區,1,1,0,1,1,0,0,0,0,0,0,0,0,0,0
109,私立,一般大學,1010,元智大學,碩士班(日間),土庫曼,其他亞洲地區,1,1,0,1,1,0,0,0,0,0,0,0,0,0,0
109,私立,一般大學,1010,元智大學,碩士班(日間),史瓦帝尼王國,非洲,3,1,2,3,1,2,0,0,0,0,0,0,0,0,0
109,私立,一般大學,1010,元智大學,碩士班(日間),瓜地馬拉共和國,中南美洲,2,2,0,2,2,0,0,0,0,0,0,0,0,0,0
109,私立,一般大學,1010,元智大學,碩士班(日間),甘比亞共和國,非洲,9,6,3,9,6,3,0,0,0,0,0,0,0,0,0
109,私立,一般大學,1010,元智大學,碩士班(日間),孟加拉人民共和國,南亞,1,0,1,1,0,1,0,0,0,0,0,0,0,0,0
109,私立,一般大學,1010,元智大學,碩士班(日間),俄羅斯聯邦,其他亞洲地區,2,1,1,2,1,1,0,0,0,0,0,0,0,0,0
109,私立,一般大學,1010,元智大學,碩士班(日間),美國,北美洲,2,2,0,2,2,0,0,0,0,0,0,0,0,0,0
109,私立,一般大學,1010,元智大學,碩士班(日間),埃及阿拉伯共和國,非洲,2,0,2,2,0,2,0,0,0,0,0,0,0,0,0
109,私立,一般大學,1010,元智大學,碩士班(日間),泰國,東協,10,3,7,10,3,7,0,0,0,0,0,0,0,0,0
109,私立,一般大學,1010,元智大學,碩士班(日間),菲律賓共和國,東協,1,0,1,1,0,1,0,0,0,0,0,0,0,0,0
109,私立,一般大學,1010,元智大學,碩士班(日間),越南社會主義共和國,東協,45,12,33,44,12,32,1,0,1,0,0,0,0,0,0
109,私立,一般大學,1010,元智大學,碩士班(日間),聖露西亞,中南美洲,1,1,0,1,1,0,0,0,0,0,0,0,0,0,0
109,私立,一般大學,1010,元智大學,碩士班(日間),墨西哥合眾國,中南美洲,1,1,0,1,1,0,0,0,0,0,0,0,0,0,0
109,私立,一般大學,1010,元智大學,碩士班(日間),大陸地區,大陸地區,9,7,2,0,0,0,0,0,0,0,0,0,9,7,2
109,私立,一般大學,1010,元智大學,碩士班(日間),巴基斯坦,南亞,5,4,1,5,4,1,0,0,0,0,0,0,0,0,0
109,私立,一般大學,1010,元智大學,碩士班(日間),尼加拉瓜,中南美洲,2,2,0,2,2,0,0,0,0,0,0,0,0,0,0
109,私立,一般大學,1010,元智大學,碩士班(日間),印度,南亞,14,11,3,14,11,3,0,0,0,0,0,0,0,0,0
109,私立,一般大學,1010,元智大學,碩士班(日間),印度尼西亞共和國,東協,24,11,13,24,11,13,0,0,0,0,0,0,0,0,0
109,私立,一般大學,1010,元智大學,碩士班(日間),吉布地共和國,非洲,1,1,0,1,1,0,0,0,0,0,0,0,0,0,0
109,私立,一般大學,1010,元智大學,碩士班(日間),宏都拉斯共和國,中南美洲,5,3,2,5,3,2,0,0,0,0,0,0,0,0,0
109,私立,一般大學,1010,元智大學,碩士班(日間),約旦哈什米王國,其他亞洲地區,1,1,0,1,1,0,0,0,0,0,0,0,0,0,0
109,私立,一般大學,1010,元智大學,碩士班(日間),香港,港澳,7,7,0,0,0,0,0,0,0,7,7,0,0,0,0
109,私立,一般大學,1010,元智大學,碩士班(日間),哥倫比亞共和國,中南美洲,1,1,0,1,1,0,0,0,0,0,0,0,0,0,0
109,私立,一般大學,1010,元智大學,碩士班(日間),海地共和國,中南美洲,2,2,0,2,2,0,0,0,0,0,0,0,0,0,0
109,私立,一般大學,1010,元智大學,碩士班(日間),馬來西亞,東協,12,5,7,10,4,6,2,1,1,0,0,0,0,0,0
109,私立,一般大學,1010,元智大學,碩士班(日間),捷克共和國,歐洲,2,1,1,2,1,1,0,0,0,0,0,0,0,0,0
109,私立,一般大學,1010,元智大學,碩士班(日間),聖文森(及格瑞那丁),中南美洲,1,0,1,1,0,1,0,0,0,0,0,0,0,0,0
109,私立,一般大學,1010,元智大學,碩士班(日間),聖克里斯多福及尼維斯,中南美洲,1,1,0,1,1,0,0,0,0,0,0,0,0,0,0
109,私立,一般大學,1010,元智大學,博士班,史瓦帝尼王國,非洲,7,5,2,7,5,2,0,0,0,0,0,0,0,0,0
109,私立,一般大學,1010,元智大學,博士班,甘比亞共和國,非洲,3,3,0,3,3,0,0,0,0,0,0,0,0,0,0
109,私立,一般大學,1010,元智大學,博士班,印度尼西亞共和國,東協,12,8,4,12,8,4,0,0,0,0,0,0,0,0,0
109,私立,一般大學,1010,元智大學,博士班,貝里斯,中南美洲,2,2,0,2,2,0,0,0,0,0,0,0,0,0,0
109,私立,一般大學,1010,元智大學,博士班,美國,北美洲,1,1,0,1,1,0,0,0,0,0,0,0,0,0,0
109,私立,一般大學,1010,元智大學,博士班,香港,港澳,1,1,0,0,0,0,0,0,0,1,1,0,0,0,0
109,私立,一般大學,1010,元智大學,博士班,泰國,東協,4,0,4,4,0,4,0,0,0,0,0,0,0,0,0
109,私立,一般大學,1010,元智大學,博士班,海地共和國,中南美洲,3,3,0,3,3,0,0,0,0,0,0,0,0,0,0
109,私立,一般大學,1010,元智大學,博士班,蓋亞那共和國,中南美洲,1,0,1,1,0,1,0,0,0,0,0,0,0,0,0
109,私立,一般大學,1010,元智大學,博士班,大陸地區,大陸地區,13,8,5,0,0,0,0,0,0,0,0,0,13,8,5
109,私立,一般大學,1010,元智大學,博士班,巴基斯坦,南亞,1,1,0,1,1,0,0,0,0,0,0,0,0,0,0
109,私立,一般大學,1010,元智大學,博士班,尼泊爾聯邦民主共和國,南亞,2,2,0,2,2,0,0,0,0,0,0,0,0,0,0
109,私立,一般大學,1010,元智大學,博士班,瓜地馬拉共和國,中南美洲,2,2,0,2,2,0,0,0,0,0,0,0,0,0,0
109,私立,一般大學,1010,元智大學,博士班,印度,南亞,10,9,1,10,9,1,0,0,0,0,0,0,0,0,0
109,私立,一般大學,1010,元智大學,博士班,宏都拉斯共和國,中南美洲,2,1,1,2,1,1,0,0,0,0,0,0,0,0,0
109,私立,一般大學,1010,元智大學,博士班,孟加拉人民共和國,南亞,1,1,0,1,1,0,0,0,0,0,0,0,0,0,0
109,私立,一般大學,1010,元智大學,博士班,俄羅斯聯邦,其他亞洲地區,2,1,1,2,1,1,0,0,0,0,0,0,0,0,0
109,私立,一般大學,1010,元智大學,博士班,菲律賓共和國,東協,1,0,1,1,0,1,0,0,0,0,0,0,0,0,0
109,私立,一般大學,1010,元智大學,博士班,越南社會主義共和國,東協,16,7,9,16,7,9,0,0,0,0,0,0,0,0,0
109,私立,一般大學,1010,元智大學,博士班,薩爾瓦多,中南美洲,1,1,0,1,1,0,0,0,0,0,0,0,0,0,0
109,私立,一般大學,1011,中華大學學校財團法人中華大學,學士班(日間),日本,其他亞洲地區,33,27,6,33,27,6,0,0,0,0,0,0,0,0,0
109,私立,一般大學,1011,中華大學學校財團法人中華大學,學士班(日間),貝里斯,中南美洲,1,0,1,0,0,0,1,0,1,0,0,0,0,0,0
109,私立,一般大學,1011,中華大學學校財團法人中華大學,學士班(日間),海地共和國,中南美洲,2,2,0,2,2,0,0,0,0,0,0,0,0,0,0
109,私立,一般大學,1011,中華大學學校財團法人中華大學,學士班(日間),烏茲別克共和國,其他亞洲地區,1,0,1,1,0,1,0,0,0,0,0,0,0,0,0
109,私立,一般大學,1011,中華大學學校財團法人中華大學,學士班(日間),緬甸,東協,4,3,1,4,3,1,0,0,0,0,0,0,0,0,0
109,私立,一般大學,1011,中華大學學校財團法人中華大學,學士班(日間),大陸地區,大陸地區,9,8,1,0,0,0,0,0,0,0,0,0,9,8,1
109,私立,一般大學,1011,中華大學學校財團法人中華大學,學士班(日間),大韓民國(南韓),其他亞洲地區,2,0,2,2,0,2,0,0,0,0,0,0,0,0,0
109,私立,一般大學,1011,中華大學學校財團法人中華大學,學士班(日間),印度尼西亞共和國,東協,7,2,5,6,1,5,1,1,0,0,0,0,0,0,0
109,私立,一般大學,1011,中華大學學校財團法人中華大學,學士班(日間),南非共和國,非洲,1,0,1,1,0,1,0,0,0,0,0,0,0,0,0
109,私立,一般大學,1011,中華大學學校財團法人中華大學,學士班(日間),香港,港澳,7,5,2,0,0,0,0,0,0,7,5,2,0,0,0
109,私立,一般大學,1011,中華大學學校財團法人中華大學,學士班(日間),秘魯共和國,中南美洲,1,0,1,1,0,1,0,0,0,0,0,0,0,0,0
109,私立,一般大學,1011,中華大學學校財團法人中華大學,學士班(日間),馬來西亞,東協,93,49,44,85,44,41,8,5,3,0,0,0,0,0,0
109,私立,一般大學,1011,中華大學學校財團法人中華大學,學士班(日間),馬拉威共和國,非洲,4,2,2,4,2,2,0,0,0,0,0,0,0,0,0
109,私立,一般大學,1011,中華大學學校財團法人中華大學,學士班(日間),菲律賓共和國,東協,68,33,35,68,33,35,0,0,0,0,0,0,0,0,0
109,私立,一般大學,1011,中華大學學校財團法人中華大學,學士班(日間),越南社會主義共和國,東協,30,12,18,29,12,17,1,0,1,0,0,0,0,0,0
109,私立,一般大學,1011,中華大學學校財團法人中華大學,學士班(日間),聖克里斯多福及尼維斯,中南美洲,1,0,1,1,0,1,0,0,0,0,0,0,0,0,0
109,私立,一般大學,1011,中華大學學校財團法人中華大學,學士班(日間),蒙古國,其他亞洲地區,10,4,6,10,4,6,0,0,0,0,0,0,0,0,0
109,私立,一般大學,1011,中華大學學校財團法人中華大學,學士班(日間),澳門,港澳,2,2,0,0,0,0,0,0,0,2,2,0,0,0,0
109,私立,一般大學,1011,中華大學學校財團法人中華大學,碩士班(日間),土耳其共和國,其他亞洲地區,2,1,1,2,1,1,0,0,0,0,0,0,0,0,0
109,私立,一般大學,1011,中華大學學校財團法人中華大學,碩士班(日間),印度,南亞,2,1,1,2,1,1,0,0,0,0,0,0,0,0,0
109,私立,一般大學,1011,中華大學學校財團法人中華大學,碩士班(日間),印度尼西亞共和國,東協,1,0,1,1,0,1,0,0,0,0,0,0,0,0,0
109,私立,一般大學,1011,中華大學學校財團法人中華大學,碩士班(日間),馬來西亞,東協,2,0,2,2,0,2,0,0,0,0,0,0,0,0,0
109,私立,一般大學,1011,中華大學學校財團法人中華大學,碩士班(日間),菲律賓共和國,東協,2,1,1,2,1,1,0,0,0,0,0,0,0,0,0
109,私立,一般大學,1011,中華大學學校財團法人中華大學,碩士班(日間),蒙古國,其他亞洲地區,11,3,8,11,3,8,0,0,0,0,0,0,0,0,0
109,私立,一般大學,1011,中華大學學校財團法人中華大學,碩士班(日間),孟加拉人民共和國,南亞,1,1,0,1,1,0,0,0,0,0,0,0,0,0,0
109,私立,一般大學,1011,中華大學學校財團法人中華大學,碩士班(日間),約旦哈什米王國,其他亞洲地區,1,1,0,1,1,0,0,0,0,0,0,0,0,0,0
109,私立,一般大學,1011,中華大學學校財團法人中華大學,碩士班(日間),泰國,東協,6,1,5,6,1,5,0,0,0,0,0,0,0,0,0
109,私立,一般大學,1011,中華大學學校財團法人中華大學,碩士班(日間),海地共和國,中南美洲,3,3,0,3,3,0,0,0,0,0,0,0,0,0,0
109,私立,一般大學,1011,中華大學學校財團法人中華大學,碩士班(日間),越南社會主義共和國,東協,6,0,6,6,0,6,0,0,0,0,0,0,0,0,0
109,私立,一般大學,1011,中華大學學校財團法人中華大學,博士班,伊拉克共和國,其他亞洲地區,1,1,0,1,1,0,0,0,0,0,0,0,0,0,0
109,私立,一般大學,1011,中華大學學校財團法人中華大學,博士班,泰國,東協,2,1,1,2,1,1,0,0,0,0,0,0,0,0,0
109,私立,一般大學,1011,中華大學學校財團法人中華大學,博士班,蒙古國,其他亞洲地區,1,0,1,1,0,1,0,0,0,0,0,0,0,0,0
109,私立,一般大學,1011,中華大學學校財團法人中華大學,博士班,大陸地區,大陸地區,6,4,2,0,0,0,0,0,0,0,0,0,6,4,2
109,私立,一般大學,1011,中華大學學校財團法人中華大學,博士班,印度,南亞,1,0,1,1,0,1,0,0,0,0,0,0,0,0,0
109,私立,一般大學,1011,中華大學學校財團法人中華大學,博士班,印度尼西亞共和國,東協,1,1,0,1,1,0,0,0,0,0,0,0,0,0,0
109,私立,一般大學,1011,中華大學學校財團法人中華大學,博士班,約旦哈什米王國,其他亞洲地區,2,2,0,2,2,0,0,0,0,0,0,0,0,0,0
109,私立,一般大學,1012,大葉大學,學士班(日間),大陸地區,大陸地區,20,11,9,0,0,0,0,0,0,0,0,0,20,11,9
109,私立,一般大學,1012,大葉大學,學士班(日間),日本,其他亞洲地區,15,4,11,15,4,11,0,0,0,0,0,0,0,0,0
109,私立,一般大學,1012,大葉大學,學士班(日間),印度尼西亞共和國,東協,12,4,8,10,3,7,2,1,1,0,0,0,0,0,0
109,私立,一般大學,1012,大葉大學,學士班(日間),玻利維亞共和國,中南美洲,1,1,0,1,1,0,0,0,0,0,0,0,0,0,0
109,私立,一般大學,1012,大葉大學,學士班(日間),馬來西亞,東協,122,69,53,100,60,40,22,9,13,0,0,0,0,0,0
109,私立,一般大學,1012,大葉大學,學士班(日間),香港,港澳,169,84,85,0,0,0,0,0,0,169,84,85,0,0,0
109,私立,一般大學,1012,大葉大學,學士班(日間),越南社會主義共和國,東協,13,6,7,13,6,7,0,0,0,0,0,0,0,0,0
109,私立,一般大學,1012,大葉大學,學士班(日間),蒙古國,其他亞洲地區,16,6,10,16,6,10,0,0,0,0,0,0,0,0,0
109,私立,一般大學,1012,大葉大學,學士班(日間),澳門,港澳,8,5,3,0,0,0,0,0,0,8,5,3,0,0,0
109,私立,一般大學,1012,大葉大學,碩士班(日間),越南社會主義共和國,東協,2,0,2,2,0,2,0,0,0,0,0,0,0,0,0
109,私立,一般大學,1012,大葉大學,碩士班(日間),蒙古國,其他亞洲地區,32,8,24,32,8,24,0,0,0,0,0,0,0,0,0
109,私立,一般大學,1012,大葉大學,碩士班(日間),緬甸,東協,1,1,0,0,0,0,1,1,0,0,0,0,0,0,0
109,私立,一般大學,1012,大葉大學,碩士班(日間),澳門,港澳,1,0,1,0,0,0,0,0,0,1,0,1,0,0,0
109,私立,一般大學,1012,大葉大學,碩士班(日間),印度尼西亞共和國,東協,6,4,2,6,4,2,0,0,0,0,0,0,0,0,0
109,私立,一般大學,1012,大葉大學,碩士班(日間),香港,港澳,10,5,5,0,0,0,0,0,0,10,5,5,0,0,0
109,私立,一般大學,1012,大葉大學,碩士班(日間),馬來西亞,東協,4,1,3,3,1,2,1,0,1,0,0,0,0,0,0
109,私立,一般大學,1012,大葉大學,博士班,大陸地區,大陸地區,1,1,0,0,0,0,0,0,0,0,0,0,1,1,0
109,私立,一般大學,1012,大葉大學,博士班,印度,南亞,1,1,0,1,1,0,0,0,0,0,0,0,0,0,0
109,私立,一般大學,1012,大葉大學,博士班,印度尼西亞共和國,東協,5,3,2,5,3,2,0,0,0,0,0,0,0,0,0
109,私立,一般大學,1012,大葉大學,博士班,越南社會主義共和國,東協,5,2,3,5,2,3,0,0,0,0,0,0,0,0,0
109,私立,一般大學,1012,大葉大學,博士班,蒙古國,其他亞洲地區,2,0,2,2,0,2,0,0,0,0,0,0,0,0,0
109,私立,一般大學,1012,大葉大學,博士班,泰國,東協,1,1,0,1,1,0,0,0,0,0,0,0,0,0,0
109,私立,一般大學,1012,大葉大學,博士班,馬來西亞,東協,1,0,1,1,0,1,0,0,0,0,0,0,0,0,0
109,私立,一般大學,1013,華梵大學,學士班(日間),大陸地區,大陸地區,3,1,2,0,0,0,0,0,0,0,0,0,3,1,2
109,私立,一般大學,1013,華梵大學,學士班(日間),大韓民國(南韓),其他亞洲地區,1,1,0,1,1,0,0,0,0,0,0,0,0,0,0
109,私立,一般大學,1013,華梵大學,學士班(日間),印度尼西亞共和國,東協,1,0,1,0,0,0,1,0,1,0,0,0,0,0,0
109,私立,一般大學,1013,華梵大學,學士班(日間),香港,港澳,40,18,22,0,0,0,0,0,0,40,18,22,0,0,0
109,私立,一般大學,1013,華梵大學,學士班(日間),馬來西亞,東協,5,3,2,2,1,1,3,2,1,0,0,0,0,0,0
109,私立,一般大學,1013,華梵大學,學士班(日間),越南社會主義共和國,東協,4,3,1,4,3,1,0,0,0,0,0,0,0,0,0
109,私立,一般大學,1013,華梵大學,碩士班(日間),法國,歐洲,1,0,1,1,0,1,0,0,0,0,0,0,0,0,0
109,私立,一般大學,1013,華梵大學,碩士班(日間),泰國,東協,1,1,0,0,0,0,1,1,0,0,0,0,0,0,0
109,私立,一般大學,1013,華梵大學,碩士班(日間),斯洛維尼亞共和國,歐洲,1,1,0,1,1,0,0,0,0,0,0,0,0,0,0
109,私立,一般大學,1013,華梵大學,碩士班(日間),大陸地區,大陸地區,1,1,0,0,0,0,0,0,0,0,0,0,1,1,0
109,私立,一般大學,1013,華梵大學,碩士班(日間),香港,港澳,1,0,1,0,0,0,0,0,0,1,0,1,0,0,0
109,私立,一般大學,1013,華梵大學,碩士班(日間),馬來西亞,東協,1,0,1,1,0,1,0,0,0,0,0,0,0,0,0
109,私立,一般大學,1013,華梵大學,碩士班(日間),越南社會主義共和國,東協,6,0,6,6,0,6,0,0,0,0,0,0,0,0,0
109,私立,一般大學,1013,華梵大學,碩士班(日間),澳門,港澳,2,2,0,0,0,0,0,0,0,2,2,0,0,0,0
109,私立,一般大學,1013,華梵大學,博士班,大陸地區,大陸地區,5,4,1,0,0,0,0,0,0,0,0,0,5,4,1
109,私立,一般大學,1013,華梵大學,博士班,加拿大,北美洲,1,1,0,1,1,0,0,0,0,0,0,0,0,0,0
109,私立,一般大學,1013,華梵大學,博士班,越南社會主義共和國,東協,3,1,2,3,1,2,0,0,0,0,0,0,0,0,0
109,私立,一般大學,1014,義守大學,學士班(日間),大韓民國(南韓),其他亞洲地區,4,2,2,0,0,0,4,2,2,0,0,0,0,0,0
109,私立,一般大學,1014,義守大學,學士班(日間),巴勒斯坦,其他亞洲地區,2,0,2,2,0,2,0,0,0,0,0,0,0,0,0
109,私立,一般大學,1014,義守大學,學士班(日間),日本,其他亞洲地區,86,30,56,86,30,56,0,0,0,0,0,0,0,0,0
109,私立,一般大學,1014,義守大學,學士班(日間),伊拉克共和國,其他亞洲地區,1,1,0,1,1,0,0,0,0,0,0,0,0,0,0
109,私立,一般大學,1014,義守大學,學士班(日間),俄羅斯聯邦,其他亞洲地區,1,1,0,1,1,0,0,0,0,0,0,0,0,0,0
109,私立,一般大學,1014,義守大學,學士班(日間),美國,北美洲,3,2,1,2,1,1,1,1,0,0,0,0,0,0,0
109,私立,一般大學,1014,義守大學,學士班(日間),英國,歐洲,1,1,0,1,1,0,0,0,0,0,0,0,0,0,0
109,私立,一般大學,1014,義守大學,學士班(日間),紐西蘭,其他亞洲地區,1,1,0,0,0,0,1,1,0,0,0,0,0,0,0
109,私立,一般大學,1014,義守大學,學士班(日間),馬來西亞,東協,217,105,112,172,83,89,45,22,23,0,0,0,0,0,0
109,私立,一般大學,1014,義守大學,學士班(日間),馬拉威共和國,非洲,2,1,1,1,1,0,1,0,1,0,0,0,0,0,0
109,私立,一般大學,1014,義守大學,學士班(日間),菲律賓共和國,東協,6,6,0,6,6,0,0,0,0,0,0,0,0,0,0
109,私立,一般大學,1014,義守大學,學士班(日間),義大利共和國,歐洲,1,1,0,1,1,0,0,0,0,0,0,0,0,0,0
109,私立,一般大學,1014,義守大學,學士班(日間),聖克里斯多福及尼維斯,中南美洲,4,1,3,4,1,3,0,0,0,0,0,0,0,0,0
109,私立,一般大學,1014,義守大學,學士班(日間),葡萄牙共和國,歐洲,2,2,0,2,2,0,0,0,0,0,0,0,0,0,0
109,私立,一般大學,1014,義守大學,學士班(日間),蒙古國,其他亞洲地區,13,5,8,13,5,8,0,0,0,0,0,0,0,0,0
109,私立,一般大學,1014,義守大學,學士班(日間),大陸地區,大陸地區,42,24,18,0,0,0,0,0,0,0,0,0,42,24,18
109,私立,一般大學,1014,義守大學,學士班(日間),巴拉圭,中南美洲,3,1,2,3,1,2,0,0,0,0,0,0,0,0,0
109,私立,一般大學,1014,義守大學,學士班(日間),加拿大,北美洲,1,1,0,1,1,0,0,0,0,0,0,0,0,0,0
109,私立,一般大學,1014,義守大學,學士班(日間),史瓦帝尼王國,非洲,35,9,26,35,9,26,0,0,0,0,0,0,0,0,0
109,私立,一般大學,1014,義守大學,學士班(日間),印度尼西亞共和國,東協,192,83,109,180,79,101,12,4,8,0,0,0,0,0,0
109,私立,一般大學,1014,義守大學,學士班(日間),吉里巴斯共和國,其他亞洲地區,5,2,3,5,2,3,0,0,0,0,0,0,0,0,0
109,私立,一般大學,1014,義守大學,學士班(日間),吉爾吉斯,其他亞洲地區,1,0,1,1,0,1,0,0,0,0,0,0,0,0,0
109,私立,一般大學,1014,義守大學,學士班(日間),宏都拉斯共和國,中南美洲,13,6,7,13,6,7,0,0,0,0,0,0,0,0,0
109,私立,一般大學,1014,義守大學,學士班(日間),貝里斯,中南美洲,16,7,9,16,7,9,0,0,0,0,0,0,0,0,0
109,私立,一般大學,1014,義守大學,學士班(日間),帛琉共和國,其他亞洲地區,2,2,0,2,2,0,0,0,0,0,0,0,0,0,0
109,私立,一般大學,1014,義守大學,學士班(日間),香港,港澳,376,184,192,0,0,0,0,0,0,376,184,192,0,0,0
109,私立,一般大學,1014,義守大學,學士班(日間),泰國,東協,28,12,16,28,12,16,0,0,0,0,0,0,0,0,0
109,私立,一般大學,1014,義守大學,學士班(日間),海地共和國,中南美洲,1,1,0,1,1,0,0,0,0,0,0,0,0,0,0
109,私立,一般大學,1014,義守大學,學士班(日間),烏茲別克共和國,其他亞洲地區,3,3,0,3,3,0,0,0,0,0,0,0,0,0,0
109,私立,一般大學,1014,義守大學,學士班(日間),秘魯共和國,中南美洲,1,0,1,1,0,1,0,0,0,0,0,0,0,0,0
109,私立,一般大學,1014,義守大學,學士班(日間),索羅門群島,其他亞洲地區,1,1,0,1,1,0,0,0,0,0,0,0,0,0,0
109,私立,一般大學,1014,義守大學,學士班(日間),馬紹爾群島共和國,其他亞洲地區,3,2,1,3,2,1,0,0,0,0,0,0,0,0,0
109,私立,一般大學,1014,義守大學,學士班(日間),斐濟群島共和國,其他亞洲地區,1,0,1,1,0,1,0,0,0,0,0,0,0,0,0
109,私立,一般大學,1014,義守大學,學士班(日間),越南社會主義共和國,東協,96,38,58,94,38,56,2,0,2,0,0,0,0,0,0
109,私立,一般大學,1014,義守大學,學士班(日間),聖文森(及格瑞那丁),中南美洲,5,2,3,5,2,3,0,0,0,0,0,0,0,0,0
109,私立,一般大學,1014,義守大學,學士班(日間),聖露西亞,中南美洲,24,10,14,24,10,14,0,0,0,0,0,0,0,0,0
109,私立,一般大學,1014,義守大學,學士班(日間),澳門,港澳,92,55,37,0,0,0,0,0,0,92,55,37,0,0,0
109,私立,一般大學,1014,義守大學,學士班(日間),薩爾瓦多,中南美洲,2,2,0,2,2,0,0,0,0,0,0,0,0,0,0
109,私立,一般大學,1014,義守大學,碩士班(日間),大陸地區,大陸地區,9,6,3,0,0,0,0,0,0,0,0,0,9,6,3
109,私立,一般大學,1014,義守大學,碩士班(日間),印度尼西亞共和國,東協,9,5,4,9,5,4,0,0,0,0,0,0,0,0,0
109,私立,一般大學,1014,義守大學,碩士班(日間),宏都拉斯共和國,中南美洲,2,1,1,2,1,1,0,0,0,0,0,0,0,0,0
109,私立,一般大學,1014,義守大學,碩士班(日間),貝里斯,中南美洲,1,1,0,1,1,0,0,0,0,0,0,0,0,0,0
109,私立,一般大學,1014,義守大學,碩士班(日間),香港,港澳,9,9,0,0,0,0,0,0,0,9,9,0,0,0,0
109,私立,一般大學,1014,義守大學,碩士班(日間),烏茲別克共和國,其他亞洲地區,1,0,1,1,0,1,0,0,0,0,0,0,0,0,0
109,私立,一般大學,1014,義守大學,碩士班(日間),越南社會主義共和國,東協,55,22,33,55,22,33,0,0,0,0,0,0,0,0,0
109,私立,一般大學,1014,義守大學,碩士班(日間),日本,其他亞洲地區,1,1,0,1,1,0,0,0,0,0,0,0,0,0,0
109,私立,一般大學,1014,義守大學,碩士班(日間),泰國,東協,6,2,4,6,2,4,0,0,0,0,0,0,0,0,0
109,私立,一般大學,1014,義守大學,碩士班(日間),馬來西亞,東協,6,2,4,4,2,2,2,0,2,0,0,0,0,0,0
109,私立,一般大學,1014,義守大學,碩士班(日間),蒙古國,其他亞洲地區,2,1,1,2,1,1,0,0,0,0,0,0,0,0,0
109,私立,一般大學,1014,義守大學,博士班,大陸地區,大陸地區,10,4,6,0,0,0,0,0,0,0,0,0,10,4,6
109,私立,一般大學,1014,義守大學,博士班,印度,南亞,1,1,0,1,1,0,0,0,0,0,0,0,0,0,0
109,私立,一般大學,1014,義守大學,博士班,印度尼西亞共和國,東協,1,1,0,1,1,0,0,0,0,0,0,0,0,0,0
109,私立,一般大學,1014,義守大學,博士班,菲律賓共和國,東協,2,1,1,2,1,1,0,0,0,0,0,0,0,0,0
109,私立,一般大學,1014,義守大學,博士班,越南社會主義共和國,東協,3,1,2,3,1,2,0,0,0,0,0,0,0,0,0
109,私立,一般大學,1014,義守大學,博士班,泰國,東協,1,0,1,1,0,1,0,0,0,0,0,0,0,0,0
109,私立,一般大學,1015,世新大學,學士班(日間),土耳其共和國,其他亞洲地區,1,1,0,1,1,0,0,0,0,0,0,0,0,0,0
109,私立,一般大學,1015,世新大學,學士班(日間),巴拉圭,中南美洲,1,0,1,1,0,1,0,0,0,0,0,0,0,0,0
109,私立,一般大學,1015,世新大學,學士班(日間),加拿大,北美洲,1,1,0,0,0,0,1,1,0,0,0,0,0,0,0
109,私立,一般大學,1015,世新大學,學士班(日間),印度尼西亞共和國,東協,17,6,11,2,0,2,15,6,9,0,0,0,0,0,0
109,私立,一般大學,1015,世新大學,學士班(日間),馬來西亞,東協,227,69,158,100,37,63,127,32,95,0,0,0,0,0,0
109,私立,一般大學,1015,世新大學,學士班(日間),越南社會主義共和國,東協,20,5,15,16,4,12,4,1,3,0,0,0,0,0,0
109,私立,一般大學,1015,世新大學,學士班(日間),瑞士聯邦,歐洲,2,0,2,2,0,2,0,0,0,0,0,0,0,0,0
109,私立,一般大學,1015,世新大學,學士班(日間),澳門,港澳,69,32,37,0,0,0,0,0,0,69,32,37,0,0,0
109,私立,一般大學,1015,世新大學,學士班(日間),大陸地區,大陸地區,86,19,67,0,0,0,0,0,0,0,0,0,86,19,67
109,私立,一般大學,1015,世新大學,學士班(日間),大韓民國(南韓),其他亞洲地區,5,1,4,5,1,4,0,0,0,0,0,0,0,0,0
109,私立,一般大學,1015,世新大學,學士班(日間),日本,其他亞洲地區,40,12,28,37,9,28,3,3,0,0,0,0,0,0,0
109,私立,一般大學,1015,世新大學,學士班(日間),奈及利亞聯邦共和國,非洲,4,3,1,4,3,1,0,0,0,0,0,0,0,0,0
109,私立,一般大學,1015,世新大學,學士班(日間),香港,港澳,122,38,84,0,0,0,0,0,0,122,38,84,0,0,0
109,私立,一般大學,1015,世新大學,學士班(日間),智利,中南美洲,1,1,0,1,1,0,0,0,0,0,0,0,0,0,0
109,私立,一般大學,1015,世新大學,學士班(日間),新加坡共和國,東協,6,1,5,6,1,5,0,0,0,0,0,0,0,0,0
109,私立,一般大學,1015,世新大學,學士班(日間),葡萄牙共和國,歐洲,1,1,0,1,1,0,0,0,0,0,0,0,0,0,0
109,私立,一般大學,1015,世新大學,學士班(日間),緬甸,東協,2,0,2,1,0,1,1,0,1,0,0,0,0,0,0
109,私立,一般大學,1015,世新大學,碩士班(日間),大韓民國(南韓),其他亞洲地區,2,1,1,2,1,1,0,0,0,0,0,0,0,0,0
109,私立,一般大學,1015,世新大學,碩士班(日間),香港,港澳,11,5,6,0,0,0,0,0,0,11,5,6,0,0,0
109,私立,一般大學,1015,世新大學,碩士班(日間),土耳其共和國,其他亞洲地區,1,1,0,1,1,0,0,0,0,0,0,0,0,0,0
109,私立,一般大學,1015,世新大學,碩士班(日間),大陸地區,大陸地區,48,10,38,0,0,0,0,0,0,0,0,0,48,10,38
109,私立,一般大學,1015,世新大學,碩士班(日間),俄羅斯聯邦,其他亞洲地區,2,0,2,2,0,2,0,0,0,0,0,0,0,0,0
109,私立,一般大學,1015,世新大學,碩士班(日間),馬來西亞,東協,7,2,5,4,1,3,3,1,2,0,0,0,0,0,0
109,私立,一般大學,1015,世新大學,碩士班(日間),菲律賓共和國,東協,1,0,1,1,0,1,0,0,0,0,0,0,0,0,0
109,私立,一般大學,1015,世新大學,碩士班(日間),越南社會主義共和國,東協,3,0,3,3,0,3,0,0,0,0,0,0,0,0,0
109,私立,一般大學,1015,世新大學,碩士班(日間),澳門,港澳,5,3,2,0,0,0,0,0,0,5,3,2,0,0,0
109,私立,一般大學,1015,世新大學,博士班,大陸地區,大陸地區,36,15,21,0,0,0,0,0,0,0,0,0,36,15,21
109,私立,一般大學,1016,銘傳大學,學士班(日間),大陸地區,大陸地區,168,59,109,0,0,0,0,0,0,0,0,0,168,59,109
109,私立,一般大學,1016,銘傳大學,學士班(日間),大韓民國(南韓),其他亞洲地區,12,7,5,10,6,4,2,1,1,0,0,0,0,0,0
109,私立,一般大學,1016,銘傳大學,學士班(日間),厄瓜多共和國,中南美洲,2,0,2,2,0,2,0,0,0,0,0,0,0,0,0
109,私立,一般大學,1016,銘傳大學,學士班(日間),巴布亞紐幾內亞獨立國,其他亞洲地區,10,5,5,10,5,5,0,0,0,0,0,0,0,0,0
109,私立,一般大學,1016,銘傳大學,學士班(日間),巴拉圭,中南美洲,1,1,0,1,1,0,0,0,0,0,0,0,0,0,0
109,私立,一般大學,1016,銘傳大學,學士班(日間),尼加拉瓜,中南美洲,6,3,3,6,3,3,0,0,0,0,0,0,0,0,0
109,私立,一般大學,1016,銘傳大學,學士班(日間),尼泊爾聯邦民主共和國,南亞,2,2,0,2,2,0,0,0,0,0,0,0,0,0,0
109,私立,一般大學,1016,銘傳大學,學士班(日間),瓜地馬拉共和國,中南美洲,11,6,5,11,6,5,0,0,0,0,0,0,0,0,0
109,私立,一般大學,1016,銘傳大學,學士班(日間),印度,南亞,7,3,4,7,3,4,0,0,0,0,0,0,0,0,0
109,私立,一般大學,1016,銘傳大學,學士班(日間),印度尼西亞共和國,東協,108,40,68,63,25,38,45,15,30,0,0,0,0,0,0
109,私立,一般大學,1016,銘傳大學,學士班(日間),吐瓦魯,其他亞洲地區,7,3,4,7,3,4,0,0,0,0,0,0,0,0,0
109,私立,一般大學,1016,銘傳大學,學士班(日間),多明尼加共和國,中南美洲,1,1,0,1,1,0,0,0,0,0,0,0,0,0,0
109,私立,一般大學,1016,銘傳大學,學士班(日間),宏都拉斯共和國,中南美洲,24,10,14,24,10,14,0,0,0,0,0,0,0,0,0
109,私立,一般大學,1016,銘傳大學,學士班(日間),貝里斯,中南美洲,10,3,7,10,3,7,0,0,0,0,0,0,0,0,0
109,私立,一般大學,1016,銘傳大學,學士班(日間),帛琉共和國,其他亞洲地區,15,6,9,15,6,9,0,0,0,0,0,0,0,0,0
109,私立,一般大學,1016,銘傳大學,學士班(日間),拉脫維亞共和國,歐洲,1,0,1,1,0,1,0,0,0,0,0,0,0,0,0
109,私立,一般大學,1016,銘傳大學,學士班(日間),南非共和國,非洲,5,2,3,5,2,3,0,0,0,0,0,0,0,0,0
109,私立,一般大學,1016,銘傳大學,學士班(日間),香港,港澳,293,131,162,0,0,0,0,0,0,293,131,162,0,0,0
109,私立,一般大學,1016,銘傳大學,學士班(日間),海地共和國,中南美洲,2,1,1,2,1,1,0,0,0,0,0,0,0,0,0
109,私立,一般大學,1016,銘傳大學,學士班(日間),秘魯共和國,中南美洲,3,0,3,3,0,3,0,0,0,0,0,0,0,0,0
109,私立,一般大學,1016,銘傳大學,學士班(日間),索羅門群島,其他亞洲地區,1,1,0,1,1,0,0,0,0,0,0,0,0,0,0
109,私立,一般大學,1016,銘傳大學,學士班(日間),馬紹爾群島共和國,其他亞洲地區,9,4,5,9,4,5,0,0,0,0,0,0,0,0,0
109,私立,一般大學,1016,銘傳大學,學士班(日間),馬達加斯加共和國,非洲,1,1,0,0,0,0,1,1,0,0,0,0,0,0,0
109,私立,一般大學,1016,銘傳大學,學士班(日間),越南社會主義共和國,東協,216,64,152,205,62,143,11,2,9,0,0,0,0,0,0
109,私立,一般大學,1016,銘傳大學,學士班(日間),瑞士聯邦,歐洲,2,2,0,2,2,0,0,0,0,0,0,0,0,0,0
109,私立,一般大學,1016,銘傳大學,學士班(日間),聖文森(及格瑞那丁),中南美洲,7,1,6,7,1,6,0,0,0,0,0,0,0,0,0
109,私立,一般大學,1016,銘傳大學,學士班(日間),聖克里斯多福及尼維斯,中南美洲,11,6,5,11,6,5,0,0,0,0,0,0,0,0,0
109,私立,一般大學,1016,銘傳大學,學士班(日間),葡萄牙共和國,歐洲,2,2,0,0,0,0,2,2,0,0,0,0,0,0,0
109,私立,一般大學,1016,銘傳大學,學士班(日間),德意志聯邦共和國,歐洲,2,2,0,2,2,0,0,0,0,0,0,0,0,0,0
109,私立,一般大學,1016,銘傳大學,學士班(日間),緬甸,東協,4,3,1,1,0,1,3,3,0,0,0,0,0,0,0
109,私立,一般大學,1016,銘傳大學,學士班(日間),澳大利亞,其他亞洲地區,3,2,1,1,1,0,2,1,1,0,0,0,0,0,0
109,私立,一般大學,1016,銘傳大學,學士班(日間),澳門,港澳,106,43,63,0,0,0,0,0,0,106,43,63,0,0,0
109,私立,一般大學,1016,銘傳大學,學士班(日間),諾魯共和國,其他亞洲地區,4,2,2,4,2,2,0,0,0,0,0,0,0,0,0
109,私立,一般大學,1016,銘傳大學,學士班(日間),巴西聯邦共和國,中南美洲,4,3,1,4,3,1,0,0,0,0,0,0,0,0,0
109,私立,一般大學,1016,銘傳大學,學士班(日間),巴勒斯坦,其他亞洲地區,1,1,0,1,1,0,0,0,0,0,0,0,0,0,0
109,私立,一般大學,1016,銘傳大學,學士班(日間),日本,其他亞洲地區,81,20,61,77,20,57,4,0,4,0,0,0,0,0,0
109,私立,一般大學,1016,銘傳大學,學士班(日間),史瓦帝尼王國,非洲,12,6,6,12,6,6,0,0,0,0,0,0,0,0,0
109,私立,一般大學,1016,銘傳大學,學士班(日間),奈及利亞聯邦共和國,非洲,2,0,2,2,0,2,0,0,0,0,0,0,0,0,0
109,私立,一般大學,1016,銘傳大學,學士班(日間),法國,歐洲,5,3,2,5,3,2,0,0,0,0,0,0,0,0,0
109,私立,一般大學,1016,銘傳大學,學士班(日間),俄羅斯聯邦,其他亞洲地區,2,1,1,2,1,1,0,0,0,0,0,0,0,0,0
109,私立,一般大學,1016,銘傳大學,學士班(日間),美國,北美洲,14,12,2,14,12,2,0,0,0,0,0,0,0,0,0
109,私立,一般大學,1016,銘傳大學,學士班(日間),英國,歐洲,3,1,2,3,1,2,0,0,0,0,0,0,0,0,0
109,私立,一般大學,1016,銘傳大學,學士班(日間),埃及阿拉伯共和國,非洲,2,1,1,2,1,1,0,0,0,0,0,0,0,0,0
109,私立,一般大學,1016,銘傳大學,學士班(日間),泰國,東協,45,19,26,41,18,23,4,1,3,0,0,0,0,0,0
109,私立,一般大學,1016,銘傳大學,學士班(日間),馬來西亞,東協,453,155,298,251,99,152,202,56,146,0,0,0,0,0,0
109,私立,一般大學,1016,銘傳大學,學士班(日間),斯洛伐克共和國,歐洲,1,1,0,1,1,0,0,0,0,0,0,0,0,0,0
109,私立,一般大學,1016,銘傳大學,學士班(日間),菲律賓共和國,東協,6,2,4,4,1,3,2,1,1,0,0,0,0,0,0
109,私立,一般大學,1016,銘傳大學,學士班(日間),聖露西亞,中南美洲,4,0,4,4,0,4,0,0,0,0,0,0,0,0,0
109,私立,一般大學,1016,銘傳大學,學士班(日間),蒙古國,其他亞洲地區,11,5,6,11,5,6,0,0,0,0,0,0,0,0,0
109,私立,一般大學,1016,銘傳大學,學士班(日間),墨西哥合眾國,中南美洲,2,1,1,2,1,1,0,0,0,0,0,0,0,0,0
109,私立,一般大學,1016,銘傳大學,學士班(日間),薩爾瓦多,中南美洲,8,3,5,8,3,5,0,0,0,0,0,0,0,0,0
109,私立,一般大學,1016,銘傳大學,碩士班(日間),巴拉圭,中南美洲,2,1,1,2,1,1,0,0,0,0,0,0,0,0,0
109,私立,一般大學,1016,銘傳大學,碩士班(日間),史瓦帝尼王國,非洲,1,0,1,1,0,1,0,0,0,0,0,0,0,0,0
109,私立,一般大學,1016,銘傳大學,碩士班(日間),布吉納法索,非洲,1,1,0,1,1,0,0,0,0,0,0,0,0,0,0
109,私立,一般大學,1016,銘傳大學,碩士班(日間),奈及利亞聯邦共和國,非洲,2,2,0,2,2,0,0,0,0,0,0,0,0,0,0
109,私立,一般大學,1016,銘傳大學,碩士班(日間),波蘭共和國,歐洲,1,1,0,1,1,0,0,0,0,0,0,0,0,0,0
109,私立,一般大學,1016,銘傳大學,碩士班(日間),哈薩克共和國,其他亞洲地區,1,1,0,1,1,0,0,0,0,0,0,0,0,0,0
109,私立,一般大學,1016,銘傳大學,碩士班(日間),美國,北美洲,4,4,0,4,4,0,0,0,0,0,0,0,0,0,0
109,私立,一般大學,1016,銘傳大學,碩士班(日間),泰國,東協,8,0,8,8,0,8,0,0,0,0,0,0,0,0,0
109,私立,一般大學,1016,銘傳大學,碩士班(日間),烏干達共和國,非洲,1,0,1,1,0,1,0,0,0,0,0,0,0,0,0
109,私立,一般大學,1016,銘傳大學,碩士班(日間),馬來西亞,東協,12,4,8,5,1,4,7,3,4,0,0,0,0,0,0
109,私立,一般大學,1016,銘傳大學,碩士班(日間),菲律賓共和國,東協,2,1,1,2,1,1,0,0,0,0,0,0,0,0,0
109,私立,一般大學,1016,銘傳大學,碩士班(日間),義大利共和國,歐洲,1,1,0,1,1,0,0,0,0,0,0,0,0,0,0
109,私立,一般大學,1016,銘傳大學,碩士班(日間),聖露西亞,中南美洲,2,0,2,2,0,2,0,0,0,0,0,0,0,0,0
109,私立,一般大學,1016,銘傳大學,碩士班(日間),蒙古國,其他亞洲地區,1,0,1,1,0,1,0,0,0,0,0,0,0,0,0
109,私立,一般大學,1016,銘傳大學,碩士班(日間),墨西哥合眾國,中南美洲,2,0,2,2,0,2,0,0,0,0,0,0,0,0,0
109,私立,一般大學,1016,銘傳大學,碩士班(日間),澳大利亞,其他亞洲地區,1,1,0,1,1,0,0,0,0,0,0,0,0,0,0
109,私立,一般大學,1016,銘傳大學,碩士班(日間),大陸地區,大陸地區,33,22,11,0,0,0,0,0,0,0,0,0,33,22,11
109,私立,一般大學,1016,銘傳大學,碩士班(日間),日本,其他亞洲地區,2,1,1,1,0,1,1,1,0,0,0,0,0,0,0
109,私立,一般大學,1016,銘傳大學,碩士班(日間),瓜地馬拉共和國,中南美洲,5,1,4,5,1,4,0,0,0,0,0,0,0,0,0
109,私立,一般大學,1016,銘傳大學,碩士班(日間),印度尼西亞共和國,東協,2,1,1,2,1,1,0,0,0,0,0,0,0,0,0
109,私立,一般大學,1016,銘傳大學,碩士班(日間),多明尼加共和國,中南美洲,1,0,1,1,0,1,0,0,0,0,0,0,0,0,0
109,私立,一般大學,1016,銘傳大學,碩士班(日間),貝里斯,中南美洲,6,4,2,6,4,2,0,0,0,0,0,0,0,0,0
109,私立,一般大學,1016,銘傳大學,碩士班(日間),帛琉共和國,其他亞洲地區,2,0,2,2,0,2,0,0,0,0,0,0,0,0,0
109,私立,一般大學,1016,銘傳大學,碩士班(日間),南非共和國,非洲,1,0,1,1,0,1,0,0,0,0,0,0,0,0,0
109,私立,一般大學,1016,銘傳大學,碩士班(日間),科威特,其他亞洲地區,1,0,1,1,0,1,0,0,0,0,0,0,0,0,0
109,私立,一般大學,1016,銘傳大學,碩士班(日間),香港,港澳,7,5,2,0,0,0,0,0,0,7,5,2,0,0,0
109,私立,一般大學,1016,銘傳大學,碩士班(日間),海地共和國,中南美洲,2,1,1,2,1,1,0,0,0,0,0,0,0,0,0
109,私立,一般大學,1016,銘傳大學,碩士班(日間),越南社會主義共和國,東協,15,5,10,14,5,9,1,0,1,0,0,0,0,0,0
109,私立,一般大學,1016,銘傳大學,碩士班(日間),聖文森(及格瑞那丁),中南美洲,1,0,1,1,0,1,0,0,0,0,0,0,0,0,0
109,私立,一般大學,1016,銘傳大學,碩士班(日間),澳門,港澳,4,2,2,0,0,0,0,0,0,4,2,2,0,0,0
109,私立,一般大學,1016,銘傳大學,碩士班(日間),諾魯共和國,其他亞洲地區,1,1,0,1,1,0,0,0,0,0,0,0,0,0,0
109,私立,一般大學,1016,銘傳大學,博士班,越南社會主義共和國,東協,1,0,1,1,0,1,0,0,0,0,0,0,0,0,0
109,私立,一般大學,1016,銘傳大學,博士班,大陸地區,大陸地區,24,10,14,0,0,0,0,0,0,0,0,0,24,10,14
109,私立,一般大學,1017,實踐大學,學士班(日間),史瓦帝尼王國,非洲,2,1,1,2,1,1,0,0,0,0,0,0,0,0,0
109,私立,一般大學,1017,實踐大學,學士班(日間),尼加拉瓜,中南美洲,1,0,1,1,0,1,0,0,0,0,0,0,0,0,0
109,私立,一般大學,1017,實踐大學,學士班(日間),俄羅斯聯邦,其他亞洲地區,2,1,1,2,1,1,0,0,0,0,0,0,0,0,0
109,私立,一般大學,1017,實踐大學,學士班(日間),美國,北美洲,2,1,1,2,1,1,0,0,0,0,0,0,0,0,0
109,私立,一般大學,1017,實踐大學,學士班(日間),泰國,東協,2,0,2,2,0,2,0,0,0,0,0,0,0,0,0
109,私立,一般大學,1017,實踐大學,學士班(日間),斯洛伐克共和國,歐洲,1,0,1,1,0,1,0,0,0,0,0,0,0,0,0
109,私立,一般大學,1017,實踐大學,學士班(日間),義大利共和國,歐洲,3,3,0,3,3,0,0,0,0,0,0,0,0,0,0
109,私立,一般大學,1017,實踐大學,學士班(日間),德意志聯邦共和國,歐洲,4,2,2,4,2,2,0,0,0,0,0,0,0,0,0
109,私立,一般大學,1017,實踐大學,學士班(日間),大陸地區,大陸地區,84,21,63,0,0,0,0,0,0,0,0,0,84,21,63
109,私立,一般大學,1017,實踐大學,學士班(日間),大韓民國(南韓),其他亞洲地區,6,3,3,4,1,3,2,2,0,0,0,0,0,0,0
109,私立,一般大學,1017,實踐大學,學士班(日間),巴拉圭,中南美洲,2,0,2,2,0,2,0,0,0,0,0,0,0,0,0
109,私立,一般大學,1017,實踐大學,學士班(日間),日本,其他亞洲地區,90,39,51,87,38,49,3,1,2,0,0,0,0,0,0
109,私立,一般大學,1017,實踐大學,學士班(日間),加拿大,北美洲,1,0,1,1,0,1,0,0,0,0,0,0,0,0,0
109,私立,一般大學,1017,實踐大學,學士班(日間),瓜地馬拉共和國,中南美洲,1,1,0,1,1,0,0,0,0,0,0,0,0,0,0
109,私立,一般大學,1017,實踐大學,學士班(日間),印度尼西亞共和國,東協,62,14,48,26,10,16,36,4,32,0,0,0,0,0,0
109,私立,一般大學,1017,實踐大學,學士班(日間),香港,港澳,180,73,107,0,0,0,0,0,0,180,73,107,0,0,0
109,私立,一般大學,1017,實踐大學,學士班(日間),哥倫比亞共和國,中南美洲,1,0,1,1,0,1,0,0,0,0,0,0,0,0,0
109,私立,一般大學,1017,實踐大學,學士班(日間),馬來西亞,東協,78,21,57,24,6,18,54,15,39,0,0,0,0,0,0
109,私立,一般大學,1017,實踐大學,學士班(日間),菲律賓共和國,東協,2,1,1,2,1,1,0,0,0,0,0,0,0,0,0
109,私立,一般大學,1017,實踐大學,學士班(日間),越南社會主義共和國,東協,23,7,16,17,4,13,6,3,3,0,0,0,0,0,0
109,私立,一般大學,1017,實踐大學,學士班(日間),緬甸,東協,2,0,2,0,0,0,2,0,2,0,0,0,0,0,0
109,私立,一般大學,1017,實踐大學,學士班(日間),澳門,港澳,84,45,39,0,0,0,0,0,0,84,45,39,0,0,0
109,私立,一般大學,1017,實踐大學,碩士班(日間),大陸地區,大陸地區,22,9,13,0,0,0,0,0,0,0,0,0,22,9,13
109,私立,一般大學,1017,實踐大學,碩士班(日間),大韓民國(南韓),其他亞洲地區,1,1,0,1,1,0,0,0,0,0,0,0,0,0,0
109,私立,一般大學,1017,實踐大學,碩士班(日間),印度,南亞,1,0,1,1,0,1,0,0,0,0,0,0,0,0,0
109,私立,一般大學,1017,實踐大學,碩士班(日間),香港,港澳,6,2,4,0,0,0,0,0,0,6,2,4,0,0,0
109,私立,一般大學,1017,實踐大學,碩士班(日間),馬來西亞,東協,6,3,3,5,2,3,1,1,0,0,0,0,0,0,0
109,私立,一般大學,1017,實踐大學,碩士班(日間),緬甸,東協,2,1,1,2,1,1,0,0,0,0,0,0,0,0,0
109,私立,一般大學,1017,實踐大學,碩士班(日間),澳門,港澳,4,2,2,0,0,0,0,0,0,4,2,2,0,0,0
109,私立,一般大學,1017,實踐大學,碩士班(日間),史瓦帝尼王國,非洲,1,0,1,1,0,1,0,0,0,0,0,0,0,0,0
109,私立,一般大學,1017,實踐大學,碩士班(日間),美國,北美洲,1,1,0,0,0,0,1,1,0,0,0,0,0,0,0
109,私立,一般大學,1017,實踐大學,碩士班(日間),泰國,東協,4,1,3,4,1,3,0,0,0,0,0,0,0,0,0
109,私立,一般大學,1017,實踐大學,博士班,大陸地區,大陸地區,14,5,9,0,0,0,0,0,0,0,0,0,14,5,9
109,私立,一般大學,1017,實踐大學,博士班,美國,北美洲,1,1,0,1,1,0,0,0,0,0,0,0,0,0,0
109,私立,技專校院,1018,朝陽科技大學,學士班(日間),巴基斯坦,南亞,1,1,0,1,1,0,0,0,0,0,0,0,0,0,0
109,私立,技專校院,1018,朝陽科技大學,學士班(日間),日本,其他亞洲地區,1,0,1,0,0,0,1,0,1,0,0,0,0,0,0
109,私立,技專校院,1018,朝陽科技大學,學士班(日間),菲律賓共和國,東協,2,1,1,2,1,1,0,0,0,0,0,0,0,0,0
109,私立,技專校院,1018,朝陽科技大學,學士班(日間),蒙古國,其他亞洲地區,26,18,8,26,18,8,0,0,0,0,0,0,0,0,0
109,私立,技專校院,1018,朝陽科技大學,學士班(日間),大陸地區,大陸地區,93,42,51,0,0,0,0,0,0,0,0,0,93,42,51
109,私立,技專校院,1018,朝陽科技大學,學士班(日間),大韓民國(南韓),其他亞洲地區,2,1,1,2,1,1,0,0,0,0,0,0,0,0,0
109,私立,技專校院,1018,朝陽科技大學,學士班(日間),印度尼西亞共和國,東協,25,13,12,23,13,10,2,0,2,0,0,0,0,0,0
109,私立,技專校院,1018,朝陽科技大學,學士班(日間),香港,港澳,69,34,35,0,0,0,0,0,0,69,34,35,0,0,0
109,私立,技專校院,1018,朝陽科技大學,學士班(日間),馬來西亞,東協,73,33,40,56,27,29,17,6,11,0,0,0,0,0,0
109,私立,技專校院,1018,朝陽科技大學,學士班(日間),越南社會主義共和國,東協,255,83,172,254,82,172,1,1,0,0,0,0,0,0,0
109,私立,技專校院,1018,朝陽科技大學,學士班(日間),寮人民民主共和國(寮國),東協,1,1,0,0,0,0,1,1,0,0,0,0,0,0,0
109,私立,技專校院,1018,朝陽科技大學,學士班(日間),緬甸,東協,1,1,0,0,0,0,1,1,0,0,0,0,0,0,0
109,私立,技專校院,1018,朝陽科技大學,學士班(日間),澳門,港澳,23,18,5,0,0,0,0,0,0,23,18,5,0,0,0
109,私立,技專校院,1018,朝陽科技大學,碩士班(日間),大陸地區,大陸地區,8,4,4,0,0,0,0,0,0,0,0,0,8,4,4
109,私立,技專校院,1018,朝陽科技大學,碩士班(日間),大韓民國(南韓),其他亞洲地區,1,1,0,1,1,0,0,0,0,0,0,0,0,0,0
109,私立,技專校院,1018,朝陽科技大學,碩士班(日間),印度尼西亞共和國,東協,12,11,1,12,11,1,0,0,0,0,0,0,0,0,0
109,私立,技專校院,1018,朝陽科技大學,碩士班(日間),香港,港澳,5,2,3,0,0,0,0,0,0,5,2,3,0,0,0
109,私立,技專校院,1018,朝陽科技大學,碩士班(日間),馬來西亞,東協,5,3,2,5,3,2,0,0,0,0,0,0,0,0,0
109,私立,技專校院,1018,朝陽科技大學,碩士班(日間),越南社會主義共和國,東協,16,6,10,16,6,10,0,0,0,0,0,0,0,0,0
109,私立,技專校院,1018,朝陽科技大學,碩士班(日間),蒙古國,其他亞洲地區,2,2,0,2,2,0,0,0,0,0,0,0,0,0,0
109,私立,技專校院,1018,朝陽科技大學,碩士班(日間),緬甸,東協,3,1,2,3,1,2,0,0,0,0,0,0,0,0,0
109,私立,技專校院,1018,朝陽科技大學,碩士班(日間),泰國,東協,1,0,1,1,0,1,0,0,0,0,0,0,0,0,0
109,私立,技專校院,1018,朝陽科技大學,碩士班(日間),菲律賓共和國,東協,1,0,1,1,0,1,0,0,0,0,0,0,0,0,0
109,私立,技專校院,1018,朝陽科技大學,博士班,大陸地區,大陸地區,6,3,3,0,0,0,0,0,0,0,0,0,6,3,3
109,私立,技專校院,1018,朝陽科技大學,博士班,尼泊爾聯邦民主共和國,南亞,4,3,1,4,3,1,0,0,0,0,0,0,0,0,0
109,私立,技專校院,1018,朝陽科技大學,博士班,印度,南亞,6,3,3,6,3,3,0,0,0,0,0,0,0,0,0
109,私立,技專校院,1018,朝陽科技大學,博士班,印度尼西亞共和國,東協,17,10,7,17,10,7,0,0,0,0,0,0,0,0,0
109,私立,技專校院,1018,朝陽科技大學,博士班,越南社會主義共和國,東協,4,1,3,4,1,3,0,0,0,0,0,0,0,0,0
109,私立,技專校院,1018,朝陽科技大學,博士班,墨西哥合眾國,中南美洲,1,0,1,1,0,1,0,0,0,0,0,0,0,0,0
109,私立,一般大學,1019,高雄醫學大學,學士班(日間),大陸地區,大陸地區,13,6,7,0,0,0,0,0,0,0,0,0,13,6,7
109,私立,一般大學,1019,高雄醫學大學,學士班(日間),大韓民國(南韓),其他亞洲地區,10,3,7,4,0,4,6,3,3,0,0,0,0,0,0
109,私立,一般大學,1019,高雄醫學大學,學士班(日間),加拿大,北美洲,7,4,3,0,0,0,7,4,3,0,0,0,0,0,0
109,私立,一般大學,1019,高雄醫學大學,學士班(日間),瓜地馬拉共和國,中南美洲,2,0,2,2,0,2,0,0,0,0,0,0,0,0,0
109,私立,一般大學,1019,高雄醫學大學,學士班(日間),印度尼西亞共和國,東協,11,3,8,2,0,2,9,3,6,0,0,0,0,0,0
109,私立,一般大學,1019,高雄醫學大學,學士班(日間),吉里巴斯共和國,其他亞洲地區,1,0,1,1,0,1,0,0,0,0,0,0,0,0,0
109,私立,一般大學,1019,高雄醫學大學,學士班(日間),宏都拉斯共和國,中南美洲,2,1,1,2,1,1,0,0,0,0,0,0,0,0,0
109,私立,一般大學,1019,高雄醫學大學,學士班(日間),貝里斯,中南美洲,4,1,3,3,0,3,1,1,0,0,0,0,0,0,0
109,私立,一般大學,1019,高雄醫學大學,學士班(日間),法國,歐洲,1,1,0,1,1,0,0,0,0,0,0,0,0,0,0
109,私立,一般大學,1019,高雄醫學大學,學士班(日間),南非共和國,非洲,1,0,1,0,0,0,1,0,1,0,0,0,0,0,0
109,私立,一般大學,1019,高雄醫學大學,學士班(日間),香港,港澳,42,18,24,0,0,0,0,0,0,42,18,24,0,0,0
109,私立,一般大學,1019,高雄醫學大學,學士班(日間),泰國,東協,1,1,0,0,0,0,1,1,0,0,0,0,0,0,0
109,私立,一般大學,1019,高雄醫學大學,學士班(日間),索羅門群島,其他亞洲地區,2,0,2,2,0,2,0,0,0,0,0,0,0,0,0
109,私立,一般大學,1019,高雄醫學大學,學士班(日間),馬來西亞,東協,106,28,78,17,3,14,89,25,64,0,0,0,0,0,0
109,私立,一般大學,1019,高雄醫學大學,學士班(日間),馬紹爾群島共和國,其他亞洲地區,1,1,0,1,1,0,0,0,0,0,0,0,0,0,0
109,私立,一般大學,1019,高雄醫學大學,學士班(日間),越南社會主義共和國,東協,1,0,1,1,0,1,0,0,0,0,0,0,0,0,0
109,私立,一般大學,1019,高雄醫學大學,學士班(日間),聖文森(及格瑞那丁),中南美洲,2,0,2,2,0,2,0,0,0,0,0,0,0,0,0
109,私立,一般大學,1019,高雄醫學大學,學士班(日間),聖露西亞,中南美洲,1,1,0,1,1,0,0,0,0,0,0,0,0,0,0
109,私立,一般大學,1019,高雄醫學大學,學士班(日間),緬甸,東協,5,0,5,1,0,1,4,0,4,0,0,0,0,0,0
109,私立,一般大學,1019,高雄醫學大學,學士班(日間),澳門,港澳,35,15,20,0,0,0,0,0,0,35,15,20,0,0,0
109,私立,一般大學,1019,高雄醫學大學,學士班(日間),薩爾瓦多,中南美洲,1,0,1,0,0,0,1,0,1,0,0,0,0,0,0
109,私立,一般大學,1019,高雄醫學大學,學士班(日間),厄瓜多共和國,中南美洲,1,0,1,1,0,1,0,0,0,0,0,0,0,0,0
109,私立,一般大學,1019,高雄醫學大學,學士班(日間),史瓦帝尼王國,非洲,1,0,1,1,0,1,0,0,0,0,0,0,0,0,0
109,私立,一般大學,1019,高雄醫學大學,學士班(日間),帛琉共和國,其他亞洲地區,3,2,1,3,2,1,0,0,0,0,0,0,0,0,0
109,私立,一般大學,1019,高雄醫學大學,學士班(日間),約旦哈什米王國,其他亞洲地區,1,1,0,1,1,0,0,0,0,0,0,0,0,0,0
109,私立,一般大學,1019,高雄醫學大學,學士班(日間),美國,北美洲,12,6,6,7,2,5,5,4,1,0,0,0,0,0,0
109,私立,一般大學,1019,高雄醫學大學,學士班(日間),新加坡共和國,東協,7,3,4,1,0,1,6,3,3,0,0,0,0,0,0
109,私立,一般大學,1019,高雄醫學大學,學士班(日間),聖克里斯多福及尼維斯,中南美洲,1,1,0,1,1,0,0,0,0,0,0,0,0,0,0
109,私立,一般大學,1019,高雄醫學大學,學士班(日間),蒙古國,其他亞洲地區,1,1,0,1,1,0,0,0,0,0,0,0,0,0,0
109,私立,一般大學,1019,高雄醫學大學,學士班(日間),諾魯共和國,其他亞洲地區,1,0,1,1,0,1,0,0,0,0,0,0,0,0,0
109,私立,一般大學,1019,高雄醫學大學,碩士班(日間),巴基斯坦,南亞,2,1,1,2,1,1,0,0,0,0,0,0,0,0,0
109,私立,一般大學,1019,高雄醫學大學,碩士班(日間),史瓦帝尼王國,非洲,1,0,1,1,0,1,0,0,0,0,0,0,0,0,0
109,私立,一般大學,1019,高雄醫學大學,碩士班(日間),俄羅斯聯邦,其他亞洲地區,1,1,0,1,1,0,0,0,0,0,0,0,0,0,0
109,私立,一般大學,1019,高雄醫學大學,碩士班(日間),美國,北美洲,1,1,0,1,1,0,0,0,0,0,0,0,0,0,0
109,私立,一般大學,1019,高雄醫學大學,碩士班(日間),巴拉圭,中南美洲,1,0,1,1,0,1,0,0,0,0,0,0,0,0,0
109,私立,一般大學,1019,高雄醫學大學,碩士班(日間),印度尼西亞共和國,東協,3,0,3,2,0,2,1,0,1,0,0,0,0,0,0
109,私立,一般大學,1019,高雄醫學大學,碩士班(日間),宏都拉斯共和國,中南美洲,1,0,1,1,0,1,0,0,0,0,0,0,0,0,0
109,私立,一般大學,1019,高雄醫學大學,碩士班(日間),貝里斯,中南美洲,1,0,1,1,0,1,0,0,0,0,0,0,0,0,0
109,私立,一般大學,1019,高雄醫學大學,碩士班(日間),孟加拉人民共和國,南亞,2,1,1,2,1,1,0,0,0,0,0,0,0,0,0
109,私立,一般大學,1019,高雄醫學大學,碩士班(日間),南非共和國,非洲,1,0,1,0,0,0,1,0,1,0,0,0,0,0,0
109,私立,一般大學,1019,高雄醫學大學,碩士班(日間),香港,港澳,3,1,2,0,0,0,0,0,0,3,1,2,0,0,0
109,私立,一般大學,1019,高雄醫學大學,碩士班(日間),海地共和國,中南美洲,2,1,1,2,1,1,0,0,0,0,0,0,0,0,0
109,私立,一般大學,1019,高雄醫學大學,碩士班(日間),索羅門群島,其他亞洲地區,2,0,2,2,0,2,0,0,0,0,0,0,0,0,0
109,私立,一般大學,1019,高雄醫學大學,碩士班(日間),馬來西亞,東協,6,0,6,0,0,0,6,0,6,0,0,0,0,0,0
109,私立,一般大學,1019,高雄醫學大學,碩士班(日間),越南社會主義共和國,東協,4,0,4,4,0,4,0,0,0,0,0,0,0,0,0
109,私立,一般大學,1019,高雄醫學大學,碩士班(日間),聖文森(及格瑞那丁),中南美洲,1,0,1,1,0,1,0,0,0,0,0,0,0,0,0
109,私立,一般大學,1019,高雄醫學大學,碩士班(日間),聖露西亞,中南美洲,1,1,0,1,1,0,0,0,0,0,0,0,0,0,0
109,私立,一般大學,1019,高雄醫學大學,碩士班(日間),澳門,港澳,5,2,3,0,0,0,0,0,0,5,2,3,0,0,0
109,私立,一般大學,1019,高雄醫學大學,博士班,巴基斯坦,南亞,1,1,0,1,1,0,0,0,0,0,0,0,0,0,0
109,私立,一般大學,1019,高雄醫學大學,博士班,史瓦帝尼王國,非洲,3,2,1,3,2,1,0,0,0,0,0,0,0,0,0
109,私立,一般大學,1019,高雄醫學大學,博士班,泰國,東協,1,0,1,1,0,1,0,0,0,0,0,0,0,0,0
109,私立,一般大學,1019,高雄醫學大學,博士班,越南社會主義共和國,東協,3,1,2,3,1,2,0,0,0,0,0,0,0,0,0
109,私立,一般大學,1019,高雄醫學大學,博士班,蒙古國,其他亞洲地區,1,0,1,1,0,1,0,0,0,0,0,0,0,0,0
109,私立,一般大學,1019,高雄醫學大學,博士班,緬甸,東協,2,1,1,2,1,1,0,0,0,0,0,0,0,0,0
109,私立,一般大學,1019,高雄醫學大學,博士班,澳門,港澳,1,0,1,0,0,0,0,0,0,1,0,1,0,0,0
109,私立,一般大學,1019,高雄醫學大學,博士班,大陸地區,大陸地區,1,0,1,0,0,0,0,0,0,0,0,0,1,0,1
109,私立,一般大學,1019,高雄醫學大學,博士班,匈牙利共和國,歐洲,2,0,2,2,0,2,0,0,0,0,0,0,0,0,0
109,私立,一般大學,1019,高雄醫學大學,博士班,印度,南亞,32,17,15,32,17,15,0,0,0,0,0,0,0,0,0
109,私立,一般大學,1019,高雄醫學大學,博士班,印度尼西亞共和國,東協,13,6,7,13,6,7,0,0,0,0,0,0,0,0,0
109,私立,一般大學,1019,高雄醫學大學,博士班,坦尚尼亞聯合共和國,非洲,1,1,0,1,1,0,0,0,0,0,0,0,0,0,0
109,私立,一般大學,1019,高雄醫學大學,博士班,馬來西亞,東協,4,1,3,1,0,1,3,1,2,0,0,0,0,0,0
109,私立,一般大學,1019,高雄醫學大學,博士班,菲律賓共和國,東協,3,0,3,3,0,3,0,0,0,0,0,0,0,0,0
109,私立,一般大學,1020,南華大學,學士班(日間),大陸地區,大陸地區,1,1,0,0,0,0,0,0,0,0,0,0,1,1,0
109,私立,一般大學,1020,南華大學,學士班(日間),日本,其他亞洲地區,8,6,2,8,6,2,0,0,0,0,0,0,0,0,0
109,私立,一般大學,1020,南華大學,學士班(日間),印度,南亞,11,7,4,11,7,4,0,0,0,0,0,0,0,0,0
109,私立,一般大學,1020,南華大學,學士班(日間),南非共和國,非洲,1,1,0,1,1,0,0,0,0,0,0,0,0,0,0
109,私立,一般大學,1020,南華大學,學士班(日間),柬埔寨王國,東協,19,8,11,19,8,11,0,0,0,0,0,0,0,0,0
109,私立,一般大學,1020,南華大學,學士班(日間),香港,港澳,12,2,10,0,0,0,0,0,0,12,2,10,0,0,0
109,私立,一般大學,1020,南華大學,學士班(日間),斯里蘭卡民主社會主義共和國,南亞,2,1,1,2,1,1,0,0,0,0,0,0,0,0,0
109,私立,一般大學,1020,南華大學,學士班(日間),緬甸,東協,1,1,0,1,1,0,0,0,0,0,0,0,0,0,0
109,私立,一般大學,1020,南華大學,學士班(日間),大韓民國(南韓),其他亞洲地區,1,1,0,1,1,0,0,0,0,0,0,0,0,0,0
109,私立,一般大學,1020,南華大學,學士班(日間),巴西聯邦共和國,中南美洲,20,20,0,20,20,0,0,0,0,0,0,0,0,0,0
109,私立,一般大學,1020,南華大學,學士班(日間),巴基斯坦,南亞,1,1,0,1,1,0,0,0,0,0,0,0,0,0,0
109,私立,一般大學,1020,南華大學,學士班(日間),史瓦帝尼王國,非洲,1,0,1,1,0,1,0,0,0,0,0,0,0,0,0
109,私立,一般大學,1020,南華大學,學士班(日間),尼泊爾聯邦民主共和國,南亞,6,3,3,6,3,3,0,0,0,0,0,0,0,0,0
109,私立,一般大學,1020,南華大學,學士班(日間),印度尼西亞共和國,東協,10,8,2,9,7,2,1,1,0,0,0,0,0,0,0
109,私立,一般大學,1020,南華大學,學士班(日間),吉爾吉斯,其他亞洲地區,5,5,0,5,5,0,0,0,0,0,0,0,0,0,0
109,私立,一般大學,1020,南華大學,學士班(日間),英國,歐洲,1,1,0,1,1,0,0,0,0,0,0,0,0,0,0
109,私立,一般大學,1020,南華大學,學士班(日間),馬來西亞,東協,53,28,25,33,16,17,20,12,8,0,0,0,0,0,0
109,私立,一般大學,1020,南華大學,學士班(日間),越南社會主義共和國,東協,14,8,6,14,8,6,0,0,0,0,0,0,0,0,0
109,私立,一般大學,1020,南華大學,學士班(日間),蒙古國,其他亞洲地區,69,38,31,69,38,31,0,0,0,0,0,0,0,0,0
109,私立,一般大學,1020,南華大學,學士班(日間),澳門,港澳,3,1,2,0,0,0,0,0,0,3,1,2,0,0,0
109,私立,一般大學,1020,南華大學,碩士班(日間),巴西聯邦共和國,中南美洲,1,1,0,1,1,0,0,0,0,0,0,0,0,0,0
109,私立,一般大學,1020,南華大學,碩士班(日間),巴基斯坦,南亞,1,1,0,1,1,0,0,0,0,0,0,0,0,0,0
109,私立,一般大學,1020,南華大學,碩士班(日間),加拿大,北美洲,1,0,1,1,0,1,0,0,0,0,0,0,0,0,0
109,私立,一般大學,1020,南華大學,碩士班(日間),孟加拉人民共和國,南亞,2,2,0,2,2,0,0,0,0,0,0,0,0,0,0
109,私立,一般大學,1020,南華大學,碩士班(日間),香港,港澳,2,1,1,0,0,0,0,0,0,2,1,1,0,0,0
109,私立,一般大學,1020,南華大學,碩士班(日間),馬來西亞,東協,14,7,7,11,5,6,3,2,1,0,0,0,0,0,0
109,私立,一般大學,1020,南華大學,碩士班(日間),菲律賓共和國,東協,14,5,9,14,5,9,0,0,0,0,0,0,0,0,0
109,私立,一般大學,1020,南華大學,碩士班(日間),越南社會主義共和國,東協,17,4,13,17,4,13,0,0,0,0,0,0,0,0,0
109,私立,一般大學,1020,南華大學,碩士班(日間),蒙古國,其他亞洲地區,7,1,6,7,1,6,0,0,0,0,0,0,0,0,0
109,私立,一般大學,1020,南華大學,碩士班(日間),印度,南亞,25,23,2,25,23,2,0,0,0,0,0,0,0,0,0
109,私立,一般大學,1020,南華大學,碩士班(日間),印度尼西亞共和國,東協,2,2,0,2,2,0,0,0,0,0,0,0,0,0,0
109,私立,一般大學,1020,南華大學,碩士班(日間),柬埔寨王國,東協,11,6,5,11,6,5,0,0,0,0,0,0,0,0,0
109,私立,一般大學,1020,南華大學,碩士班(日間),新加坡共和國,東協,1,0,1,1,0,1,0,0,0,0,0,0,0,0,0
109,私立,一般大學,1020,南華大學,博士班,大陸地區,大陸地區,1,0,1,0,0,0,0,0,0,0,0,0,1,0,1
109,私立,一般大學,1020,南華大學,博士班,泰國,東協,1,1,0,1,1,0,0,0,0,0,0,0,0,0,0
109,私立,一般大學,1020,南華大學,博士班,越南社會主義共和國,東協,17,10,7,17,10,7,0,0,0,0,0,0,0,0,0
109,私立,一般大學,1020,南華大學,博士班,印度,南亞,5,5,0,5,5,0,0,0,0,0,0,0,0,0,0
109,私立,一般大學,1020,南華大學,博士班,蒙古國,其他亞洲地區,5,1,4,5,1,4,0,0,0,0,0,0,0,0,0
109,私立,一般大學,1021,真理大學,學士班(日間),馬來西亞,東協,41,26,15,3,1,2,38,25,13,0,0,0,0,0,0
109,私立,一般大學,1021,真理大學,學士班(日間),日本,其他亞洲地區,21,5,16,20,5,15,1,0,1,0,0,0,0,0,0
109,私立,一般大學,1021,真理大學,學士班(日間),香港,港澳,24,13,11,0,0,0,0,0,0,24,13,11,0,0,0
109,私立,一般大學,1021,真理大學,學士班(日間),越南社會主義共和國,東協,28,8,20,25,6,19,3,2,1,0,0,0,0,0,0
109,私立,一般大學,1021,真理大學,學士班(日間),澳門,港澳,3,3,0,0,0,0,0,0,0,3,3,0,0,0,0
109,私立,一般大學,1021,真理大學,碩士班(日間),香港,港澳,2,2,0,0,0,0,0,0,0,2,2,0,0,0,0
109,私立,一般大學,1021,真理大學,碩士班(日間),泰國,東協,1,0,1,1,0,1,0,0,0,0,0,0,0,0,0
109,私立,一般大學,1021,真理大學,碩士班(日間),馬來西亞,東協,2,1,1,0,0,0,2,1,1,0,0,0,0,0,0
109,私立,一般大學,1021,真理大學,碩士班(日間),菲律賓共和國,東協,3,0,3,3,0,3,0,0,0,0,0,0,0,0,0
109,私立,一般大學,1021,真理大學,碩士班(日間),越南社會主義共和國,東協,10,4,6,9,4,5,1,0,1,0,0,0,0,0,0
109,私立,一般大學,1022,大同大學,學士班(日間),大陸地區,大陸地區,23,18,5,0,0,0,0,0,0,0,0,0,23,18,5
109,私立,一般大學,1022,大同大學,學士班(日間),俄羅斯聯邦,其他亞洲地區,1,0,1,1,0,1,0,0,0,0,0,0,0,0,0
109,私立,一般大學,1022,大同大學,學士班(日間),香港,港澳,25,15,10,0,0,0,0,0,0,25,15,10,0,0,0
109,私立,一般大學,1022,大同大學,學士班(日間),海地共和國,中南美洲,1,1,0,1,1,0,0,0,0,0,0,0,0,0,0
109,私立,一般大學,1022,大同大學,學士班(日間),馬來西亞,東協,1,1,0,0,0,0,1,1,0,0,0,0,0,0,0
109,私立,一般大學,1022,大同大學,學士班(日間),菲律賓共和國,東協,1,1,0,0,0,0,1,1,0,0,0,0,0,0,0
109,私立,一般大學,1022,大同大學,學士班(日間),新加坡共和國,東協,1,1,0,0,0,0,1,1,0,0,0,0,0,0,0
109,私立,一般大學,1022,大同大學,學士班(日間),聖文森(及格瑞那丁),中南美洲,1,1,0,1,1,0,0,0,0,0,0,0,0,0,0
109,私立,一般大學,1022,大同大學,學士班(日間),日本,其他亞洲地區,5,2,3,5,2,3,0,0,0,0,0,0,0,0,0
109,私立,一般大學,1022,大同大學,學士班(日間),印度尼西亞共和國,東協,2,0,2,2,0,2,0,0,0,0,0,0,0,0,0
109,私立,一般大學,1022,大同大學,學士班(日間),越南社會主義共和國,東協,2,0,2,2,0,2,0,0,0,0,0,0,0,0,0
109,私立,一般大學,1022,大同大學,學士班(日間),緬甸,東協,1,1,0,0,0,0,1,1,0,0,0,0,0,0,0
109,私立,一般大學,1022,大同大學,學士班(日間),澳門,港澳,6,6,0,0,0,0,0,0,0,6,6,0,0,0,0
109,私立,一般大學,1022,大同大學,碩士班(日間),大陸地區,大陸地區,5,3,2,0,0,0,0,0,0,0,0,0,5,3,2
109,私立,一般大學,1022,大同大學,碩士班(日間),俄羅斯聯邦,其他亞洲地區,1,0,1,1,0,1,0,0,0,0,0,0,0,0,0
109,私立,一般大學,1022,大同大學,碩士班(日間),香港,港澳,1,0,1,0,0,0,0,0,0,1,0,1,0,0,0
109,私立,一般大學,1022,大同大學,碩士班(日間),德意志聯邦共和國,歐洲,2,1,1,2,1,1,0,0,0,0,0,0,0,0,0
109,私立,一般大學,1022,大同大學,博士班,大陸地區,大陸地區,23,14,9,0,0,0,0,0,0,0,0,0,23,14,9
109,私立,技專校院,1023,南臺學校財團法人南臺科技大學,五專,加拿大,北美洲,1,1,0,0,0,0,1,1,0,0,0,0,0,0,0
109,私立,技專校院,1023,南臺學校財團法人南臺科技大學,學士班(日間),大陸地區,大陸地區,28,17,11,0,0,0,0,0,0,0,0,0,28,17,11
109,私立,技專校院,1023,南臺學校財團法人南臺科技大學,學士班(日間),巴拉圭,中南美洲,1,0,1,1,0,1,0,0,0,0,0,0,0,0,0
109,私立,技專校院,1023,南臺學校財團法人南臺科技大學,學士班(日間),日本,其他亞洲地區,2,2,0,2,2,0,0,0,0,0,0,0,0,0,0
109,私立,技專校院,1023,南臺學校財團法人南臺科技大學,學士班(日間),印度,南亞,2,2,0,2,2,0,0,0,0,0,0,0,0,0,0
109,私立,技專校院,1023,南臺學校財團法人南臺科技大學,學士班(日間),克羅埃西亞共和國,歐洲,1,1,0,1,1,0,0,0,0,0,0,0,0,0,0
109,私立,技專校院,1023,南臺學校財團法人南臺科技大學,學士班(日間),宏都拉斯共和國,中南美洲,3,1,2,3,1,2,0,0,0,0,0,0,0,0,0
109,私立,技專校院,1023,南臺學校財團法人南臺科技大學,學士班(日間),香港,港澳,43,32,11,0,0,0,0,0,0,43,32,11,0,0,0
109,私立,技專校院,1023,南臺學校財團法人南臺科技大學,學士班(日間),斯洛伐克共和國,歐洲,2,2,0,2,2,0,0,0,0,0,0,0,0,0,0
109,私立,技專校院,1023,南臺學校財團法人南臺科技大學,學士班(日間),越南社會主義共和國,東協,39,23,16,35,23,12,4,0,4,0,0,0,0,0,0
109,私立,技專校院,1023,南臺學校財團法人南臺科技大學,學士班(日間),葡萄牙共和國,歐洲,1,1,0,0,0,0,1,1,0,0,0,0,0,0,0
109,私立,技專校院,1023,南臺學校財團法人南臺科技大學,學士班(日間),摩洛哥王國,非洲,1,1,0,1,1,0,0,0,0,0,0,0,0,0,0
109,私立,技專校院,1023,南臺學校財團法人南臺科技大學,學士班(日間),澳門,港澳,7,4,3,0,0,0,0,0,0,7,4,3,0,0,0
109,私立,技專校院,1023,南臺學校財團法人南臺科技大學,學士班(日間),巴西聯邦共和國,中南美洲,1,1,0,0,0,0,1,1,0,0,0,0,0,0,0
109,私立,技專校院,1023,南臺學校財團法人南臺科技大學,學士班(日間),史瓦帝尼王國,非洲,8,2,6,8,2,6,0,0,0,0,0,0,0,0,0
109,私立,技專校院,1023,南臺學校財團法人南臺科技大學,學士班(日間),匈牙利共和國,歐洲,1,1,0,1,1,0,0,0,0,0,0,0,0,0,0
109,私立,技專校院,1023,南臺學校財團法人南臺科技大學,學士班(日間),印度尼西亞共和國,東協,14,7,7,9,5,4,5,2,3,0,0,0,0,0,0
109,私立,技專校院,1023,南臺學校財團法人南臺科技大學,學士班(日間),美國,北美洲,1,1,0,1,1,0,0,0,0,0,0,0,0,0,0
109,私立,技專校院,1023,南臺學校財團法人南臺科技大學,學士班(日間),泰國,東協,7,1,6,6,1,5,1,0,1,0,0,0,0,0,0
109,私立,技專校院,1023,南臺學校財團法人南臺科技大學,學士班(日間),馬來西亞,東協,96,55,41,73,45,28,23,10,13,0,0,0,0,0,0
109,私立,技專校院,1023,南臺學校財團法人南臺科技大學,學士班(日間),菲律賓共和國,東協,3,0,3,3,0,3,0,0,0,0,0,0,0,0,0
109,私立,技專校院,1023,南臺學校財團法人南臺科技大學,學士班(日間),聖露西亞,中南美洲,1,1,0,1,1,0,0,0,0,0,0,0,0,0,0
109,私立,技專校院,1023,南臺學校財團法人南臺科技大學,學士班(日間),蒙古國,其他亞洲地區,16,8,8,16,8,8,0,0,0,0,0,0,0,0,0
109,私立,技專校院,1023,南臺學校財團法人南臺科技大學,學士班(日間),薩爾瓦多,中南美洲,3,1,2,3,1,2,0,0,0,0,0,0,0,0,0
109,私立,技專校院,1023,南臺學校財團法人南臺科技大學,碩士班(日間),大韓民國(南韓),其他亞洲地區,2,0,2,2,0,2,0,0,0,0,0,0,0,0,0
109,私立,技專校院,1023,南臺學校財團法人南臺科技大學,碩士班(日間),史瓦帝尼王國,非洲,1,1,0,1,1,0,0,0,0,0,0,0,0,0,0
109,私立,技專校院,1023,南臺學校財團法人南臺科技大學,碩士班(日間),印度尼西亞共和國,東協,1,1,0,1,1,0,0,0,0,0,0,0,0,0,0
109,私立,技專校院,1023,南臺學校財團法人南臺科技大學,碩士班(日間),法國,歐洲,6,1,5,6,1,5,0,0,0,0,0,0,0,0,0
109,私立,技專校院,1023,南臺學校財團法人南臺科技大學,碩士班(日間),約旦哈什米王國,其他亞洲地區,1,1,0,1,1,0,0,0,0,0,0,0,0,0,0
109,私立,技專校院,1023,南臺學校財團法人南臺科技大學,碩士班(日間),美國,北美洲,1,1,0,1,1,0,0,0,0,0,0,0,0,0,0
109,私立,技專校院,1023,南臺學校財團法人南臺科技大學,碩士班(日間),泰國,東協,2,0,2,2,0,2,0,0,0,0,0,0,0,0,0
109,私立,技專校院,1023,南臺學校財團法人南臺科技大學,碩士班(日間),馬來西亞,東協,17,11,6,16,11,5,1,0,1,0,0,0,0,0,0
109,私立,技專校院,1023,南臺學校財團法人南臺科技大學,碩士班(日間),荷蘭王國,歐洲,1,1,0,1,1,0,0,0,0,0,0,0,0,0,0
109,私立,技專校院,1023,南臺學校財團法人南臺科技大學,碩士班(日間),菲律賓共和國,東協,13,7,6,13,7,6,0,0,0,0,0,0,0,0,0
109,私立,技專校院,1023,南臺學校財團法人南臺科技大學,碩士班(日間),越南社會主義共和國,東協,10,6,4,10,6,4,0,0,0,0,0,0,0,0,0
109,私立,技專校院,1023,南臺學校財團法人南臺科技大學,碩士班(日間),奧地利共和國,歐洲,1,1,0,1,1,0,0,0,0,0,0,0,0,0,0
109,私立,技專校院,1023,南臺學校財團法人南臺科技大學,碩士班(日間),聖露西亞,中南美洲,1,1,0,1,1,0,0,0,0,0,0,0,0,0,0
109,私立,技專校院,1023,南臺學校財團法人南臺科技大學,碩士班(日間),蒙古國,其他亞洲地區,6,2,4,6,2,4,0,0,0,0,0,0,0,0,0
109,私立,技專校院,1023,南臺學校財團法人南臺科技大學,碩士班(日間),薩爾瓦多,中南美洲,2,2,0,2,2,0,0,0,0,0,0,0,0,0,0
109,私立,技專校院,1023,南臺學校財團法人南臺科技大學,碩士班(日間),大陸地區,大陸地區,14,9,5,0,0,0,0,0,0,0,0,0,14,9,5
109,私立,技專校院,1023,南臺學校財團法人南臺科技大學,碩士班(日間),巴拿馬共和國,中南美洲,1,1,0,1,1,0,0,0,0,0,0,0,0,0,0
109,私立,技專校院,1023,南臺學校財團法人南臺科技大學,碩士班(日間),甘比亞共和國,非洲,1,1,0,1,1,0,0,0,0,0,0,0,0,0,0
109,私立,技專校院,1023,南臺學校財團法人南臺科技大學,碩士班(日間),印度,南亞,4,2,2,4,2,2,0,0,0,0,0,0,0,0,0
109,私立,技專校院,1023,南臺學校財團法人南臺科技大學,碩士班(日間),克羅埃西亞共和國,歐洲,1,1,0,1,1,0,0,0,0,0,0,0,0,0,0
109,私立,技專校院,1023,南臺學校財團法人南臺科技大學,碩士班(日間),宏都拉斯共和國,中南美洲,1,1,0,1,1,0,0,0,0,0,0,0,0,0,0
109,私立,技專校院,1023,南臺學校財團法人南臺科技大學,碩士班(日間),貝里斯,中南美洲,1,0,1,1,0,1,0,0,0,0,0,0,0,0,0
109,私立,技專校院,1023,南臺學校財團法人南臺科技大學,碩士班(日間),香港,港澳,4,2,2,0,0,0,0,0,0,4,2,2,0,0,0
109,私立,技專校院,1023,南臺學校財團法人南臺科技大學,碩士班(日間),海地共和國,中南美洲,2,2,0,2,2,0,0,0,0,0,0,0,0,0,0
109,私立,技專校院,1023,南臺學校財團法人南臺科技大學,碩士班(日間),秘魯共和國,中南美洲,1,1,0,1,1,0,0,0,0,0,0,0,0,0,0
109,私立,技專校院,1023,南臺學校財團法人南臺科技大學,碩士班(日間),摩洛哥王國,非洲,1,1,0,1,1,0,0,0,0,0,0,0,0,0,0
109,私立,技專校院,1023,南臺學校財團法人南臺科技大學,博士班,克羅埃西亞共和國,歐洲,2,2,0,2,2,0,0,0,0,0,0,0,0,0,0
109,私立,技專校院,1023,南臺學校財團法人南臺科技大學,博士班,法國,歐洲,2,0,2,2,0,2,0,0,0,0,0,0,0,0,0
109,私立,技專校院,1023,南臺學校財團法人南臺科技大學,博士班,美國,北美洲,1,1,0,1,1,0,0,0,0,0,0,0,0,0,0
109,私立,技專校院,1023,南臺學校財團法人南臺科技大學,博士班,埃及阿拉伯共和國,非洲,1,1,0,1,1,0,0,0,0,0,0,0,0,0,0
109,私立,技專校院,1023,南臺學校財團法人南臺科技大學,博士班,泰國,東協,2,1,1,2,1,1,0,0,0,0,0,0,0,0,0
109,私立,技專校院,1023,南臺學校財團法人南臺科技大學,博士班,越南社會主義共和國,東協,17,8,9,17,8,9,0,0,0,0,0,0,0,0,0
109,私立,技專校院,1023,南臺學校財團法人南臺科技大學,博士班,墨西哥合眾國,中南美洲,1,1,0,1,1,0,0,0,0,0,0,0,0,0,0
109,私立,技專校院,1023,南臺學校財團法人南臺科技大學,博士班,大陸地區,大陸地區,1,1,0,0,0,0,0,0,0,0,0,0,1,1,0
109,私立,技專校院,1023,南臺學校財團法人南臺科技大學,博士班,丹麥王國,歐洲,1,1,0,1,1,0,0,0,0,0,0,0,0,0,0
109,私立,技專校院,1023,南臺學校財團法人南臺科技大學,博士班,印度,南亞,6,5,1,6,5,1,0,0,0,0,0,0,0,0,0
109,私立,技專校院,1023,南臺學校財團法人南臺科技大學,博士班,印度尼西亞共和國,東協,17,13,4,17,13,4,0,0,0,0,0,0,0,0,0
109,私立,技專校院,1023,南臺學校財團法人南臺科技大學,博士班,南非共和國,非洲,1,0,1,1,0,1,0,0,0,0,0,0,0,0,0
109,私立,技專校院,1023,南臺學校財團法人南臺科技大學,博士班,約旦哈什米王國,其他亞洲地區,1,1,0,1,1,0,0,0,0,0,0,0,0,0,0
109,私立,技專校院,1023,南臺學校財團法人南臺科技大學,博士班,秘魯共和國,中南美洲,1,1,0,1,1,0,0,0,0,0,0,0,0,0,0
109,私立,技專校院,1023,南臺學校財團法人南臺科技大學,博士班,菲律賓共和國,東協,4,1,3,4,1,3,0,0,0,0,0,0,0,0,0
109,私立,技專校院,1024,崑山科技大學,學士班(日間),巴拉圭,中南美洲,1,1,0,1,1,0,0,0,0,0,0,0,0,0,0
109,私立,技專校院,1024,崑山科技大學,學士班(日間),史瓦帝尼王國,非洲,19,13,6,19,13,6,0,0,0,0,0,0,0,0,0
109,私立,技專校院,1024,崑山科技大學,學士班(日間),尼加拉瓜,中南美洲,3,0,3,3,0,3,0,0,0,0,0,0,0,0,0
109,私立,技專校院,1024,崑山科技大學,學士班(日間),瓜地馬拉共和國,中南美洲,3,3,0,3,3,0,0,0,0,0,0,0,0,0,0
109,私立,技專校院,1024,崑山科技大學,學士班(日間),印度尼西亞共和國,東協,22,13,9,19,13,6,3,0,3,0,0,0,0,0,0
109,私立,技專校院,1024,崑山科技大學,學士班(日間),泰國,東協,1,1,0,0,0,0,1,1,0,0,0,0,0,0,0
109,私立,技專校院,1024,崑山科技大學,學士班(日間),海地共和國,中南美洲,3,3,0,3,3,0,0,0,0,0,0,0,0,0,0
109,私立,技專校院,1024,崑山科技大學,學士班(日間),菲律賓共和國,東協,160,77,83,160,77,83,0,0,0,0,0,0,0,0,0
109,私立,技專校院,1024,崑山科技大學,學士班(日間),越南社會主義共和國,東協,170,79,91,132,57,75,38,22,16,0,0,0,0,0,0
109,私立,技專校院,1024,崑山科技大學,學士班(日間),澳門,港澳,1,0,1,0,0,0,0,0,0,1,0,1,0,0,0
109,私立,技專校院,1024,崑山科技大學,學士班(日間),大陸地區,大陸地區,15,7,8,0,0,0,0,0,0,0,0,0,15,7,8
109,私立,技專校院,1024,崑山科技大學,學士班(日間),大韓民國(南韓),其他亞洲地區,12,8,4,12,8,4,0,0,0,0,0,0,0,0,0
109,私立,技專校院,1024,崑山科技大學,學士班(日間),巴基斯坦,南亞,1,1,0,1,1,0,0,0,0,0,0,0,0,0,0
109,私立,技專校院,1024,崑山科技大學,學士班(日間),日本,其他亞洲地區,21,6,15,21,6,15,0,0,0,0,0,0,0,0,0
109,私立,技專校院,1024,崑山科技大學,學士班(日間),宏都拉斯共和國,中南美洲,11,10,1,11,10,1,0,0,0,0,0,0,0,0,0
109,私立,技專校院,1024,崑山科技大學,學士班(日間),貝里斯,中南美洲,16,11,5,16,11,5,0,0,0,0,0,0,0,0,0
109,私立,技專校院,1024,崑山科技大學,學士班(日間),帛琉共和國,其他亞洲地區,1,1,0,1,1,0,0,0,0,0,0,0,0,0,0
109,私立,技專校院,1024,崑山科技大學,學士班(日間),南非共和國,非洲,1,0,1,1,0,1,0,0,0,0,0,0,0,0,0
109,私立,技專校院,1024,崑山科技大學,學士班(日間),香港,港澳,10,6,4,0,0,0,0,0,0,10,6,4,0,0,0
109,私立,技專校院,1024,崑山科技大學,學士班(日間),哥斯大黎加共和國,中南美洲,1,1,0,1,1,0,0,0,0,0,0,0,0,0,0
109,私立,技專校院,1024,崑山科技大學,學士班(日間),秘魯共和國,中南美洲,2,1,1,2,1,1,0,0,0,0,0,0,0,0,0
109,私立,技專校院,1024,崑山科技大學,學士班(日間),馬來西亞,東協,31,23,8,20,12,8,11,11,0,0,0,0,0,0,0
109,私立,技專校院,1024,崑山科技大學,學士班(日間),聖文森(及格瑞那丁),中南美洲,4,3,1,4,3,1,0,0,0,0,0,0,0,0,0
109,私立,技專校院,1024,崑山科技大學,學士班(日間),聖克里斯多福及尼維斯,中南美洲,4,4,0,4,4,0,0,0,0,0,0,0,0,0,0
109,私立,技專校院,1024,崑山科技大學,學士班(日間),聖露西亞,中南美洲,6,5,1,6,5,1,0,0,0,0,0,0,0,0,0
109,私立,技專校院,1024,崑山科技大學,學士班(日間),蒙古國,其他亞洲地區,1,0,1,1,0,1,0,0,0,0,0,0,0,0,0
109,私立,技專校院,1024,崑山科技大學,學士班(日間),諾魯共和國,其他亞洲地區,2,2,0,2,2,0,0,0,0,0,0,0,0,0,0
109,私立,技專校院,1024,崑山科技大學,學士班(日間),薩爾瓦多,中南美洲,1,1,0,1,1,0,0,0,0,0,0,0,0,0,0
109,私立,技專校院,1024,崑山科技大學,碩士班(日間),大陸地區,大陸地區,5,3,2,0,0,0,0,0,0,0,0,0,5,3,2
109,私立,技專校院,1024,崑山科技大學,碩士班(日間),巴拿馬共和國,中南美洲,1,1,0,1,1,0,0,0,0,0,0,0,0,0,0
109,私立,技專校院,1024,崑山科技大學,碩士班(日間),印度,南亞,1,1,0,1,1,0,0,0,0,0,0,0,0,0,0
109,私立,技專校院,1024,崑山科技大學,碩士班(日間),香港,港澳,3,1,2,0,0,0,0,0,0,3,1,2,0,0,0
109,私立,技專校院,1024,崑山科技大學,碩士班(日間),聖露西亞,中南美洲,1,1,0,1,1,0,0,0,0,0,0,0,0,0,0
109,私立,技專校院,1024,崑山科技大學,碩士班(日間),土耳其共和國,其他亞洲地區,1,1,0,1,1,0,0,0,0,0,0,0,0,0,0
109,私立,技專校院,1024,崑山科技大學,碩士班(日間),貝里斯,中南美洲,2,2,0,2,2,0,0,0,0,0,0,0,0,0,0
109,私立,技專校院,1024,崑山科技大學,碩士班(日間),智利,中南美洲,1,0,1,1,0,1,0,0,0,0,0,0,0,0,0
109,私立,技專校院,1024,崑山科技大學,碩士班(日間),越南社會主義共和國,東協,1,0,1,1,0,1,0,0,0,0,0,0,0,0,0
109,私立,技專校院,1024,崑山科技大學,碩士班(日間),澳門,港澳,1,0,1,0,0,0,0,0,0,1,0,1,0,0,0
109,私立,技專校院,1024,崑山科技大學,博士班,大陸地區,大陸地區,1,0,1,0,0,0,0,0,0,0,0,0,1,0,1
109,私立,技專校院,1024,崑山科技大學,博士班,貝里斯,中南美洲,2,1,1,2,1,1,0,0,0,0,0,0,0,0,0
109,私立,技專校院,1024,崑山科技大學,博士班,印度尼西亞共和國,東協,1,1,0,1,1,0,0,0,0,0,0,0,0,0,0
109,私立,技專校院,1025,嘉藥學校財團法人嘉南藥理大學,學士班(日間),大韓民國(南韓),其他亞洲地區,2,2,0,0,0,0,2,2,0,0,0,0,0,0,0
109,私立,技專校院,1025,嘉藥學校財團法人嘉南藥理大學,學士班(日間),巴西聯邦共和國,中南美洲,2,1,1,0,0,0,2,1,1,0,0,0,0,0,0
109,私立,技專校院,1025,嘉藥學校財團法人嘉南藥理大學,學士班(日間),美國,北美洲,1,1,0,0,0,0,1,1,0,0,0,0,0,0,0
109,私立,技專校院,1025,嘉藥學校財團法人嘉南藥理大學,學士班(日間),香港,港澳,39,23,16,0,0,0,0,0,0,39,23,16,0,0,0
109,私立,技專校院,1025,嘉藥學校財團法人嘉南藥理大學,學士班(日間),澳門,港澳,3,3,0,0,0,0,0,0,0,3,3,0,0,0,0
109,私立,技專校院,1025,嘉藥學校財團法人嘉南藥理大學,學士班(日間),日本,其他亞洲地區,5,1,4,5,1,4,0,0,0,0,0,0,0,0,0
109,私立,技專校院,1025,嘉藥學校財團法人嘉南藥理大學,學士班(日間),印度尼西亞共和國,東協,78,74,4,78,74,4,0,0,0,0,0,0,0,0,0
109,私立,技專校院,1025,嘉藥學校財團法人嘉南藥理大學,學士班(日間),馬來西亞,東協,7,2,5,2,0,2,5,2,3,0,0,0,0,0,0
109,私立,技專校院,1025,嘉藥學校財團法人嘉南藥理大學,碩士班(日間),泰國,東協,3,2,1,3,2,1,0,0,0,0,0,0,0,0,0
109,私立,技專校院,1025,嘉藥學校財團法人嘉南藥理大學,碩士班(日間),馬來西亞,東協,1,1,0,0,0,0,1,1,0,0,0,0,0,0,0
109,私立,技專校院,1025,嘉藥學校財團法人嘉南藥理大學,碩士班(日間),越南社會主義共和國,東協,1,0,1,1,0,1,0,0,0,0,0,0,0,0,0
109,私立,技專校院,1026,樹德科技大學,學士班(日間),日本,其他亞洲地區,50,22,28,49,22,27,1,0,1,0,0,0,0,0,0
109,私立,技專校院,1026,樹德科技大學,學士班(日間),印度尼西亞共和國,東協,90,41,49,76,38,38,14,3,11,0,0,0,0,0,0
109,私立,技專校院,1026,樹德科技大學,學士班(日間),緬甸,東協,10,4,6,0,0,0,10,4,6,0,0,0,0,0,0
109,私立,技專校院,1026,樹德科技大學,學士班(日間),澳門,港澳,5,2,3,0,0,0,0,0,0,5,2,3,0,0,0
109,私立,技專校院,1026,樹德科技大學,學士班(日間),大陸地區,大陸地區,55,23,32,0,0,0,0,0,0,0,0,0,55,23,32
109,私立,技專校院,1026,樹德科技大學,學士班(日間),大韓民國(南韓),其他亞洲地區,2,1,1,2,1,1,0,0,0,0,0,0,0,0,0
109,私立,技專校院,1026,樹德科技大學,學士班(日間),印度,南亞,1,0,1,1,0,1,0,0,0,0,0,0,0,0,0
109,私立,技專校院,1026,樹德科技大學,學士班(日間),香港,港澳,121,62,59,0,0,0,0,0,0,121,62,59,0,0,0
109,私立,技專校院,1026,樹德科技大學,學士班(日間),馬來西亞,東協,148,67,81,51,26,25,97,41,56,0,0,0,0,0,0
109,私立,技專校院,1026,樹德科技大學,學士班(日間),菲律賓共和國,東協,2,1,1,2,1,1,0,0,0,0,0,0,0,0,0
109,私立,技專校院,1026,樹德科技大學,學士班(日間),越南社會主義共和國,東協,25,6,19,10,2,8,15,4,11,0,0,0,0,0,0
109,私立,技專校院,1026,樹德科技大學,學士班(日間),蒙古國,其他亞洲地區,1,0,1,1,0,1,0,0,0,0,0,0,0,0,0
109,私立,技專校院,1026,樹德科技大學,碩士班(日間),大陸地區,大陸地區,17,12,5,0,0,0,0,0,0,0,0,0,17,12,5
109,私立,技專校院,1026,樹德科技大學,碩士班(日間),香港,港澳,2,1,1,0,0,0,0,0,0,2,1,1,0,0,0
109,私立,技專校院,1026,樹德科技大學,碩士班(日間),馬來西亞,東協,6,4,2,5,3,2,1,1,0,0,0,0,0,0,0
109,私立,技專校院,1026,樹德科技大學,碩士班(日間),菲律賓共和國,東協,1,1,0,1,1,0,0,0,0,0,0,0,0,0,0
109,私立,技專校院,1026,樹德科技大學,碩士班(日間),越南社會主義共和國,東協,7,4,3,7,4,3,0,0,0,0,0,0,0,0,0
109,私立,技專校院,1026,樹德科技大學,碩士班(日間),印度尼西亞共和國,東協,1,0,1,1,0,1,0,0,0,0,0,0,0,0,0
109,私立,技專校院,1026,樹德科技大學,博士班,馬來西亞,東協,1,1,0,1,1,0,0,0,0,0,0,0,0,0,0
109,私立,技專校院,1026,樹德科技大學,博士班,越南社會主義共和國,東協,1,1,0,1,1,0,0,0,0,0,0,0,0,0,0
109,私立,技專校院,1026,樹德科技大學,博士班,墨西哥合眾國,中南美洲,1,0,1,1,0,1,0,0,0,0,0,0,0,0,0
109,私立,一般大學,1027,慈濟學校財團法人慈濟大學,學士班(日間),大陸地區,大陸地區,8,2,6,0,0,0,0,0,0,0,0,0,8,2,6
109,私立,一般大學,1027,慈濟學校財團法人慈濟大學,學士班(日間),大韓民國(南韓),其他亞洲地區,13,7,6,12,6,6,1,1,0,0,0,0,0,0,0
109,私立,一般大學,1027,慈濟學校財團法人慈濟大學,學士班(日間),南非共和國,非洲,2,0,2,2,0,2,0,0,0,0,0,0,0,0,0
109,私立,一般大學,1027,慈濟學校財團法人慈濟大學,學士班(日間),英國,歐洲,1,1,0,1,1,0,0,0,0,0,0,0,0,0,0
109,私立,一般大學,1027,慈濟學校財團法人慈濟大學,學士班(日間),香港,港澳,6,4,2,0,0,0,0,0,0,6,4,2,0,0,0
109,私立,一般大學,1027,慈濟學校財團法人慈濟大學,學士班(日間),馬來西亞,東協,128,44,84,96,31,65,32,13,19,0,0,0,0,0,0
109,私立,一般大學,1027,慈濟學校財團法人慈濟大學,學士班(日間),菲律賓共和國,東協,1,0,1,1,0,1,0,0,0,0,0,0,0,0,0
109,私立,一般大學,1027,慈濟學校財團法人慈濟大學,學士班(日間),新加坡共和國,東協,2,0,2,1,0,1,1,0,1,0,0,0,0,0,0
109,私立,一般大學,1027,慈濟學校財團法人慈濟大學,學士班(日間),緬甸,東協,1,0,1,1,0,1,0,0,0,0,0,0,0,0,0
109,私立,一般大學,1027,慈濟學校財團法人慈濟大學,學士班(日間),澳大利亞,其他亞洲地區,1,1,0,0,0,0,1,1,0,0,0,0,0,0,0
109,私立,一般大學,1027,慈濟學校財團法人慈濟大學,學士班(日間),加拿大,北美洲,2,1,1,0,0,0,2,1,1,0,0,0,0,0,0
109,私立,一般大學,1027,慈濟學校財團法人慈濟大學,學士班(日間),史瓦帝尼王國,非洲,1,0,1,1,0,1,0,0,0,0,0,0,0,0,0
109,私立,一般大學,1027,慈濟學校財團法人慈濟大學,學士班(日間),印度尼西亞共和國,東協,39,11,28,32,10,22,7,1,6,0,0,0,0,0,0
109,私立,一般大學,1027,慈濟學校財團法人慈濟大學,學士班(日間),法國,歐洲,1,1,0,1,1,0,0,0,0,0,0,0,0,0,0
109,私立,一般大學,1027,慈濟學校財團法人慈濟大學,學士班(日間),柬埔寨王國,東協,1,1,0,1,1,0,0,0,0,0,0,0,0,0,0
109,私立,一般大學,1027,慈濟學校財團法人慈濟大學,學士班(日間),美國,北美洲,3,2,1,1,0,1,2,2,0,0,0,0,0,0,0
109,私立,一般大學,1027,慈濟學校財團法人慈濟大學,學士班(日間),泰國,東協,3,2,1,3,2,1,0,0,0,0,0,0,0,0,0
109,私立,一般大學,1027,慈濟學校財團法人慈濟大學,學士班(日間),越南社會主義共和國,東協,3,1,2,3,1,2,0,0,0,0,0,0,0,0,0
109,私立,一般大學,1027,慈濟學校財團法人慈濟大學,學士班(日間),瑞典王國,歐洲,1,1,0,1,1,0,0,0,0,0,0,0,0,0,0
109,私立,一般大學,1027,慈濟學校財團法人慈濟大學,學士班(日間),澳門,港澳,5,4,1,0,0,0,0,0,0,5,4,1,0,0,0
109,私立,一般大學,1027,慈濟學校財團法人慈濟大學,碩士班(日間),大陸地區,大陸地區,1,0,1,0,0,0,0,0,0,0,0,0,1,0,1
109,私立,一般大學,1027,慈濟學校財團法人慈濟大學,碩士班(日間),印度尼西亞共和國,東協,5,4,1,5,4,1,0,0,0,0,0,0,0,0,0
109,私立,一般大學,1027,慈濟學校財團法人慈濟大學,碩士班(日間),南非共和國,非洲,2,0,2,2,0,2,0,0,0,0,0,0,0,0,0
109,私立,一般大學,1027,慈濟學校財團法人慈濟大學,碩士班(日間),泰國,東協,2,1,1,2,1,1,0,0,0,0,0,0,0,0,0
109,私立,一般大學,1027,慈濟學校財團法人慈濟大學,碩士班(日間),越南社會主義共和國,東協,3,1,2,3,1,2,0,0,0,0,0,0,0,0,0
109,私立,一般大學,1027,慈濟學校財團法人慈濟大學,碩士班(日間),澳門,港澳,4,2,2,0,0,0,0,0,0,4,2,2,0,0,0
109,私立,一般大學,1027,慈濟學校財團法人慈濟大學,碩士班(日間),日本,其他亞洲地區,1,1,0,1,1,0,0,0,0,0,0,0,0,0,0
109,私立,一般大學,1027,慈濟學校財團法人慈濟大學,碩士班(日間),印度,南亞,8,3,5,8,3,5,0,0,0,0,0,0,0,0,0
109,私立,一般大學,1027,慈濟學校財團法人慈濟大學,碩士班(日間),孟加拉人民共和國,南亞,1,0,1,1,0,1,0,0,0,0,0,0,0,0,0
109,私立,一般大學,1027,慈濟學校財團法人慈濟大學,碩士班(日間),美國,北美洲,1,1,0,0,0,0,1,1,0,0,0,0,0,0,0
109,私立,一般大學,1027,慈濟學校財團法人慈濟大學,碩士班(日間),香港,港澳,1,0,1,0,0,0,0,0,0,1,0,1,0,0,0
109,私立,一般大學,1027,慈濟學校財團法人慈濟大學,碩士班(日間),馬來西亞,東協,10,4,6,9,3,6,1,1,0,0,0,0,0,0,0
109,私立,一般大學,1027,慈濟學校財團法人慈濟大學,碩士班(日間),馬拉威共和國,非洲,1,0,1,1,0,1,0,0,0,0,0,0,0,0,0
109,私立,一般大學,1027,慈濟學校財團法人慈濟大學,碩士班(日間),菲律賓共和國,東協,1,0,1,1,0,1,0,0,0,0,0,0,0,0,0
109,私立,一般大學,1027,慈濟學校財團法人慈濟大學,碩士班(日間),蒙古國,其他亞洲地區,3,0,3,3,0,3,0,0,0,0,0,0,0,0,0
109,私立,一般大學,1027,慈濟學校財團法人慈濟大學,博士班,印度,南亞,8,3,5,8,3,5,0,0,0,0,0,0,0,0,0
109,私立,一般大學,1027,慈濟學校財團法人慈濟大學,博士班,印度尼西亞共和國,東協,2,0,2,2,0,2,0,0,0,0,0,0,0,0,0
109,私立,一般大學,1027,慈濟學校財團法人慈濟大學,博士班,馬來西亞,東協,3,2,1,1,0,1,2,2,0,0,0,0,0,0,0
109,私立,一般大學,1027,慈濟學校財團法人慈濟大學,博士班,尼泊爾聯邦民主共和國,南亞,2,2,0,2,2,0,0,0,0,0,0,0,0,0,0
109,私立,一般大學,1027,慈濟學校財團法人慈濟大學,博士班,奈及利亞聯邦共和國,非洲,1,1,0,1,1,0,0,0,0,0,0,0,0,0,0
109,私立,一般大學,1027,慈濟學校財團法人慈濟大學,博士班,孟加拉人民共和國,南亞,1,1,0,1,1,0,0,0,0,0,0,0,0,0,0
109,私立,一般大學,1027,慈濟學校財團法人慈濟大學,博士班,香港,港澳,1,1,0,0,0,0,0,0,0,1,1,0,0,0,0
109,私立,一般大學,1027,慈濟學校財團法人慈濟大學,博士班,泰國,東協,3,1,2,3,1,2,0,0,0,0,0,0,0,0,0
109,私立,一般大學,1027,慈濟學校財團法人慈濟大學,博士班,越南社會主義共和國,東協,2,2,0,2,2,0,0,0,0,0,0,0,0,0,0
109,私立,一般大學,1027,慈濟學校財團法人慈濟大學,博士班,緬甸,東協,1,0,1,1,0,1,0,0,0,0,0,0,0,0,0
109,私立,一般大學,1028,臺北醫學大學,學士班(日間),日本,其他亞洲地區,3,2,1,3,2,1,0,0,0,0,0,0,0,0,0
109,私立,一般大學,1028,臺北醫學大學,學士班(日間),加拿大,北美洲,11,7,4,0,0,0,11,7,4,0,0,0,0,0,0
109,私立,一般大學,1028,臺北醫學大學,學士班(日間),印度尼西亞共和國,東協,15,5,10,0,0,0,15,5,10,0,0,0,0,0,0
109,私立,一般大學,1028,臺北醫學大學,學士班(日間),馬來西亞,東協,112,26,86,8,1,7,104,25,79,0,0,0,0,0,0
109,私立,一般大學,1028,臺北醫學大學,學士班(日間),新加坡共和國,東協,7,1,6,0,0,0,7,1,6,0,0,0,0,0,0
109,私立,一般大學,1028,臺北醫學大學,學士班(日間),葡萄牙共和國,歐洲,1,0,1,1,0,1,0,0,0,0,0,0,0,0,0
109,私立,一般大學,1028,臺北醫學大學,學士班(日間),大陸地區,大陸地區,21,7,14,0,0,0,0,0,0,0,0,0,21,7,14
109,私立,一般大學,1028,臺北醫學大學,學士班(日間),大韓民國(南韓),其他亞洲地區,14,5,9,2,0,2,12,5,7,0,0,0,0,0,0
109,私立,一般大學,1028,臺北醫學大學,學士班(日間),伊朗伊斯蘭共和國,其他亞洲地區,1,0,1,0,0,0,1,0,1,0,0,0,0,0,0
109,私立,一般大學,1028,臺北醫學大學,學士班(日間),美國,北美洲,14,9,5,7,3,4,7,6,1,0,0,0,0,0,0
109,私立,一般大學,1028,臺北醫學大學,學士班(日間),香港,港澳,38,19,19,0,0,0,0,0,0,38,19,19,0,0,0
109,私立,一般大學,1028,臺北醫學大學,學士班(日間),泰國,東協,2,1,1,0,0,0,2,1,1,0,0,0,0,0,0
109,私立,一般大學,1028,臺北醫學大學,學士班(日間),紐西蘭,其他亞洲地區,1,1,0,0,0,0,1,1,0,0,0,0,0,0,0
109,私立,一般大學,1028,臺北醫學大學,學士班(日間),越南社會主義共和國,東協,6,3,3,0,0,0,6,3,3,0,0,0,0,0,0
109,私立,一般大學,1028,臺北醫學大學,學士班(日間),澳門,港澳,26,12,14,0,0,0,0,0,0,26,12,14,0,0,0
109,私立,一般大學,1028,臺北醫學大學,碩士班(日間),大陸地區,大陸地區,2,2,0,0,0,0,0,0,0,0,0,0,2,2,0
109,私立,一般大學,1028,臺北醫學大學,碩士班(日間),厄瓜多共和國,中南美洲,1,0,1,1,0,1,0,0,0,0,0,0,0,0,0
109,私立,一般大學,1028,臺北醫學大學,碩士班(日間),巴拉圭,中南美洲,1,0,1,1,0,1,0,0,0,0,0,0,0,0,0
109,私立,一般大學,1028,臺北醫學大學,碩士班(日間),史瓦帝尼王國,非洲,2,1,1,2,1,1,0,0,0,0,0,0,0,0,0
109,私立,一般大學,1028,臺北醫學大學,碩士班(日間),尼加拉瓜,中南美洲,1,1,0,1,1,0,0,0,0,0,0,0,0,0,0
109,私立,一般大學,1028,臺北醫學大學,碩士班(日間),瓜地馬拉共和國,中南美洲,2,1,1,2,1,1,0,0,0,0,0,0,0,0,0
109,私立,一般大學,1028,臺北醫學大學,碩士班(日間),甘比亞共和國,非洲,2,2,0,2,2,0,0,0,0,0,0,0,0,0,0
109,私立,一般大學,1028,臺北醫學大學,碩士班(日間),宏都拉斯共和國,中南美洲,2,1,1,2,1,1,0,0,0,0,0,0,0,0,0
109,私立,一般大學,1028,臺北醫學大學,碩士班(日間),奈及利亞聯邦共和國,非洲,1,1,0,1,1,0,0,0,0,0,0,0,0,0,0
109,私立,一般大學,1028,臺北醫學大學,碩士班(日間),美國,北美洲,6,3,3,5,3,2,1,0,1,0,0,0,0,0,0
109,私立,一般大學,1028,臺北醫學大學,碩士班(日間),香港,港澳,8,4,4,0,0,0,0,0,0,8,4,4,0,0,0
109,私立,一般大學,1028,臺北醫學大學,碩士班(日間),泰國,東協,6,2,4,6,2,4,0,0,0,0,0,0,0,0,0
109,私立,一般大學,1028,臺北醫學大學,碩士班(日間),海地共和國,中南美洲,2,1,1,2,1,1,0,0,0,0,0,0,0,0,0
109,私立,一般大學,1028,臺北醫學大學,碩士班(日間),馬拉威共和國,非洲,2,0,2,2,0,2,0,0,0,0,0,0,0,0,0
109,私立,一般大學,1028,臺北醫學大學,碩士班(日間),馬紹爾群島共和國,其他亞洲地區,2,0,2,2,0,2,0,0,0,0,0,0,0,0,0
109,私立,一般大學,1028,臺北醫學大學,碩士班(日間),智利,中南美洲,1,0,1,1,0,1,0,0,0,0,0,0,0,0,0
109,私立,一般大學,1028,臺北醫學大學,碩士班(日間),越南社會主義共和國,東協,26,9,17,26,9,17,0,0,0,0,0,0,0,0,0
109,私立,一般大學,1028,臺北醫學大學,碩士班(日間),聖露西亞,中南美洲,2,1,1,2,1,1,0,0,0,0,0,0,0,0,0
109,私立,一般大學,1028,臺北醫學大學,碩士班(日間),蒙古國,其他亞洲地區,3,0,3,3,0,3,0,0,0,0,0,0,0,0,0
109,私立,一般大學,1028,臺北醫學大學,碩士班(日間),緬甸,東協,2,1,1,2,1,1,0,0,0,0,0,0,0,0,0
109,私立,一般大學,1028,臺北醫學大學,碩士班(日間),澳大利亞,其他亞洲地區,1,1,0,1,1,0,0,0,0,0,0,0,0,0,0
109,私立,一般大學,1028,臺北醫學大學,碩士班(日間),澳門,港澳,3,2,1,0,0,0,0,0,0,3,2,1,0,0,0
109,私立,一般大學,1028,臺北醫學大學,碩士班(日間),印度,南亞,1,0,1,1,0,1,0,0,0,0,0,0,0,0,0
109,私立,一般大學,1028,臺北醫學大學,碩士班(日間),印度尼西亞共和國,東協,21,6,15,21,6,15,0,0,0,0,0,0,0,0,0
109,私立,一般大學,1028,臺北醫學大學,碩士班(日間),俄羅斯聯邦,其他亞洲地區,1,1,0,1,1,0,0,0,0,0,0,0,0,0,0
109,私立,一般大學,1028,臺北醫學大學,碩士班(日間),英國,歐洲,1,0,1,1,0,1,0,0,0,0,0,0,0,0,0
109,私立,一般大學,1028,臺北醫學大學,碩士班(日間),馬來西亞,東協,6,2,4,2,0,2,4,2,2,0,0,0,0,0,0
109,私立,一般大學,1028,臺北醫學大學,碩士班(日間),菲律賓共和國,東協,1,1,0,1,1,0,0,0,0,0,0,0,0,0,0
109,私立,一般大學,1028,臺北醫學大學,碩士班(日間),愛沙尼亞共和國,歐洲,1,0,1,1,0,1,0,0,0,0,0,0,0,0,0
109,私立,一般大學,1028,臺北醫學大學,碩士班(日間),新加坡共和國,東協,1,1,0,0,0,0,1,1,0,0,0,0,0,0,0
109,私立,一般大學,1028,臺北醫學大學,碩士班(日間),聖文森(及格瑞那丁),中南美洲,2,0,2,2,0,2,0,0,0,0,0,0,0,0,0
109,私立,一般大學,1028,臺北醫學大學,博士班,大陸地區,大陸地區,2,2,0,0,0,0,0,0,0,0,0,0,2,2,0
109,私立,一般大學,1028,臺北醫學大學,博士班,大韓民國(南韓),其他亞洲地區,1,0,1,1,0,1,0,0,0,0,0,0,0,0,0
109,私立,一般大學,1028,臺北醫學大學,博士班,加拿大,北美洲,1,1,0,1,1,0,0,0,0,0,0,0,0,0,0
109,私立,一般大學,1028,臺北醫學大學,博士班,瓜地馬拉共和國,中南美洲,1,1,0,1,1,0,0,0,0,0,0,0,0,0,0
109,私立,一般大學,1028,臺北醫學大學,博士班,印度,南亞,26,14,12,26,14,12,0,0,0,0,0,0,0,0,0
109,私立,一般大學,1028,臺北醫學大學,博士班,印度尼西亞共和國,東協,80,41,39,80,41,39,0,0,0,0,0,0,0,0,0
109,私立,一般大學,1028,臺北醫學大學,博士班,宏都拉斯共和國,中南美洲,1,1,0,1,1,0,0,0,0,0,0,0,0,0,0
109,私立,一般大學,1028,臺北醫學大學,博士班,貝里斯,中南美洲,2,0,2,2,0,2,0,0,0,0,0,0,0,0,0
109,私立,一般大學,1028,臺北醫學大學,博士班,孟加拉人民共和國,南亞,3,2,1,3,2,1,0,0,0,0,0,0,0,0,0
109,私立,一般大學,1028,臺北醫學大學,博士班,波蘭共和國,歐洲,1,1,0,1,1,0,0,0,0,0,0,0,0,0,0
109,私立,一般大學,1028,臺北醫學大學,博士班,南非共和國,非洲,1,1,0,1,1,0,0,0,0,0,0,0,0,0,0
109,私立,一般大學,1028,臺北醫學大學,博士班,香港,港澳,2,2,0,0,0,0,0,0,0,2,2,0,0,0,0
109,私立,一般大學,1028,臺北醫學大學,博士班,海地共和國,中南美洲,1,0,1,1,0,1,0,0,0,0,0,0,0,0,0
109,私立,一般大學,1028,臺北醫學大學,博士班,馬來西亞,東協,5,4,1,2,2,0,3,2,1,0,0,0,0,0,0
109,私立,一般大學,1028,臺北醫學大學,博士班,喀麥隆共和國,非洲,1,0,1,1,0,1,0,0,0,0,0,0,0,0,0
109,私立,一般大學,1028,臺北醫學大學,博士班,越南社會主義共和國,東協,65,38,27,65,38,27,0,0,0,0,0,0,0,0,0
109,私立,一般大學,1028,臺北醫學大學,博士班,獅子山共和國,非洲,2,1,1,2,1,1,0,0,0,0,0,0,0,0,0
109,私立,一般大學,1028,臺北醫學大學,博士班,聖文森(及格瑞那丁),中南美洲,1,0,1,1,0,1,0,0,0,0,0,0,0,0,0
109,私立,一般大學,1028,臺北醫學大學,博士班,澳門,港澳,1,1,0,0,0,0,0,0,0,1,1,0,0,0,0
109,私立,一般大學,1028,臺北醫學大學,博士班,巴基斯坦,南亞,1,1,0,1,1,0,0,0,0,0,0,0,0,0,0
109,私立,一般大學,1028,臺北醫學大學,博士班,史瓦帝尼王國,非洲,3,2,1,3,2,1,0,0,0,0,0,0,0,0,0
109,私立,一般大學,1028,臺北醫學大學,博士班,布吉納法索,非洲,4,3,1,4,3,1,0,0,0,0,0,0,0,0,0
109,私立,一般大學,1028,臺北醫學大學,博士班,甘比亞共和國,非洲,2,2,0,2,2,0,0,0,0,0,0,0,0,0,0
109,私立,一般大學,1028,臺北醫學大學,博士班,西班牙王國,歐洲,1,1,0,1,1,0,0,0,0,0,0,0,0,0,0
109,私立,一般大學,1028,臺北醫學大學,博士班,奈及利亞聯邦共和國,非洲,3,2,1,3,2,1,0,0,0,0,0,0,0,0,0
109,私立,一般大學,1028,臺北醫學大學,博士班,俄羅斯聯邦,其他亞洲地區,2,1,1,2,1,1,0,0,0,0,0,0,0,0,0
109,私立,一般大學,1028,臺北醫學大學,博士班,美國,北美洲,1,1,0,1,1,0,0,0,0,0,0,0,0,0,0
109,私立,一般大學,1028,臺北醫學大學,博士班,泰國,東協,7,1,6,7,1,6,0,0,0,0,0,0,0,0,0
109,私立,一般大學,1028,臺北醫學大學,博士班,馬拉威共和國,非洲,5,4,1,5,4,1,0,0,0,0,0,0,0,0,0
109,私立,一般大學,1028,臺北醫學大學,博士班,新加坡共和國,東協,1,0,1,1,0,1,0,0,0,0,0,0,0,0,0
109,私立,一般大學,1028,臺北醫學大學,博士班,聖克里斯多福及尼維斯,中南美洲,1,1,0,1,1,0,0,0,0,0,0,0,0,0,0
109,私立,一般大學,1028,臺北醫學大學,博士班,蒙古國,其他亞洲地區,10,1,9,10,1,9,0,0,0,0,0,0,0,0,0
109,私立,一般大學,1029,中山醫學大學,學士班(日間),巴拉圭,中南美洲,1,0,1,0,0,0,1,0,1,0,0,0,0,0,0
109,私立,一般大學,1029,中山醫學大學,學士班(日間),美國,北美洲,3,2,1,0,0,0,3,2,1,0,0,0,0,0,0
109,私立,一般大學,1029,中山醫學大學,學士班(日間),香港,港澳,47,21,26,0,0,0,0,0,0,47,21,26,0,0,0
109,私立,一般大學,1029,中山醫學大學,學士班(日間),泰國,東協,2,0,2,0,0,0,2,0,2,0,0,0,0,0,0
109,私立,一般大學,1029,中山醫學大學,學士班(日間),越南社會主義共和國,東協,3,0,3,0,0,0,3,0,3,0,0,0,0,0,0
109,私立,一般大學,1029,中山醫學大學,學士班(日間),新加坡共和國,東協,3,0,3,0,0,0,3,0,3,0,0,0,0,0,0
109,私立,一般大學,1029,中山醫學大學,學士班(日間),緬甸,東協,4,1,3,0,0,0,4,1,3,0,0,0,0,0,0
109,私立,一般大學,1029,中山醫學大學,學士班(日間),澳門,港澳,76,30,46,0,0,0,0,0,0,76,30,46,0,0,0
109,私立,一般大學,1029,中山醫學大學,學士班(日間),大陸地區,大陸地區,16,8,8,0,0,0,0,0,0,0,0,0,16,8,8
109,私立,一般大學,1029,中山醫學大學,學士班(日間),大韓民國(南韓),其他亞洲地區,4,2,2,0,0,0,4,2,2,0,0,0,0,0,0
109,私立,一般大學,1029,中山醫學大學,學士班(日間),日本,其他亞洲地區,1,0,1,0,0,0,1,0,1,0,0,0,0,0,0
109,私立,一般大學,1029,中山醫學大學,學士班(日間),加拿大,北美洲,8,5,3,0,0,0,8,5,3,0,0,0,0,0,0
109,私立,一般大學,1029,中山醫學大學,學士班(日間),印度尼西亞共和國,東協,5,1,4,0,0,0,5,1,4,0,0,0,0,0,0
109,私立,一般大學,1029,中山醫學大學,學士班(日間),南非共和國,非洲,1,1,0,0,0,0,1,1,0,0,0,0,0,0,0
109,私立,一般大學,1029,中山醫學大學,學士班(日間),英國,歐洲,1,1,0,0,0,0,1,1,0,0,0,0,0,0,0
109,私立,一般大學,1029,中山醫學大學,學士班(日間),馬來西亞,東協,58,20,38,4,2,2,54,18,36,0,0,0,0,0,0
109,私立,一般大學,1029,中山醫學大學,學士班(日間),葡萄牙共和國,歐洲,2,1,1,0,0,0,2,1,1,0,0,0,0,0,0
109,私立,一般大學,1029,中山醫學大學,碩士班(日間),大陸地區,大陸地區,4,3,1,0,0,0,0,0,0,0,0,0,4,3,1
109,私立,一般大學,1029,中山醫學大學,碩士班(日間),印度尼西亞共和國,東協,1,1,0,1,1,0,0,0,0,0,0,0,0,0,0
109,私立,一般大學,1029,中山醫學大學,碩士班(日間),馬來西亞,東協,7,3,4,2,0,2,5,3,2,0,0,0,0,0,0
109,私立,一般大學,1029,中山醫學大學,碩士班(日間),澳門,港澳,7,2,5,0,0,0,0,0,0,7,2,5,0,0,0
109,私立,一般大學,1029,中山醫學大學,博士班,俄羅斯聯邦,其他亞洲地區,1,0,1,1,0,1,0,0,0,0,0,0,0,0,0
109,私立,一般大學,1029,中山醫學大學,博士班,馬來西亞,東協,3,2,1,0,0,0,3,2,1,0,0,0,0,0,0
109,私立,一般大學,1029,中山醫學大學,博士班,印度尼西亞共和國,東協,1,1,0,0,0,0,1,1,0,0,0,0,0,0,0
109,私立,技專校院,1030,龍華科技大學,五專,香港,港澳,1,1,0,0,0,0,0,0,0,1,1,0,0,0,0
109,私立,技專校院,1030,龍華科技大學,五專,俄羅斯聯邦,其他亞洲地區,1,1,0,1,1,0,0,0,0,0,0,0,0,0,0
109,私立,技專校院,1030,龍華科技大學,學士班(日間),泰國,東協,3,0,3,1,0,1,2,0,2,0,0,0,0,0,0
109,私立,技專校院,1030,龍華科技大學,學士班(日間),菲律賓共和國,東協,1,0,1,0,0,0,1,0,1,0,0,0,0,0,0
109,私立,技專校院,1030,龍華科技大學,學士班(日間),大陸地區,大陸地區,13,10,3,0,0,0,0,0,0,0,0,0,13,10,3
109,私立,技專校院,1030,龍華科技大學,學士班(日間),大韓民國(南韓),其他亞洲地區,1,0,1,1,0,1,0,0,0,0,0,0,0,0,0
109,私立,技專校院,1030,龍華科技大學,學士班(日間),印度尼西亞共和國,東協,118,93,25,89,73,16,29,20,9,0,0,0,0,0,0
109,私立,技專校院,1030,龍華科技大學,學士班(日間),香港,港澳,39,31,8,0,0,0,0,0,0,39,31,8,0,0,0
109,私立,技專校院,1030,龍華科技大學,學士班(日間),烏克蘭,其他亞洲地區,1,1,0,1,1,0,0,0,0,0,0,0,0,0,0
109,私立,技專校院,1030,龍華科技大學,學士班(日間),馬來西亞,東協,62,57,5,50,45,5,12,12,0,0,0,0,0,0,0
109,私立,技專校院,1030,龍華科技大學,學士班(日間),越南社會主義共和國,東協,656,337,319,490,237,253,166,100,66,0,0,0,0,0,0
109,私立,技專校院,1030,龍華科技大學,學士班(日間),緬甸,東協,2,0,2,0,0,0,2,0,2,0,0,0,0,0,0
109,私立,技專校院,1030,龍華科技大學,學士班(日間),澳門,港澳,1,1,0,0,0,0,0,0,0,1,1,0,0,0,0
109,私立,技專校院,1030,龍華科技大學,碩士班(日間),大陸地區,大陸地區,1,1,0,0,0,0,0,0,0,0,0,0,1,1,0
109,私立,技專校院,1030,龍華科技大學,碩士班(日間),香港,港澳,5,4,1,0,0,0,0,0,0,5,4,1,0,0,0
109,私立,技專校院,1030,龍華科技大學,碩士班(日間),馬來西亞,東協,4,4,0,4,4,0,0,0,0,0,0,0,0,0,0
109,私立,技專校院,1030,龍華科技大學,碩士班(日間),美國,北美洲,1,1,0,1,1,0,0,0,0,0,0,0,0,0,0
109,私立,技專校院,1030,龍華科技大學,碩士班(日間),越南社會主義共和國,東協,44,17,27,44,17,27,0,0,0,0,0,0,0,0,0
109,私立,技專校院,1031,輔英科技大學,學士班(日間),香港,港澳,38,22,16,0,0,0,0,0,0,38,22,16,0,0,0
109,私立,技專校院,1031,輔英科技大學,學士班(日間),越南社會主義共和國,東協,87,22,65,59,16,43,28,6,22,0,0,0,0,0,0
109,私立,技專校院,1031,輔英科技大學,學士班(日間),蒙古國,其他亞洲地區,1,0,1,1,0,1,0,0,0,0,0,0,0,0,0
109,私立,技專校院,1031,輔英科技大學,學士班(日間),澳門,港澳,18,10,8,0,0,0,0,0,0,18,10,8,0,0,0
109,私立,技專校院,1031,輔英科技大學,學士班(日間),西班牙王國,歐洲,2,1,1,2,1,1,0,0,0,0,0,0,0,0,0
109,私立,技專校院,1031,輔英科技大學,學士班(日間),馬來西亞,東協,16,4,12,1,0,1,15,4,11,0,0,0,0,0,0
109,私立,技專校院,1031,輔英科技大學,學士班(日間),馬拉威共和國,非洲,2,0,2,2,0,2,0,0,0,0,0,0,0,0,0
109,私立,技專校院,1031,輔英科技大學,碩士班(日間),越南社會主義共和國,東協,9,3,6,9,3,6,0,0,0,0,0,0,0,0,0
109,私立,技專校院,1032,明新學校財團法人明新科技大學,學士班(日間),日本,其他亞洲地區,28,17,11,28,17,11,0,0,0,0,0,0,0,0,0
109,私立,技專校院,1032,明新學校財團法人明新科技大學,學士班(日間),俄羅斯聯邦,其他亞洲地區,1,1,0,1,1,0,0,0,0,0,0,0,0,0,0
109,私立,技專校院,1032,明新學校財團法人明新科技大學,學士班(日間),菲律賓共和國,東協,57,8,49,57,8,49,0,0,0,0,0,0,0,0,0
109,私立,技專校院,1032,明新學校財團法人明新科技大學,學士班(日間),大陸地區,大陸地區,1,1,0,0,0,0,0,0,0,0,0,0,1,1,0
109,私立,技專校院,1032,明新學校財團法人明新科技大學,學士班(日間),大韓民國(南韓),其他亞洲地區,11,4,7,11,4,7,0,0,0,0,0,0,0,0,0
109,私立,技專校院,1032,明新學校財團法人明新科技大學,學士班(日間),印度尼西亞共和國,東協,24,12,12,22,11,11,2,1,1,0,0,0,0,0,0
109,私立,技專校院,1032,明新學校財團法人明新科技大學,學士班(日間),香港,港澳,12,7,5,0,0,0,0,0,0,12,7,5,0,0,0
109,私立,技專校院,1032,明新學校財團法人明新科技大學,學士班(日間),馬來西亞,東協,14,10,4,9,7,2,5,3,2,0,0,0,0,0,0
109,私立,技專校院,1032,明新學校財團法人明新科技大學,學士班(日間),越南社會主義共和國,東協,933,521,412,912,514,398,21,7,14,0,0,0,0,0,0
109,私立,技專校院,1032,明新學校財團法人明新科技大學,學士班(日間),蒙古國,其他亞洲地區,7,5,2,7,5,2,0,0,0,0,0,0,0,0,0
109,私立,技專校院,1032,明新學校財團法人明新科技大學,學士班(日間),緬甸,東協,33,12,21,31,12,19,2,0,2,0,0,0,0,0,0
109,私立,技專校院,1032,明新學校財團法人明新科技大學,碩士班(日間),尼加拉瓜,中南美洲,1,1,0,1,1,0,0,0,0,0,0,0,0,0,0
109,私立,技專校院,1032,明新學校財團法人明新科技大學,碩士班(日間),印度,南亞,2,1,1,2,1,1,0,0,0,0,0,0,0,0,0
109,私立,技專校院,1032,明新學校財團法人明新科技大學,碩士班(日間),柬埔寨王國,東協,1,1,0,1,1,0,0,0,0,0,0,0,0,0,0
109,私立,技專校院,1032,明新學校財團法人明新科技大學,碩士班(日間),烏克蘭,其他亞洲地區,1,0,1,1,0,1,0,0,0,0,0,0,0,0,0
109,私立,技專校院,1032,明新學校財團法人明新科技大學,碩士班(日間),馬來西亞,東協,1,1,0,0,0,0,1,1,0,0,0,0,0,0,0
109,私立,技專校院,1032,明新學校財團法人明新科技大學,碩士班(日間),越南社會主義共和國,東協,23,7,16,23,7,16,0,0,0,0,0,0,0,0,0
109,私立,技專校院,1032,明新學校財團法人明新科技大學,碩士班(日間),蒙古國,其他亞洲地區,3,0,3,3,0,3,0,0,0,0,0,0,0,0,0
109,私立,技專校院,1032,明新學校財團法人明新科技大學,碩士班(日間),俄羅斯聯邦,其他亞洲地區,1,0,1,1,0,1,0,0,0,0,0,0,0,0,0
109,私立,技專校院,1032,明新學校財團法人明新科技大學,碩士班(日間),菲律賓共和國,東協,9,6,3,9,6,3,0,0,0,0,0,0,0,0,0
109,私立,一般大學,1033,長榮大學,學士班(日間),日本,其他亞洲地區,46,17,29,45,17,28,1,0,1,0,0,0,0,0,0
109,私立,一般大學,1033,長榮大學,學士班(日間),史瓦帝尼王國,非洲,5,2,3,5,2,3,0,0,0,0,0,0,0,0,0
109,私立,一般大學,1033,長榮大學,學士班(日間),西班牙王國,歐洲,1,1,0,1,1,0,0,0,0,0,0,0,0,0,0
109,私立,一般大學,1033,長榮大學,學士班(日間),阿爾及利亞人民民主共和國,非洲,1,1,0,1,1,0,0,0,0,0,0,0,0,0,0
109,私立,一般大學,1033,長榮大學,學士班(日間),美國,北美洲,1,0,1,1,0,1,0,0,0,0,0,0,0,0,0
109,私立,一般大學,1033,長榮大學,學士班(日間),義大利共和國,歐洲,1,1,0,1,1,0,0,0,0,0,0,0,0,0,0
109,私立,一般大學,1033,長榮大學,學士班(日間),蒙古國,其他亞洲地區,3,3,0,3,3,0,0,0,0,0,0,0,0,0,0
109,私立,一般大學,1033,長榮大學,學士班(日間),蒲隆地共和國,非洲,27,20,7,27,20,7,0,0,0,0,0,0,0,0,0
109,私立,一般大學,1033,長榮大學,學士班(日間),大陸地區,大陸地區,8,3,5,0,0,0,0,0,0,0,0,0,8,3,5
109,私立,一般大學,1033,長榮大學,學士班(日間),大韓民國(南韓),其他亞洲地區,5,4,1,4,4,0,1,0,1,0,0,0,0,0,0
109,私立,一般大學,1033,長榮大學,學士班(日間),印度尼西亞共和國,東協,36,14,22,4,2,2,32,12,20,0,0,0,0,0,0
109,私立,一般大學,1033,長榮大學,學士班(日間),坦尚尼亞聯合共和國,非洲,46,25,21,46,25,21,0,0,0,0,0,0,0,0,0
109,私立,一般大學,1033,長榮大學,學士班(日間),孟加拉人民共和國,南亞,1,0,1,1,0,1,0,0,0,0,0,0,0,0,0
109,私立,一般大學,1033,長榮大學,學士班(日間),香港,港澳,45,21,24,0,0,0,0,0,0,45,21,24,0,0,0
109,私立,一般大學,1033,長榮大學,學士班(日間),烏干達共和國,非洲,2,2,0,2,2,0,0,0,0,0,0,0,0,0,0
109,私立,一般大學,1033,長榮大學,學士班(日間),馬來西亞,東協,112,57,55,16,10,6,96,47,49,0,0,0,0,0,0
109,私立,一般大學,1033,長榮大學,學士班(日間),越南社會主義共和國,東協,1,1,0,1,1,0,0,0,0,0,0,0,0,0,0
109,私立,一般大學,1033,長榮大學,學士班(日間),澳門,港澳,12,4,8,0,0,0,0,0,0,12,4,8,0,0,0
109,私立,一般大學,1033,長榮大學,碩士班(日間),大韓民國(南韓),其他亞洲地區,1,1,0,1,1,0,0,0,0,0,0,0,0,0,0
109,私立,一般大學,1033,長榮大學,碩士班(日間),印度,南亞,2,2,0,2,2,0,0,0,0,0,0,0,0,0,0
109,私立,一般大學,1033,長榮大學,碩士班(日間),印度尼西亞共和國,東協,3,1,2,2,0,2,1,1,0,0,0,0,0,0,0
109,私立,一般大學,1033,長榮大學,碩士班(日間),香港,港澳,2,0,2,0,0,0,0,0,0,2,0,2,0,0,0
109,私立,一般大學,1033,長榮大學,碩士班(日間),馬來西亞,東協,3,2,1,1,0,1,2,2,0,0,0,0,0,0,0
109,私立,一般大學,1033,長榮大學,碩士班(日間),馬拉威共和國,非洲,1,1,0,1,1,0,0,0,0,0,0,0,0,0,0
109,私立,一般大學,1033,長榮大學,碩士班(日間),越南社會主義共和國,東協,5,2,3,5,2,3,0,0,0,0,0,0,0,0,0
109,私立,一般大學,1033,長榮大學,碩士班(日間),日本,其他亞洲地區,1,1,0,1,1,0,0,0,0,0,0,0,0,0,0
109,私立,一般大學,1033,長榮大學,碩士班(日間),美國,北美洲,1,1,0,1,1,0,0,0,0,0,0,0,0,0,0
109,私立,一般大學,1033,長榮大學,碩士班(日間),泰國,東協,2,0,2,2,0,2,0,0,0,0,0,0,0,0,0
109,私立,一般大學,1033,長榮大學,碩士班(日間),瑞典王國,歐洲,1,1,0,1,1,0,0,0,0,0,0,0,0,0,0
109,私立,一般大學,1033,長榮大學,博士班,大陸地區,大陸地區,1,1,0,0,0,0,0,0,0,0,0,0,1,1,0
109,私立,一般大學,1033,長榮大學,博士班,孟加拉人民共和國,南亞,1,1,0,1,1,0,0,0,0,0,0,0,0,0,0
109,私立,一般大學,1033,長榮大學,博士班,越南社會主義共和國,東協,6,3,3,6,3,3,0,0,0,0,0,0,0,0,0
109,私立,技專校院,1034,弘光科技大學,學士班(日間),汶萊和平之國,東協,1,1,0,0,0,0,1,1,0,0,0,0,0,0,0
109,私立,技專校院,1034,弘光科技大學,學士班(日間),越南社會主義共和國,東協,2,0,2,2,0,2,0,0,0,0,0,0,0,0,0
109,私立,技專校院,1034,弘光科技大學,學士班(日間),大陸地區,大陸地區,6,5,1,0,0,0,0,0,0,0,0,0,6,5,1
109,私立,技專校院,1034,弘光科技大學,學士班(日間),日本,其他亞洲地區,8,3,5,8,3,5,0,0,0,0,0,0,0,0,0
109,私立,技專校院,1034,弘光科技大學,學士班(日間),加拿大,北美洲,1,1,0,1,1,0,0,0,0,0,0,0,0,0,0
109,私立,技專校院,1034,弘光科技大學,學士班(日間),印度尼西亞共和國,東協,5,0,5,2,0,2,3,0,3,0,0,0,0,0,0
109,私立,技專校院,1034,弘光科技大學,學士班(日間),香港,港澳,81,38,43,0,0,0,0,0,0,81,38,43,0,0,0
109,私立,技專校院,1034,弘光科技大學,學士班(日間),馬來西亞,東協,226,103,123,94,43,51,132,60,72,0,0,0,0,0,0
109,私立,技專校院,1034,弘光科技大學,學士班(日間),緬甸,東協,1,0,1,0,0,0,1,0,1,0,0,0,0,0,0
109,私立,技專校院,1034,弘光科技大學,學士班(日間),澳門,港澳,45,24,21,0,0,0,0,0,0,45,24,21,0,0,0
109,私立,技專校院,1034,弘光科技大學,碩士班(日間),馬來西亞,東協,5,3,2,5,3,2,0,0,0,0,0,0,0,0,0
109,私立,技專校院,1034,弘光科技大學,碩士班(日間),越南社會主義共和國,東協,1,0,1,1,0,1,0,0,0,0,0,0,0,0,0
109,私立,技專校院,1034,弘光科技大學,博士班,越南社會主義共和國,東協,1,1,0,1,1,0,0,0,0,0,0,0,0,0,0
109,私立,一般大學,1035,中國醫藥大學,學士班(日間),大陸地區,大陸地區,13,3,10,0,0,0,0,0,0,0,0,0,13,3,10
109,私立,一般大學,1035,中國醫藥大學,學士班(日間),大韓民國(南韓),其他亞洲地區,21,10,11,8,6,2,13,4,9,0,0,0,0,0,0
109,私立,一般大學,1035,中國醫藥大學,學士班(日間),加拿大,北美洲,14,6,8,1,0,1,13,6,7,0,0,0,0,0,0
109,私立,一般大學,1035,中國醫藥大學,學士班(日間),印度尼西亞共和國,東協,11,3,8,4,1,3,7,2,5,0,0,0,0,0,0
109,私立,一般大學,1035,中國醫藥大學,學士班(日間),香港,港澳,54,27,27,0,0,0,0,0,0,54,27,27,0,0,0
109,私立,一般大學,1035,中國醫藥大學,學士班(日間),智利,中南美洲,1,1,0,0,0,0,1,1,0,0,0,0,0,0,0
109,私立,一般大學,1035,中國醫藥大學,學士班(日間),越南社會主義共和國,東協,5,3,2,3,2,1,2,1,1,0,0,0,0,0,0
109,私立,一般大學,1035,中國醫藥大學,學士班(日間),聖文森(及格瑞那丁),中南美洲,2,1,1,2,1,1,0,0,0,0,0,0,0,0,0
109,私立,一般大學,1035,中國醫藥大學,學士班(日間),聖克里斯多福及尼維斯,中南美洲,1,1,0,1,1,0,0,0,0,0,0,0,0,0,0
109,私立,一般大學,1035,中國醫藥大學,學士班(日間),聖露西亞,中南美洲,1,1,0,1,1,0,0,0,0,0,0,0,0,0,0
109,私立,一般大學,1035,中國醫藥大學,學士班(日間),緬甸,東協,9,4,5,1,1,0,8,3,5,0,0,0,0,0,0
109,私立,一般大學,1035,中國醫藥大學,學士班(日間),澳門,港澳,67,38,29,0,0,0,0,0,0,67,38,29,0,0,0
109,私立,一般大學,1035,中國醫藥大學,學士班(日間),巴西聯邦共和國,中南美洲,1,0,1,0,0,0,1,0,1,0,0,0,0,0,0
109,私立,一般大學,1035,中國醫藥大學,學士班(日間),日本,其他亞洲地區,14,5,9,12,5,7,2,0,2,0,0,0,0,0,0
109,私立,一般大學,1035,中國醫藥大學,學士班(日間),史瓦帝尼王國,非洲,1,0,1,1,0,1,0,0,0,0,0,0,0,0,0
109,私立,一般大學,1035,中國醫藥大學,學士班(日間),俄羅斯聯邦,其他亞洲地區,1,0,1,1,0,1,0,0,0,0,0,0,0,0,0
109,私立,一般大學,1035,中國醫藥大學,學士班(日間),美國,北美洲,25,16,9,6,6,0,19,10,9,0,0,0,0,0,0
109,私立,一般大學,1035,中國醫藥大學,學士班(日間),泰國,東協,2,1,1,1,0,1,1,1,0,0,0,0,0,0,0
109,私立,一般大學,1035,中國醫藥大學,學士班(日間),紐西蘭,其他亞洲地區,2,0,2,0,0,0,2,0,2,0,0,0,0,0,0
109,私立,一般大學,1035,中國醫藥大學,學士班(日間),馬來西亞,東協,134,46,88,28,10,18,106,36,70,0,0,0,0,0,0
109,私立,一般大學,1035,中國醫藥大學,學士班(日間),新加坡共和國,東協,13,6,7,1,1,0,12,5,7,0,0,0,0,0,0
109,私立,一般大學,1035,中國醫藥大學,學士班(日間),葡萄牙共和國,歐洲,1,0,1,1,0,1,0,0,0,0,0,0,0,0,0
109,私立,一般大學,1035,中國醫藥大學,碩士班(日間),美國,北美洲,1,1,0,1,1,0,0,0,0,0,0,0,0,0,0
109,私立,一般大學,1035,中國醫藥大學,碩士班(日間),英國,歐洲,1,1,0,1,1,0,0,0,0,0,0,0,0,0,0
109,私立,一般大學,1035,中國醫藥大學,碩士班(日間),泰國,東協,1,1,0,1,1,0,0,0,0,0,0,0,0,0,0
109,私立,一般大學,1035,中國醫藥大學,碩士班(日間),馬來西亞,東協,2,2,0,0,0,0,2,2,0,0,0,0,0,0,0
109,私立,一般大學,1035,中國醫藥大學,碩士班(日間),菲律賓共和國,東協,1,0,1,1,0,1,0,0,0,0,0,0,0,0,0
109,私立,一般大學,1035,中國醫藥大學,碩士班(日間),蒙古國,其他亞洲地區,2,0,2,2,0,2,0,0,0,0,0,0,0,0,0
109,私立,一般大學,1035,中國醫藥大學,碩士班(日間),墨西哥合眾國,中南美洲,1,1,0,1,1,0,0,0,0,0,0,0,0,0,0
109,私立,一般大學,1035,中國醫藥大學,碩士班(日間),大陸地區,大陸地區,3,1,2,0,0,0,0,0,0,0,0,0,3,1,2
109,私立,一般大學,1035,中國醫藥大學,碩士班(日間),巴基斯坦,南亞,1,1,0,1,1,0,0,0,0,0,0,0,0,0,0
109,私立,一般大學,1035,中國醫藥大學,碩士班(日間),加拿大,北美洲,1,1,0,0,0,0,1,1,0,0,0,0,0,0,0
109,私立,一般大學,1035,中國醫藥大學,碩士班(日間),印度,南亞,1,0,1,1,0,1,0,0,0,0,0,0,0,0,0
109,私立,一般大學,1035,中國醫藥大學,碩士班(日間),印度尼西亞共和國,東協,3,0,3,3,0,3,0,0,0,0,0,0,0,0,0
109,私立,一般大學,1035,中國醫藥大學,碩士班(日間),尚比亞共和國,非洲,2,0,2,2,0,2,0,0,0,0,0,0,0,0,0
109,私立,一般大學,1035,中國醫藥大學,碩士班(日間),香港,港澳,1,0,1,0,0,0,0,0,0,1,0,1,0,0,0
109,私立,一般大學,1035,中國醫藥大學,碩士班(日間),哥倫比亞共和國,中南美洲,1,0,1,1,0,1,0,0,0,0,0,0,0,0,0
109,私立,一般大學,1035,中國醫藥大學,碩士班(日間),智利,中南美洲,1,0,1,1,0,1,0,0,0,0,0,0,0,0,0
109,私立,一般大學,1035,中國醫藥大學,碩士班(日間),越南社會主義共和國,東協,13,5,8,13,5,8,0,0,0,0,0,0,0,0,0
109,私立,一般大學,1035,中國醫藥大學,碩士班(日間),聖克里斯多福及尼維斯,中南美洲,1,1,0,1,1,0,0,0,0,0,0,0,0,0,0
109,私立,一般大學,1035,中國醫藥大學,博士班,日本,其他亞洲地區,1,1,0,1,1,0,0,0,0,0,0,0,0,0,0
109,私立,一般大學,1035,中國醫藥大學,博士班,泰國,東協,3,1,2,3,1,2,0,0,0,0,0,0,0,0,0
109,私立,一般大學,1035,中國醫藥大學,博士班,墨西哥合眾國,中南美洲,1,0,1,1,0,1,0,0,0,0,0,0,0,0,0
109,私立,一般大學,1035,中國醫藥大學,博士班,巴基斯坦,南亞,1,1,0,1,1,0,0,0,0,0,0,0,0,0,0
109,私立,一般大學,1035,中國醫藥大學,博士班,以色列,其他亞洲地區,1,1,0,1,1,0,0,0,0,0,0,0,0,0,0
109,私立,一般大學,1035,中國醫藥大學,博士班,印度,南亞,5,4,1,5,4,1,0,0,0,0,0,0,0,0,0
109,私立,一般大學,1035,中國醫藥大學,博士班,印度尼西亞共和國,東協,8,6,2,7,5,2,1,1,0,0,0,0,0,0,0
109,私立,一般大學,1035,中國醫藥大學,博士班,南非共和國,非洲,1,0,1,1,0,1,0,0,0,0,0,0,0,0,0
109,私立,一般大學,1035,中國醫藥大學,博士班,剛果民主共和國,非洲,1,0,1,1,0,1,0,0,0,0,0,0,0,0,0
109,私立,一般大學,1035,中國醫藥大學,博士班,秘魯共和國,中南美洲,1,0,1,1,0,1,0,0,0,0,0,0,0,0,0
109,私立,一般大學,1035,中國醫藥大學,博士班,馬來西亞,東協,2,1,1,0,0,0,2,1,1,0,0,0,0,0,0
109,私立,一般大學,1035,中國醫藥大學,博士班,馬拉威共和國,非洲,3,3,0,3,3,0,0,0,0,0,0,0,0,0,0
109,私立,一般大學,1035,中國醫藥大學,博士班,越南社會主義共和國,東協,9,3,6,9,3,6,0,0,0,0,0,0,0,0,0
109,私立,技專校院,1036,健行學校財團法人健行科技大學,學士班(日間),印度尼西亞共和國,東協,470,323,147,461,318,143,9,5,4,0,0,0,0,0,0
109,私立,技專校院,1036,健行學校財團法人健行科技大學,學士班(日間),俄羅斯聯邦,其他亞洲地區,1,0,1,1,0,1,0,0,0,0,0,0,0,0,0
109,私立,技專校院,1036,健行學校財團法人健行科技大學,學士班(日間),泰國,東協,1,0,1,1,0,1,0,0,0,0,0,0,0,0,0
109,私立,技專校院,1036,健行學校財團法人健行科技大學,學士班(日間),馬來西亞,東協,38,20,18,38,20,18,0,0,0,0,0,0,0,0,0
109,私立,技專校院,1036,健行學校財團法人健行科技大學,學士班(日間),聖文森(及格瑞那丁),中南美洲,2,2,0,2,2,0,0,0,0,0,0,0,0,0,0
109,私立,技專校院,1036,健行學校財團法人健行科技大學,學士班(日間),巴基斯坦,南亞,1,1,0,1,1,0,0,0,0,0,0,0,0,0,0
109,私立,技專校院,1036,健行學校財團法人健行科技大學,學士班(日間),香港,港澳,6,5,1,0,0,0,0,0,0,6,5,1,0,0,0
109,私立,技專校院,1036,健行學校財團法人健行科技大學,學士班(日間),越南社會主義共和國,東協,115,37,78,115,37,78,0,0,0,0,0,0,0,0,0
109,私立,技專校院,1036,健行學校財團法人健行科技大學,學士班(日間),新加坡共和國,東協,1,1,0,1,1,0,0,0,0,0,0,0,0,0,0
109,私立,技專校院,1036,健行學校財團法人健行科技大學,學士班(日間),澳大利亞,其他亞洲地區,1,1,0,1,1,0,0,0,0,0,0,0,0,0,0
109,私立,技專校院,1036,健行學校財團法人健行科技大學,碩士班(日間),甘比亞共和國,非洲,1,1,0,1,1,0,0,0,0,0,0,0,0,0,0
109,私立,技專校院,1036,健行學校財團法人健行科技大學,碩士班(日間),越南社會主義共和國,東協,25,9,16,25,9,16,0,0,0,0,0,0,0,0,0
109,私立,技專校院,1036,健行學校財團法人健行科技大學,碩士班(日間),馬來西亞,東協,1,0,1,1,0,1,0,0,0,0,0,0,0,0,0
109,私立,技專校院,1037,正修學校財團法人正修科技大學,學士班(日間),印度尼西亞共和國,東協,307,189,118,185,113,72,122,76,46,0,0,0,0,0,0
109,私立,技專校院,1037,正修學校財團法人正修科技大學,學士班(日間),挪威王國,歐洲,1,0,1,1,0,1,0,0,0,0,0,0,0,0,0
109,私立,技專校院,1037,正修學校財團法人正修科技大學,學士班(日間),泰國,東協,14,6,8,5,4,1,9,2,7,0,0,0,0,0,0
109,私立,技專校院,1037,正修學校財團法人正修科技大學,學士班(日間),越南社會主義共和國,東協,280,129,151,24,9,15,256,120,136,0,0,0,0,0,0
109,私立,技專校院,1037,正修學校財團法人正修科技大學,學士班(日間),瑞士聯邦,歐洲,1,0,1,1,0,1,0,0,0,0,0,0,0,0,0
109,私立,技專校院,1037,正修學校財團法人正修科技大學,學士班(日間),大陸地區,大陸地區,4,3,1,0,0,0,0,0,0,0,0,0,4,3,1
109,私立,技專校院,1037,正修學校財團法人正修科技大學,學士班(日間),日本,其他亞洲地區,1,1,0,1,1,0,0,0,0,0,0,0,0,0,0
109,私立,技專校院,1037,正修學校財團法人正修科技大學,學士班(日間),香港,港澳,8,3,5,0,0,0,0,0,0,8,3,5,0,0,0
109,私立,技專校院,1037,正修學校財團法人正修科技大學,學士班(日間),馬來西亞,東協,26,20,6,3,3,0,23,17,6,0,0,0,0,0,0
109,私立,技專校院,1037,正修學校財團法人正修科技大學,學士班(日間),緬甸,東協,9,5,4,0,0,0,9,5,4,0,0,0,0,0,0
109,私立,技專校院,1037,正修學校財團法人正修科技大學,碩士班(日間),印度,南亞,1,1,0,1,1,0,0,0,0,0,0,0,0,0,0
109,私立,技專校院,1037,正修學校財團法人正修科技大學,碩士班(日間),美國,北美洲,1,1,0,1,1,0,0,0,0,0,0,0,0,0,0
109,私立,技專校院,1037,正修學校財團法人正修科技大學,碩士班(日間),印度尼西亞共和國,東協,28,8,20,28,8,20,0,0,0,0,0,0,0,0,0
109,私立,技專校院,1037,正修學校財團法人正修科技大學,碩士班(日間),香港,港澳,1,0,1,0,0,0,0,0,0,1,0,1,0,0,0
109,私立,技專校院,1037,正修學校財團法人正修科技大學,碩士班(日間),泰國,東協,2,1,1,2,1,1,0,0,0,0,0,0,0,0,0
109,私立,技專校院,1038,萬能學校財團法人萬能科技大學,學士班(日間),大陸地區,大陸地區,1,1,0,0,0,0,0,0,0,0,0,0,1,1,0
109,私立,技專校院,1038,萬能學校財團法人萬能科技大學,學士班(日間),印度尼西亞共和國,東協,57,25,32,44,14,30,13,11,2,0,0,0,0,0,0
109,私立,技專校院,1038,萬能學校財團法人萬能科技大學,學士班(日間),香港,港澳,63,35,28,0,0,0,0,0,0,63,35,28,0,0,0
109,私立,技專校院,1038,萬能學校財團法人萬能科技大學,學士班(日間),馬來西亞,東協,136,96,40,132,93,39,4,3,1,0,0,0,0,0,0
109,私立,技專校院,1038,萬能學校財團法人萬能科技大學,學士班(日間),越南社會主義共和國,東協,171,56,115,113,34,79,58,22,36,0,0,0,0,0,0
109,私立,技專校院,1038,萬能學校財團法人萬能科技大學,學士班(日間),日本,其他亞洲地區,3,2,1,3,2,1,0,0,0,0,0,0,0,0,0
109,私立,技專校院,1038,萬能學校財團法人萬能科技大學,學士班(日間),奈及利亞聯邦共和國,非洲,1,1,0,1,1,0,0,0,0,0,0,0,0,0,0
109,私立,技專校院,1038,萬能學校財團法人萬能科技大學,學士班(日間),美國,北美洲,1,1,0,1,1,0,0,0,0,0,0,0,0,0,0
109,私立,技專校院,1038,萬能學校財團法人萬能科技大學,學士班(日間),泰國,東協,39,17,22,39,17,22,0,0,0,0,0,0,0,0,0
109,私立,技專校院,1038,萬能學校財團法人萬能科技大學,碩士班(日間),馬來西亞,東協,9,5,4,9,5,4,0,0,0,0,0,0,0,0,0
109,私立,技專校院,1038,萬能學校財團法人萬能科技大學,碩士班(日間),越南社會主義共和國,東協,1,1,0,1,1,0,0,0,0,0,0,0,0,0,0
109,私立,一般大學,1039,玄奘大學,學士班(日間),印度尼西亞共和國,東協,1,1,0,1,1,0,0,0,0,0,0,0,0,0,0
109,私立,一般大學,1039,玄奘大學,學士班(日間),美國,北美洲,1,1,0,1,1,0,0,0,0,0,0,0,0,0,0
109,私立,一般大學,1039,玄奘大學,學士班(日間),泰國,東協,1,0,1,1,0,1,0,0,0,0,0,0,0,0,0
109,私立,一般大學,1039,玄奘大學,學士班(日間),越南社會主義共和國,東協,9,1,8,9,1,8,0,0,0,0,0,0,0,0,0
109,私立,一般大學,1039,玄奘大學,學士班(日間),墨西哥合眾國,中南美洲,1,1,0,1,1,0,0,0,0,0,0,0,0,0,0
109,私立,一般大學,1039,玄奘大學,學士班(日間),澳門,港澳,1,0,1,0,0,0,0,0,0,1,0,1,0,0,0
109,私立,一般大學,1039,玄奘大學,學士班(日間),大陸地區,大陸地區,2,0,2,0,0,0,0,0,0,0,0,0,2,0,2
109,私立,一般大學,1039,玄奘大學,學士班(日間),印度,南亞,7,5,2,7,5,2,0,0,0,0,0,0,0,0,0
109,私立,一般大學,1039,玄奘大學,學士班(日間),南非共和國,非洲,1,1,0,1,1,0,0,0,0,0,0,0,0,0,0
109,私立,一般大學,1039,玄奘大學,學士班(日間),香港,港澳,78,38,40,0,0,0,0,0,0,78,38,40,0,0,0
109,私立,一般大學,1039,玄奘大學,學士班(日間),馬來西亞,東協,64,25,39,34,10,24,30,15,15,0,0,0,0,0,0
109,私立,一般大學,1039,玄奘大學,碩士班(日間),印度,南亞,4,2,2,4,2,2,0,0,0,0,0,0,0,0,0
109,私立,一般大學,1039,玄奘大學,碩士班(日間),馬來西亞,東協,6,2,4,3,2,1,3,0,3,0,0,0,0,0,0
109,私立,一般大學,1039,玄奘大學,碩士班(日間),大陸地區,大陸地區,1,1,0,0,0,0,0,0,0,0,0,0,1,1,0
109,私立,一般大學,1039,玄奘大學,碩士班(日間),香港,港澳,3,3,0,0,0,0,0,0,0,3,3,0,0,0,0
109,私立,一般大學,1039,玄奘大學,碩士班(日間),越南社會主義共和國,東協,7,0,7,7,0,7,0,0,0,0,0,0,0,0,0
109,私立,一般大學,1039,玄奘大學,碩士班(日間),澳門,港澳,2,0,2,0,0,0,0,0,0,2,0,2,0,0,0
109,私立,技專校院,1040,建國科技大學,學士班(日間),大陸地區,大陸地區,1,1,0,0,0,0,0,0,0,0,0,0,1,1,0
109,私立,技專校院,1040,建國科技大學,學士班(日間),印度尼西亞共和國,東協,90,74,16,89,73,16,1,1,0,0,0,0,0,0,0
109,私立,技專校院,1040,建國科技大學,學士班(日間),香港,港澳,4,0,4,0,0,0,0,0,0,4,0,4,0,0,0
109,私立,技專校院,1040,建國科技大學,學士班(日間),馬來西亞,東協,57,47,10,52,44,8,5,3,2,0,0,0,0,0,0
109,私立,技專校院,1040,建國科技大學,學士班(日間),越南社會主義共和國,東協,79,54,25,76,53,23,3,1,2,0,0,0,0,0,0
109,私立,技專校院,1040,建國科技大學,學士班(日間),緬甸,東協,3,2,1,3,2,1,0,0,0,0,0,0,0,0,0
109,私立,技專校院,1040,建國科技大學,學士班(日間),日本,其他亞洲地區,9,4,5,9,4,5,0,0,0,0,0,0,0,0,0
109,私立,技專校院,1040,建國科技大學,學士班(日間),蒙古國,其他亞洲地區,29,16,13,29,16,13,0,0,0,0,0,0,0,0,0
109,私立,技專校院,1040,建國科技大學,碩士班(日間),蒙古國,其他亞洲地區,3,2,1,3,2,1,0,0,0,0,0,0,0,0,0
109,私立,技專校院,1040,建國科技大學,碩士班(日間),越南社會主義共和國,東協,2,0,2,2,0,2,0,0,0,0,0,0,0,0,0
109,私立,技專校院,1041,明志科技大學,學士班(日間),大陸地區,大陸地區,7,5,2,0,0,0,0,0,0,0,0,0,7,5,2
109,私立,技專校院,1041,明志科技大學,學士班(日間),大韓民國(南韓),其他亞洲地區,1,1,0,0,0,0,1,1,0,0,0,0,0,0,0
109,私立,技專校院,1041,明志科技大學,學士班(日間),香港,港澳,2,2,0,0,0,0,0,0,0,2,2,0,0,0,0
109,私立,技專校院,1041,明志科技大學,學士班(日間),馬來西亞,東協,7,5,2,1,0,1,6,5,1,0,0,0,0,0,0
109,私立,技專校院,1041,明志科技大學,學士班(日間),越南社會主義共和國,東協,2,1,1,1,0,1,1,1,0,0,0,0,0,0,0
109,私立,技專校院,1041,明志科技大學,碩士班(日間),大陸地區,大陸地區,4,4,0,0,0,0,0,0,0,0,0,0,4,4,0
109,私立,技專校院,1041,明志科技大學,碩士班(日間),印度尼西亞共和國,東協,22,15,7,22,15,7,0,0,0,0,0,0,0,0,0
109,私立,技專校院,1041,明志科技大學,碩士班(日間),法國,歐洲,1,1,0,1,1,0,0,0,0,0,0,0,0,0,0
109,私立,技專校院,1041,明志科技大學,碩士班(日間),香港,港澳,1,1,0,0,0,0,0,0,0,1,1,0,0,0,0
109,私立,技專校院,1041,明志科技大學,碩士班(日間),泰國,東協,9,3,6,9,3,6,0,0,0,0,0,0,0,0,0
109,私立,技專校院,1041,明志科技大學,碩士班(日間),越南社會主義共和國,東協,18,5,13,18,5,13,0,0,0,0,0,0,0,0,0
109,私立,技專校院,1041,明志科技大學,碩士班(日間),印度,南亞,11,8,3,11,8,3,0,0,0,0,0,0,0,0,0
109,私立,技專校院,1041,明志科技大學,博士班,印度,南亞,5,3,2,5,3,2,0,0,0,0,0,0,0,0,0
109,私立,技專校院,1041,明志科技大學,博士班,衣索比亞聯邦民主共和國,非洲,8,8,0,8,8,0,0,0,0,0,0,0,0,0,0
109,私立,技專校院,1041,明志科技大學,博士班,越南社會主義共和國,東協,2,1,1,2,1,1,0,0,0,0,0,0,0,0,0
109,私立,技專校院,1042,高苑科技大學,學士班(日間),柬埔寨王國,東協,15,10,5,15,10,5,0,0,0,0,0,0,0,0,0
109,私立,技專校院,1042,高苑科技大學,學士班(日間),泰國,東協,1,0,1,1,0,1,0,0,0,0,0,0,0,0,0
109,私立,技專校院,1042,高苑科技大學,學士班(日間),菲律賓共和國,東協,131,65,66,131,65,66,0,0,0,0,0,0,0,0,0
109,私立,技專校院,1042,高苑科技大學,學士班(日間),越南社會主義共和國,東協,368,181,187,347,173,174,21,8,13,0,0,0,0,0,0
109,私立,技專校院,1042,高苑科技大學,學士班(日間),日本,其他亞洲地區,1,1,0,1,1,0,0,0,0,0,0,0,0,0,0
109,私立,技專校院,1042,高苑科技大學,學士班(日間),印度尼西亞共和國,東協,246,169,77,208,150,58,38,19,19,0,0,0,0,0,0
109,私立,技專校院,1042,高苑科技大學,學士班(日間),香港,港澳,3,3,0,0,0,0,0,0,0,3,3,0,0,0,0
109,私立,技專校院,1042,高苑科技大學,學士班(日間),馬來西亞,東協,12,6,6,9,4,5,3,2,1,0,0,0,0,0,0
109,私立,技專校院,1042,高苑科技大學,學士班(日間),斯里蘭卡民主社會主義共和國,南亞,2,1,1,2,1,1,0,0,0,0,0,0,0,0,0
109,私立,技專校院,1042,高苑科技大學,學士班(日間),緬甸,東協,5,2,3,5,2,3,0,0,0,0,0,0,0,0,0
109,私立,技專校院,1042,高苑科技大學,學士班(日間),澳門,港澳,1,0,1,0,0,0,0,0,0,1,0,1,0,0,0
109,私立,技專校院,1042,高苑科技大學,碩士班(日間),馬來西亞,東協,1,1,0,1,1,0,0,0,0,0,0,0,0,0,0
109,私立,技專校院,1042,高苑科技大學,碩士班(日間),印度尼西亞共和國,東協,1,1,0,0,0,0,1,1,0,0,0,0,0,0,0
109,私立,技專校院,1042,高苑科技大學,碩士班(日間),越南社會主義共和國,東協,6,0,6,6,0,6,0,0,0,0,0,0,0,0,0
109,私立,技專校院,1043,大仁科技大學,學士班(日間),大陸地區,大陸地區,1,0,1,0,0,0,0,0,0,0,0,0,1,0,1
109,私立,技專校院,1043,大仁科技大學,學士班(日間),香港,港澳,91,27,64,0,0,0,0,0,0,91,27,64,0,0,0
109,私立,技專校院,1043,大仁科技大學,學士班(日間),越南社會主義共和國,東協,43,22,21,1,1,0,42,21,21,0,0,0,0,0,0
109,私立,技專校院,1043,大仁科技大學,學士班(日間),緬甸,東協,3,1,2,0,0,0,3,1,2,0,0,0,0,0,0
109,私立,技專校院,1043,大仁科技大學,學士班(日間),澳門,港澳,4,2,2,0,0,0,0,0,0,4,2,2,0,0,0
109,私立,技專校院,1043,大仁科技大學,學士班(日間),日本,其他亞洲地區,1,0,1,0,0,0,1,0,1,0,0,0,0,0,0
109,私立,技專校院,1043,大仁科技大學,學士班(日間),印度尼西亞共和國,東協,8,4,4,0,0,0,8,4,4,0,0,0,0,0,0
109,私立,技專校院,1043,大仁科技大學,學士班(日間),美國,北美洲,1,1,0,0,0,0,1,1,0,0,0,0,0,0,0
109,私立,技專校院,1043,大仁科技大學,學士班(日間),馬來西亞,東協,40,21,19,10,5,5,30,16,14,0,0,0,0,0,0
109,私立,技專校院,1043,大仁科技大學,碩士班(日間),香港,港澳,1,1,0,0,0,0,0,0,0,1,1,0,0,0,0
109,私立,技專校院,1044,聖約翰科技大學,五專,印度尼西亞共和國,東協,1,0,1,1,0,1,0,0,0,0,0,0,0,0,0
109,私立,技專校院,1044,聖約翰科技大學,學士班(日間),大陸地區,大陸地區,10,7,3,0,0,0,0,0,0,0,0,0,10,7,3
109,私立,技專校院,1044,聖約翰科技大學,學士班(日間),日本,其他亞洲地區,1,1,0,0,0,0,1,1,0,0,0,0,0,0,0
109,私立,技專校院,1044,聖約翰科技大學,學士班(日間),香港,港澳,28,22,6,0,0,0,0,0,0,28,22,6,0,0,0
109,私立,技專校院,1044,聖約翰科技大學,學士班(日間),馬來西亞,東協,152,95,57,127,81,46,25,14,11,0,0,0,0,0,0
109,私立,技專校院,1044,聖約翰科技大學,學士班(日間),印度尼西亞共和國,東協,1,0,1,1,0,1,0,0,0,0,0,0,0,0,0
109,私立,技專校院,1044,聖約翰科技大學,學士班(日間),泰國,東協,1,1,0,0,0,0,1,1,0,0,0,0,0,0,0
109,私立,技專校院,1044,聖約翰科技大學,學士班(日間),越南社會主義共和國,東協,106,58,48,106,58,48,0,0,0,0,0,0,0,0,0
109,私立,技專校院,1044,聖約翰科技大學,碩士班(日間),越南社會主義共和國,東協,2,1,1,2,1,1,0,0,0,0,0,0,0,0,0
109,私立,技專校院,1044,聖約翰科技大學,碩士班(日間),香港,港澳,1,1,0,0,0,0,0,0,0,1,1,0,0,0,0
109,私立,技專校院,1044,聖約翰科技大學,碩士班(日間),馬來西亞,東協,25,18,7,25,18,7,0,0,0,0,0,0,0,0,0
109,私立,技專校院,1045,嶺東科技大學,學士班(日間),大陸地區,大陸地區,19,7,12,0,0,0,0,0,0,0,0,0,19,7,12
109,私立,技專校院,1045,嶺東科技大學,學士班(日間),印度尼西亞共和國,東協,3,0,3,2,0,2,1,0,1,0,0,0,0,0,0
109,私立,技專校院,1045,嶺東科技大學,學士班(日間),香港,港澳,4,2,2,0,0,0,0,0,0,4,2,2,0,0,0
109,私立,技專校院,1045,嶺東科技大學,學士班(日間),馬來西亞,東協,33,17,16,23,11,12,10,6,4,0,0,0,0,0,0
109,私立,技專校院,1045,嶺東科技大學,學士班(日間),越南社會主義共和國,東協,3,2,1,3,2,1,0,0,0,0,0,0,0,0,0
109,私立,技專校院,1045,嶺東科技大學,學士班(日間),澳門,港澳,5,3,2,0,0,0,0,0,0,5,3,2,0,0,0
109,私立,技專校院,1045,嶺東科技大學,學士班(日間),泰國,東協,2,0,2,0,0,0,2,0,2,0,0,0,0,0,0
109,私立,技專校院,1045,嶺東科技大學,碩士班(日間),大陸地區,大陸地區,9,5,4,0,0,0,0,0,0,0,0,0,9,5,4
109,私立,技專校院,1045,嶺東科技大學,碩士班(日間),大韓民國(南韓),其他亞洲地區,1,1,0,1,1,0,0,0,0,0,0,0,0,0,0
109,私立,技專校院,1045,嶺東科技大學,碩士班(日間),香港,港澳,1,1,0,0,0,0,0,0,0,1,1,0,0,0,0
109,私立,技專校院,1045,嶺東科技大學,碩士班(日間),馬來西亞,東協,4,2,2,3,2,1,1,0,1,0,0,0,0,0,0
109,私立,技專校院,1045,嶺東科技大學,碩士班(日間),越南社會主義共和國,東協,1,0,1,1,0,1,0,0,0,0,0,0,0,0,0
109,私立,技專校院,1046,中國科技大學,學士班(日間),大陸地區,大陸地區,28,11,17,0,0,0,0,0,0,0,0,0,28,11,17
109,私立,技專校院,1046,中國科技大學,學士班(日間),印度尼西亞共和國,東協,7,6,1,3,3,0,4,3,1,0,0,0,0,0,0
109,私立,技專校院,1046,中國科技大學,學士班(日間),泰國,東協,1,0,1,1,0,1,0,0,0,0,0,0,0,0,0
109,私立,技專校院,1046,中國科技大學,學士班(日間),菲律賓共和國,東協,1,1,0,0,0,0,1,1,0,0,0,0,0,0,0
109,私立,技專校院,1046,中國科技大學,學士班(日間),越南社會主義共和國,東協,48,2,46,45,1,44,3,1,2,0,0,0,0,0,0
109,私立,技專校院,1046,中國科技大學,學士班(日間),寮人民民主共和國(寮國),東協,1,0,1,1,0,1,0,0,0,0,0,0,0,0,0
109,私立,技專校院,1046,中國科技大學,學士班(日間),澳門,港澳,3,2,1,0,0,0,0,0,0,3,2,1,0,0,0
109,私立,技專校院,1046,中國科技大學,學士班(日間),大韓民國(南韓),其他亞洲地區,1,1,0,1,1,0,0,0,0,0,0,0,0,0,0
109,私立,技專校院,1046,中國科技大學,學士班(日間),巴拿馬共和國,中南美洲,1,0,1,1,0,1,0,0,0,0,0,0,0,0,0
109,私立,技專校院,1046,中國科技大學,學士班(日間),日本,其他亞洲地區,9,4,5,9,4,5,0,0,0,0,0,0,0,0,0
109,私立,技專校院,1046,中國科技大學,學士班(日間),美國,北美洲,1,1,0,1,1,0,0,0,0,0,0,0,0,0,0
109,私立,技專校院,1046,中國科技大學,學士班(日間),香港,港澳,8,3,5,0,0,0,0,0,0,8,3,5,0,0,0
109,私立,技專校院,1046,中國科技大學,學士班(日間),馬來西亞,東協,75,41,34,65,33,32,10,8,2,0,0,0,0,0,0
109,私立,技專校院,1046,中國科技大學,學士班(日間),緬甸,東協,2,2,0,0,0,0,2,2,0,0,0,0,0,0,0
109,私立,技專校院,1046,中國科技大學,碩士班(日間),伊拉克共和國,其他亞洲地區,1,1,0,1,1,0,0,0,0,0,0,0,0,0,0
109,私立,技專校院,1046,中國科技大學,碩士班(日間),大陸地區,大陸地區,1,0,1,0,0,0,0,0,0,0,0,0,1,0,1
109,私立,技專校院,1046,中國科技大學,碩士班(日間),馬來西亞,東協,9,5,4,9,5,4,0,0,0,0,0,0,0,0,0
109,私立,技專校院,1046,中國科技大學,碩士班(日間),越南社會主義共和國,東協,1,0,1,1,0,1,0,0,0,0,0,0,0,0,0
109,私立,技專校院,1047,中臺科技大學,二專(日間),越南社會主義共和國,東協,18,8,10,18,8,10,0,0,0,0,0,0,0,0,0
109,私立,技專校院,1047,中臺科技大學,學士班(日間),大陸地區,大陸地區,3,1,2,0,0,0,0,0,0,0,0,0,3,1,2
109,私立,技專校院,1047,中臺科技大學,學士班(日間),印度尼西亞共和國,東協,2,0,2,0,0,0,2,0,2,0,0,0,0,0,0
109,私立,技專校院,1047,中臺科技大學,學士班(日間),香港,港澳,3,1,2,0,0,0,0,0,0,3,1,2,0,0,0
109,私立,技專校院,1047,中臺科技大學,學士班(日間),馬來西亞,東協,14,6,8,9,5,4,5,1,4,0,0,0,0,0,0
109,私立,技專校院,1047,中臺科技大學,學士班(日間),澳門,港澳,1,1,0,0,0,0,0,0,0,1,1,0,0,0,0
109,私立,技專校院,1047,中臺科技大學,碩士班(日間),印度,南亞,1,0,1,1,0,1,0,0,0,0,0,0,0,0,0
109,私立,技專校院,1047,中臺科技大學,碩士班(日間),阿根廷,中南美洲,1,0,1,1,0,1,0,0,0,0,0,0,0,0,0
109,私立,一般大學,1048,亞洲大學,學士班(日間),大陸地區,大陸地區,34,20,14,0,0,0,0,0,0,0,0,0,34,20,14
109,私立,一般大學,1048,亞洲大學,學士班(日間),大韓民國(南韓),其他亞洲地區,1,1,0,1,1,0,0,0,0,0,0,0,0,0,0
109,私立,一般大學,1048,亞洲大學,學士班(日間),日本,其他亞洲地區,31,9,22,30,9,21,1,0,1,0,0,0,0,0,0
109,私立,一般大學,1048,亞洲大學,學士班(日間),尼泊爾聯邦民主共和國,南亞,1,1,0,1,1,0,0,0,0,0,0,0,0,0,0
109,私立,一般大學,1048,亞洲大學,學士班(日間),瓜地馬拉共和國,中南美洲,1,0,1,1,0,1,0,0,0,0,0,0,0,0,0
109,私立,一般大學,1048,亞洲大學,學士班(日間),印度,南亞,1,0,1,1,0,1,0,0,0,0,0,0,0,0,0
109,私立,一般大學,1048,亞洲大學,學士班(日間),印度尼西亞共和國,東協,46,25,21,41,22,19,5,3,2,0,0,0,0,0,0
109,私立,一般大學,1048,亞洲大學,學士班(日間),南非共和國,非洲,1,1,0,1,1,0,0,0,0,0,0,0,0,0,0
109,私立,一般大學,1048,亞洲大學,學士班(日間),英國,歐洲,1,1,0,1,1,0,0,0,0,0,0,0,0,0,0
109,私立,一般大學,1048,亞洲大學,學士班(日間),香港,港澳,62,28,34,0,0,0,0,0,0,62,28,34,0,0,0
109,私立,一般大學,1048,亞洲大學,學士班(日間),馬來西亞,東協,25,9,16,7,4,3,18,5,13,0,0,0,0,0,0
109,私立,一般大學,1048,亞洲大學,學士班(日間),越南社會主義共和國,東協,11,6,5,10,5,5,1,1,0,0,0,0,0,0,0
109,私立,一般大學,1048,亞洲大學,學士班(日間),蒙古國,其他亞洲地區,63,24,39,63,24,39,0,0,0,0,0,0,0,0,0
109,私立,一般大學,1048,亞洲大學,學士班(日間),澳門,港澳,21,8,13,0,0,0,0,0,0,21,8,13,0,0,0
109,私立,一般大學,1048,亞洲大學,學士班(日間),賴索托王國,非洲,1,0,1,1,0,1,0,0,0,0,0,0,0,0,0
109,私立,一般大學,1048,亞洲大學,學士班(日間),泰國,東協,1,0,1,1,0,1,0,0,0,0,0,0,0,0,0
109,私立,一般大學,1048,亞洲大學,碩士班(日間),布吉納法索,非洲,1,1,0,1,1,0,0,0,0,0,0,0,0,0,0
109,私立,一般大學,1048,亞洲大學,碩士班(日間),甘比亞共和國,非洲,2,2,0,2,2,0,0,0,0,0,0,0,0,0,0
109,私立,一般大學,1048,亞洲大學,碩士班(日間),美國,北美洲,1,1,0,1,1,0,0,0,0,0,0,0,0,0,0
109,私立,一般大學,1048,亞洲大學,碩士班(日間),泰國,東協,4,0,4,4,0,4,0,0,0,0,0,0,0,0,0
109,私立,一般大學,1048,亞洲大學,碩士班(日間),菲律賓共和國,東協,1,0,1,1,0,1,0,0,0,0,0,0,0,0,0
109,私立,一般大學,1048,亞洲大學,碩士班(日間),越南社會主義共和國,東協,3,0,3,3,0,3,0,0,0,0,0,0,0,0,0
109,私立,一般大學,1048,亞洲大學,碩士班(日間),大陸地區,大陸地區,9,7,2,0,0,0,0,0,0,0,0,0,9,7,2
109,私立,一般大學,1048,亞洲大學,碩士班(日間),巴基斯坦,南亞,1,1,0,1,1,0,0,0,0,0,0,0,0,0,0
109,私立,一般大學,1048,亞洲大學,碩士班(日間),印度,南亞,11,6,5,11,6,5,0,0,0,0,0,0,0,0,0
109,私立,一般大學,1048,亞洲大學,碩士班(日間),印度尼西亞共和國,東協,33,16,17,33,16,17,0,0,0,0,0,0,0,0,0
109,私立,一般大學,1048,亞洲大學,碩士班(日間),宏都拉斯共和國,中南美洲,1,0,1,1,0,1,0,0,0,0,0,0,0,0,0
109,私立,一般大學,1048,亞洲大學,碩士班(日間),英國,歐洲,1,1,0,1,1,0,0,0,0,0,0,0,0,0,0
109,私立,一般大學,1048,亞洲大學,碩士班(日間),香港,港澳,2,1,1,0,0,0,0,0,0,2,1,1,0,0,0
109,私立,一般大學,1048,亞洲大學,碩士班(日間),哥倫比亞共和國,中南美洲,1,0,1,1,0,1,0,0,0,0,0,0,0,0,0
109,私立,一般大學,1048,亞洲大學,碩士班(日間),馬來西亞,東協,6,4,2,3,3,0,3,1,2,0,0,0,0,0,0
109,私立,一般大學,1048,亞洲大學,碩士班(日間),蒙古國,其他亞洲地區,10,1,9,10,1,9,0,0,0,0,0,0,0,0,0
109,私立,一般大學,1048,亞洲大學,碩士班(日間),澳門,港澳,5,2,3,0,0,0,0,0,0,5,2,3,0,0,0
109,私立,一般大學,1048,亞洲大學,碩士班(日間),盧安達共和國,非洲,1,1,0,1,1,0,0,0,0,0,0,0,0,0,0
109,私立,一般大學,1048,亞洲大學,博士班,大陸地區,大陸地區,8,3,5,0,0,0,0,0,0,0,0,0,8,3,5
109,私立,一般大學,1048,亞洲大學,博士班,日本,其他亞洲地區,2,2,0,2,2,0,0,0,0,0,0,0,0,0,0
109,私立,一般大學,1048,亞洲大學,博士班,甘比亞共和國,非洲,2,2,0,2,2,0,0,0,0,0,0,0,0,0,0
109,私立,一般大學,1048,亞洲大學,博士班,印度,南亞,4,4,0,4,4,0,0,0,0,0,0,0,0,0,0
109,私立,一般大學,1048,亞洲大學,博士班,印度尼西亞共和國,東協,38,28,10,38,28,10,0,0,0,0,0,0,0,0,0
109,私立,一般大學,1048,亞洲大學,博士班,美國,北美洲,1,1,0,1,1,0,0,0,0,0,0,0,0,0,0
109,私立,一般大學,1048,亞洲大學,博士班,泰國,東協,7,3,4,7,3,4,0,0,0,0,0,0,0,0,0
109,私立,一般大學,1048,亞洲大學,博士班,土耳其共和國,其他亞洲地區,1,1,0,1,1,0,0,0,0,0,0,0,0,0,0
109,私立,一般大學,1048,亞洲大學,博士班,伊拉克共和國,其他亞洲地區,1,1,0,1,1,0,0,0,0,0,0,0,0,0,0
109,私立,一般大學,1048,亞洲大學,博士班,衣索比亞聯邦民主共和國,非洲,1,1,0,1,1,0,0,0,0,0,0,0,0,0,0
109,私立,一般大學,1048,亞洲大學,博士班,索馬利蘭共和國,非洲,1,1,0,1,1,0,0,0,0,0,0,0,0,0,0
109,私立,一般大學,1048,亞洲大學,博士班,紐西蘭,其他亞洲地區,1,1,0,1,1,0,0,0,0,0,0,0,0,0,0
109,私立,一般大學,1048,亞洲大學,博士班,馬來西亞,東協,1,1,0,1,1,0,0,0,0,0,0,0,0,0,0
109,私立,一般大學,1048,亞洲大學,博士班,越南社會主義共和國,東協,7,3,4,7,3,4,0,0,0,0,0,0,0,0,0
109,私立,一般大學,1048,亞洲大學,博士班,蒙古國,其他亞洲地區,1,0,1,1,0,1,0,0,0,0,0,0,0,0,0
109,私立,一般大學,1049,開南大學,學士班(日間),大陸地區,大陸地區,1,1,0,0,0,0,0,0,0,0,0,0,1,1,0
109,私立,一般大學,1049,開南大學,學士班(日間),大韓民國(南韓),其他亞洲地區,1,0,1,1,0,1,0,0,0,0,0,0,0,0,0
109,私立,一般大學,1049,開南大學,學士班(日間),日本,其他亞洲地區,108,45,63,108,45,63,0,0,0,0,0,0,0,0,0
109,私立,一般大學,1049,開南大學,學士班(日間),帛琉共和國,其他亞洲地區,4,3,1,4,3,1,0,0,0,0,0,0,0,0,0
109,私立,一般大學,1049,開南大學,學士班(日間),南非共和國,非洲,1,1,0,1,1,0,0,0,0,0,0,0,0,0,0
109,私立,一般大學,1049,開南大學,學士班(日間),香港,港澳,9,7,2,0,0,0,0,0,0,9,7,2,0,0,0
109,私立,一般大學,1049,開南大學,學士班(日間),馬來西亞,東協,6,4,2,1,1,0,5,3,2,0,0,0,0,0,0
109,私立,一般大學,1049,開南大學,學士班(日間),蒙古國,其他亞洲地區,17,11,6,17,11,6,0,0,0,0,0,0,0,0,0
109,私立,一般大學,1049,開南大學,學士班(日間),印度尼西亞共和國,東協,6,1,5,4,0,4,2,1,1,0,0,0,0,0,0
109,私立,一般大學,1049,開南大學,學士班(日間),俄羅斯聯邦,其他亞洲地區,1,0,1,1,0,1,0,0,0,0,0,0,0,0,0
109,私立,一般大學,1049,開南大學,學士班(日間),美國,北美洲,1,1,0,1,1,0,0,0,0,0,0,0,0,0,0
109,私立,一般大學,1049,開南大學,學士班(日間),泰國,東協,9,0,9,9,0,9,0,0,0,0,0,0,0,0,0
109,私立,一般大學,1049,開南大學,學士班(日間),海地共和國,中南美洲,11,9,2,11,9,2,0,0,0,0,0,0,0,0,0
109,私立,一般大學,1049,開南大學,學士班(日間),菲律賓共和國,東協,2,1,1,2,1,1,0,0,0,0,0,0,0,0,0
109,私立,一般大學,1049,開南大學,學士班(日間),越南社會主義共和國,東協,379,109,270,344,101,243,35,8,27,0,0,0,0,0,0
109,私立,一般大學,1049,開南大學,學士班(日間),奧地利共和國,歐洲,1,1,0,1,1,0,0,0,0,0,0,0,0,0,0
109,私立,一般大學,1049,開南大學,學士班(日間),寮人民民主共和國(寮國),東協,13,6,7,13,6,7,0,0,0,0,0,0,0,0,0
109,私立,一般大學,1049,開南大學,學士班(日間),澳門,港澳,2,2,0,0,0,0,0,0,0,2,2,0,0,0,0
109,私立,一般大學,1049,開南大學,碩士班(日間),菲律賓共和國,東協,11,0,11,11,0,11,0,0,0,0,0,0,0,0,0
109,私立,一般大學,1049,開南大學,碩士班(日間),越南社會主義共和國,東協,21,9,12,20,9,11,1,0,1,0,0,0,0,0,0
109,私立,一般大學,1049,開南大學,碩士班(日間),美國,北美洲,2,2,0,2,2,0,0,0,0,0,0,0,0,0,0
109,私立,一般大學,1049,開南大學,碩士班(日間),香港,港澳,1,0,1,0,0,0,0,0,0,1,0,1,0,0,0
109,私立,一般大學,1049,開南大學,碩士班(日間),馬來西亞,東協,1,0,1,1,0,1,0,0,0,0,0,0,0,0,0
109,私立,一般大學,1050,佛光大學,學士班(日間),大陸地區,大陸地區,2,0,2,0,0,0,0,0,0,0,0,0,2,0,2
109,私立,一般大學,1050,佛光大學,學士班(日間),巴西聯邦共和國,中南美洲,1,0,1,0,0,0,1,0,1,0,0,0,0,0,0
109,私立,一般大學,1050,佛光大學,學士班(日間),日本,其他亞洲地區,1,1,0,0,0,0,1,1,0,0,0,0,0,0,0
109,私立,一般大學,1050,佛光大學,學士班(日間),印度尼西亞共和國,東協,10,3,7,3,0,3,7,3,4,0,0,0,0,0,0
109,私立,一般大學,1050,佛光大學,學士班(日間),阿根廷,中南美洲,1,0,1,0,0,0,1,0,1,0,0,0,0,0,0
109,私立,一般大學,1050,佛光大學,學士班(日間),香港,港澳,13,6,7,0,0,0,0,0,0,13,6,7,0,0,0
109,私立,一般大學,1050,佛光大學,學士班(日間),馬來西亞,東協,61,27,34,3,0,3,58,27,31,0,0,0,0,0,0
109,私立,一般大學,1050,佛光大學,學士班(日間),越南社會主義共和國,東協,27,9,18,27,9,18,0,0,0,0,0,0,0,0,0
109,私立,一般大學,1050,佛光大學,學士班(日間),緬甸,東協,2,1,1,0,0,0,2,1,1,0,0,0,0,0,0
109,私立,一般大學,1050,佛光大學,學士班(日間),澳門,港澳,1,1,0,0,0,0,0,0,0,1,1,0,0,0,0
109,私立,一般大學,1050,佛光大學,學士班(日間),大韓民國(南韓),其他亞洲地區,1,1,0,1,1,0,0,0,0,0,0,0,0,0,0
109,私立,一般大學,1050,佛光大學,學士班(日間),印度,南亞,3,3,0,3,3,0,0,0,0,0,0,0,0,0,0
109,私立,一般大學,1050,佛光大學,學士班(日間),美國,北美洲,1,1,0,0,0,0,1,1,0,0,0,0,0,0,0
109,私立,一般大學,1050,佛光大學,學士班(日間),新加坡共和國,東協,1,0,1,1,0,1,0,0,0,0,0,0,0,0,0
109,私立,一般大學,1050,佛光大學,學士班(日間),義大利共和國,歐洲,1,0,1,1,0,1,0,0,0,0,0,0,0,0,0
109,私立,一般大學,1050,佛光大學,碩士班(日間),吉爾吉斯,其他亞洲地區,1,0,1,1,0,1,0,0,0,0,0,0,0,0,0
109,私立,一般大學,1050,佛光大學,碩士班(日間),新加坡共和國,東協,1,0,1,1,0,1,0,0,0,0,0,0,0,0,0
109,私立,一般大學,1050,佛光大學,碩士班(日間),大陸地區,大陸地區,1,1,0,0,0,0,0,0,0,0,0,0,1,1,0
109,私立,一般大學,1050,佛光大學,碩士班(日間),大韓民國(南韓),其他亞洲地區,3,1,2,3,1,2,0,0,0,0,0,0,0,0,0
109,私立,一般大學,1050,佛光大學,碩士班(日間),加拿大,北美洲,1,1,0,1,1,0,0,0,0,0,0,0,0,0,0
109,私立,一般大學,1050,佛光大學,碩士班(日間),法國,歐洲,1,0,1,1,0,1,0,0,0,0,0,0,0,0,0
109,私立,一般大學,1050,佛光大學,碩士班(日間),香港,港澳,3,2,1,0,0,0,0,0,0,3,2,1,0,0,0
109,私立,一般大學,1050,佛光大學,碩士班(日間),泰國,東協,1,1,0,1,1,0,0,0,0,0,0,0,0,0,0
109,私立,一般大學,1050,佛光大學,碩士班(日間),馬來西亞,東協,6,1,5,4,1,3,2,0,2,0,0,0,0,0,0
109,私立,一般大學,1050,佛光大學,碩士班(日間),荷蘭王國,歐洲,1,1,0,1,1,0,0,0,0,0,0,0,0,0,0
109,私立,一般大學,1050,佛光大學,碩士班(日間),菲律賓共和國,東協,3,1,2,3,1,2,0,0,0,0,0,0,0,0,0
109,私立,一般大學,1050,佛光大學,碩士班(日間),越南社會主義共和國,東協,14,8,6,14,8,6,0,0,0,0,0,0,0,0,0
109,私立,一般大學,1050,佛光大學,碩士班(日間),緬甸,東協,1,0,1,1,0,1,0,0,0,0,0,0,0,0,0
109,私立,一般大學,1050,佛光大學,博士班,大陸地區,大陸地區,3,0,3,0,0,0,0,0,0,0,0,0,3,0,3
109,私立,一般大學,1050,佛光大學,博士班,香港,港澳,1,0,1,0,0,0,0,0,0,1,0,1,0,0,0
109,私立,一般大學,1050,佛光大學,博士班,越南社會主義共和國,東協,2,0,2,2,0,2,0,0,0,0,0,0,0,0,0
109,私立,一般大學,1050,佛光大學,博士班,馬來西亞,東協,4,0,4,4,0,4,0,0,0,0,0,0,0,0,0
109,私立,技專校院,1051,台南家專學校財團法人台南應用科技大學,五專,日本,其他亞洲地區,1,1,0,0,0,0,1,1,0,0,0,0,0,0,0
109,私立,技專校院,1051,台南家專學校財團法人台南應用科技大學,五專,美國,北美洲,2,2,0,2,2,0,0,0,0,0,0,0,0,0,0
109,私立,技專校院,1051,台南家專學校財團法人台南應用科技大學,學士班(日間),大陸地區,大陸地區,10,5,5,0,0,0,0,0,0,0,0,0,10,5,5
109,私立,技專校院,1051,台南家專學校財團法人台南應用科技大學,學士班(日間),大韓民國(南韓),其他亞洲地區,1,0,1,1,0,1,0,0,0,0,0,0,0,0,0
109,私立,技專校院,1051,台南家專學校財團法人台南應用科技大學,學士班(日間),日本,其他亞洲地區,5,0,5,5,0,5,0,0,0,0,0,0,0,0,0
109,私立,技專校院,1051,台南家專學校財團法人台南應用科技大學,學士班(日間),印度尼西亞共和國,東協,1,1,0,0,0,0,1,1,0,0,0,0,0,0,0
109,私立,技專校院,1051,台南家專學校財團法人台南應用科技大學,學士班(日間),香港,港澳,25,8,17,0,0,0,0,0,0,25,8,17,0,0,0
109,私立,技專校院,1051,台南家專學校財團法人台南應用科技大學,學士班(日間),馬來西亞,東協,35,15,20,15,7,8,20,8,12,0,0,0,0,0,0
109,私立,技專校院,1051,台南家專學校財團法人台南應用科技大學,學士班(日間),澳門,港澳,4,1,3,0,0,0,0,0,0,4,1,3,0,0,0
109,私立,技專校院,1051,台南家專學校財團法人台南應用科技大學,碩士班(日間),大陸地區,大陸地區,4,2,2,0,0,0,0,0,0,0,0,0,4,2,2
109,私立,技專校院,1051,台南家專學校財團法人台南應用科技大學,碩士班(日間),香港,港澳,1,1,0,0,0,0,0,0,0,1,1,0,0,0,0
109,私立,技專校院,1052,遠東科技大學,學士班(日間),大陸地區,大陸地區,2,1,1,0,0,0,0,0,0,0,0,0,2,1,1
109,私立,技專校院,1052,遠東科技大學,學士班(日間),大韓民國(南韓),其他亞洲地區,9,8,1,9,8,1,0,0,0,0,0,0,0,0,0
109,私立,技專校院,1052,遠東科技大學,學士班(日間),印度尼西亞共和國,東協,54,38,16,52,36,16,2,2,0,0,0,0,0,0,0
109,私立,技專校院,1052,遠東科技大學,學士班(日間),香港,港澳,11,9,2,0,0,0,0,0,0,11,9,2,0,0,0
109,私立,技專校院,1052,遠東科技大學,學士班(日間),泰國,東協,1,0,1,1,0,1,0,0,0,0,0,0,0,0,0
109,私立,技專校院,1052,遠東科技大學,學士班(日間),馬來西亞,東協,17,11,6,17,11,6,0,0,0,0,0,0,0,0,0
109,私立,技專校院,1052,遠東科技大學,學士班(日間),菲律賓共和國,東協,14,14,0,14,14,0,0,0,0,0,0,0,0,0,0
109,私立,技專校院,1052,遠東科技大學,學士班(日間),越南社會主義共和國,東協,5,3,2,3,3,0,2,0,2,0,0,0,0,0,0
109,私立,技專校院,1052,遠東科技大學,學士班(日間),澳門,港澳,1,1,0,0,0,0,0,0,0,1,1,0,0,0,0
109,私立,技專校院,1052,遠東科技大學,學士班(日間),美國,北美洲,1,1,0,1,1,0,0,0,0,0,0,0,0,0,0
109,私立,技專校院,1052,遠東科技大學,碩士班(日間),大韓民國(南韓),其他亞洲地區,1,1,0,1,1,0,0,0,0,0,0,0,0,0,0
109,私立,技專校院,1052,遠東科技大學,碩士班(日間),馬來西亞,東協,1,1,0,0,0,0,1,1,0,0,0,0,0,0,0
109,私立,技專校院,1052,遠東科技大學,碩士班(日間),越南社會主義共和國,東協,5,3,2,4,2,2,1,1,0,0,0,0,0,0,0
109,私立,技專校院,1053,光宇學校財團法人元培醫事科技大學,學士班(日間),加拿大,北美洲,1,1,0,1,1,0,0,0,0,0,0,0,0,0,0
109,私立,技專校院,1053,光宇學校財團法人元培醫事科技大學,學士班(日間),印度尼西亞共和國,東協,43,23,20,43,23,20,0,0,0,0,0,0,0,0,0
109,私立,技專校院,1053,光宇學校財團法人元培醫事科技大學,學士班(日間),宏都拉斯共和國,中南美洲,1,1,0,1,1,0,0,0,0,0,0,0,0,0,0
109,私立,技專校院,1053,光宇學校財團法人元培醫事科技大學,學士班(日間),香港,港澳,9,4,5,0,0,0,0,0,0,9,4,5,0,0,0
109,私立,技專校院,1053,光宇學校財團法人元培醫事科技大學,學士班(日間),馬來西亞,東協,41,21,20,40,20,20,1,1,0,0,0,0,0,0,0
109,私立,技專校院,1053,光宇學校財團法人元培醫事科技大學,學士班(日間),菲律賓共和國,東協,1,1,0,0,0,0,1,1,0,0,0,0,0,0,0
109,私立,技專校院,1053,光宇學校財團法人元培醫事科技大學,學士班(日間),日本,其他亞洲地區,1,1,0,1,1,0,0,0,0,0,0,0,0,0,0
109,私立,技專校院,1053,光宇學校財團法人元培醫事科技大學,學士班(日間),史瓦帝尼王國,非洲,1,0,1,1,0,1,0,0,0,0,0,0,0,0,0
109,私立,技專校院,1053,光宇學校財團法人元培醫事科技大學,學士班(日間),美國,北美洲,1,0,1,0,0,0,1,0,1,0,0,0,0,0,0
109,私立,技專校院,1053,光宇學校財團法人元培醫事科技大學,學士班(日間),越南社會主義共和國,東協,153,83,70,153,83,70,0,0,0,0,0,0,0,0,0
109,私立,技專校院,1053,光宇學校財團法人元培醫事科技大學,學士班(日間),澳門,港澳,2,1,1,0,0,0,0,0,0,2,1,1,0,0,0
109,私立,技專校院,1053,光宇學校財團法人元培醫事科技大學,碩士班(日間),日本,其他亞洲地區,1,1,0,1,1,0,0,0,0,0,0,0,0,0,0
109,私立,技專校院,1053,光宇學校財團法人元培醫事科技大學,碩士班(日間),馬來西亞,東協,2,1,1,2,1,1,0,0,0,0,0,0,0,0,0
109,私立,技專校院,1054,景文科技大學,學士班(日間),日本,其他亞洲地區,36,18,18,34,17,17,2,1,1,0,0,0,0,0,0
109,私立,技專校院,1054,景文科技大學,學士班(日間),馬來西亞,東協,46,12,34,13,5,8,33,7,26,0,0,0,0,0,0
109,私立,技專校院,1054,景文科技大學,學士班(日間),蒙古國,其他亞洲地區,1,1,0,1,1,0,0,0,0,0,0,0,0,0,0
109,私立,技專校院,1054,景文科技大學,學士班(日間),大陸地區,大陸地區,15,8,7,0,0,0,0,0,0,0,0,0,15,8,7
109,私立,技專校院,1054,景文科技大學,學士班(日間),大韓民國(南韓),其他亞洲地區,1,1,0,0,0,0,1,1,0,0,0,0,0,0,0
109,私立,技專校院,1054,景文科技大學,學士班(日間),印度尼西亞共和國,東協,9,3,6,2,1,1,7,2,5,0,0,0,0,0,0
109,私立,技專校院,1054,景文科技大學,學士班(日間),香港,港澳,71,34,37,0,0,0,0,0,0,71,34,37,0,0,0
109,私立,技專校院,1054,景文科技大學,學士班(日間),越南社會主義共和國,東協,368,138,230,366,137,229,2,1,1,0,0,0,0,0,0
109,私立,技專校院,1054,景文科技大學,學士班(日間),緬甸,東協,1,0,1,0,0,0,1,0,1,0,0,0,0,0,0
109,私立,技專校院,1054,景文科技大學,學士班(日間),澳門,港澳,19,11,8,0,0,0,0,0,0,19,11,8,0,0,0
109,私立,技專校院,1054,景文科技大學,碩士班(日間),越南社會主義共和國,東協,1,1,0,1,1,0,0,0,0,0,0,0,0,0,0
109,私立,技專校院,1055,中華醫事科技大學,五專,越南社會主義共和國,東協,1,1,0,1,1,0,0,0,0,0,0,0,0,0,0
109,私立,技專校院,1055,中華醫事科技大學,學士班(日間),印度尼西亞共和國,東協,175,120,55,175,120,55,0,0,0,0,0,0,0,0,0
109,私立,技專校院,1055,中華醫事科技大學,學士班(日間),香港,港澳,1,0,1,0,0,0,0,0,0,1,0,1,0,0,0
109,私立,技專校院,1055,中華醫事科技大學,學士班(日間),泰國,東協,1,0,1,1,0,1,0,0,0,0,0,0,0,0,0
109,私立,技專校院,1055,中華醫事科技大學,學士班(日間),越南社會主義共和國,東協,162,48,114,161,47,114,1,1,0,0,0,0,0,0,0
109,私立,技專校院,1055,中華醫事科技大學,學士班(日間),馬來西亞,東協,13,2,11,9,1,8,4,1,3,0,0,0,0,0,0
109,私立,技專校院,1056,東南科技大學,學士班(日間),大陸地區,大陸地區,1,1,0,0,0,0,0,0,0,0,0,0,1,1,0
109,私立,技專校院,1056,東南科技大學,學士班(日間),印度尼西亞共和國,東協,21,9,12,0,0,0,21,9,12,0,0,0,0,0,0
109,私立,技專校院,1056,東南科技大學,學士班(日間),香港,港澳,8,4,4,0,0,0,0,0,0,8,4,4,0,0,0
109,私立,技專校院,1056,東南科技大學,學士班(日間),越南社會主義共和國,東協,426,187,239,340,154,186,86,33,53,0,0,0,0,0,0
109,私立,技專校院,1056,東南科技大學,學士班(日間),緬甸,東協,16,5,11,1,0,1,15,5,10,0,0,0,0,0,0
109,私立,技專校院,1056,東南科技大學,學士班(日間),澳門,港澳,3,1,2,0,0,0,0,0,0,3,1,2,0,0,0
109,私立,技專校院,1056,東南科技大學,學士班(日間),日本,其他亞洲地區,4,2,2,2,0,2,2,2,0,0,0,0,0,0,0
109,私立,技專校院,1056,東南科技大學,學士班(日間),馬來西亞,東協,92,61,31,17,12,5,75,49,26,0,0,0,0,0,0
109,私立,技專校院,1056,東南科技大學,碩士班(日間),馬來西亞,東協,2,1,1,1,0,1,1,1,0,0,0,0,0,0,0
109,私立,技專校院,1057,德明財經科技大學,學士班(日間),日本,其他亞洲地區,10,6,4,10,6,4,0,0,0,0,0,0,0,0,0
109,私立,技專校院,1057,德明財經科技大學,學士班(日間),印度尼西亞共和國,東協,20,3,17,20,3,17,0,0,0,0,0,0,0,0,0
109,私立,技專校院,1057,德明財經科技大學,學士班(日間),柬埔寨王國,東協,1,0,1,1,0,1,0,0,0,0,0,0,0,0,0
109,私立,技專校院,1057,德明財經科技大學,學士班(日間),越南社會主義共和國,東協,406,158,248,403,158,245,3,0,3,0,0,0,0,0,0
109,私立,技專校院,1057,德明財經科技大學,學士班(日間),大韓民國(南韓),其他亞洲地區,3,2,1,3,2,1,0,0,0,0,0,0,0,0,0
109,私立,技專校院,1057,德明財經科技大學,學士班(日間),孟加拉人民共和國,南亞,1,1,0,1,1,0,0,0,0,0,0,0,0,0,0
109,私立,技專校院,1057,德明財經科技大學,學士班(日間),香港,港澳,2,1,1,0,0,0,0,0,0,2,1,1,0,0,0
109,私立,技專校院,1057,德明財經科技大學,學士班(日間),馬來西亞,東協,2,1,1,1,0,1,1,1,0,0,0,0,0,0,0
109,私立,技專校院,1057,德明財經科技大學,碩士班(日間),越南社會主義共和國,東協,14,4,10,14,4,10,0,0,0,0,0,0,0,0,0
109,私立,一般大學,1058,明道學校財團法人明道大學,學士班(日間),大陸地區,大陸地區,3,2,1,0,0,0,0,0,0,0,0,0,3,2,1
109,私立,一般大學,1058,明道學校財團法人明道大學,學士班(日間),日本,其他亞洲地區,10,1,9,10,1,9,0,0,0,0,0,0,0,0,0
109,私立,一般大學,1058,明道學校財團法人明道大學,學士班(日間),奈及利亞聯邦共和國,非洲,2,2,0,2,2,0,0,0,0,0,0,0,0,0,0
109,私立,一般大學,1058,明道學校財團法人明道大學,學士班(日間),香港,港澳,48,29,19,0,0,0,0,0,0,48,29,19,0,0,0
109,私立,一般大學,1058,明道學校財團法人明道大學,學士班(日間),莫三比克共和國,非洲,1,1,0,1,1,0,0,0,0,0,0,0,0,0,0
109,私立,一般大學,1058,明道學校財團法人明道大學,學士班(日間),澳門,港澳,3,2,1,0,0,0,0,0,0,3,2,1,0,0,0
109,私立,一般大學,1058,明道學校財團法人明道大學,學士班(日間),大韓民國(南韓),其他亞洲地區,7,6,1,7,6,1,0,0,0,0,0,0,0,0,0
109,私立,一般大學,1058,明道學校財團法人明道大學,學士班(日間),史瓦帝尼王國,非洲,47,28,19,47,28,19,0,0,0,0,0,0,0,0,0
109,私立,一般大學,1058,明道學校財團法人明道大學,學士班(日間),印度尼西亞共和國,東協,142,88,54,112,73,39,30,15,15,0,0,0,0,0,0
109,私立,一般大學,1058,明道學校財團法人明道大學,學士班(日間),英國,歐洲,1,1,0,1,1,0,0,0,0,0,0,0,0,0,0
109,私立,一般大學,1058,明道學校財團法人明道大學,學士班(日間),泰國,東協,29,21,8,29,21,8,0,0,0,0,0,0,0,0,0
109,私立,一般大學,1058,明道學校財團法人明道大學,學士班(日間),馬來西亞,東協,43,24,19,20,9,11,23,15,8,0,0,0,0,0,0
109,私立,一般大學,1058,明道學校財團法人明道大學,學士班(日間),越南社會主義共和國,東協,15,4,11,10,3,7,5,1,4,0,0,0,0,0,0
109,私立,一般大學,1058,明道學校財團法人明道大學,學士班(日間),蒙古國,其他亞洲地區,9,4,5,9,4,5,0,0,0,0,0,0,0,0,0
109,私立,一般大學,1058,明道學校財團法人明道大學,碩士班(日間),大韓民國(南韓),其他亞洲地區,1,1,0,1,1,0,0,0,0,0,0,0,0,0,0
109,私立,一般大學,1058,明道學校財團法人明道大學,碩士班(日間),印度尼西亞共和國,東協,1,1,0,1,1,0,0,0,0,0,0,0,0,0,0
109,私立,一般大學,1058,明道學校財團法人明道大學,碩士班(日間),泰國,東協,2,0,2,2,0,2,0,0,0,0,0,0,0,0,0
109,私立,一般大學,1058,明道學校財團法人明道大學,碩士班(日間),馬來西亞,東協,7,5,2,4,3,1,3,2,1,0,0,0,0,0,0
109,私立,一般大學,1058,明道學校財團法人明道大學,碩士班(日間),越南社會主義共和國,東協,22,12,10,22,12,10,0,0,0,0,0,0,0,0,0
109,私立,一般大學,1058,明道學校財團法人明道大學,碩士班(日間),蒙古國,其他亞洲地區,7,0,7,7,0,7,0,0,0,0,0,0,0,0,0
109,私立,一般大學,1058,明道學校財團法人明道大學,碩士班(日間),香港,港澳,1,0,1,0,0,0,0,0,0,1,0,1,0,0,0
109,私立,一般大學,1058,明道學校財團法人明道大學,博士班,大陸地區,大陸地區,5,5,0,0,0,0,0,0,0,0,0,0,5,5,0
109,私立,技專校院,1060,南開科技大學,學士班(日間),香港,港澳,2,2,0,0,0,0,0,0,0,2,2,0,0,0,0
109,私立,技專校院,1060,南開科技大學,學士班(日間),越南社會主義共和國,東協,98,48,50,97,47,50,1,1,0,0,0,0,0,0,0
109,私立,技專校院,1060,南開科技大學,學士班(日間),澳門,港澳,4,4,0,0,0,0,0,0,0,4,4,0,0,0,0
109,私立,技專校院,1060,南開科技大學,學士班(日間),印度尼西亞共和國,東協,70,37,33,67,34,33,3,3,0,0,0,0,0,0,0
109,私立,技專校院,1060,南開科技大學,學士班(日間),馬來西亞,東協,106,89,17,29,22,7,77,67,10,0,0,0,0,0,0
109,私立,技專校院,1061,中華學校財團法人中華科技大學,學士班(日間),馬來西亞,東協,10,3,7,9,2,7,1,1,0,0,0,0,0,0,0
109,私立,技專校院,1061,中華學校財團法人中華科技大學,學士班(日間),越南社會主義共和國,東協,8,2,6,7,1,6,1,1,0,0,0,0,0,0,0
109,私立,技專校院,1061,中華學校財團法人中華科技大學,學士班(日間),大陸地區,大陸地區,2,2,0,0,0,0,0,0,0,0,0,0,2,2,0
109,私立,技專校院,1061,中華學校財團法人中華科技大學,學士班(日間),美國,北美洲,1,1,0,0,0,0,1,1,0,0,0,0,0,0,0
109,私立,技專校院,1061,中華學校財團法人中華科技大學,學士班(日間),緬甸,東協,15,6,9,15,6,9,0,0,0,0,0,0,0,0,0
109,私立,技專校院,1061,中華學校財團法人中華科技大學,碩士班(日間),香港,港澳,1,1,0,0,0,0,0,0,0,1,1,0,0,0,0
109,私立,技專校院,1062,僑光科技大學,學士班(日間),日本,其他亞洲地區,1,0,1,1,0,1,0,0,0,0,0,0,0,0,0
109,私立,技專校院,1062,僑光科技大學,學士班(日間),印度尼西亞共和國,東協,75,65,10,74,65,9,1,0,1,0,0,0,0,0,0
109,私立,技專校院,1062,僑光科技大學,學士班(日間),馬來西亞,東協,83,58,25,75,55,20,8,3,5,0,0,0,0,0,0
109,私立,技專校院,1062,僑光科技大學,學士班(日間),大陸地區,大陸地區,1,1,0,0,0,0,0,0,0,0,0,0,1,1,0
109,私立,技專校院,1062,僑光科技大學,學士班(日間),香港,港澳,5,5,0,0,0,0,0,0,0,5,5,0,0,0,0
109,私立,技專校院,1062,僑光科技大學,學士班(日間),泰國,東協,3,2,1,3,2,1,0,0,0,0,0,0,0,0,0
109,私立,技專校院,1062,僑光科技大學,學士班(日間),越南社會主義共和國,東協,5,1,4,5,1,4,0,0,0,0,0,0,0,0,0
109,私立,技專校院,1062,僑光科技大學,學士班(日間),澳門,港澳,1,0,1,0,0,0,0,0,0,1,0,1,0,0,0
109,私立,技專校院,1063,廣亞學校財團法人育達科技大學,學士班(日間),越南社會主義共和國,東協,189,70,119,189,70,119,0,0,0,0,0,0,0,0,0
109,私立,技專校院,1063,廣亞學校財團法人育達科技大學,學士班(日間),印度尼西亞共和國,東協,21,8,13,21,8,13,0,0,0,0,0,0,0,0,0
109,私立,技專校院,1063,廣亞學校財團法人育達科技大學,學士班(日間),馬來西亞,東協,4,4,0,3,3,0,1,1,0,0,0,0,0,0,0
109,私立,技專校院,1063,廣亞學校財團法人育達科技大學,學士班(日間),菲律賓共和國,東協,1,1,0,1,1,0,0,0,0,0,0,0,0,0,0
109,私立,技專校院,1063,廣亞學校財團法人育達科技大學,碩士班(日間),馬來西亞,東協,1,1,0,1,1,0,0,0,0,0,0,0,0,0,0
109,私立,技專校院,1063,廣亞學校財團法人育達科技大學,碩士班(日間),菲律賓共和國,東協,33,7,26,33,7,26,0,0,0,0,0,0,0,0,0
109,私立,技專校院,1063,廣亞學校財團法人育達科技大學,碩士班(日間),緬甸,東協,1,0,1,0,0,0,1,0,1,0,0,0,0,0,0
109,私立,技專校院,1064,美和學校財團法人美和科技大學,學士班(日間),印度尼西亞共和國,東協,26,10,16,26,10,16,0,0,0,0,0,0,0,0,0
109,私立,技專校院,1064,美和學校財團法人美和科技大學,學士班(日間),香港,港澳,3,1,2,0,0,0,0,0,0,3,1,2,0,0,0
109,私立,技專校院,1064,美和學校財團法人美和科技大學,學士班(日間),馬來西亞,東協,1,1,0,0,0,0,1,1,0,0,0,0,0,0,0
109,私立,技專校院,1064,美和學校財團法人美和科技大學,學士班(日間),越南社會主義共和國,東協,0,0,0,0,0,0,0,0,0,0,0,0,0,0,0
109,私立,技專校院,1064,美和學校財團法人美和科技大學,學士班(日間),德意志聯邦共和國,歐洲,1,0,1,1,0,1,0,0,0,0,0,0,0,0,0
109,私立,技專校院,1064,美和學校財團法人美和科技大學,碩士班(日間),越南社會主義共和國,東協,7,5,2,7,5,2,0,0,0,0,0,0,0,0,0
109,私立,技專校院,1065,吳鳳科技大學,學士班(日間),大韓民國(南韓),其他亞洲地區,5,5,0,5,5,0,0,0,0,0,0,0,0,0,0
109,私立,技專校院,1065,吳鳳科技大學,學士班(日間),印度尼西亞共和國,東協,17,10,7,12,8,4,5,2,3,0,0,0,0,0,0
109,私立,技專校院,1065,吳鳳科技大學,學士班(日間),泰國,東協,1,0,1,1,0,1,0,0,0,0,0,0,0,0,0
109,私立,技專校院,1065,吳鳳科技大學,學士班(日間),馬來西亞,東協,15,11,4,1,0,1,14,11,3,0,0,0,0,0,0
109,私立,技專校院,1065,吳鳳科技大學,學士班(日間),印度,南亞,1,1,0,1,1,0,0,0,0,0,0,0,0,0,0
109,私立,技專校院,1065,吳鳳科技大學,學士班(日間),越南社會主義共和國,東協,268,140,128,136,72,64,132,68,64,0,0,0,0,0,0
109,私立,技專校院,1065,吳鳳科技大學,學士班(日間),蒙古國,其他亞洲地區,1,1,0,1,1,0,0,0,0,0,0,0,0,0,0
109,私立,技專校院,1065,吳鳳科技大學,學士班(日間),緬甸,東協,1,0,1,1,0,1,0,0,0,0,0,0,0,0,0
109,私立,技專校院,1066,環球學校財團法人環球科技大學,學士班(日間),日本,其他亞洲地區,11,4,7,11,4,7,0,0,0,0,0,0,0,0,0
109,私立,技專校院,1066,環球學校財團法人環球科技大學,學士班(日間),汶萊和平之國,東協,1,0,1,0,0,0,1,0,1,0,0,0,0,0,0
109,私立,技專校院,1066,環球學校財團法人環球科技大學,學士班(日間),泰國,東協,1,0,1,1,0,1,0,0,0,0,0,0,0,0,0
109,私立,技專校院,1066,環球學校財團法人環球科技大學,學士班(日間),馬來西亞,東協,225,113,112,197,99,98,28,14,14,0,0,0,0,0,0
109,私立,技專校院,1066,環球學校財團法人環球科技大學,學士班(日間),印度尼西亞共和國,東協,88,59,29,80,54,26,8,5,3,0,0,0,0,0,0
109,私立,技專校院,1066,環球學校財團法人環球科技大學,學士班(日間),香港,港澳,11,3,8,0,0,0,0,0,0,11,3,8,0,0,0
109,私立,技專校院,1066,環球學校財團法人環球科技大學,學士班(日間),越南社會主義共和國,東協,39,16,23,26,7,19,13,9,4,0,0,0,0,0,0
109,私立,技專校院,1066,環球學校財團法人環球科技大學,學士班(日間),新加坡共和國,東協,1,0,1,1,0,1,0,0,0,0,0,0,0,0,0
109,私立,技專校院,1066,環球學校財團法人環球科技大學,學士班(日間),澳門,港澳,1,1,0,0,0,0,0,0,0,1,1,0,0,0,0
109,私立,技專校院,1066,環球學校財團法人環球科技大學,碩士班(日間),日本,其他亞洲地區,1,1,0,1,1,0,0,0,0,0,0,0,0,0,0
109,私立,技專校院,1066,環球學校財團法人環球科技大學,碩士班(日間),香港,港澳,2,1,1,0,0,0,0,0,0,2,1,1,0,0,0
109,私立,技專校院,1066,環球學校財團法人環球科技大學,碩士班(日間),馬來西亞,東協,23,17,6,22,17,5,1,0,1,0,0,0,0,0,0
109,私立,技專校院,1066,環球學校財團法人環球科技大學,碩士班(日間),菲律賓共和國,東協,3,1,2,3,1,2,0,0,0,0,0,0,0,0,0
109,私立,一般大學,1067,台灣首府學校財團法人台灣首府大學,學士班(日間),大陸地區,大陸地區,1,0,1,0,0,0,0,0,0,0,0,0,1,0,1
109,私立,一般大學,1067,台灣首府學校財團法人台灣首府大學,學士班(日間),香港,港澳,3,1,2,0,0,0,0,0,0,3,1,2,0,0,0
109,私立,一般大學,1067,台灣首府學校財團法人台灣首府大學,學士班(日間),越南社會主義共和國,東協,3,0,3,0,0,0,3,0,3,0,0,0,0,0,0
109,私立,一般大學,1067,台灣首府學校財團法人台灣首府大學,學士班(日間),緬甸,東協,2,0,2,2,0,2,0,0,0,0,0,0,0,0,0
109,私立,一般大學,1067,台灣首府學校財團法人台灣首府大學,學士班(日間),澳門,港澳,10,3,7,0,0,0,0,0,0,10,3,7,0,0,0
109,私立,一般大學,1067,台灣首府學校財團法人台灣首府大學,學士班(日間),印度尼西亞共和國,東協,181,96,85,130,71,59,51,25,26,0,0,0,0,0,0
109,私立,一般大學,1067,台灣首府學校財團法人台灣首府大學,學士班(日間),柬埔寨王國,東協,1,1,0,0,0,0,1,1,0,0,0,0,0,0,0
109,私立,一般大學,1067,台灣首府學校財團法人台灣首府大學,學士班(日間),泰國,東協,1,0,1,1,0,1,0,0,0,0,0,0,0,0,0
109,私立,一般大學,1067,台灣首府學校財團法人台灣首府大學,學士班(日間),馬來西亞,東協,17,8,9,5,3,2,12,5,7,0,0,0,0,0,0
109,私立,一般大學,1067,台灣首府學校財團法人台灣首府大學,碩士班(日間),印度尼西亞共和國,東協,3,0,3,2,0,2,1,0,1,0,0,0,0,0,0
109,私立,一般大學,1067,台灣首府學校財團法人台灣首府大學,碩士班(日間),柬埔寨王國,東協,1,1,0,1,1,0,0,0,0,0,0,0,0,0,0
109,私立,一般大學,1067,台灣首府學校財團法人台灣首府大學,碩士班(日間),馬來西亞,東協,2,1,1,2,1,1,0,0,0,0,0,0,0,0,0
109,私立,一般大學,1067,台灣首府學校財團法人台灣首府大學,碩士班(日間),越南社會主義共和國,東協,1,0,1,1,0,1,0,0,0,0,0,0,0,0,0
109,私立,技專校院,1068,中州學校財團法人中州科技大學,學士班(日間),香港,港澳,1,1,0,0,0,0,0,0,0,1,1,0,0,0,0
109,私立,技專校院,1068,中州學校財團法人中州科技大學,學士班(日間),烏干達共和國,非洲,16,9,7,16,9,7,0,0,0,0,0,0,0,0,0
109,私立,技專校院,1068,中州學校財團法人中州科技大學,學士班(日間),馬來西亞,東協,27,20,7,24,17,7,3,3,0,0,0,0,0,0,0
109,私立,技專校院,1068,中州學校財團法人中州科技大學,學士班(日間),越南社會主義共和國,東協,5,2,3,5,2,3,0,0,0,0,0,0,0,0,0
109,私立,技專校院,1068,中州學校財團法人中州科技大學,學士班(日間),緬甸,東協,3,1,2,3,1,2,0,0,0,0,0,0,0,0,0
109,私立,技專校院,1068,中州學校財團法人中州科技大學,學士班(日間),史瓦帝尼王國,非洲,42,21,21,42,21,21,0,0,0,0,0,0,0,0,0
109,私立,技專校院,1068,中州學校財團法人中州科技大學,學士班(日間),塞內加爾共和國,非洲,1,1,0,1,1,0,0,0,0,0,0,0,0,0,0
109,私立,技專校院,1068,中州學校財團法人中州科技大學,學士班(日間),蒙古國,其他亞洲地區,8,4,4,8,4,4,0,0,0,0,0,0,0,0,0
109,私立,技專校院,1068,中州學校財團法人中州科技大學,碩士班(日間),馬來西亞,東協,2,2,0,2,2,0,0,0,0,0,0,0,0,0,0
109,私立,技專校院,1069,修平學校財團法人修平科技大學,學士班(日間),馬來西亞,東協,28,24,4,28,24,4,0,0,0,0,0,0,0,0,0
109,私立,技專校院,1069,修平學校財團法人修平科技大學,學士班(日間),越南社會主義共和國,東協,3,1,2,3,1,2,0,0,0,0,0,0,0,0,0
109,私立,技專校院,1069,修平學校財團法人修平科技大學,學士班(日間),澳門,港澳,1,1,0,0,0,0,0,0,0,1,1,0,0,0,0
109,私立,技專校院,1069,修平學校財團法人修平科技大學,學士班(日間),日本,其他亞洲地區,5,4,1,4,3,1,1,1,0,0,0,0,0,0,0
109,私立,技專校院,1069,修平學校財團法人修平科技大學,學士班(日間),印度尼西亞共和國,東協,82,50,32,82,50,32,0,0,0,0,0,0,0,0,0
109,私立,技專校院,1069,修平學校財團法人修平科技大學,學士班(日間),香港,港澳,3,1,2,0,0,0,0,0,0,3,1,2,0,0,0
109,私立,技專校院,1069,修平學校財團法人修平科技大學,碩士班(日間),印度尼西亞共和國,東協,1,1,0,1,1,0,0,0,0,0,0,0,0,0,0
109,私立,技專校院,1070,長庚學校財團法人長庚科技大學,學士班(日間),馬來西亞,東協,2,0,2,0,0,0,2,0,2,0,0,0,0,0,0
109,私立,技專校院,1070,長庚學校財團法人長庚科技大學,學士班(日間),大陸地區,大陸地區,1,0,1,0,0,0,0,0,0,0,0,0,1,0,1
109,私立,技專校院,1070,長庚學校財團法人長庚科技大學,學士班(日間),香港,港澳,27,9,18,0,0,0,0,0,0,27,9,18,0,0,0
109,私立,技專校院,1070,長庚學校財團法人長庚科技大學,學士班(日間),澳門,港澳,4,2,2,0,0,0,0,0,0,4,2,2,0,0,0
109,私立,技專校院,1071,城市學校財團法人臺北城市科技大學,學士班(日間),大陸地區,大陸地區,2,1,1,0,0,0,0,0,0,0,0,0,2,1,1
109,私立,技專校院,1071,城市學校財團法人臺北城市科技大學,學士班(日間),大韓民國(南韓),其他亞洲地區,1,0,1,1,0,1,0,0,0,0,0,0,0,0,0
109,私立,技專校院,1071,城市學校財團法人臺北城市科技大學,學士班(日間),巴西聯邦共和國,中南美洲,1,0,1,0,0,0,1,0,1,0,0,0,0,0,0
109,私立,技專校院,1071,城市學校財團法人臺北城市科技大學,學士班(日間),印度尼西亞共和國,東協,4,2,2,1,0,1,3,2,1,0,0,0,0,0,0
109,私立,技專校院,1071,城市學校財團法人臺北城市科技大學,學士班(日間),香港,港澳,21,11,10,0,0,0,0,0,0,21,11,10,0,0,0
109,私立,技專校院,1071,城市學校財團法人臺北城市科技大學,學士班(日間),馬來西亞,東協,27,16,11,16,11,5,11,5,6,0,0,0,0,0,0
109,私立,技專校院,1071,城市學校財團法人臺北城市科技大學,學士班(日間),馬拉威共和國,非洲,3,3,0,3,3,0,0,0,0,0,0,0,0,0,0
109,私立,技專校院,1071,城市學校財團法人臺北城市科技大學,學士班(日間),越南社會主義共和國,東協,214,78,136,176,74,102,38,4,34,0,0,0,0,0,0
109,私立,技專校院,1071,城市學校財團法人臺北城市科技大學,學士班(日間),澳門,港澳,4,1,3,0,0,0,0,0,0,4,1,3,0,0,0
109,私立,技專校院,1071,城市學校財團法人臺北城市科技大學,學士班(日間),日本,其他亞洲地區,1,0,1,1,0,1,0,0,0,0,0,0,0,0,0
109,私立,技專校院,1071,城市學校財團法人臺北城市科技大學,學士班(日間),泰國,東協,2,0,2,1,0,1,1,0,1,0,0,0,0,0,0
109,私立,技專校院,1071,城市學校財團法人臺北城市科技大學,學士班(日間),緬甸,東協,4,1,3,0,0,0,4,1,3,0,0,0,0,0,0
109,私立,技專校院,1071,城市學校財團法人臺北城市科技大學,碩士班(日間),泰國,東協,1,0,1,1,0,1,0,0,0,0,0,0,0,0,0
109,私立,技專校院,1071,城市學校財團法人臺北城市科技大學,碩士班(日間),越南社會主義共和國,東協,2,0,2,2,0,2,0,0,0,0,0,0,0,0,0
109,私立,技專校院,1071,城市學校財團法人臺北城市科技大學,碩士班(日間),印度尼西亞共和國,東協,1,0,1,0,0,0,1,0,1,0,0,0,0,0,0
109,私立,技專校院,1071,城市學校財團法人臺北城市科技大學,碩士班(日間),馬來西亞,東協,1,1,0,0,0,0,1,1,0,0,0,0,0,0,0
109,私立,技專校院,1072,大華學校財團法人敏實科技大學,學士班(日間),印度尼西亞共和國,東協,1,0,1,0,0,0,1,0,1,0,0,0,0,0,0
109,私立,技專校院,1072,大華學校財團法人敏實科技大學,學士班(日間),馬來西亞,東協,19,5,14,19,5,14,0,0,0,0,0,0,0,0,0
109,私立,技專校院,1073,醒吾學校財團法人醒吾科技大學,五專,尼加拉瓜,中南美洲,1,0,1,0,0,0,1,0,1,0,0,0,0,0,0
109,私立,技專校院,1073,醒吾學校財團法人醒吾科技大學,學士班(日間),大陸地區,大陸地區,2,0,2,0,0,0,0,0,0,0,0,0,2,0,2
109,私立,技專校院,1073,醒吾學校財團法人醒吾科技大學,學士班(日間),印度尼西亞共和國,東協,289,122,167,233,94,139,56,28,28,0,0,0,0,0,0
109,私立,技專校院,1073,醒吾學校財團法人醒吾科技大學,學士班(日間),烏茲別克共和國,其他亞洲地區,1,0,1,1,0,1,0,0,0,0,0,0,0,0,0
109,私立,技專校院,1073,醒吾學校財團法人醒吾科技大學,學士班(日間),越南社會主義共和國,東協,479,178,301,474,178,296,5,0,5,0,0,0,0,0,0
109,私立,技專校院,1073,醒吾學校財團法人醒吾科技大學,學士班(日間),塞內加爾共和國,非洲,1,1,0,1,1,0,0,0,0,0,0,0,0,0,0
109,私立,技專校院,1073,醒吾學校財團法人醒吾科技大學,學士班(日間),澳門,港澳,5,1,4,0,0,0,0,0,0,5,1,4,0,0,0
109,私立,技專校院,1073,醒吾學校財團法人醒吾科技大學,學士班(日間),日本,其他亞洲地區,7,4,3,7,4,3,0,0,0,0,0,0,0,0,0
109,私立,技專校院,1073,醒吾學校財團法人醒吾科技大學,學士班(日間),美國,北美洲,1,1,0,1,1,0,0,0,0,0,0,0,0,0,0
109,私立,技專校院,1073,醒吾學校財團法人醒吾科技大學,學士班(日間),香港,港澳,18,6,12,0,0,0,0,0,0,18,6,12,0,0,0
109,私立,技專校院,1073,醒吾學校財團法人醒吾科技大學,學士班(日間),紐西蘭,其他亞洲地區,1,1,0,0,0,0,1,1,0,0,0,0,0,0,0
109,私立,技專校院,1073,醒吾學校財團法人醒吾科技大學,學士班(日間),馬來西亞,東協,19,8,11,8,4,4,11,4,7,0,0,0,0,0,0
109,私立,技專校院,1073,醒吾學校財團法人醒吾科技大學,學士班(日間),緬甸,東協,2,2,0,0,0,0,2,2,0,0,0,0,0,0,0
109,私立,技專校院,1073,醒吾學校財團法人醒吾科技大學,碩士班(日間),馬來西亞,東協,1,0,1,1,0,1,0,0,0,0,0,0,0,0,0
109,私立,技專校院,1075,文藻學校財團法人文藻外語大學,五專,日本,其他亞洲地區,3,0,3,1,0,1,2,0,2,0,0,0,0,0,0
109,私立,技專校院,1075,文藻學校財團法人文藻外語大學,五專,泰國,東協,2,1,1,0,0,0,2,1,1,0,0,0,0,0,0
109,私立,技專校院,1075,文藻學校財團法人文藻外語大學,五專,馬紹爾群島共和國,其他亞洲地區,1,0,1,0,0,0,1,0,1,0,0,0,0,0,0
109,私立,技專校院,1075,文藻學校財團法人文藻外語大學,五專,越南社會主義共和國,東協,1,0,1,0,0,0,1,0,1,0,0,0,0,0,0
109,私立,技專校院,1075,文藻學校財團法人文藻外語大學,五專,義大利共和國,歐洲,1,0,1,1,0,1,0,0,0,0,0,0,0,0,0
109,私立,技專校院,1075,文藻學校財團法人文藻外語大學,五專,大韓民國(南韓),其他亞洲地區,1,1,0,1,1,0,0,0,0,0,0,0,0,0,0
109,私立,技專校院,1075,文藻學校財團法人文藻外語大學,五專,印度尼西亞共和國,東協,1,0,1,0,0,0,1,0,1,0,0,0,0,0,0
109,私立,技專校院,1075,文藻學校財團法人文藻外語大學,五專,阿根廷,中南美洲,1,1,0,0,0,0,1,1,0,0,0,0,0,0,0
109,私立,技專校院,1075,文藻學校財團法人文藻外語大學,五專,哥斯大黎加共和國,中南美洲,1,0,1,0,0,0,1,0,1,0,0,0,0,0,0
109,私立,技專校院,1075,文藻學校財團法人文藻外語大學,學士班(日間),巴西聯邦共和國,中南美洲,3,1,2,3,1,2,0,0,0,0,0,0,0,0,0
109,私立,技專校院,1075,文藻學校財團法人文藻外語大學,學士班(日間),日本,其他亞洲地區,51,16,35,51,16,35,0,0,0,0,0,0,0,0,0
109,私立,技專校院,1075,文藻學校財團法人文藻外語大學,學士班(日間),尼加拉瓜,中南美洲,2,2,0,2,2,0,0,0,0,0,0,0,0,0,0
109,私立,技專校院,1075,文藻學校財團法人文藻外語大學,學士班(日間),西班牙王國,歐洲,2,2,0,2,2,0,0,0,0,0,0,0,0,0,0
109,私立,技專校院,1075,文藻學校財團法人文藻外語大學,學士班(日間),奈及利亞聯邦共和國,非洲,2,1,1,2,1,1,0,0,0,0,0,0,0,0,0
109,私立,技專校院,1075,文藻學校財團法人文藻外語大學,學士班(日間),俄羅斯聯邦,其他亞洲地區,4,3,1,4,3,1,0,0,0,0,0,0,0,0,0
109,私立,技專校院,1075,文藻學校財團法人文藻外語大學,學士班(日間),美國,北美洲,9,4,5,9,4,5,0,0,0,0,0,0,0,0,0
109,私立,技專校院,1075,文藻學校財團法人文藻外語大學,學士班(日間),義大利共和國,歐洲,3,2,1,3,2,1,0,0,0,0,0,0,0,0,0
109,私立,技專校院,1075,文藻學校財團法人文藻外語大學,學士班(日間),葡萄牙共和國,歐洲,1,1,0,1,1,0,0,0,0,0,0,0,0,0,0
109,私立,技專校院,1075,文藻學校財團法人文藻外語大學,學士班(日間),蒙古國,其他亞洲地區,2,1,1,2,1,1,0,0,0,0,0,0,0,0,0
109,私立,技專校院,1075,文藻學校財團法人文藻外語大學,學士班(日間),德意志聯邦共和國,歐洲,1,1,0,1,1,0,0,0,0,0,0,0,0,0,0
109,私立,技專校院,1075,文藻學校財團法人文藻外語大學,學士班(日間),大陸地區,大陸地區,32,12,20,0,0,0,0,0,0,0,0,0,32,12,20
109,私立,技專校院,1075,文藻學校財團法人文藻外語大學,學士班(日間),大韓民國(南韓),其他亞洲地區,4,2,2,4,2,2,0,0,0,0,0,0,0,0,0
109,私立,技專校院,1075,文藻學校財團法人文藻外語大學,學士班(日間),印度,南亞,5,0,5,5,0,5,0,0,0,0,0,0,0,0,0
109,私立,技專校院,1075,文藻學校財團法人文藻外語大學,學士班(日間),印度尼西亞共和國,東協,37,5,32,34,5,29,3,0,3,0,0,0,0,0,0
109,私立,技專校院,1075,文藻學校財團法人文藻外語大學,學士班(日間),波蘭共和國,歐洲,1,1,0,1,1,0,0,0,0,0,0,0,0,0,0
109,私立,技專校院,1075,文藻學校財團法人文藻外語大學,學士班(日間),法國,歐洲,2,2,0,2,2,0,0,0,0,0,0,0,0,0,0
109,私立,技專校院,1075,文藻學校財團法人文藻外語大學,學士班(日間),肯亞共和國,非洲,1,1,0,1,1,0,0,0,0,0,0,0,0,0,0
109,私立,技專校院,1075,文藻學校財團法人文藻外語大學,學士班(日間),南非共和國,非洲,1,1,0,1,1,0,0,0,0,0,0,0,0,0,0
109,私立,技專校院,1075,文藻學校財團法人文藻外語大學,學士班(日間),香港,港澳,32,10,22,0,0,0,0,0,0,32,10,22,0,0,0
109,私立,技專校院,1075,文藻學校財團法人文藻外語大學,學士班(日間),哥倫比亞共和國,中南美洲,1,0,1,1,0,1,0,0,0,0,0,0,0,0,0
109,私立,技專校院,1075,文藻學校財團法人文藻外語大學,學士班(日間),泰國,東協,3,0,3,2,0,2,1,0,1,0,0,0,0,0,0
109,私立,技專校院,1075,文藻學校財團法人文藻外語大學,學士班(日間),秘魯共和國,中南美洲,4,1,3,3,1,2,1,0,1,0,0,0,0,0,0
109,私立,技專校院,1075,文藻學校財團法人文藻外語大學,學士班(日間),馬來西亞,東協,22,5,17,13,3,10,9,2,7,0,0,0,0,0,0
109,私立,技專校院,1075,文藻學校財團法人文藻外語大學,學士班(日間),荷蘭王國,歐洲,1,1,0,1,1,0,0,0,0,0,0,0,0,0,0
109,私立,技專校院,1075,文藻學校財團法人文藻外語大學,學士班(日間),菲律賓共和國,東協,1,0,1,0,0,0,1,0,1,0,0,0,0,0,0
109,私立,技專校院,1075,文藻學校財團法人文藻外語大學,學士班(日間),越南社會主義共和國,東協,62,11,51,58,9,49,4,2,2,0,0,0,0,0,0
109,私立,技專校院,1075,文藻學校財團法人文藻外語大學,學士班(日間),聖文森(及格瑞那丁),中南美洲,1,1,0,1,1,0,0,0,0,0,0,0,0,0,0
109,私立,技專校院,1075,文藻學校財團法人文藻外語大學,學士班(日間),緬甸,東協,1,1,0,0,0,0,1,1,0,0,0,0,0,0,0
109,私立,技專校院,1075,文藻學校財團法人文藻外語大學,學士班(日間),澳門,港澳,1,0,1,0,0,0,0,0,0,1,0,1,0,0,0
109,私立,技專校院,1075,文藻學校財團法人文藻外語大學,碩士班(日間),土耳其共和國,其他亞洲地區,1,1,0,1,1,0,0,0,0,0,0,0,0,0,0
109,私立,技專校院,1075,文藻學校財團法人文藻外語大學,碩士班(日間),大陸地區,大陸地區,2,1,1,0,0,0,0,0,0,0,0,0,2,1,1
109,私立,技專校院,1075,文藻學校財團法人文藻外語大學,碩士班(日間),大韓民國(南韓),其他亞洲地區,2,1,1,2,1,1,0,0,0,0,0,0,0,0,0
109,私立,技專校院,1075,文藻學校財團法人文藻外語大學,碩士班(日間),印度,南亞,1,1,0,1,1,0,0,0,0,0,0,0,0,0,0
109,私立,技專校院,1075,文藻學校財團法人文藻外語大學,碩士班(日間),印度尼西亞共和國,東協,4,1,3,3,1,2,1,0,1,0,0,0,0,0,0
109,私立,技專校院,1075,文藻學校財團法人文藻外語大學,碩士班(日間),波蘭共和國,歐洲,1,0,1,1,0,1,0,0,0,0,0,0,0,0,0
109,私立,技專校院,1075,文藻學校財團法人文藻外語大學,碩士班(日間),法國,歐洲,4,1,3,4,1,3,0,0,0,0,0,0,0,0,0
109,私立,技專校院,1075,文藻學校財團法人文藻外語大學,碩士班(日間),英國,歐洲,1,1,0,1,1,0,0,0,0,0,0,0,0,0,0
109,私立,技專校院,1075,文藻學校財團法人文藻外語大學,碩士班(日間),馬來西亞,東協,2,0,2,2,0,2,0,0,0,0,0,0,0,0,0
109,私立,技專校院,1075,文藻學校財團法人文藻外語大學,碩士班(日間),菲律賓共和國,東協,2,0,2,2,0,2,0,0,0,0,0,0,0,0,0
109,私立,技專校院,1075,文藻學校財團法人文藻外語大學,碩士班(日間),越南社會主義共和國,東協,15,5,10,15,5,10,0,0,0,0,0,0,0,0,0
109,私立,技專校院,1075,文藻學校財團法人文藻外語大學,碩士班(日間),日本,其他亞洲地區,3,0,3,3,0,3,0,0,0,0,0,0,0,0,0
109,私立,技專校院,1075,文藻學校財團法人文藻外語大學,碩士班(日間),尼加拉瓜,中南美洲,1,0,1,1,0,1,0,0,0,0,0,0,0,0,0
109,私立,技專校院,1075,文藻學校財團法人文藻外語大學,碩士班(日間),西班牙王國,歐洲,5,2,3,5,2,3,0,0,0,0,0,0,0,0,0
109,私立,技專校院,1075,文藻學校財團法人文藻外語大學,碩士班(日間),美國,北美洲,2,2,0,2,2,0,0,0,0,0,0,0,0,0,0
109,私立,技專校院,1075,文藻學校財團法人文藻外語大學,碩士班(日間),澳大利亞,其他亞洲地區,1,1,0,1,1,0,0,0,0,0,0,0,0,0,0
109,私立,技專校院,1076,華夏學校財團法人華夏科技大學,學士班(日間),日本,其他亞洲地區,1,1,0,1,1,0,0,0,0,0,0,0,0,0,0
109,私立,技專校院,1076,華夏學校財團法人華夏科技大學,學士班(日間),香港,港澳,5,1,4,0,0,0,0,0,0,5,1,4,0,0,0
109,私立,技專校院,1076,華夏學校財團法人華夏科技大學,學士班(日間),越南社會主義共和國,東協,78,39,39,77,38,39,1,1,0,0,0,0,0,0,0
109,私立,技專校院,1076,華夏學校財團法人華夏科技大學,學士班(日間),緬甸,東協,15,7,8,15,7,8,0,0,0,0,0,0,0,0,0
109,私立,技專校院,1076,華夏學校財團法人華夏科技大學,學士班(日間),澳門,港澳,2,1,1,0,0,0,0,0,0,2,1,1,0,0,0
109,私立,技專校院,1076,華夏學校財團法人華夏科技大學,學士班(日間),大陸地區,大陸地區,1,1,0,0,0,0,0,0,0,0,0,0,1,1,0
109,私立,技專校院,1076,華夏學校財團法人華夏科技大學,學士班(日間),大韓民國(南韓),其他亞洲地區,1,0,1,1,0,1,0,0,0,0,0,0,0,0,0
109,私立,技專校院,1076,華夏學校財團法人華夏科技大學,學士班(日間),印度尼西亞共和國,東協,2,0,2,2,0,2,0,0,0,0,0,0,0,0,0
109,私立,技專校院,1076,華夏學校財團法人華夏科技大學,學士班(日間),馬來西亞,東協,4,0,4,2,0,2,2,0,2,0,0,0,0,0,0
109,私立,技專校院,1077,慈濟學校財團法人慈濟科技大學,二專(日間),菲律賓共和國,東協,32,12,20,32,12,20,0,0,0,0,0,0,0,0,0
109,私立,技專校院,1077,慈濟學校財團法人慈濟科技大學,五專,印度尼西亞共和國,東協,1,0,1,0,0,0,1,0,1,0,0,0,0,0,0
109,私立,技專校院,1077,慈濟學校財團法人慈濟科技大學,五專,泰國,東協,4,1,3,4,1,3,0,0,0,0,0,0,0,0,0
109,私立,技專校院,1077,慈濟學校財團法人慈濟科技大學,五專,馬來西亞,東協,9,5,4,9,5,4,0,0,0,0,0,0,0,0,0
109,私立,技專校院,1077,慈濟學校財團法人慈濟科技大學,學士班(日間),泰國,東協,6,0,6,3,0,3,3,0,3,0,0,0,0,0,0
109,私立,技專校院,1077,慈濟學校財團法人慈濟科技大學,學士班(日間),馬來西亞,東協,112,53,59,95,46,49,17,7,10,0,0,0,0,0,0
109,私立,技專校院,1077,慈濟學校財團法人慈濟科技大學,學士班(日間),菲律賓共和國,東協,2,1,1,2,1,1,0,0,0,0,0,0,0,0,0
109,私立,技專校院,1077,慈濟學校財團法人慈濟科技大學,學士班(日間),越南社會主義共和國,東協,4,2,2,4,2,2,0,0,0,0,0,0,0,0,0
109,私立,技專校院,1077,慈濟學校財團法人慈濟科技大學,學士班(日間),尼泊爾聯邦民主共和國,南亞,2,0,2,2,0,2,0,0,0,0,0,0,0,0,0
109,私立,技專校院,1077,慈濟學校財團法人慈濟科技大學,學士班(日間),印度尼西亞共和國,東協,50,33,17,50,33,17,0,0,0,0,0,0,0,0,0
109,私立,技專校院,1077,慈濟學校財團法人慈濟科技大學,學士班(日間),香港,港澳,8,5,3,0,0,0,0,0,0,8,5,3,0,0,0
109,私立,技專校院,1077,慈濟學校財團法人慈濟科技大學,碩士班(日間),馬來西亞,東協,3,2,1,2,1,1,1,1,0,0,0,0,0,0,0
109,私立,技專校院,1078,致理學校財團法人致理科技大學,五專,美國,北美洲,1,1,0,1,1,0,0,0,0,0,0,0,0,0,0
109,私立,技專校院,1078,致理學校財團法人致理科技大學,學士班(日間),大陸地區,大陸地區,9,6,3,0,0,0,0,0,0,0,0,0,9,6,3
109,私立,技專校院,1078,致理學校財團法人致理科技大學,學士班(日間),印度尼西亞共和國,東協,2,1,1,0,0,0,2,1,1,0,0,0,0,0,0
109,私立,技專校院,1078,致理學校財團法人致理科技大學,學士班(日間),南非共和國,非洲,1,1,0,0,0,0,1,1,0,0,0,0,0,0,0
109,私立,技專校院,1078,致理學校財團法人致理科技大學,學士班(日間),香港,港澳,48,22,26,0,0,0,0,0,0,48,22,26,0,0,0
109,私立,技專校院,1078,致理學校財團法人致理科技大學,學士班(日間),馬來西亞,東協,10,4,6,9,3,6,1,1,0,0,0,0,0,0,0
109,私立,技專校院,1078,致理學校財團法人致理科技大學,學士班(日間),越南社會主義共和國,東協,163,40,123,163,40,123,0,0,0,0,0,0,0,0,0
109,私立,技專校院,1078,致理學校財團法人致理科技大學,學士班(日間),日本,其他亞洲地區,4,3,1,4,3,1,0,0,0,0,0,0,0,0,0
109,私立,技專校院,1078,致理學校財團法人致理科技大學,學士班(日間),汶萊和平之國,東協,1,1,0,1,1,0,0,0,0,0,0,0,0,0,0
109,私立,技專校院,1078,致理學校財團法人致理科技大學,學士班(日間),泰國,東協,4,1,3,2,1,1,2,0,2,0,0,0,0,0,0
109,私立,技專校院,1078,致理學校財團法人致理科技大學,碩士班(日間),香港,港澳,1,0,1,0,0,0,0,0,0,1,0,1,0,0,0
109,私立,技專校院,1078,致理學校財團法人致理科技大學,碩士班(日間),越南社會主義共和國,東協,4,1,3,4,1,3,0,0,0,0,0,0,0,0,0
109,私立,一般大學,1079,康寧學校財團法人康寧大學,五專,義大利共和國,歐洲,1,0,1,1,0,1,0,0,0,0,0,0,0,0,0
109,私立,一般大學,1079,康寧學校財團法人康寧大學,五專,泰國,東協,1,0,1,1,0,1,0,0,0,0,0,0,0,0,0
109,私立,一般大學,1079,康寧學校財團法人康寧大學,五專,馬來西亞,東協,1,0,1,0,0,0,1,0,1,0,0,0,0,0,0
109,私立,一般大學,1079,康寧學校財團法人康寧大學,學士班(日間),斯里蘭卡民主社會主義共和國,南亞,22,20,2,22,20,2,0,0,0,0,0,0,0,0,0
109,私立,一般大學,1079,康寧學校財團法人康寧大學,學士班(日間),緬甸,東協,4,0,4,4,0,4,0,0,0,0,0,0,0,0,0
109,私立,一般大學,1079,康寧學校財團法人康寧大學,學士班(日間),馬來西亞,東協,3,1,2,1,0,1,2,1,1,0,0,0,0,0,0
109,私立,一般大學,1079,康寧學校財團法人康寧大學,碩士班(日間),越南社會主義共和國,東協,1,0,1,1,0,1,0,0,0,0,0,0,0,0,0
109,私立,技專校院,1080,宏國學校財團法人宏國德霖科技大學,學士班(日間),大韓民國(南韓),其他亞洲地區,1,1,0,1,1,0,0,0,0,0,0,0,0,0,0
109,私立,技專校院,1080,宏國學校財團法人宏國德霖科技大學,學士班(日間),印度尼西亞共和國,東協,2,1,1,0,0,0,2,1,1,0,0,0,0,0,0
109,私立,技專校院,1080,宏國學校財團法人宏國德霖科技大學,學士班(日間),香港,港澳,1,1,0,0,0,0,0,0,0,1,1,0,0,0,0
109,私立,技專校院,1080,宏國學校財團法人宏國德霖科技大學,學士班(日間),馬來西亞,東協,6,4,2,0,0,0,6,4,2,0,0,0,0,0,0
109,私立,技專校院,1080,宏國學校財團法人宏國德霖科技大學,學士班(日間),越南社會主義共和國,東協,72,28,44,72,28,44,0,0,0,0,0,0,0,0,0
109,私立,技專校院,1080,宏國學校財團法人宏國德霖科技大學,學士班(日間),澳門,港澳,1,1,0,0,0,0,0,0,0,1,1,0,0,0,0
109,私立,技專校院,1081,東方學校財團法人東方設計大學,五專,馬來西亞,東協,1,0,1,0,0,0,1,0,1,0,0,0,0,0,0
109,私立,技專校院,1081,東方學校財團法人東方設計大學,學士班(日間),馬來西亞,東協,2,2,0,0,0,0,2,2,0,0,0,0,0,0,0
109,私立,技專校院,1081,東方學校財團法人東方設計大學,學士班(日間),大陸地區,大陸地區,1,1,0,0,0,0,0,0,0,0,0,0,1,1,0
109,私立,技專校院,1081,東方學校財團法人東方設計大學,學士班(日間),印度尼西亞共和國,東協,128,88,40,127,87,40,1,1,0,0,0,0,0,0,0
109,私立,技專校院,1081,東方學校財團法人東方設計大學,學士班(日間),香港,港澳,1,0,1,0,0,0,0,0,0,1,0,1,0,0,0
109,私立,技專校院,1081,東方學校財團法人東方設計大學,學士班(日間),越南社會主義共和國,東協,13,6,7,13,6,7,0,0,0,0,0,0,0,0,0
109,私立,技專校院,1081,東方學校財團法人東方設計大學,學士班(日間),緬甸,東協,35,20,15,34,19,15,1,1,0,0,0,0,0,0,0
109,私立,技專校院,1081,東方學校財團法人東方設計大學,學士班(日間),澳門,港澳,1,1,0,0,0,0,0,0,0,1,1,0,0,0,0
109,私立,技專校院,1081,東方學校財團法人東方設計大學,碩士班(日間),肯亞共和國,非洲,1,1,0,1,1,0,0,0,0,0,0,0,0,0,0
109,私立,技專校院,1081,東方學校財團法人東方設計大學,碩士班(日間),越南社會主義共和國,東協,7,5,2,7,5,2,0,0,0,0,0,0,0,0,0
109,私立,技專校院,1081,東方學校財團法人東方設計大學,碩士班(日間),日本,其他亞洲地區,1,0,1,1,0,1,0,0,0,0,0,0,0,0,0
109,私立,技專校院,1081,東方學校財團法人東方設計大學,博士班,大陸地區,大陸地區,1,1,0,0,0,0,0,0,0,0,0,0,1,1,0
109,私立,技專校院,1082,崇右學校財團法人崇右影藝科技大學,學士班(日間),香港,港澳,5,2,3,0,0,0,0,0,0,5,2,3,0,0,0
109,私立,技專校院,1082,崇右學校財團法人崇右影藝科技大學,學士班(日間),越南社會主義共和國,東協,120,38,82,102,31,71,18,7,11,0,0,0,0,0,0
109,私立,技專校院,1082,崇右學校財團法人崇右影藝科技大學,學士班(日間),緬甸,東協,8,3,5,8,3,5,0,0,0,0,0,0,0,0,0
109,私立,技專校院,1082,崇右學校財團法人崇右影藝科技大學,學士班(日間),澳門,港澳,2,0,2,0,0,0,0,0,0,2,0,2,0,0,0
109,私立,技專校院,1082,崇右學校財團法人崇右影藝科技大學,學士班(日間),印度尼西亞共和國,東協,89,49,40,88,49,39,1,0,1,0,0,0,0,0,0
109,私立,技專校院,1082,崇右學校財團法人崇右影藝科技大學,學士班(日間),泰國,東協,1,1,0,0,0,0,1,1,0,0,0,0,0,0,0
109,私立,技專校院,1082,崇右學校財團法人崇右影藝科技大學,學士班(日間),馬來西亞,東協,3,2,1,2,1,1,1,1,0,0,0,0,0,0,0
109,私立,技專校院,1082,崇右學校財團法人崇右影藝科技大學,學士班(日間),菲律賓共和國,東協,1,1,0,0,0,0,1,1,0,0,0,0,0,0,0
109,私立,技專校院,1083,台北海洋學校財團法人台北海洋科技大學,五專,越南社會主義共和國,東協,1,1,0,1,1,0,0,0,0,0,0,0,0,0,0
109,私立,技專校院,1083,台北海洋學校財團法人台北海洋科技大學,學士班(日間),大韓民國(南韓),其他亞洲地區,1,0,1,1,0,1,0,0,0,0,0,0,0,0,0
109,私立,技專校院,1083,台北海洋學校財團法人台北海洋科技大學,學士班(日間),印度尼西亞共和國,東協,34,21,13,33,20,13,1,1,0,0,0,0,0,0,0
109,私立,技專校院,1083,台北海洋學校財團法人台北海洋科技大學,學士班(日間),香港,港澳,4,2,2,0,0,0,0,0,0,4,2,2,0,0,0
109,私立,技專校院,1083,台北海洋學校財團法人台北海洋科技大學,學士班(日間),馬來西亞,東協,10,3,7,1,0,1,9,3,6,0,0,0,0,0,0
109,私立,技專校院,1083,台北海洋學校財團法人台北海洋科技大學,學士班(日間),菲律賓共和國,東協,48,16,32,48,16,32,0,0,0,0,0,0,0,0,0
109,私立,技專校院,1083,台北海洋學校財團法人台北海洋科技大學,學士班(日間),日本,其他亞洲地區,1,0,1,1,0,1,0,0,0,0,0,0,0,0,0
109,私立,技專校院,1083,台北海洋學校財團法人台北海洋科技大學,學士班(日間),委內瑞拉共和國,中南美洲,1,0,1,1,0,1,0,0,0,0,0,0,0,0,0
109,私立,技專校院,1083,台北海洋學校財團法人台北海洋科技大學,學士班(日間),泰國,東協,1,0,1,0,0,0,1,0,1,0,0,0,0,0,0
109,私立,技專校院,1083,台北海洋學校財團法人台北海洋科技大學,學士班(日間),越南社會主義共和國,東協,1,0,1,1,0,1,0,0,0,0,0,0,0,0,0
109,私立,技專校院,1083,台北海洋學校財團法人台北海洋科技大學,學士班(日間),緬甸,東協,1,0,1,0,0,0,1,0,1,0,0,0,0,0,0
109,私立,技專校院,1083,台北海洋學校財團法人台北海洋科技大學,碩士班(日間),菲律賓共和國,東協,5,0,5,5,0,5,0,0,0,0,0,0,0,0,0
109,私立,一般大學,1125,中信學校財團法人中信金融管理學院,學士班(日間),大陸地區,大陸地區,1,1,0,0,0,0,0,0,0,0,0,0,1,1,0
109,私立,一般大學,1125,中信學校財團法人中信金融管理學院,學士班(日間),日本,其他亞洲地區,4,3,1,4,3,1,0,0,0,0,0,0,0,0,0
109,私立,一般大學,1125,中信學校財團法人中信金融管理學院,學士班(日間),加拿大,北美洲,1,1,0,1,1,0,0,0,0,0,0,0,0,0,0
109,私立,一般大學,1125,中信學校財團法人中信金融管理學院,學士班(日間),俄羅斯聯邦,其他亞洲地區,1,1,0,1,1,0,0,0,0,0,0,0,0,0,0
109,私立,一般大學,1125,中信學校財團法人中信金融管理學院,學士班(日間),格瑞那達,中南美洲,1,0,1,1,0,1,0,0,0,0,0,0,0,0,0
109,私立,一般大學,1125,中信學校財團法人中信金融管理學院,學士班(日間),泰國,東協,1,0,1,1,0,1,0,0,0,0,0,0,0,0,0
109,私立,一般大學,1125,中信學校財團法人中信金融管理學院,學士班(日間),甘比亞共和國,非洲,1,0,1,1,0,1,0,0,0,0,0,0,0,0,0
109,私立,一般大學,1125,中信學校財團法人中信金融管理學院,碩士班(日間),泰國,東協,2,2,0,2,2,0,0,0,0,0,0,0,0,0,0
109,私立,一般大學,1125,中信學校財團法人中信金融管理學院,碩士班(日間),印度,南亞,1,1,0,1,1,0,0,0,0,0,0,0,0,0,0
109,私立,一般大學,1125,中信學校財團法人中信金融管理學院,碩士班(日間),俄羅斯聯邦,其他亞洲地區,1,1,0,1,1,0,0,0,0,0,0,0,0,0,0
109,私立,一般大學,1125,中信學校財團法人中信金融管理學院,碩士班(日間),菲律賓共和國,東協,3,0,3,3,0,3,0,0,0,0,0,0,0,0,0
109,私立,技專校院,1159,和春技術學院,五專,越南社會主義共和國,東協,6,0,6,6,0,6,0,0,0,0,0,0,0,0,0
109,私立,技專校院,1159,和春技術學院,學士班(日間),越南社會主義共和國,東協,8,5,3,8,5,3,0,0,0,0,0,0,0,0,0
109,私立,技專校院,1166,亞東技術學院,學士班(日間),越南社會主義共和國,東協,2,2,0,1,1,0,1,1,0,0,0,0,0,0,0
109,私立,技專校院,1166,亞東技術學院,學士班(日間),約旦哈什米王國,其他亞洲地區,1,0,1,1,0,1,0,0,0,0,0,0,0,0,0
109,私立,技專校院,1166,亞東技術學院,碩士班(日間),約旦哈什米王國,其他亞洲地區,1,1,0,1,1,0,0,0,0,0,0,0,0,0,0
109,私立,技專校院,1168,南亞科技學校財團法人南亞技術學院,學士班(日間),越南社會主義共和國,東協,6,1,5,6,1,5,0,0,0,0,0,0,0,0,0
109,私立,技專校院,1182,蘭陽技術學院,學士班(日間),越南社會主義共和國,東協,1,0,1,1,0,1,0,0,0,0,0,0,0,0,0
109,私立,技專校院,1183,黎明技術學院,學士班(日間),印度尼西亞共和國,東協,1,0,1,0,0,0,1,0,1,0,0,0,0,0,0
109,私立,技專校院,1183,黎明技術學院,學士班(日間),馬來西亞,東協,51,19,32,27,10,17,24,9,15,0,0,0,0,0,0
109,私立,技專校院,1183,黎明技術學院,學士班(日間),香港,港澳,6,2,4,0,0,0,0,0,0,6,2,4,0,0,0
109,私立,技專校院,1183,黎明技術學院,學士班(日間),泰國,東協,1,0,1,0,0,0,1,0,1,0,0,0,0,0,0
109,私立,技專校院,1183,黎明技術學院,學士班(日間),越南社會主義共和國,東協,457,308,149,403,295,108,54,13,41,0,0,0,0,0,0
109,私立,技專校院,1183,黎明技術學院,學士班(日間),緬甸,東協,4,0,4,0,0,0,4,0,4,0,0,0,0,0,0
109,私立,技專校院,1185,經國管理暨健康學院,學士班(日間),香港,港澳,2,2,0,0,0,0,0,0,0,2,2,0,0,0,0
109,私立,技專校院,1185,經國管理暨健康學院,學士班(日間),越南社會主義共和國,東協,238,99,139,238,99,139,0,0,0,0,0,0,0,0,0
109,私立,技專校院,1185,經國管理暨健康學院,學士班(日間),馬來西亞,東協,26,23,3,9,8,1,17,15,2,0,0,0,0,0,0
109,私立,技專校院,1188,大同技術學院,學士班(日間),印度尼西亞共和國,東協,17,12,5,17,12,5,0,0,0,0,0,0,0,0,0
109,私立,技專校院,1188,大同技術學院,學士班(日間),巴西聯邦共和國,中南美洲,1,0,1,0,0,0,1,0,1,0,0,0,0,0,0
109,私立,技專校院,1188,大同技術學院,學士班(日間),馬來西亞,東協,1,0,1,0,0,0,1,0,1,0,0,0,0,0,0
109,私立,技專校院,1188,大同技術學院,學士班(日間),越南社會主義共和國,東協,4,0,4,2,0,2,2,0,2,0,0,0,0,0,0
109,私立,一般大學,1195,馬偕學校財團法人馬偕醫學院,學士班(日間),加拿大,北美洲,1,0,1,0,0,0,1,0,1,0,0,0,0,0,0
109,私立,一般大學,1195,馬偕學校財團法人馬偕醫學院,學士班(日間),香港,港澳,7,5,2,0,0,0,0,0,0,7,5,2,0,0,0
109,私立,一般大學,1195,馬偕學校財團法人馬偕醫學院,學士班(日間),澳門,港澳,1,0,1,0,0,0,0,0,0,1,0,1,0,0,0
109,私立,一般大學,1195,馬偕學校財團法人馬偕醫學院,學士班(日間),大韓民國(南韓),其他亞洲地區,2,1,1,0,0,0,2,1,1,0,0,0,0,0,0
109,私立,一般大學,1196,法鼓學校財團法人法鼓文理學院,學士班(日間),香港,港澳,3,1,2,0,0,0,0,0,0,3,1,2,0,0,0
109,私立,一般大學,1196,法鼓學校財團法人法鼓文理學院,學士班(日間),印度尼西亞共和國,東協,1,0,1,1,0,1,0,0,0,0,0,0,0,0,0
109,私立,一般大學,1196,法鼓學校財團法人法鼓文理學院,學士班(日間),挪威王國,歐洲,1,1,0,1,1,0,0,0,0,0,0,0,0,0,0
109,私立,一般大學,1196,法鼓學校財團法人法鼓文理學院,學士班(日間),泰國,東協,2,2,0,2,2,0,0,0,0,0,0,0,0,0,0
109,私立,一般大學,1196,法鼓學校財團法人法鼓文理學院,學士班(日間),越南社會主義共和國,東協,8,3,5,8,3,5,0,0,0,0,0,0,0,0,0
109,私立,一般大學,1196,法鼓學校財團法人法鼓文理學院,碩士班(日間),香港,港澳,2,2,0,0,0,0,0,0,0,2,2,0,0,0,0
109,私立,一般大學,1196,法鼓學校財團法人法鼓文理學院,碩士班(日間),泰國,東協,1,1,0,1,1,0,0,0,0,0,0,0,0,0,0
109,私立,一般大學,1196,法鼓學校財團法人法鼓文理學院,碩士班(日間),馬來西亞,東協,5,2,3,5,2,3,0,0,0,0,0,0,0,0,0
109,私立,一般大學,1196,法鼓學校財團法人法鼓文理學院,碩士班(日間),越南社會主義共和國,東協,7,1,6,7,1,6,0,0,0,0,0,0,0,0,0
109,私立,一般大學,1196,法鼓學校財團法人法鼓文理學院,碩士班(日間),瑞士聯邦,歐洲,1,0,1,1,0,1,0,0,0,0,0,0,0,0,0
109,私立,一般大學,1196,法鼓學校財團法人法鼓文理學院,碩士班(日間),大韓民國(南韓),其他亞洲地區,1,1,0,1,1,0,0,0,0,0,0,0,0,0,0
109,私立,一般大學,1196,法鼓學校財團法人法鼓文理學院,碩士班(日間),愛爾蘭共和國,歐洲,1,1,0,1,1,0,0,0,0,0,0,0,0,0,0
109,私立,一般大學,1196,法鼓學校財團法人法鼓文理學院,碩士班(日間),新加坡共和國,東協,1,1,0,1,1,0,0,0,0,0,0,0,0,0,0
109,私立,一般大學,1196,法鼓學校財團法人法鼓文理學院,碩士班(日間),德意志聯邦共和國,歐洲,1,1,0,1,1,0,0,0,0,0,0,0,0,0,0
109,私立,一般大學,1196,法鼓學校財團法人法鼓文理學院,博士班,波蘭共和國,歐洲,1,1,0,1,1,0,0,0,0,0,0,0,0,0,0
109,私立,一般大學,1196,法鼓學校財團法人法鼓文理學院,博士班,馬來西亞,東協,1,1,0,1,1,0,0,0,0,0,0,0,0,0,0
109,私立,一般大學,1196,法鼓學校財團法人法鼓文理學院,博士班,大陸地區,大陸地區,2,2,0,0,0,0,0,0,0,0,0,0,2,2,0
109,私立,一般大學,1196,法鼓學校財團法人法鼓文理學院,博士班,香港,港澳,1,1,0,0,0,0,0,0,0,1,1,0,0,0,0
109,私立,技專校院,1284,樹人醫護管理專科學校,五專,尼加拉瓜,中南美洲,2,1,1,2,1,1,0,0,0,0,0,0,0,0,0
109,私立,技專校院,1286,耕莘健康管理專科學校,五專,馬來西亞,東協,1,0,1,1,0,1,0,0,0,0,0,0,0,0,0
109,私立,技專校院,1286,耕莘健康管理專科學校,五專,越南社會主義共和國,東協,2,0,2,0,0,0,2,0,2,0,0,0,0,0,0
109,私立,技專校院,1287,敏惠醫護管理專科學校,五專,菲律賓共和國,東協,1,0,1,1,0,1,0,0,0,0,0,0,0,0,0
109,私立,技專校院,1289,育英醫護管理專科學校,五專,日本,其他亞洲地區,1,0,1,0,0,0,1,0,1,0,0,0,0,0,0
109,私立,宗教研修學院,1R02,學校財團法人中華浸信會基督教台灣浸會神學院,碩士班(日間),大韓民國(南韓),其他亞洲地區,1,0,1,1,0,1,0,0,0,0,0,0,0,0,0
109,私立,宗教研修學院,1R02,學校財團法人中華浸信會基督教台灣浸會神學院,碩士班(日間),香港,港澳,1,0,1,0,0,0,0,0,0,1,0,1,0,0,0
109,私立,宗教研修學院,1R03,臺北基督學院,學士班(日間),大韓民國(南韓),其他亞洲地區,1,0,1,1,0,1,0,0,0,0,0,0,0,0,0
109,私立,宗教研修學院,1R03,臺北基督學院,學士班(日間),日本,其他亞洲地區,1,0,1,1,0,1,0,0,0,0,0,0,0,0,0
109,私立,宗教研修學院,1R03,臺北基督學院,學士班(日間),香港,港澳,1,1,0,0,0,0,0,0,0,1,1,0,0,0,0
109,私立,宗教研修學院,1R04,財團法人一貫道天皇基金會一貫道天皇學院,學士班(日間),馬來西亞,東協,3,1,2,3,1,2,0,0,0,0,0,0,0,0,0
109,私立,宗教研修學院,1R04,財團法人一貫道天皇基金會一貫道天皇學院,碩士班(日間),馬來西亞,東協,1,1,0,1,1,0,0,0,0,0,0,0,0,0,0
109,私立,宗教研修學院,1R05,台神學校財團法人台灣神學研究學院,碩士班(日間),馬來西亞,東協,3,0,3,3,0,3,0,0,0,0,0,0,0,0,0
109,私立,宗教研修學院,1R06,一貫道崇德學院,碩士班(日間),加拿大,北美洲,1,1,0,0,0,0,1,1,0,0,0,0,0,0,0
109,私立,宗教研修學院,1R06,一貫道崇德學院,碩士班(日間),印度尼西亞共和國,東協,1,0,1,0,0,0,1,0,1,0,0,0,0,0,0
109,私立,宗教研修學院,1R06,一貫道崇德學院,碩士班(日間),泰國,東協,1,1,0,1,1,0,0,0,0,0,0,0,0,0,0
109,私立,宗教研修學院,1R06,一貫道崇德學院,碩士班(日間),馬來西亞,東協,5,3,2,3,1,2,2,2,0,0,0,0,0,0,0
109,私立,宗教研修學院,1R06,一貫道崇德學院,碩士班(日間),越南社會主義共和國,東協,2,0,2,2,0,2,0,0,0,0,0,0,0,0,0
109,公立,一般大學,3002,臺北市立大學,學士班(日間),土耳其共和國,其他亞洲地區,1,0,1,1,0,1,0,0,0,0,0,0,0,0,0
109,公立,一般大學,3002,臺北市立大學,學士班(日間),大陸地區,大陸地區,3,1,2,0,0,0,0,0,0,0,0,0,3,1,2
109,公立,一般大學,3002,臺北市立大學,學士班(日間),印度尼西亞共和國,東協,2,1,1,1,1,0,1,0,1,0,0,0,0,0,0
109,公立,一般大學,3002,臺北市立大學,學士班(日間),法國,歐洲,1,1,0,1,1,0,0,0,0,0,0,0,0,0,0
109,公立,一般大學,3002,臺北市立大學,學士班(日間),香港,港澳,30,16,14,0,0,0,0,0,0,30,16,14,0,0,0
109,公立,一般大學,3002,臺北市立大學,學士班(日間),泰國,東協,1,1,0,0,0,0,1,1,0,0,0,0,0,0,0
109,公立,一般大學,3002,臺北市立大學,學士班(日間),越南社會主義共和國,東協,8,3,5,2,0,2,6,3,3,0,0,0,0,0,0
109,公立,一般大學,3002,臺北市立大學,學士班(日間),緬甸,東協,15,5,10,0,0,0,15,5,10,0,0,0,0,0,0
109,公立,一般大學,3002,臺北市立大學,學士班(日間),澳門,港澳,16,9,7,0,0,0,0,0,0,16,9,7,0,0,0
109,公立,一般大學,3002,臺北市立大學,學士班(日間),大韓民國(南韓),其他亞洲地區,4,0,4,4,0,4,0,0,0,0,0,0,0,0,0
109,公立,一般大學,3002,臺北市立大學,學士班(日間),厄瓜多共和國,中南美洲,1,0,1,0,0,0,1,0,1,0,0,0,0,0,0
109,公立,一般大學,3002,臺北市立大學,學士班(日間),日本,其他亞洲地區,7,3,4,5,2,3,2,1,1,0,0,0,0,0,0
109,公立,一般大學,3002,臺北市立大學,學士班(日間),馬來西亞,東協,45,19,26,4,2,2,41,17,24,0,0,0,0,0,0
109,公立,一般大學,3002,臺北市立大學,碩士班(日間),馬來西亞,東協,18,10,8,1,0,1,17,10,7,0,0,0,0,0,0
109,公立,一般大學,3002,臺北市立大學,碩士班(日間),大陸地區,大陸地區,6,2,4,0,0,0,0,0,0,0,0,0,6,2,4
109,公立,一般大學,3002,臺北市立大學,碩士班(日間),大韓民國(南韓),其他亞洲地區,1,0,1,1,0,1,0,0,0,0,0,0,0,0,0
109,公立,一般大學,3002,臺北市立大學,碩士班(日間),印度尼西亞共和國,東協,1,0,1,1,0,1,0,0,0,0,0,0,0,0,0
109,公立,一般大學,3002,臺北市立大學,碩士班(日間),貝里斯,中南美洲,1,1,0,1,1,0,0,0,0,0,0,0,0,0,0
109,公立,一般大學,3002,臺北市立大學,碩士班(日間),南非共和國,非洲,1,0,1,0,0,0,1,0,1,0,0,0,0,0,0
109,公立,一般大學,3002,臺北市立大學,碩士班(日間),香港,港澳,9,4,5,0,0,0,0,0,0,9,4,5,0,0,0
109,公立,一般大學,3002,臺北市立大學,碩士班(日間),泰國,東協,1,0,1,1,0,1,0,0,0,0,0,0,0,0,0
109,公立,一般大學,3002,臺北市立大學,碩士班(日間),澳門,港澳,1,0,1,0,0,0,0,0,0,1,0,1,0,0,0
109,公立,一般大學,3002,臺北市立大學,博士班,泰國,東協,4,2,2,4,2,2,0,0,0,0,0,0,0,0,0
109,公立,一般大學,3002,臺北市立大學,博士班,捷克共和國,歐洲,1,1,0,1,1,0,0,0,0,0,0,0,0,0,0
109,公立,一般大學,3002,臺北市立大學,博士班,大陸地區,大陸地區,9,3,6,0,0,0,0,0,0,0,0,0,9,3,6
109,公立,一般大學,3002,臺北市立大學,博士班,印度尼西亞共和國,東協,1,0,1,1,0,1,0,0,0,0,0,0,0,0,0
109,公立,一般大學,3002,臺北市立大學,博士班,香港,港澳,1,0,1,0,0,0,0,0,0,1,0,1,0,0,0
109,公立,一般大學,3002,臺北市立大學,博士班,馬來西亞,東協,1,1,0,0,0,0,1,1,0,0,0,0,0,0,0
109,公立,一般大學,3002,臺北市立大學,博士班,越南社會主義共和國,東協,1,0,1,1,0,1,0,0,0,0,0,0,0,0,0
110,公立,一般大學,0001,國立政治大學,學士班(日間),土耳其共和國,其他亞洲地區,1,0,1,1,0,1,0,0,0,0,0,0,0,0,0
110,公立,一般大學,0001,國立政治大學,學士班(日間),大韓民國(南韓),其他亞洲地區,37,19,18,31,16,15,6,3,3,0,0,0,0,0,0
110,公立,一般大學,0001,國立政治大學,學士班(日間),厄瓜多共和國,中南美洲,1,1,0,0,0,0,1,1,0,0,0,0,0,0,0
110,公立,一般大學,0001,國立政治大學,學士班(日間),巴拉圭,中南美洲,4,0,4,4,0,4,0,0,0,0,0,0,0,0,0
110,公立,一般大學,0001,國立政治大學,學士班(日間),尼加拉瓜,中南美洲,1,1,0,0,0,0,1,1,0,0,0,0,0,0,0
110,公立,一般大學,0001,國立政治大學,學士班(日間),瓜地馬拉共和國,中南美洲,1,0,1,1,0,1,0,0,0,0,0,0,0,0,0
110,公立,一般大學,0001,國立政治大學,學士班(日間),貝里斯,中南美洲,5,2,3,5,2,3,0,0,0,0,0,0,0,0,0
110,公立,一般大學,0001,國立政治大學,學士班(日間),美國,北美洲,2,1,1,1,1,0,1,0,1,0,0,0,0,0,0
110,公立,一般大學,0001,國立政治大學,學士班(日間),海地共和國,中南美洲,2,0,2,2,0,2,0,0,0,0,0,0,0,0,0
110,公立,一般大學,0001,國立政治大學,學士班(日間),智利,中南美洲,1,0,1,0,0,0,1,0,1,0,0,0,0,0,0
110,公立,一般大學,0001,國立政治大學,學士班(日間),新加坡共和國,東協,5,1,4,2,0,2,3,1,2,0,0,0,0,0,0
110,公立,一般大學,0001,國立政治大學,學士班(日間),聖文森(及格瑞那丁),中南美洲,2,1,1,2,1,1,0,0,0,0,0,0,0,0,0
110,公立,一般大學,0001,國立政治大學,學士班(日間),聖露西亞,中南美洲,1,0,1,1,0,1,0,0,0,0,0,0,0,0,0
110,公立,一般大學,0001,國立政治大學,學士班(日間),蒙古國,其他亞洲地區,3,1,2,3,1,2,0,0,0,0,0,0,0,0,0
110,公立,一般大學,0001,國立政治大學,學士班(日間),德意志聯邦共和國,歐洲,1,1,0,1,1,0,0,0,0,0,0,0,0,0,0
110,公立,一般大學,0001,國立政治大學,學士班(日間),緬甸,東協,13,4,9,0,0,0,13,4,9,0,0,0,0,0,0
110,公立,一般大學,0001,國立政治大學,學士班(日間),大陸地區,大陸地區,9,1,8,0,0,0,0,0,0,0,0,0,9,1,8
110,公立,一般大學,0001,國立政治大學,學士班(日間),日本,其他亞洲地區,42,16,26,29,11,18,13,5,8,0,0,0,0,0,0
110,公立,一般大學,0001,國立政治大學,學士班(日間),以色列,其他亞洲地區,1,1,0,1,1,0,0,0,0,0,0,0,0,0,0
110,公立,一般大學,0001,國立政治大學,學士班(日間),加拿大,北美洲,3,2,1,2,2,0,1,0,1,0,0,0,0,0,0
110,公立,一般大學,0001,國立政治大學,學士班(日間),印度尼西亞共和國,東協,67,17,50,10,5,5,57,12,45,0,0,0,0,0,0
110,公立,一般大學,0001,國立政治大學,學士班(日間),宏都拉斯共和國,中南美洲,13,3,10,13,3,10,0,0,0,0,0,0,0,0,0
110,公立,一般大學,0001,國立政治大學,學士班(日間),委內瑞拉共和國,中南美洲,1,1,0,1,1,0,0,0,0,0,0,0,0,0,0
110,公立,一般大學,0001,國立政治大學,學士班(日間),法國,歐洲,1,1,0,1,1,0,0,0,0,0,0,0,0,0,0
110,公立,一般大學,0001,國立政治大學,學士班(日間),阿根廷,中南美洲,3,1,2,0,0,0,3,1,2,0,0,0,0,0,0
110,公立,一般大學,0001,國立政治大學,學士班(日間),俄羅斯聯邦,其他亞洲地區,4,3,1,4,3,1,0,0,0,0,0,0,0,0,0
110,公立,一般大學,0001,國立政治大學,學士班(日間),南非共和國,非洲,2,0,2,0,0,0,2,0,2,0,0,0,0,0,0
110,公立,一般大學,0001,國立政治大學,學士班(日間),香港,港澳,86,36,50,0,0,0,0,0,0,86,36,50,0,0,0
110,公立,一般大學,0001,國立政治大學,學士班(日間),泰國,東協,14,3,11,4,1,3,10,2,8,0,0,0,0,0,0
110,公立,一般大學,0001,國立政治大學,學士班(日間),秘魯共和國,中南美洲,1,0,1,1,0,1,0,0,0,0,0,0,0,0,0
110,公立,一般大學,0001,國立政治大學,學士班(日間),馬來西亞,東協,198,61,137,12,2,10,186,59,127,0,0,0,0,0,0
110,公立,一般大學,0001,國立政治大學,學士班(日間),菲律賓共和國,東協,2,1,1,1,1,0,1,0,1,0,0,0,0,0,0
110,公立,一般大學,0001,國立政治大學,學士班(日間),越南社會主義共和國,東協,40,14,26,14,3,11,26,11,15,0,0,0,0,0,0
110,公立,一般大學,0001,國立政治大學,學士班(日間),墨西哥合眾國,中南美洲,1,0,1,0,0,0,1,0,1,0,0,0,0,0,0
110,公立,一般大學,0001,國立政治大學,學士班(日間),澳門,港澳,90,33,57,0,0,0,0,0,0,90,33,57,0,0,0
110,公立,一般大學,0001,國立政治大學,碩士班(日間),大陸地區,大陸地區,183,60,123,0,0,0,0,0,0,0,0,0,183,60,123
110,公立,一般大學,0001,國立政治大學,碩士班(日間),大韓民國(南韓),其他亞洲地區,16,11,5,16,11,5,0,0,0,0,0,0,0,0,0
110,公立,一般大學,0001,國立政治大學,碩士班(日間),巴西聯邦共和國,中南美洲,3,1,2,2,1,1,1,0,1,0,0,0,0,0,0
110,公立,一般大學,0001,國立政治大學,碩士班(日間),日本,其他亞洲地區,14,4,10,13,3,10,1,1,0,0,0,0,0,0,0
110,公立,一般大學,0001,國立政治大學,碩士班(日間),加拿大,北美洲,8,6,2,5,4,1,3,2,1,0,0,0,0,0,0
110,公立,一般大學,0001,國立政治大學,碩士班(日間),冰島共和國,歐洲,1,0,1,1,0,1,0,0,0,0,0,0,0,0,0
110,公立,一般大學,0001,國立政治大學,碩士班(日間),匈牙利共和國,歐洲,1,0,1,1,0,1,0,0,0,0,0,0,0,0,0
110,公立,一般大學,0001,國立政治大學,碩士班(日間),印度,南亞,1,0,1,1,0,1,0,0,0,0,0,0,0,0,0
110,公立,一般大學,0001,國立政治大學,碩士班(日間),印度尼西亞共和國,東協,9,3,6,6,1,5,3,2,1,0,0,0,0,0,0
110,公立,一般大學,0001,國立政治大學,碩士班(日間),多明尼加共和國,中南美洲,1,0,1,0,0,0,1,0,1,0,0,0,0,0,0
110,公立,一般大學,0001,國立政治大學,碩士班(日間),西班牙王國,歐洲,1,1,0,1,1,0,0,0,0,0,0,0,0,0,0
110,公立,一般大學,0001,國立政治大學,碩士班(日間),克羅埃西亞共和國,歐洲,1,0,1,1,0,1,0,0,0,0,0,0,0,0,0
110,公立,一般大學,0001,國立政治大學,碩士班(日間),宏都拉斯共和國,中南美洲,7,5,2,7,5,2,0,0,0,0,0,0,0,0,0
110,公立,一般大學,0001,國立政治大學,碩士班(日間),委內瑞拉共和國,中南美洲,1,1,0,0,0,0,1,1,0,0,0,0,0,0,0
110,公立,一般大學,0001,國立政治大學,碩士班(日間),波蘭共和國,歐洲,3,2,1,3,2,1,0,0,0,0,0,0,0,0,0
110,公立,一般大學,0001,國立政治大學,碩士班(日間),法國,歐洲,3,0,3,3,0,3,0,0,0,0,0,0,0,0,0
110,公立,一般大學,0001,國立政治大學,碩士班(日間),阿根廷,中南美洲,1,1,0,1,1,0,0,0,0,0,0,0,0,0,0
110,公立,一般大學,0001,國立政治大學,碩士班(日間),俄羅斯聯邦,其他亞洲地區,11,3,8,11,3,8,0,0,0,0,0,0,0,0,0
110,公立,一般大學,0001,國立政治大學,碩士班(日間),科索沃共和國,歐洲,1,0,1,1,0,1,0,0,0,0,0,0,0,0,0
110,公立,一般大學,0001,國立政治大學,碩士班(日間),英國,歐洲,3,2,1,3,2,1,0,0,0,0,0,0,0,0,0
110,公立,一般大學,0001,國立政治大學,碩士班(日間),香港,港澳,64,34,30,0,0,0,0,0,0,64,34,30,0,0,0
110,公立,一般大學,0001,國立政治大學,碩士班(日間),泰國,東協,19,6,13,17,6,11,2,0,2,0,0,0,0,0,0
110,公立,一般大學,0001,國立政治大學,碩士班(日間),秘魯共和國,中南美洲,1,1,0,1,1,0,0,0,0,0,0,0,0,0,0
110,公立,一般大學,0001,國立政治大學,碩士班(日間),馬來西亞,東協,71,29,42,22,10,12,49,19,30,0,0,0,0,0,0
110,公立,一般大學,0001,國立政治大學,碩士班(日間),荷蘭王國,歐洲,1,1,0,1,1,0,0,0,0,0,0,0,0,0,0
110,公立,一般大學,0001,國立政治大學,碩士班(日間),菲律賓共和國,東協,4,0,4,4,0,4,0,0,0,0,0,0,0,0,0
110,公立,一般大學,0001,國立政治大學,碩士班(日間),越南社會主義共和國,東協,13,6,7,11,5,6,2,1,1,0,0,0,0,0,0
110,公立,一般大學,0001,國立政治大學,碩士班(日間),奧地利共和國,歐洲,3,2,1,3,2,1,0,0,0,0,0,0,0,0,0
110,公立,一般大學,0001,國立政治大學,碩士班(日間),瑞士聯邦,歐洲,1,0,1,1,0,1,0,0,0,0,0,0,0,0,0
110,公立,一般大學,0001,國立政治大學,碩士班(日間),聖文森(及格瑞那丁),中南美洲,1,0,1,1,0,1,0,0,0,0,0,0,0,0,0
110,公立,一般大學,0001,國立政治大學,碩士班(日間),墨西哥合眾國,中南美洲,4,3,1,4,3,1,0,0,0,0,0,0,0,0,0
110,公立,一般大學,0001,國立政治大學,碩士班(日間),澳門,港澳,17,9,8,0,0,0,0,0,0,17,9,8,0,0,0
110,公立,一般大學,0001,國立政治大學,碩士班(日間),薩爾瓦多,中南美洲,2,2,0,2,2,0,0,0,0,0,0,0,0,0,0
110,公立,一般大學,0001,國立政治大學,碩士班(日間),羅馬尼亞,歐洲,1,0,1,1,0,1,0,0,0,0,0,0,0,0,0
110,公立,一般大學,0001,國立政治大學,碩士班(日間),土耳其共和國,其他亞洲地區,5,4,1,5,4,1,0,0,0,0,0,0,0,0,0
110,公立,一般大學,0001,國立政治大學,碩士班(日間),厄瓜多共和國,中南美洲,1,0,1,1,0,1,0,0,0,0,0,0,0,0,0
110,公立,一般大學,0001,國立政治大學,碩士班(日間),巴拉圭,中南美洲,1,1,0,0,0,0,1,1,0,0,0,0,0,0,0
110,公立,一般大學,0001,國立政治大學,碩士班(日間),巴拿馬共和國,中南美洲,1,0,1,1,0,1,0,0,0,0,0,0,0,0,0
110,公立,一般大學,0001,國立政治大學,碩士班(日間),史瓦帝尼王國,非洲,1,0,1,1,0,1,0,0,0,0,0,0,0,0,0
110,公立,一般大學,0001,國立政治大學,碩士班(日間),尼加拉瓜,中南美洲,5,2,3,5,2,3,0,0,0,0,0,0,0,0,0
110,公立,一般大學,0001,國立政治大學,碩士班(日間),瓜地馬拉共和國,中南美洲,5,4,1,5,4,1,0,0,0,0,0,0,0,0,0
110,公立,一般大學,0001,國立政治大學,碩士班(日間),貝里斯,中南美洲,3,3,0,2,2,0,1,1,0,0,0,0,0,0,0
110,公立,一般大學,0001,國立政治大學,碩士班(日間),美國,北美洲,25,15,10,23,14,9,2,1,1,0,0,0,0,0,0
110,公立,一般大學,0001,國立政治大學,碩士班(日間),海地共和國,中南美洲,1,1,0,1,1,0,0,0,0,0,0,0,0,0,0
110,公立,一般大學,0001,國立政治大學,碩士班(日間),紐西蘭,其他亞洲地區,1,1,0,1,1,0,0,0,0,0,0,0,0,0,0
110,公立,一般大學,0001,國立政治大學,碩士班(日間),馬拉威共和國,非洲,1,1,0,1,1,0,0,0,0,0,0,0,0,0,0
110,公立,一般大學,0001,國立政治大學,碩士班(日間),捷克共和國,歐洲,1,1,0,1,1,0,0,0,0,0,0,0,0,0,0
110,公立,一般大學,0001,國立政治大學,碩士班(日間),斯洛伐克共和國,歐洲,1,1,0,1,1,0,0,0,0,0,0,0,0,0,0
110,公立,一般大學,0001,國立政治大學,碩士班(日間),新加坡共和國,東協,1,0,1,1,0,1,0,0,0,0,0,0,0,0,0
110,公立,一般大學,0001,國立政治大學,碩士班(日間),義大利共和國,歐洲,2,1,1,2,1,1,0,0,0,0,0,0,0,0,0
110,公立,一般大學,0001,國立政治大學,碩士班(日間),聖克里斯多福及尼維斯,中南美洲,2,0,2,2,0,2,0,0,0,0,0,0,0,0,0
110,公立,一般大學,0001,國立政治大學,碩士班(日間),聖露西亞,中南美洲,1,0,1,1,0,1,0,0,0,0,0,0,0,0,0
110,公立,一般大學,0001,國立政治大學,碩士班(日間),德意志聯邦共和國,歐洲,3,1,2,3,1,2,0,0,0,0,0,0,0,0,0
110,公立,一般大學,0001,國立政治大學,碩士班(日間),緬甸,東協,3,2,1,0,0,0,3,2,1,0,0,0,0,0,0
110,公立,一般大學,0001,國立政治大學,碩士班(日間),澳大利亞,其他亞洲地區,1,1,0,1,1,0,0,0,0,0,0,0,0,0,0
110,公立,一般大學,0001,國立政治大學,博士班,大韓民國(南韓),其他亞洲地區,13,6,7,13,6,7,0,0,0,0,0,0,0,0,0
110,公立,一般大學,0001,國立政治大學,博士班,巴西聯邦共和國,中南美洲,3,1,2,3,1,2,0,0,0,0,0,0,0,0,0
110,公立,一般大學,0001,國立政治大學,博士班,日本,其他亞洲地區,4,4,0,4,4,0,0,0,0,0,0,0,0,0,0
110,公立,一般大學,0001,國立政治大學,博士班,史瓦帝尼王國,非洲,1,1,0,1,1,0,0,0,0,0,0,0,0,0,0
110,公立,一般大學,0001,國立政治大學,博士班,布吉納法索,非洲,1,0,1,1,0,1,0,0,0,0,0,0,0,0,0
110,公立,一般大學,0001,國立政治大學,博士班,多明尼加共和國,中南美洲,1,1,0,1,1,0,0,0,0,0,0,0,0,0,0
110,公立,一般大學,0001,國立政治大學,博士班,西班牙王國,歐洲,3,2,1,3,2,1,0,0,0,0,0,0,0,0,0
110,公立,一般大學,0001,國立政治大學,博士班,俄羅斯聯邦,其他亞洲地區,2,1,1,2,1,1,0,0,0,0,0,0,0,0,0
110,公立,一般大學,0001,國立政治大學,博士班,美國,北美洲,9,6,3,8,5,3,1,1,0,0,0,0,0,0,0
110,公立,一般大學,0001,國立政治大學,博士班,英國,歐洲,2,2,0,2,2,0,0,0,0,0,0,0,0,0,0
110,公立,一般大學,0001,國立政治大學,博士班,泰國,東協,7,4,3,7,4,3,0,0,0,0,0,0,0,0,0
110,公立,一般大學,0001,國立政治大學,博士班,馬來西亞,東協,14,7,7,8,4,4,6,3,3,0,0,0,0,0,0
110,公立,一般大學,0001,國立政治大學,博士班,斯里蘭卡民主社會主義共和國,南亞,1,0,1,1,0,1,0,0,0,0,0,0,0,0,0
110,公立,一般大學,0001,國立政治大學,博士班,菲律賓共和國,東協,5,3,2,5,3,2,0,0,0,0,0,0,0,0,0
110,公立,一般大學,0001,國立政治大學,博士班,新加坡共和國,東協,1,0,1,0,0,0,1,0,1,0,0,0,0,0,0
110,公立,一般大學,0001,國立政治大學,博士班,土耳其共和國,其他亞洲地區,3,2,1,3,2,1,0,0,0,0,0,0,0,0,0
110,公立,一般大學,0001,國立政治大學,博士班,大陸地區,大陸地區,103,53,50,0,0,0,0,0,0,0,0,0,103,53,50
110,公立,一般大學,0001,國立政治大學,博士班,巴拉圭,中南美洲,1,1,0,1,1,0,0,0,0,0,0,0,0,0,0
110,公立,一般大學,0001,國立政治大學,博士班,巴基斯坦,南亞,5,5,0,5,5,0,0,0,0,0,0,0,0,0,0
110,公立,一般大學,0001,國立政治大學,博士班,比利時王國,歐洲,1,1,0,1,1,0,0,0,0,0,0,0,0,0,0
110,公立,一般大學,0001,國立政治大學,博士班,尼加拉瓜,中南美洲,1,0,1,1,0,1,0,0,0,0,0,0,0,0,0
110,公立,一般大學,0001,國立政治大學,博士班,白俄羅斯共和國,其他亞洲地區,1,1,0,1,1,0,0,0,0,0,0,0,0,0,0
110,公立,一般大學,0001,國立政治大學,博士班,匈牙利共和國,歐洲,1,1,0,1,1,0,0,0,0,0,0,0,0,0,0
110,公立,一般大學,0001,國立政治大學,博士班,印度,南亞,6,3,3,6,3,3,0,0,0,0,0,0,0,0,0
110,公立,一般大學,0001,國立政治大學,博士班,印度尼西亞共和國,東協,14,6,8,14,6,8,0,0,0,0,0,0,0,0,0
110,公立,一般大學,0001,國立政治大學,博士班,奈及利亞聯邦共和國,非洲,1,1,0,1,1,0,0,0,0,0,0,0,0,0,0
110,公立,一般大學,0001,國立政治大學,博士班,孟加拉人民共和國,南亞,1,1,0,1,1,0,0,0,0,0,0,0,0,0,0
110,公立,一般大學,0001,國立政治大學,博士班,拉脫維亞共和國,歐洲,1,1,0,1,1,0,0,0,0,0,0,0,0,0,0
110,公立,一般大學,0001,國立政治大學,博士班,波蘭共和國,歐洲,5,2,3,5,2,3,0,0,0,0,0,0,0,0,0
110,公立,一般大學,0001,國立政治大學,博士班,南非共和國,非洲,1,0,1,0,0,0,1,0,1,0,0,0,0,0,0
110,公立,一般大學,0001,國立政治大學,博士班,香港,港澳,7,6,1,0,0,0,0,0,0,7,6,1,0,0,0
110,公立,一般大學,0001,國立政治大學,博士班,烏克蘭,其他亞洲地區,1,0,1,1,0,1,0,0,0,0,0,0,0,0,0
110,公立,一般大學,0001,國立政治大學,博士班,紐西蘭,其他亞洲地區,1,1,0,1,1,0,0,0,0,0,0,0,0,0,0
110,公立,一般大學,0001,國立政治大學,博士班,捷克共和國,歐洲,2,0,2,2,0,2,0,0,0,0,0,0,0,0,0
110,公立,一般大學,0001,國立政治大學,博士班,斯洛伐克共和國,歐洲,1,1,0,1,1,0,0,0,0,0,0,0,0,0,0
110,公立,一般大學,0001,國立政治大學,博士班,越南社會主義共和國,東協,9,3,6,9,3,6,0,0,0,0,0,0,0,0,0
110,公立,一般大學,0001,國立政治大學,博士班,蒙古國,其他亞洲地區,2,0,2,2,0,2,0,0,0,0,0,0,0,0,0
110,公立,一般大學,0001,國立政治大學,博士班,德意志聯邦共和國,歐洲,2,2,0,2,2,0,0,0,0,0,0,0,0,0,0
110,公立,一般大學,0001,國立政治大學,博士班,澳大利亞,其他亞洲地區,1,1,0,1,1,0,0,0,0,0,0,0,0,0,0
110,公立,一般大學,0001,國立政治大學,博士班,澳門,港澳,4,4,0,0,0,0,0,0,0,4,4,0,0,0,0
110,公立,一般大學,0002,國立清華大學,學士班(日間),大陸地區,大陸地區,10,4,6,0,0,0,0,0,0,0,0,0,10,4,6
110,公立,一般大學,0002,國立清華大學,學士班(日間),大韓民國(南韓),其他亞洲地區,32,13,19,30,11,19,2,2,0,0,0,0,0,0,0
110,公立,一般大學,0002,國立清華大學,學士班(日間),巴拉圭,中南美洲,3,2,1,1,0,1,2,2,0,0,0,0,0,0,0
110,公立,一般大學,0002,國立清華大學,學士班(日間),加拿大,北美洲,5,1,4,1,0,1,4,1,3,0,0,0,0,0,0
110,公立,一般大學,0002,國立清華大學,學士班(日間),尼加拉瓜,中南美洲,1,1,0,1,1,0,0,0,0,0,0,0,0,0,0
110,公立,一般大學,0002,國立清華大學,學士班(日間),瓜地馬拉共和國,中南美洲,3,2,1,3,2,1,0,0,0,0,0,0,0,0,0
110,公立,一般大學,0002,國立清華大學,學士班(日間),印度,南亞,1,0,1,0,0,0,1,0,1,0,0,0,0,0,0
110,公立,一般大學,0002,國立清華大學,學士班(日間),印度尼西亞共和國,東協,193,124,69,132,90,42,61,34,27,0,0,0,0,0,0
110,公立,一般大學,0002,國立清華大學,學士班(日間),多明尼加共和國,中南美洲,1,1,0,0,0,0,1,1,0,0,0,0,0,0,0
110,公立,一般大學,0002,國立清華大學,學士班(日間),宏都拉斯共和國,中南美洲,5,4,1,5,4,1,0,0,0,0,0,0,0,0,0
110,公立,一般大學,0002,國立清華大學,學士班(日間),貝里斯,中南美洲,2,1,1,2,1,1,0,0,0,0,0,0,0,0,0
110,公立,一般大學,0002,國立清華大學,學士班(日間),委內瑞拉共和國,中南美洲,1,1,0,0,0,0,1,1,0,0,0,0,0,0,0
110,公立,一般大學,0002,國立清華大學,學士班(日間),波蘭共和國,歐洲,2,1,1,2,1,1,0,0,0,0,0,0,0,0,0
110,公立,一般大學,0002,國立清華大學,學士班(日間),阿根廷,中南美洲,3,3,0,0,0,0,3,3,0,0,0,0,0,0,0
110,公立,一般大學,0002,國立清華大學,學士班(日間),南非共和國,非洲,2,2,0,0,0,0,2,2,0,0,0,0,0,0,0
110,公立,一般大學,0002,國立清華大學,學士班(日間),香港,港澳,94,55,39,0,0,0,0,0,0,94,55,39,0,0,0
110,公立,一般大學,0002,國立清華大學,學士班(日間),哥倫比亞共和國,中南美洲,1,0,1,1,0,1,0,0,0,0,0,0,0,0,0
110,公立,一般大學,0002,國立清華大學,學士班(日間),哥斯大黎加共和國,中南美洲,1,0,1,0,0,0,1,0,1,0,0,0,0,0,0
110,公立,一般大學,0002,國立清華大學,學士班(日間),海地共和國,中南美洲,6,5,1,6,5,1,0,0,0,0,0,0,0,0,0
110,公立,一般大學,0002,國立清華大學,學士班(日間),秘魯共和國,中南美洲,1,1,0,0,0,0,1,1,0,0,0,0,0,0,0
110,公立,一般大學,0002,國立清華大學,學士班(日間),越南社會主義共和國,東協,62,20,42,54,16,38,8,4,4,0,0,0,0,0,0
110,公立,一般大學,0002,國立清華大學,學士班(日間),聖露西亞,中南美洲,2,0,2,2,0,2,0,0,0,0,0,0,0,0,0
110,公立,一般大學,0002,國立清華大學,學士班(日間),葉門共和國,其他亞洲地區,1,1,0,1,1,0,0,0,0,0,0,0,0,0,0
110,公立,一般大學,0002,國立清華大學,學士班(日間),蒙古國,其他亞洲地區,3,2,1,3,2,1,0,0,0,0,0,0,0,0,0
110,公立,一般大學,0002,國立清華大學,學士班(日間),緬甸,東協,14,5,9,0,0,0,14,5,9,0,0,0,0,0,0
110,公立,一般大學,0002,國立清華大學,學士班(日間),澳門,港澳,41,26,15,0,0,0,0,0,0,41,26,15,0,0,0
110,公立,一般大學,0002,國立清華大學,學士班(日間),巴西聯邦共和國,中南美洲,1,1,0,1,1,0,0,0,0,0,0,0,0,0,0
110,公立,一般大學,0002,國立清華大學,學士班(日間),日本,其他亞洲地區,33,17,16,23,11,12,10,6,4,0,0,0,0,0,0
110,公立,一般大學,0002,國立清華大學,學士班(日間),史瓦帝尼王國,非洲,1,1,0,1,1,0,0,0,0,0,0,0,0,0,0
110,公立,一般大學,0002,國立清華大學,學士班(日間),尼泊爾聯邦民主共和國,南亞,1,1,0,1,1,0,0,0,0,0,0,0,0,0,0
110,公立,一般大學,0002,國立清華大學,學士班(日間),西班牙王國,歐洲,3,1,2,0,0,0,3,1,2,0,0,0,0,0,0
110,公立,一般大學,0002,國立清華大學,學士班(日間),約旦哈什米王國,其他亞洲地區,1,0,1,0,0,0,1,0,1,0,0,0,0,0,0
110,公立,一般大學,0002,國立清華大學,學士班(日間),美國,北美洲,2,2,0,1,1,0,1,1,0,0,0,0,0,0,0
110,公立,一般大學,0002,國立清華大學,學士班(日間),泰國,東協,51,22,29,40,18,22,11,4,7,0,0,0,0,0,0
110,公立,一般大學,0002,國立清華大學,學士班(日間),烏克蘭,其他亞洲地區,1,0,1,1,0,1,0,0,0,0,0,0,0,0,0
110,公立,一般大學,0002,國立清華大學,學士班(日間),馬來西亞,東協,159,78,81,6,1,5,153,77,76,0,0,0,0,0,0
110,公立,一般大學,0002,國立清華大學,學士班(日間),菲律賓共和國,東協,10,4,6,8,4,4,2,0,2,0,0,0,0,0,0
110,公立,一般大學,0002,國立清華大學,學士班(日間),新加坡共和國,東協,2,1,1,1,0,1,1,1,0,0,0,0,0,0,0
110,公立,一般大學,0002,國立清華大學,碩士班(日間),巴西聯邦共和國,中南美洲,1,0,1,1,0,1,0,0,0,0,0,0,0,0,0
110,公立,一般大學,0002,國立清華大學,碩士班(日間),巴基斯坦,南亞,1,1,0,1,1,0,0,0,0,0,0,0,0,0,0
110,公立,一般大學,0002,國立清華大學,碩士班(日間),日本,其他亞洲地區,3,2,1,2,1,1,1,1,0,0,0,0,0,0,0
110,公立,一般大學,0002,國立清華大學,碩士班(日間),史瓦帝尼王國,非洲,1,0,1,1,0,1,0,0,0,0,0,0,0,0,0
110,公立,一般大學,0002,國立清華大學,碩士班(日間),法國,歐洲,2,1,1,2,1,1,0,0,0,0,0,0,0,0,0
110,公立,一般大學,0002,國立清華大學,碩士班(日間),俄羅斯聯邦,其他亞洲地區,2,0,2,2,0,2,0,0,0,0,0,0,0,0,0
110,公立,一般大學,0002,國立清華大學,碩士班(日間),玻利維亞共和國,中南美洲,1,0,1,0,0,0,1,0,1,0,0,0,0,0,0
110,公立,一般大學,0002,國立清華大學,碩士班(日間),美國,北美洲,10,7,3,8,6,2,2,1,1,0,0,0,0,0,0
110,公立,一般大學,0002,國立清華大學,碩士班(日間),英國,歐洲,2,2,0,2,2,0,0,0,0,0,0,0,0,0,0
110,公立,一般大學,0002,國立清華大學,碩士班(日間),埃及阿拉伯共和國,非洲,3,2,1,3,2,1,0,0,0,0,0,0,0,0,0
110,公立,一般大學,0002,國立清華大學,碩士班(日間),泰國,東協,27,7,20,23,6,17,4,1,3,0,0,0,0,0,0
110,公立,一般大學,0002,國立清華大學,碩士班(日間),馬來西亞,東協,69,37,32,21,8,13,48,29,19,0,0,0,0,0,0
110,公立,一般大學,0002,國立清華大學,碩士班(日間),菲律賓共和國,東協,6,2,4,5,2,3,1,0,1,0,0,0,0,0,0
110,公立,一般大學,0002,國立清華大學,碩士班(日間),義大利共和國,歐洲,2,2,0,2,2,0,0,0,0,0,0,0,0,0,0
110,公立,一般大學,0002,國立清華大學,碩士班(日間),德意志聯邦共和國,歐洲,1,1,0,1,1,0,0,0,0,0,0,0,0,0,0
110,公立,一般大學,0002,國立清華大學,碩士班(日間),墨西哥合眾國,中南美洲,2,1,1,2,1,1,0,0,0,0,0,0,0,0,0
110,公立,一般大學,0002,國立清華大學,碩士班(日間),薩爾瓦多,中南美洲,1,1,0,1,1,0,0,0,0,0,0,0,0,0,0
110,公立,一般大學,0002,國立清華大學,碩士班(日間),土耳其共和國,其他亞洲地區,1,0,1,1,0,1,0,0,0,0,0,0,0,0,0
110,公立,一般大學,0002,國立清華大學,碩士班(日間),大陸地區,大陸地區,167,90,77,0,0,0,0,0,0,0,0,0,167,90,77
110,公立,一般大學,0002,國立清華大學,碩士班(日間),大韓民國(南韓),其他亞洲地區,2,1,1,2,1,1,0,0,0,0,0,0,0,0,0
110,公立,一般大學,0002,國立清華大學,碩士班(日間),巴拉圭,中南美洲,2,2,0,2,2,0,0,0,0,0,0,0,0,0,0
110,公立,一般大學,0002,國立清華大學,碩士班(日間),尼加拉瓜,中南美洲,2,2,0,2,2,0,0,0,0,0,0,0,0,0,0
110,公立,一般大學,0002,國立清華大學,碩士班(日間),尼泊爾聯邦民主共和國,南亞,1,1,0,1,1,0,0,0,0,0,0,0,0,0,0
110,公立,一般大學,0002,國立清華大學,碩士班(日間),瓜地馬拉共和國,中南美洲,4,4,0,4,4,0,0,0,0,0,0,0,0,0,0
110,公立,一般大學,0002,國立清華大學,碩士班(日間),伊朗伊斯蘭共和國,其他亞洲地區,3,1,2,3,1,2,0,0,0,0,0,0,0,0,0
110,公立,一般大學,0002,國立清華大學,碩士班(日間),印度,南亞,26,21,5,26,21,5,0,0,0,0,0,0,0,0,0
110,公立,一般大學,0002,國立清華大學,碩士班(日間),印度尼西亞共和國,東協,24,14,10,18,10,8,6,4,2,0,0,0,0,0,0
110,公立,一般大學,0002,國立清華大學,碩士班(日間),吐瓦魯,其他亞洲地區,1,1,0,1,1,0,0,0,0,0,0,0,0,0,0
110,公立,一般大學,0002,國立清華大學,碩士班(日間),宏都拉斯共和國,中南美洲,7,5,2,7,5,2,0,0,0,0,0,0,0,0,0
110,公立,一般大學,0002,國立清華大學,碩士班(日間),貝里斯,中南美洲,4,1,3,4,1,3,0,0,0,0,0,0,0,0,0
110,公立,一般大學,0002,國立清華大學,碩士班(日間),坦尚尼亞聯合共和國,非洲,1,0,1,1,0,1,0,0,0,0,0,0,0,0,0
110,公立,一般大學,0002,國立清華大學,碩士班(日間),尚比亞共和國,非洲,1,1,0,1,1,0,0,0,0,0,0,0,0,0,0
110,公立,一般大學,0002,國立清華大學,碩士班(日間),波蘭共和國,歐洲,1,1,0,1,1,0,0,0,0,0,0,0,0,0,0
110,公立,一般大學,0002,國立清華大學,碩士班(日間),阿根廷,中南美洲,1,0,1,1,0,1,0,0,0,0,0,0,0,0,0
110,公立,一般大學,0002,國立清華大學,碩士班(日間),南非共和國,非洲,3,2,1,1,1,0,2,1,1,0,0,0,0,0,0
110,公立,一般大學,0002,國立清華大學,碩士班(日間),香港,港澳,52,30,22,0,0,0,0,0,0,52,30,22,0,0,0
110,公立,一般大學,0002,國立清華大學,碩士班(日間),哥倫比亞共和國,中南美洲,5,3,2,5,3,2,0,0,0,0,0,0,0,0,0
110,公立,一般大學,0002,國立清華大學,碩士班(日間),挪威王國,歐洲,1,1,0,1,1,0,0,0,0,0,0,0,0,0,0
110,公立,一般大學,0002,國立清華大學,碩士班(日間),海地共和國,中南美洲,7,5,2,7,5,2,0,0,0,0,0,0,0,0,0
110,公立,一般大學,0002,國立清華大學,碩士班(日間),烏干達共和國,非洲,1,0,1,1,0,1,0,0,0,0,0,0,0,0,0
110,公立,一般大學,0002,國立清華大學,碩士班(日間),烏克蘭,其他亞洲地區,1,0,1,1,0,1,0,0,0,0,0,0,0,0,0
110,公立,一般大學,0002,國立清華大學,碩士班(日間),秘魯共和國,中南美洲,1,0,1,1,0,1,0,0,0,0,0,0,0,0,0
110,公立,一般大學,0002,國立清華大學,碩士班(日間),荷蘭王國,歐洲,1,0,1,1,0,1,0,0,0,0,0,0,0,0,0
110,公立,一般大學,0002,國立清華大學,碩士班(日間),斯洛維尼亞共和國,歐洲,1,1,0,1,1,0,0,0,0,0,0,0,0,0,0
110,公立,一般大學,0002,國立清華大學,碩士班(日間),越南社會主義共和國,東協,46,14,32,45,13,32,1,1,0,0,0,0,0,0,0
110,公立,一般大學,0002,國立清華大學,碩士班(日間),聖文森(及格瑞那丁),中南美洲,1,1,0,1,1,0,0,0,0,0,0,0,0,0,0
110,公立,一般大學,0002,國立清華大學,碩士班(日間),聖露西亞,中南美洲,2,1,1,2,1,1,0,0,0,0,0,0,0,0,0
110,公立,一般大學,0002,國立清華大學,碩士班(日間),葡萄牙共和國,歐洲,1,1,0,1,1,0,0,0,0,0,0,0,0,0,0
110,公立,一般大學,0002,國立清華大學,碩士班(日間),蒙古國,其他亞洲地區,3,1,2,3,1,2,0,0,0,0,0,0,0,0,0
110,公立,一般大學,0002,國立清華大學,碩士班(日間),緬甸,東協,3,1,2,0,0,0,3,1,2,0,0,0,0,0,0
110,公立,一般大學,0002,國立清華大學,碩士班(日間),澳門,港澳,15,11,4,0,0,0,0,0,0,15,11,4,0,0,0
110,公立,一般大學,0002,國立清華大學,博士班,日本,其他亞洲地區,2,2,0,2,2,0,0,0,0,0,0,0,0,0,0
110,公立,一般大學,0002,國立清華大學,博士班,衣索比亞聯邦民主共和國,非洲,2,1,1,2,1,1,0,0,0,0,0,0,0,0,0
110,公立,一般大學,0002,國立清華大學,博士班,孟加拉人民共和國,南亞,1,1,0,1,1,0,0,0,0,0,0,0,0,0,0
110,公立,一般大學,0002,國立清華大學,博士班,俄羅斯聯邦,其他亞洲地區,3,2,1,3,2,1,0,0,0,0,0,0,0,0,0
110,公立,一般大學,0002,國立清華大學,博士班,哈薩克共和國,其他亞洲地區,1,1,0,1,1,0,0,0,0,0,0,0,0,0,0
110,公立,一般大學,0002,國立清華大學,博士班,美國,北美洲,9,8,1,8,7,1,1,1,0,0,0,0,0,0,0
110,公立,一般大學,0002,國立清華大學,博士班,埃及阿拉伯共和國,非洲,10,9,1,10,9,1,0,0,0,0,0,0,0,0,0
110,公立,一般大學,0002,國立清華大學,博士班,泰國,東協,9,5,4,9,5,4,0,0,0,0,0,0,0,0,0
110,公立,一般大學,0002,國立清華大學,博士班,海地共和國,中南美洲,1,1,0,1,1,0,0,0,0,0,0,0,0,0,0
110,公立,一般大學,0002,國立清華大學,博士班,烏干達共和國,非洲,2,2,0,2,2,0,0,0,0,0,0,0,0,0,0
110,公立,一般大學,0002,國立清華大學,博士班,塞爾維亞共和國,歐洲,1,1,0,1,1,0,0,0,0,0,0,0,0,0,0
110,公立,一般大學,0002,國立清華大學,博士班,德意志聯邦共和國,歐洲,2,2,0,2,2,0,0,0,0,0,0,0,0,0,0
110,公立,一般大學,0002,國立清華大學,博士班,緬甸,東協,1,1,0,1,1,0,0,0,0,0,0,0,0,0,0
110,公立,一般大學,0002,國立清華大學,博士班,土耳其共和國,其他亞洲地區,2,1,1,2,1,1,0,0,0,0,0,0,0,0,0
110,公立,一般大學,0002,國立清華大學,博士班,大陸地區,大陸地區,62,28,34,0,0,0,0,0,0,0,0,0,62,28,34
110,公立,一般大學,0002,國立清華大學,博士班,大韓民國(南韓),其他亞洲地區,1,1,0,1,1,0,0,0,0,0,0,0,0,0,0
110,公立,一般大學,0002,國立清華大學,博士班,厄瓜多共和國,中南美洲,1,1,0,1,1,0,0,0,0,0,0,0,0,0,0
110,公立,一般大學,0002,國立清華大學,博士班,巴西聯邦共和國,中南美洲,3,1,2,3,1,2,0,0,0,0,0,0,0,0,0
110,公立,一般大學,0002,國立清華大學,博士班,巴基斯坦,南亞,8,5,3,8,5,3,0,0,0,0,0,0,0,0,0
110,公立,一般大學,0002,國立清華大學,博士班,以色列,其他亞洲地區,2,2,0,2,2,0,0,0,0,0,0,0,0,0,0
110,公立,一般大學,0002,國立清華大學,博士班,尼泊爾聯邦民主共和國,南亞,2,2,0,2,2,0,0,0,0,0,0,0,0,0,0
110,公立,一般大學,0002,國立清華大學,博士班,布吉納法索,非洲,1,1,0,1,1,0,0,0,0,0,0,0,0,0,0
110,公立,一般大學,0002,國立清華大學,博士班,伊朗伊斯蘭共和國,其他亞洲地區,8,6,2,8,6,2,0,0,0,0,0,0,0,0,0
110,公立,一般大學,0002,國立清華大學,博士班,印度,南亞,162,110,52,162,110,52,0,0,0,0,0,0,0,0,0
110,公立,一般大學,0002,國立清華大學,博士班,印度尼西亞共和國,東協,23,15,8,23,15,8,0,0,0,0,0,0,0,0,0
110,公立,一般大學,0002,國立清華大學,博士班,多明尼加共和國,中南美洲,1,0,1,1,0,1,0,0,0,0,0,0,0,0,0
110,公立,一般大學,0002,國立清華大學,博士班,宏都拉斯共和國,中南美洲,4,4,0,4,4,0,0,0,0,0,0,0,0,0,0
110,公立,一般大學,0002,國立清華大學,博士班,辛巴威共和國,非洲,1,0,1,1,0,1,0,0,0,0,0,0,0,0,0
110,公立,一般大學,0002,國立清華大學,博士班,波士尼亞與赫塞哥維納,歐洲,1,0,1,1,0,1,0,0,0,0,0,0,0,0,0
110,公立,一般大學,0002,國立清華大學,博士班,波蘭共和國,歐洲,1,0,1,1,0,1,0,0,0,0,0,0,0,0,0
110,公立,一般大學,0002,國立清華大學,博士班,英國,歐洲,5,4,1,5,4,1,0,0,0,0,0,0,0,0,0
110,公立,一般大學,0002,國立清華大學,博士班,香港,港澳,10,9,1,0,0,0,0,0,0,10,9,1,0,0,0
110,公立,一般大學,0002,國立清華大學,博士班,烏克蘭,其他亞洲地區,1,1,0,1,1,0,0,0,0,0,0,0,0,0,0
110,公立,一般大學,0002,國立清華大學,博士班,秘魯共和國,中南美洲,1,1,0,1,1,0,0,0,0,0,0,0,0,0,0
110,公立,一般大學,0002,國立清華大學,博士班,馬來西亞,東協,20,8,12,11,3,8,9,5,4,0,0,0,0,0,0
110,公立,一般大學,0002,國立清華大學,博士班,馬拉威共和國,非洲,1,0,1,1,0,1,0,0,0,0,0,0,0,0,0
110,公立,一般大學,0002,國立清華大學,博士班,捷克共和國,歐洲,3,1,2,3,1,2,0,0,0,0,0,0,0,0,0
110,公立,一般大學,0002,國立清華大學,博士班,菲律賓共和國,東協,12,11,1,12,11,1,0,0,0,0,0,0,0,0,0
110,公立,一般大學,0002,國立清華大學,博士班,越南社會主義共和國,東協,46,25,21,46,25,21,0,0,0,0,0,0,0,0,0
110,公立,一般大學,0002,國立清華大學,博士班,新加坡共和國,東協,4,3,1,4,3,1,0,0,0,0,0,0,0,0,0
110,公立,一般大學,0002,國立清華大學,博士班,蒙古國,其他亞洲地區,1,0,1,1,0,1,0,0,0,0,0,0,0,0,0
110,公立,一般大學,0002,國立清華大學,博士班,澳門,港澳,3,2,1,0,0,0,0,0,0,3,2,1,0,0,0
110,公立,一般大學,0003,國立臺灣大學,學士班(日間),大韓民國(南韓),其他亞洲地區,124,51,73,112,47,65,12,4,8,0,0,0,0,0,0
110,公立,一般大學,0003,國立臺灣大學,學士班(日間),巴西聯邦共和國,中南美洲,5,1,4,0,0,0,5,1,4,0,0,0,0,0,0
110,公立,一般大學,0003,國立臺灣大學,學士班(日間),日本,其他亞洲地區,115,40,75,83,30,53,32,10,22,0,0,0,0,0,0
110,公立,一般大學,0003,國立臺灣大學,學士班(日間),以色列,其他亞洲地區,1,1,0,1,1,0,0,0,0,0,0,0,0,0,0
110,公立,一般大學,0003,國立臺灣大學,學士班(日間),加拿大,北美洲,14,7,7,0,0,0,14,7,7,0,0,0,0,0,0
110,公立,一般大學,0003,國立臺灣大學,學士班(日間),印度尼西亞共和國,東協,276,131,145,76,39,37,200,92,108,0,0,0,0,0,0
110,公立,一般大學,0003,國立臺灣大學,學士班(日間),汶萊和平之國,東協,3,0,3,0,0,0,3,0,3,0,0,0,0,0,0
110,公立,一般大學,0003,國立臺灣大學,學士班(日間),法國,歐洲,1,0,1,0,0,0,1,0,1,0,0,0,0,0,0
110,公立,一般大學,0003,國立臺灣大學,學士班(日間),芬蘭共和國,歐洲,2,1,1,2,1,1,0,0,0,0,0,0,0,0,0
110,公立,一般大學,0003,國立臺灣大學,學士班(日間),保加利亞共和國,歐洲,1,1,0,1,1,0,0,0,0,0,0,0,0,0,0
110,公立,一般大學,0003,國立臺灣大學,學士班(日間),俄羅斯聯邦,其他亞洲地區,3,1,2,3,1,2,0,0,0,0,0,0,0,0,0
110,公立,一般大學,0003,國立臺灣大學,學士班(日間),約旦哈什米王國,其他亞洲地區,1,0,1,0,0,0,1,0,1,0,0,0,0,0,0
110,公立,一般大學,0003,國立臺灣大學,學士班(日間),美國,北美洲,34,25,9,17,14,3,17,11,6,0,0,0,0,0,0
110,公立,一般大學,0003,國立臺灣大學,學士班(日間),英國,歐洲,3,2,1,3,2,1,0,0,0,0,0,0,0,0,0
110,公立,一般大學,0003,國立臺灣大學,學士班(日間),泰國,東協,49,20,29,9,4,5,40,16,24,0,0,0,0,0,0
110,公立,一般大學,0003,國立臺灣大學,學士班(日間),馬來西亞,東協,486,227,259,25,9,16,461,218,243,0,0,0,0,0,0
110,公立,一般大學,0003,國立臺灣大學,學士班(日間),菲律賓共和國,東協,13,6,7,4,2,2,9,4,5,0,0,0,0,0,0
110,公立,一般大學,0003,國立臺灣大學,學士班(日間),義大利共和國,歐洲,1,0,1,0,0,0,1,0,1,0,0,0,0,0,0
110,公立,一般大學,0003,國立臺灣大學,學士班(日間),聖克里斯多福及尼維斯,中南美洲,1,0,1,1,0,1,0,0,0,0,0,0,0,0,0
110,公立,一般大學,0003,國立臺灣大學,學士班(日間),聖露西亞,中南美洲,3,1,2,3,1,2,0,0,0,0,0,0,0,0,0
110,公立,一般大學,0003,國立臺灣大學,學士班(日間),蒙古國,其他亞洲地區,6,1,5,6,1,5,0,0,0,0,0,0,0,0,0
110,公立,一般大學,0003,國立臺灣大學,學士班(日間),寮人民民主共和國(寮國),東協,1,0,1,0,0,0,1,0,1,0,0,0,0,0,0
110,公立,一般大學,0003,國立臺灣大學,學士班(日間),黎巴嫩共和國,其他亞洲地區,1,0,1,0,0,0,1,0,1,0,0,0,0,0,0
110,公立,一般大學,0003,國立臺灣大學,學士班(日間),墨西哥合眾國,中南美洲,3,1,2,1,1,0,2,0,2,0,0,0,0,0,0
110,公立,一般大學,0003,國立臺灣大學,學士班(日間),薩爾瓦多,中南美洲,3,2,1,2,2,0,1,0,1,0,0,0,0,0,0
110,公立,一般大學,0003,國立臺灣大學,學士班(日間),土耳其共和國,其他亞洲地區,1,1,0,1,1,0,0,0,0,0,0,0,0,0,0
110,公立,一般大學,0003,國立臺灣大學,學士班(日間),大陸地區,大陸地區,10,3,7,0,0,0,0,0,0,0,0,0,10,3,7
110,公立,一般大學,0003,國立臺灣大學,學士班(日間),丹麥王國,歐洲,1,0,1,1,0,1,0,0,0,0,0,0,0,0,0
110,公立,一般大學,0003,國立臺灣大學,學士班(日間),巴拉圭,中南美洲,22,14,8,20,13,7,2,1,1,0,0,0,0,0,0
110,公立,一般大學,0003,國立臺灣大學,學士班(日間),巴拿馬共和國,中南美洲,3,1,2,3,1,2,0,0,0,0,0,0,0,0,0
110,公立,一般大學,0003,國立臺灣大學,學士班(日間),比利時王國,歐洲,1,0,1,0,0,0,1,0,1,0,0,0,0,0,0
110,公立,一般大學,0003,國立臺灣大學,學士班(日間),史瓦帝尼王國,非洲,1,1,0,1,1,0,0,0,0,0,0,0,0,0,0
110,公立,一般大學,0003,國立臺灣大學,學士班(日間),尼加拉瓜,中南美洲,3,2,1,2,2,0,1,0,1,0,0,0,0,0,0
110,公立,一般大學,0003,國立臺灣大學,學士班(日間),瓜地馬拉共和國,中南美洲,3,1,2,3,1,2,0,0,0,0,0,0,0,0,0
110,公立,一般大學,0003,國立臺灣大學,學士班(日間),白俄羅斯共和國,其他亞洲地區,1,1,0,1,1,0,0,0,0,0,0,0,0,0,0
110,公立,一般大學,0003,國立臺灣大學,學士班(日間),匈牙利共和國,歐洲,1,0,1,0,0,0,1,0,1,0,0,0,0,0,0
110,公立,一般大學,0003,國立臺灣大學,學士班(日間),宏都拉斯共和國,中南美洲,33,16,17,33,16,17,0,0,0,0,0,0,0,0,0
110,公立,一般大學,0003,國立臺灣大學,學士班(日間),貝里斯,中南美洲,6,4,2,6,4,2,0,0,0,0,0,0,0,0,0
110,公立,一般大學,0003,國立臺灣大學,學士班(日間),帛琉共和國,其他亞洲地區,2,0,2,1,0,1,1,0,1,0,0,0,0,0,0
110,公立,一般大學,0003,國立臺灣大學,學士班(日間),阿根廷,中南美洲,3,2,1,1,0,1,2,2,0,0,0,0,0,0,0
110,公立,一般大學,0003,國立臺灣大學,學士班(日間),香港,港澳,226,131,95,0,0,0,0,0,0,226,131,95,0,0,0
110,公立,一般大學,0003,國立臺灣大學,學士班(日間),哥倫比亞共和國,中南美洲,1,0,1,0,0,0,1,0,1,0,0,0,0,0,0
110,公立,一般大學,0003,國立臺灣大學,學士班(日間),海地共和國,中南美洲,3,3,0,3,3,0,0,0,0,0,0,0,0,0,0
110,公立,一般大學,0003,國立臺灣大學,學士班(日間),斯洛伐克共和國,歐洲,1,1,0,1,1,0,0,0,0,0,0,0,0,0,0
110,公立,一般大學,0003,國立臺灣大學,學士班(日間),智利,中南美洲,3,2,1,0,0,0,3,2,1,0,0,0,0,0,0
110,公立,一般大學,0003,國立臺灣大學,學士班(日間),越南社會主義共和國,東協,52,16,36,13,4,9,39,12,27,0,0,0,0,0,0
110,公立,一般大學,0003,國立臺灣大學,學士班(日間),新加坡共和國,東協,10,2,8,5,1,4,5,1,4,0,0,0,0,0,0
110,公立,一般大學,0003,國立臺灣大學,學士班(日間),瑞士聯邦,歐洲,1,1,0,0,0,0,1,1,0,0,0,0,0,0,0
110,公立,一般大學,0003,國立臺灣大學,學士班(日間),葉門共和國,其他亞洲地區,1,0,1,0,0,0,1,0,1,0,0,0,0,0,0
110,公立,一般大學,0003,國立臺灣大學,學士班(日間),葡萄牙共和國,歐洲,1,1,0,1,1,0,0,0,0,0,0,0,0,0,0
110,公立,一般大學,0003,國立臺灣大學,學士班(日間),德意志聯邦共和國,歐洲,3,2,1,3,2,1,0,0,0,0,0,0,0,0,0
110,公立,一般大學,0003,國立臺灣大學,學士班(日間),緬甸,東協,24,11,13,0,0,0,24,11,13,0,0,0,0,0,0
110,公立,一般大學,0003,國立臺灣大學,學士班(日間),澳門,港澳,183,101,82,0,0,0,0,0,0,183,101,82,0,0,0
110,公立,一般大學,0003,國立臺灣大學,碩士班(日間),大陸地區,大陸地區,285,125,160,0,0,0,0,0,0,0,0,0,285,125,160
110,公立,一般大學,0003,國立臺灣大學,碩士班(日間),巴拉圭,中南美洲,5,2,3,3,2,1,2,0,2,0,0,0,0,0,0
110,公立,一般大學,0003,國立臺灣大學,碩士班(日間),巴拿馬共和國,中南美洲,2,1,1,2,1,1,0,0,0,0,0,0,0,0,0
110,公立,一般大學,0003,國立臺灣大學,碩士班(日間),日本,其他亞洲地區,37,17,20,34,15,19,3,2,1,0,0,0,0,0,0
110,公立,一般大學,0003,國立臺灣大學,碩士班(日間),比利時王國,歐洲,1,1,0,1,1,0,0,0,0,0,0,0,0,0,0
110,公立,一般大學,0003,國立臺灣大學,碩士班(日間),史瓦帝尼王國,非洲,2,1,1,2,1,1,0,0,0,0,0,0,0,0,0
110,公立,一般大學,0003,國立臺灣大學,碩士班(日間),尼加拉瓜,中南美洲,1,0,1,1,0,1,0,0,0,0,0,0,0,0,0
110,公立,一般大學,0003,國立臺灣大學,碩士班(日間),瓜地馬拉共和國,中南美洲,6,3,3,6,3,3,0,0,0,0,0,0,0,0,0
110,公立,一般大學,0003,國立臺灣大學,碩士班(日間),白俄羅斯共和國,其他亞洲地區,1,1,0,1,1,0,0,0,0,0,0,0,0,0,0
110,公立,一般大學,0003,國立臺灣大學,碩士班(日間),印度,南亞,28,23,5,28,23,5,0,0,0,0,0,0,0,0,0
110,公立,一般大學,0003,國立臺灣大學,碩士班(日間),西班牙王國,歐洲,3,2,1,2,2,0,1,0,1,0,0,0,0,0,0
110,公立,一般大學,0003,國立臺灣大學,碩士班(日間),宏都拉斯共和國,中南美洲,1,1,0,1,1,0,0,0,0,0,0,0,0,0,0
110,公立,一般大學,0003,國立臺灣大學,碩士班(日間),貝里斯,中南美洲,4,2,2,2,1,1,2,1,1,0,0,0,0,0,0
110,公立,一般大學,0003,國立臺灣大學,碩士班(日間),奈及利亞聯邦共和國,非洲,1,1,0,1,1,0,0,0,0,0,0,0,0,0,0
110,公立,一般大學,0003,國立臺灣大學,碩士班(日間),阿根廷,中南美洲,1,1,0,1,1,0,0,0,0,0,0,0,0,0,0
110,公立,一般大學,0003,國立臺灣大學,碩士班(日間),南非共和國,非洲,2,1,1,1,1,0,1,0,1,0,0,0,0,0,0
110,公立,一般大學,0003,國立臺灣大學,碩士班(日間),香港,港澳,97,52,45,0,0,0,0,0,0,97,52,45,0,0,0
110,公立,一般大學,0003,國立臺灣大學,碩士班(日間),哥倫比亞共和國,中南美洲,2,1,1,2,1,1,0,0,0,0,0,0,0,0,0
110,公立,一般大學,0003,國立臺灣大學,碩士班(日間),海地共和國,中南美洲,5,3,2,5,3,2,0,0,0,0,0,0,0,0,0
110,公立,一般大學,0003,國立臺灣大學,碩士班(日間),紐西蘭,其他亞洲地區,2,2,0,1,1,0,1,1,0,0,0,0,0,0,0
110,公立,一般大學,0003,國立臺灣大學,碩士班(日間),斯里蘭卡民主社會主義共和國,南亞,2,0,2,2,0,2,0,0,0,0,0,0,0,0,0
110,公立,一般大學,0003,國立臺灣大學,碩士班(日間),越南社會主義共和國,東協,30,12,18,24,9,15,6,3,3,0,0,0,0,0,0
110,公立,一般大學,0003,國立臺灣大學,碩士班(日間),愛爾蘭共和國,歐洲,1,0,1,1,0,1,0,0,0,0,0,0,0,0,0
110,公立,一般大學,0003,國立臺灣大學,碩士班(日間),新加坡共和國,東協,3,1,2,3,1,2,0,0,0,0,0,0,0,0,0
110,公立,一般大學,0003,國立臺灣大學,碩士班(日間),瑞士聯邦,歐洲,1,1,0,1,1,0,0,0,0,0,0,0,0,0,0
110,公立,一般大學,0003,國立臺灣大學,碩士班(日間),瑞典王國,歐洲,2,0,2,2,0,2,0,0,0,0,0,0,0,0,0
110,公立,一般大學,0003,國立臺灣大學,碩士班(日間),德意志聯邦共和國,歐洲,10,9,1,10,9,1,0,0,0,0,0,0,0,0,0
110,公立,一般大學,0003,國立臺灣大學,碩士班(日間),緬甸,東協,4,2,2,3,1,2,1,1,0,0,0,0,0,0,0
110,公立,一般大學,0003,國立臺灣大學,碩士班(日間),澳門,港澳,42,23,19,0,0,0,0,0,0,42,23,19,0,0,0
110,公立,一般大學,0003,國立臺灣大學,碩士班(日間),土耳其共和國,其他亞洲地區,3,2,1,3,2,1,0,0,0,0,0,0,0,0,0
110,公立,一般大學,0003,國立臺灣大學,碩士班(日間),大韓民國(南韓),其他亞洲地區,25,11,14,24,10,14,1,1,0,0,0,0,0,0,0
110,公立,一般大學,0003,國立臺灣大學,碩士班(日間),巴基斯坦,南亞,1,1,0,1,1,0,0,0,0,0,0,0,0,0,0
110,公立,一般大學,0003,國立臺灣大學,碩士班(日間),以色列,其他亞洲地區,2,1,1,2,1,1,0,0,0,0,0,0,0,0,0
110,公立,一般大學,0003,國立臺灣大學,碩士班(日間),加拿大,北美洲,16,14,2,10,9,1,6,5,1,0,0,0,0,0,0
110,公立,一般大學,0003,國立臺灣大學,碩士班(日間),尼泊爾聯邦民主共和國,南亞,2,1,1,2,1,1,0,0,0,0,0,0,0,0,0
110,公立,一般大學,0003,國立臺灣大學,碩士班(日間),布吉納法索,非洲,2,2,0,2,2,0,0,0,0,0,0,0,0,0,0
110,公立,一般大學,0003,國立臺灣大學,碩士班(日間),伊拉克共和國,其他亞洲地區,1,1,0,1,1,0,0,0,0,0,0,0,0,0,0
110,公立,一般大學,0003,國立臺灣大學,碩士班(日間),印度尼西亞共和國,東協,43,21,22,29,16,13,14,5,9,0,0,0,0,0,0
110,公立,一般大學,0003,國立臺灣大學,碩士班(日間),坦尚尼亞聯合共和國,非洲,2,1,1,2,1,1,0,0,0,0,0,0,0,0,0
110,公立,一般大學,0003,國立臺灣大學,碩士班(日間),波士尼亞與赫塞哥維納,歐洲,1,1,0,1,1,0,0,0,0,0,0,0,0,0,0
110,公立,一般大學,0003,國立臺灣大學,碩士班(日間),波蘭共和國,歐洲,2,1,1,2,1,1,0,0,0,0,0,0,0,0,0
110,公立,一般大學,0003,國立臺灣大學,碩士班(日間),法國,歐洲,8,4,4,8,4,4,0,0,0,0,0,0,0,0,0
110,公立,一般大學,0003,國立臺灣大學,碩士班(日間),俄羅斯聯邦,其他亞洲地區,5,3,2,5,3,2,0,0,0,0,0,0,0,0,0
110,公立,一般大學,0003,國立臺灣大學,碩士班(日間),美國,北美洲,62,30,32,56,28,28,6,2,4,0,0,0,0,0,0
110,公立,一般大學,0003,國立臺灣大學,碩士班(日間),英國,歐洲,8,6,2,8,6,2,0,0,0,0,0,0,0,0,0
110,公立,一般大學,0003,國立臺灣大學,碩士班(日間),埃及阿拉伯共和國,非洲,1,1,0,1,1,0,0,0,0,0,0,0,0,0,0
110,公立,一般大學,0003,國立臺灣大學,碩士班(日間),泰國,東協,37,14,23,35,12,23,2,2,0,0,0,0,0,0,0
110,公立,一般大學,0003,國立臺灣大學,碩士班(日間),烏克蘭,其他亞洲地區,1,1,0,1,1,0,0,0,0,0,0,0,0,0,0
110,公立,一般大學,0003,國立臺灣大學,碩士班(日間),馬來西亞,東協,182,95,87,59,24,35,123,71,52,0,0,0,0,0,0
110,公立,一般大學,0003,國立臺灣大學,碩士班(日間),荷蘭王國,歐洲,3,2,1,3,2,1,0,0,0,0,0,0,0,0,0
110,公立,一般大學,0003,國立臺灣大學,碩士班(日間),菲律賓共和國,東協,18,9,9,15,8,7,3,1,2,0,0,0,0,0,0
110,公立,一般大學,0003,國立臺灣大學,碩士班(日間),義大利共和國,歐洲,3,1,2,3,1,2,0,0,0,0,0,0,0,0,0
110,公立,一般大學,0003,國立臺灣大學,碩士班(日間),聖文森(及格瑞那丁),中南美洲,2,1,1,2,1,1,0,0,0,0,0,0,0,0,0
110,公立,一般大學,0003,國立臺灣大學,碩士班(日間),聖克里斯多福及尼維斯,中南美洲,1,1,0,1,1,0,0,0,0,0,0,0,0,0,0
110,公立,一般大學,0003,國立臺灣大學,碩士班(日間),聖露西亞,中南美洲,2,1,1,2,1,1,0,0,0,0,0,0,0,0,0
110,公立,一般大學,0003,國立臺灣大學,碩士班(日間),蒙古國,其他亞洲地區,2,2,0,2,2,0,0,0,0,0,0,0,0,0,0
110,公立,一般大學,0003,國立臺灣大學,碩士班(日間),墨西哥合眾國,中南美洲,5,4,1,5,4,1,0,0,0,0,0,0,0,0,0
110,公立,一般大學,0003,國立臺灣大學,碩士班(日間),澳大利亞,其他亞洲地區,5,4,1,2,2,0,3,2,1,0,0,0,0,0,0
110,公立,一般大學,0003,國立臺灣大學,碩士班(日間),薩爾瓦多,中南美洲,1,1,0,0,0,0,1,1,0,0,0,0,0,0,0
110,公立,一般大學,0003,國立臺灣大學,博士班,大陸地區,大陸地區,78,55,23,0,0,0,0,0,0,0,0,0,78,55,23
110,公立,一般大學,0003,國立臺灣大學,博士班,大韓民國(南韓),其他亞洲地區,8,3,5,7,2,5,1,1,0,0,0,0,0,0,0
110,公立,一般大學,0003,國立臺灣大學,博士班,厄瓜多共和國,中南美洲,1,1,0,1,1,0,0,0,0,0,0,0,0,0,0
110,公立,一般大學,0003,國立臺灣大學,博士班,巴拿馬共和國,中南美洲,1,1,0,1,1,0,0,0,0,0,0,0,0,0,0
110,公立,一般大學,0003,國立臺灣大學,博士班,巴基斯坦,南亞,12,10,2,12,10,2,0,0,0,0,0,0,0,0,0
110,公立,一般大學,0003,國立臺灣大學,博士班,日本,其他亞洲地區,14,9,5,14,9,5,0,0,0,0,0,0,0,0,0
110,公立,一般大學,0003,國立臺灣大學,博士班,加拿大,北美洲,6,5,1,3,2,1,3,3,0,0,0,0,0,0,0
110,公立,一般大學,0003,國立臺灣大學,博士班,尼泊爾聯邦民主共和國,南亞,3,2,1,3,2,1,0,0,0,0,0,0,0,0,0
110,公立,一般大學,0003,國立臺灣大學,博士班,伊朗伊斯蘭共和國,其他亞洲地區,3,3,0,3,3,0,0,0,0,0,0,0,0,0,0
110,公立,一般大學,0003,國立臺灣大學,博士班,印度,南亞,92,57,35,92,57,35,0,0,0,0,0,0,0,0,0
110,公立,一般大學,0003,國立臺灣大學,博士班,印度尼西亞共和國,東協,40,28,12,38,28,10,2,0,2,0,0,0,0,0,0
110,公立,一般大學,0003,國立臺灣大學,博士班,衣索比亞聯邦民主共和國,非洲,4,3,1,4,3,1,0,0,0,0,0,0,0,0,0
110,公立,一般大學,0003,國立臺灣大學,博士班,西班牙王國,歐洲,2,1,1,2,1,1,0,0,0,0,0,0,0,0,0
110,公立,一般大學,0003,國立臺灣大學,博士班,利比亞,非洲,1,1,0,1,1,0,0,0,0,0,0,0,0,0,0
110,公立,一般大學,0003,國立臺灣大學,博士班,貝里斯,中南美洲,1,1,0,1,1,0,0,0,0,0,0,0,0,0,0
110,公立,一般大學,0003,國立臺灣大學,博士班,貝南共和國,非洲,1,0,1,1,0,1,0,0,0,0,0,0,0,0,0
110,公立,一般大學,0003,國立臺灣大學,博士班,南非共和國,非洲,2,1,1,1,0,1,1,1,0,0,0,0,0,0,0
110,公立,一般大學,0003,國立臺灣大學,博士班,約旦哈什米王國,其他亞洲地區,1,1,0,1,1,0,0,0,0,0,0,0,0,0,0
110,公立,一般大學,0003,國立臺灣大學,博士班,英國,歐洲,3,2,1,3,2,1,0,0,0,0,0,0,0,0,0
110,公立,一般大學,0003,國立臺灣大學,博士班,香港,港澳,15,11,4,0,0,0,0,0,0,15,11,4,0,0,0
110,公立,一般大學,0003,國立臺灣大學,博士班,哥倫比亞共和國,中南美洲,2,2,0,2,2,0,0,0,0,0,0,0,0,0,0
110,公立,一般大學,0003,國立臺灣大學,博士班,秘魯共和國,中南美洲,1,0,1,1,0,1,0,0,0,0,0,0,0,0,0
110,公立,一般大學,0003,國立臺灣大學,博士班,馬來西亞,東協,53,30,23,28,16,12,25,14,11,0,0,0,0,0,0
110,公立,一般大學,0003,國立臺灣大學,博士班,捷克共和國,歐洲,1,1,0,1,1,0,0,0,0,0,0,0,0,0,0
110,公立,一般大學,0003,國立臺灣大學,博士班,荷蘭王國,歐洲,2,2,0,2,2,0,0,0,0,0,0,0,0,0,0
110,公立,一般大學,0003,國立臺灣大學,博士班,愛爾蘭共和國,歐洲,1,1,0,1,1,0,0,0,0,0,0,0,0,0,0
110,公立,一般大學,0003,國立臺灣大學,博士班,新加坡共和國,東協,1,1,0,1,1,0,0,0,0,0,0,0,0,0,0
110,公立,一般大學,0003,國立臺灣大學,博士班,蒙古國,其他亞洲地區,4,2,2,4,2,2,0,0,0,0,0,0,0,0,0
110,公立,一般大學,0003,國立臺灣大學,博士班,緬甸,東協,4,1,3,4,1,3,0,0,0,0,0,0,0,0,0
110,公立,一般大學,0003,國立臺灣大學,博士班,澳大利亞,其他亞洲地區,1,1,0,1,1,0,0,0,0,0,0,0,0,0,0
110,公立,一般大學,0003,國立臺灣大學,博士班,澳門,港澳,12,9,3,0,0,0,0,0,0,12,9,3,0,0,0
110,公立,一般大學,0003,國立臺灣大學,博士班,土耳其共和國,其他亞洲地區,3,2,1,3,2,1,0,0,0,0,0,0,0,0,0
110,公立,一般大學,0003,國立臺灣大學,博士班,巴西聯邦共和國,中南美洲,1,0,1,1,0,1,0,0,0,0,0,0,0,0,0
110,公立,一般大學,0003,國立臺灣大學,博士班,比利時王國,歐洲,1,1,0,1,1,0,0,0,0,0,0,0,0,0,0
110,公立,一般大學,0003,國立臺灣大學,博士班,瓜地馬拉共和國,中南美洲,3,3,0,3,3,0,0,0,0,0,0,0,0,0,0
110,公立,一般大學,0003,國立臺灣大學,博士班,希臘共和國,歐洲,1,1,0,1,1,0,0,0,0,0,0,0,0,0,0
110,公立,一般大學,0003,國立臺灣大學,博士班,奈及利亞聯邦共和國,非洲,1,1,0,1,1,0,0,0,0,0,0,0,0,0,0
110,公立,一般大學,0003,國立臺灣大學,博士班,波蘭共和國,歐洲,1,1,0,1,1,0,0,0,0,0,0,0,0,0,0
110,公立,一般大學,0003,國立臺灣大學,博士班,法國,歐洲,4,4,0,4,4,0,0,0,0,0,0,0,0,0,0
110,公立,一般大學,0003,國立臺灣大學,博士班,俄羅斯聯邦,其他亞洲地區,2,0,2,2,0,2,0,0,0,0,0,0,0,0,0
110,公立,一般大學,0003,國立臺灣大學,博士班,美國,北美洲,18,13,5,18,13,5,0,0,0,0,0,0,0,0,0
110,公立,一般大學,0003,國立臺灣大學,博士班,埃及阿拉伯共和國,非洲,2,1,1,2,1,1,0,0,0,0,0,0,0,0,0
110,公立,一般大學,0003,國立臺灣大學,博士班,泰國,東協,12,6,6,12,6,6,0,0,0,0,0,0,0,0,0
110,公立,一般大學,0003,國立臺灣大學,博士班,海地共和國,中南美洲,2,2,0,2,2,0,0,0,0,0,0,0,0,0,0
110,公立,一般大學,0003,國立臺灣大學,博士班,斯洛維尼亞共和國,歐洲,1,0,1,1,0,1,0,0,0,0,0,0,0,0,0
110,公立,一般大學,0003,國立臺灣大學,博士班,菲律賓共和國,東協,11,8,3,11,8,3,0,0,0,0,0,0,0,0,0
110,公立,一般大學,0003,國立臺灣大學,博士班,越南社會主義共和國,東協,27,15,12,27,15,12,0,0,0,0,0,0,0,0,0
110,公立,一般大學,0003,國立臺灣大學,博士班,奧地利共和國,歐洲,1,0,1,1,0,1,0,0,0,0,0,0,0,0,0
110,公立,一般大學,0003,國立臺灣大學,博士班,瑞士聯邦,歐洲,1,1,0,1,1,0,0,0,0,0,0,0,0,0,0
110,公立,一般大學,0003,國立臺灣大學,博士班,義大利共和國,歐洲,1,0,1,1,0,1,0,0,0,0,0,0,0,0,0
110,公立,一般大學,0003,國立臺灣大學,博士班,葉門共和國,其他亞洲地區,1,1,0,1,1,0,0,0,0,0,0,0,0,0,0
110,公立,一般大學,0003,國立臺灣大學,博士班,德意志聯邦共和國,歐洲,7,7,0,7,7,0,0,0,0,0,0,0,0,0,0
110,公立,一般大學,0004,國立臺灣師範大學,學士班(日間),大陸地區,大陸地區,11,3,8,0,0,0,0,0,0,0,0,0,11,3,8
110,公立,一般大學,0004,國立臺灣師範大學,學士班(日間),巴拉圭,中南美洲,7,2,5,5,1,4,2,1,1,0,0,0,0,0,0
110,公立,一般大學,0004,國立臺灣師範大學,學士班(日間),尼加拉瓜,中南美洲,1,0,1,1,0,1,0,0,0,0,0,0,0,0,0
110,公立,一般大學,0004,國立臺灣師範大學,學士班(日間),瓜地馬拉共和國,中南美洲,2,2,0,2,2,0,0,0,0,0,0,0,0,0,0
110,公立,一般大學,0004,國立臺灣師範大學,學士班(日間),伊朗伊斯蘭共和國,其他亞洲地區,1,1,0,0,0,0,1,1,0,0,0,0,0,0,0
110,公立,一般大學,0004,國立臺灣師範大學,學士班(日間),印度,南亞,2,1,1,2,1,1,0,0,0,0,0,0,0,0,0
110,公立,一般大學,0004,國立臺灣師範大學,學士班(日間),宏都拉斯共和國,中南美洲,2,2,0,2,2,0,0,0,0,0,0,0,0,0,0
110,公立,一般大學,0004,國立臺灣師範大學,學士班(日間),法國,歐洲,4,2,2,4,2,2,0,0,0,0,0,0,0,0,0
110,公立,一般大學,0004,國立臺灣師範大學,學士班(日間),阿根廷,中南美洲,2,1,1,0,0,0,2,1,1,0,0,0,0,0,0
110,公立,一般大學,0004,國立臺灣師範大學,學士班(日間),美國,北美洲,8,5,3,5,4,1,3,1,2,0,0,0,0,0,0
110,公立,一般大學,0004,國立臺灣師範大學,學士班(日間),香港,港澳,141,65,76,0,0,0,0,0,0,141,65,76,0,0,0
110,公立,一般大學,0004,國立臺灣師範大學,學士班(日間),哥倫比亞共和國,中南美洲,1,1,0,1,1,0,0,0,0,0,0,0,0,0,0
110,公立,一般大學,0004,國立臺灣師範大學,學士班(日間),越南社會主義共和國,東協,101,13,88,74,7,67,27,6,21,0,0,0,0,0,0
110,公立,一般大學,0004,國立臺灣師範大學,學士班(日間),新加坡共和國,東協,5,1,4,4,1,3,1,0,1,0,0,0,0,0,0
110,公立,一般大學,0004,國立臺灣師範大學,學士班(日間),瑞士聯邦,歐洲,1,1,0,1,1,0,0,0,0,0,0,0,0,0,0
110,公立,一般大學,0004,國立臺灣師範大學,學士班(日間),葡萄牙共和國,歐洲,1,0,1,1,0,1,0,0,0,0,0,0,0,0,0
110,公立,一般大學,0004,國立臺灣師範大學,學士班(日間),德意志聯邦共和國,歐洲,2,1,1,2,1,1,0,0,0,0,0,0,0,0,0
110,公立,一般大學,0004,國立臺灣師範大學,學士班(日間),緬甸,東協,66,15,51,0,0,0,66,15,51,0,0,0,0,0,0
110,公立,一般大學,0004,國立臺灣師範大學,學士班(日間),墨西哥合眾國,中南美洲,1,0,1,1,0,1,0,0,0,0,0,0,0,0,0
110,公立,一般大學,0004,國立臺灣師範大學,學士班(日間),澳大利亞,其他亞洲地區,1,1,0,1,1,0,0,0,0,0,0,0,0,0,0
110,公立,一般大學,0004,國立臺灣師範大學,學士班(日間),澳門,港澳,117,57,60,0,0,0,0,0,0,117,57,60,0,0,0
110,公立,一般大學,0004,國立臺灣師範大學,學士班(日間),大韓民國(南韓),其他亞洲地區,42,14,28,36,13,23,6,1,5,0,0,0,0,0,0
110,公立,一般大學,0004,國立臺灣師範大學,學士班(日間),日本,其他亞洲地區,88,26,62,73,22,51,15,4,11,0,0,0,0,0,0
110,公立,一般大學,0004,國立臺灣師範大學,學士班(日間),加拿大,北美洲,2,0,2,1,0,1,1,0,1,0,0,0,0,0,0
110,公立,一般大學,0004,國立臺灣師範大學,學士班(日間),印度尼西亞共和國,東協,76,20,56,20,6,14,56,14,42,0,0,0,0,0,0
110,公立,一般大學,0004,國立臺灣師範大學,學士班(日間),克羅埃西亞共和國,歐洲,1,1,0,1,1,0,0,0,0,0,0,0,0,0,0
110,公立,一般大學,0004,國立臺灣師範大學,學士班(日間),波蘭共和國,歐洲,2,1,1,2,1,1,0,0,0,0,0,0,0,0,0
110,公立,一般大學,0004,國立臺灣師範大學,學士班(日間),俄羅斯聯邦,其他亞洲地區,2,2,0,2,2,0,0,0,0,0,0,0,0,0,0
110,公立,一般大學,0004,國立臺灣師範大學,學士班(日間),柬埔寨王國,東協,1,0,1,1,0,1,0,0,0,0,0,0,0,0,0
110,公立,一般大學,0004,國立臺灣師範大學,學士班(日間),玻利維亞共和國,中南美洲,1,0,1,1,0,1,0,0,0,0,0,0,0,0,0
110,公立,一般大學,0004,國立臺灣師範大學,學士班(日間),英國,歐洲,1,1,0,1,1,0,0,0,0,0,0,0,0,0,0
110,公立,一般大學,0004,國立臺灣師範大學,學士班(日間),泰國,東協,22,8,14,13,7,6,9,1,8,0,0,0,0,0,0
110,公立,一般大學,0004,國立臺灣師範大學,學士班(日間),烏克蘭,其他亞洲地區,1,0,1,1,0,1,0,0,0,0,0,0,0,0,0
110,公立,一般大學,0004,國立臺灣師範大學,學士班(日間),馬來西亞,東協,197,69,128,11,7,4,186,62,124,0,0,0,0,0,0
110,公立,一般大學,0004,國立臺灣師範大學,學士班(日間),菲律賓共和國,東協,3,0,3,2,0,2,1,0,1,0,0,0,0,0,0
110,公立,一般大學,0004,國立臺灣師範大學,學士班(日間),義大利共和國,歐洲,1,1,0,1,1,0,0,0,0,0,0,0,0,0,0
110,公立,一般大學,0004,國立臺灣師範大學,學士班(日間),聖文森(及格瑞那丁),中南美洲,1,0,1,1,0,1,0,0,0,0,0,0,0,0,0
110,公立,一般大學,0004,國立臺灣師範大學,碩士班(日間),大韓民國(南韓),其他亞洲地區,16,3,13,15,3,12,1,0,1,0,0,0,0,0,0
110,公立,一般大學,0004,國立臺灣師範大學,碩士班(日間),日本,其他亞洲地區,19,6,13,18,6,12,1,0,1,0,0,0,0,0,0
110,公立,一般大學,0004,國立臺灣師範大學,碩士班(日間),加拿大,北美洲,6,4,2,4,3,1,2,1,1,0,0,0,0,0,0
110,公立,一般大學,0004,國立臺灣師範大學,碩士班(日間),印度尼西亞共和國,東協,18,3,15,13,3,10,5,0,5,0,0,0,0,0,0
110,公立,一般大學,0004,國立臺灣師範大學,碩士班(日間),西班牙王國,歐洲,1,1,0,1,1,0,0,0,0,0,0,0,0,0,0
110,公立,一般大學,0004,國立臺灣師範大學,碩士班(日間),汶萊和平之國,東協,1,1,0,0,0,0,1,1,0,0,0,0,0,0,0
110,公立,一般大學,0004,國立臺灣師範大學,碩士班(日間),波蘭共和國,歐洲,1,0,1,1,0,1,0,0,0,0,0,0,0,0,0
110,公立,一般大學,0004,國立臺灣師範大學,碩士班(日間),法國,歐洲,2,1,1,2,1,1,0,0,0,0,0,0,0,0,0
110,公立,一般大學,0004,國立臺灣師範大學,碩士班(日間),俄羅斯聯邦,其他亞洲地區,6,2,4,6,2,4,0,0,0,0,0,0,0,0,0
110,公立,一般大學,0004,國立臺灣師範大學,碩士班(日間),英國,歐洲,2,2,0,2,2,0,0,0,0,0,0,0,0,0,0
110,公立,一般大學,0004,國立臺灣師範大學,碩士班(日間),泰國,東協,19,4,15,17,3,14,2,1,1,0,0,0,0,0,0
110,公立,一般大學,0004,國立臺灣師範大學,碩士班(日間),秘魯共和國,中南美洲,1,1,0,1,1,0,0,0,0,0,0,0,0,0,0
110,公立,一般大學,0004,國立臺灣師範大學,碩士班(日間),索馬利蘭共和國,非洲,1,1,0,1,1,0,0,0,0,0,0,0,0,0,0
110,公立,一般大學,0004,國立臺灣師範大學,碩士班(日間),馬來西亞,東協,81,23,58,19,6,13,62,17,45,0,0,0,0,0,0
110,公立,一般大學,0004,國立臺灣師範大學,碩士班(日間),菲律賓共和國,東協,9,3,6,7,3,4,2,0,2,0,0,0,0,0,0
110,公立,一般大學,0004,國立臺灣師範大學,碩士班(日間),聖文森(及格瑞那丁),中南美洲,2,0,2,2,0,2,0,0,0,0,0,0,0,0,0
110,公立,一般大學,0004,國立臺灣師範大學,碩士班(日間),聖露西亞,中南美洲,1,0,1,1,0,1,0,0,0,0,0,0,0,0,0
110,公立,一般大學,0004,國立臺灣師範大學,碩士班(日間),土耳其共和國,其他亞洲地區,1,0,1,1,0,1,0,0,0,0,0,0,0,0,0
110,公立,一般大學,0004,國立臺灣師範大學,碩士班(日間),大陸地區,大陸地區,82,24,58,0,0,0,0,0,0,0,0,0,82,24,58
110,公立,一般大學,0004,國立臺灣師範大學,碩士班(日間),比利時王國,歐洲,3,1,2,3,1,2,0,0,0,0,0,0,0,0,0
110,公立,一般大學,0004,國立臺灣師範大學,碩士班(日間),瓜地馬拉共和國,中南美洲,1,0,1,1,0,1,0,0,0,0,0,0,0,0,0
110,公立,一般大學,0004,國立臺灣師範大學,碩士班(日間),匈牙利共和國,歐洲,1,1,0,1,1,0,0,0,0,0,0,0,0,0,0
110,公立,一般大學,0004,國立臺灣師範大學,碩士班(日間),印度,南亞,7,3,4,7,3,4,0,0,0,0,0,0,0,0,0
110,公立,一般大學,0004,國立臺灣師範大學,碩士班(日間),宏都拉斯共和國,中南美洲,3,1,2,3,1,2,0,0,0,0,0,0,0,0,0
110,公立,一般大學,0004,國立臺灣師範大學,碩士班(日間),貝里斯,中南美洲,4,0,4,4,0,4,0,0,0,0,0,0,0,0,0
110,公立,一般大學,0004,國立臺灣師範大學,碩士班(日間),美國,北美洲,25,17,8,24,17,7,1,0,1,0,0,0,0,0,0
110,公立,一般大學,0004,國立臺灣師範大學,碩士班(日間),香港,港澳,75,36,39,0,0,0,0,0,0,75,36,39,0,0,0
110,公立,一般大學,0004,國立臺灣師範大學,碩士班(日間),捷克共和國,歐洲,1,1,0,1,1,0,0,0,0,0,0,0,0,0,0
110,公立,一般大學,0004,國立臺灣師範大學,碩士班(日間),越南社會主義共和國,東協,40,7,33,39,6,33,1,1,0,0,0,0,0,0,0
110,公立,一般大學,0004,國立臺灣師範大學,碩士班(日間),愛爾蘭共和國,歐洲,1,1,0,1,1,0,0,0,0,0,0,0,0,0,0
110,公立,一般大學,0004,國立臺灣師範大學,碩士班(日間),新加坡共和國,東協,1,1,0,1,1,0,0,0,0,0,0,0,0,0,0
110,公立,一般大學,0004,國立臺灣師範大學,碩士班(日間),葡萄牙共和國,歐洲,2,0,2,2,0,2,0,0,0,0,0,0,0,0,0
110,公立,一般大學,0004,國立臺灣師範大學,碩士班(日間),德意志聯邦共和國,歐洲,4,2,2,4,2,2,0,0,0,0,0,0,0,0,0
110,公立,一般大學,0004,國立臺灣師範大學,碩士班(日間),緬甸,東協,7,1,6,1,0,1,6,1,5,0,0,0,0,0,0
110,公立,一般大學,0004,國立臺灣師範大學,碩士班(日間),澳門,港澳,33,19,14,0,0,0,0,0,0,33,19,14,0,0,0
110,公立,一般大學,0004,國立臺灣師範大學,博士班,巴西聯邦共和國,中南美洲,4,2,2,3,2,1,1,0,1,0,0,0,0,0,0
110,公立,一般大學,0004,國立臺灣師範大學,博士班,法國,歐洲,5,4,1,5,4,1,0,0,0,0,0,0,0,0,0
110,公立,一般大學,0004,國立臺灣師範大學,博士班,俄羅斯聯邦,其他亞洲地區,5,2,3,5,2,3,0,0,0,0,0,0,0,0,0
110,公立,一般大學,0004,國立臺灣師範大學,博士班,美國,北美洲,5,5,0,5,5,0,0,0,0,0,0,0,0,0,0
110,公立,一般大學,0004,國立臺灣師範大學,博士班,泰國,東協,7,3,4,7,3,4,0,0,0,0,0,0,0,0,0
110,公立,一般大學,0004,國立臺灣師範大學,博士班,斯洛伐克共和國,歐洲,1,1,0,1,1,0,0,0,0,0,0,0,0,0,0
110,公立,一般大學,0004,國立臺灣師範大學,博士班,菲律賓共和國,東協,8,6,2,8,6,2,0,0,0,0,0,0,0,0,0
110,公立,一般大學,0004,國立臺灣師範大學,博士班,義大利共和國,歐洲,1,1,0,1,1,0,0,0,0,0,0,0,0,0,0
110,公立,一般大學,0004,國立臺灣師範大學,博士班,墨西哥合眾國,中南美洲,1,1,0,1,1,0,0,0,0,0,0,0,0,0,0
110,公立,一般大學,0004,國立臺灣師範大學,博士班,大陸地區,大陸地區,46,14,32,0,0,0,0,0,0,0,0,0,46,14,32
110,公立,一般大學,0004,國立臺灣師範大學,博士班,大韓民國(南韓),其他亞洲地區,8,3,5,8,3,5,0,0,0,0,0,0,0,0,0
110,公立,一般大學,0004,國立臺灣師範大學,博士班,丹麥王國,歐洲,2,1,1,2,1,1,0,0,0,0,0,0,0,0,0
110,公立,一般大學,0004,國立臺灣師範大學,博士班,巴基斯坦,南亞,1,1,0,1,1,0,0,0,0,0,0,0,0,0,0
110,公立,一般大學,0004,國立臺灣師範大學,博士班,日本,其他亞洲地區,3,2,1,3,2,1,0,0,0,0,0,0,0,0,0
110,公立,一般大學,0004,國立臺灣師範大學,博士班,印度,南亞,10,6,4,10,6,4,0,0,0,0,0,0,0,0,0
110,公立,一般大學,0004,國立臺灣師範大學,博士班,印度尼西亞共和國,東協,16,5,11,16,5,11,0,0,0,0,0,0,0,0,0
110,公立,一般大學,0004,國立臺灣師範大學,博士班,西班牙王國,歐洲,3,3,0,3,3,0,0,0,0,0,0,0,0,0,0
110,公立,一般大學,0004,國立臺灣師範大學,博士班,貝南共和國,非洲,1,1,0,1,1,0,0,0,0,0,0,0,0,0,0
110,公立,一般大學,0004,國立臺灣師範大學,博士班,尚比亞共和國,非洲,1,1,0,1,1,0,0,0,0,0,0,0,0,0,0
110,公立,一般大學,0004,國立臺灣師範大學,博士班,南非共和國,非洲,4,3,1,2,2,0,2,1,1,0,0,0,0,0,0
110,公立,一般大學,0004,國立臺灣師範大學,博士班,英國,歐洲,3,2,1,3,2,1,0,0,0,0,0,0,0,0,0
110,公立,一般大學,0004,國立臺灣師範大學,博士班,香港,港澳,8,5,3,0,0,0,0,0,0,8,5,3,0,0,0
110,公立,一般大學,0004,國立臺灣師範大學,博士班,馬來西亞,東協,15,7,8,9,3,6,6,4,2,0,0,0,0,0,0
110,公立,一般大學,0004,國立臺灣師範大學,博士班,捷克共和國,歐洲,1,1,0,1,1,0,0,0,0,0,0,0,0,0,0
110,公立,一般大學,0004,國立臺灣師範大學,博士班,荷蘭王國,歐洲,3,0,3,3,0,3,0,0,0,0,0,0,0,0,0
110,公立,一般大學,0004,國立臺灣師範大學,博士班,越南社會主義共和國,東協,17,6,11,17,6,11,0,0,0,0,0,0,0,0,0
110,公立,一般大學,0004,國立臺灣師範大學,博士班,新加坡共和國,東協,2,0,2,2,0,2,0,0,0,0,0,0,0,0,0
110,公立,一般大學,0004,國立臺灣師範大學,博士班,澳門,港澳,3,2,1,0,0,0,0,0,0,3,2,1,0,0,0
110,公立,一般大學,0004,國立臺灣師範大學,博士班,羅馬尼亞,歐洲,1,0,1,1,0,1,0,0,0,0,0,0,0,0,0
110,公立,一般大學,0005,國立成功大學,學士班(日間),大陸地區,大陸地區,10,3,7,0,0,0,0,0,0,0,0,0,10,3,7
110,公立,一般大學,0005,國立成功大學,學士班(日間),日本,其他亞洲地區,33,17,16,28,14,14,5,3,2,0,0,0,0,0,0
110,公立,一般大學,0005,國立成功大學,學士班(日間),史瓦帝尼王國,非洲,3,1,2,3,1,2,0,0,0,0,0,0,0,0,0
110,公立,一般大學,0005,國立成功大學,學士班(日間),印度,南亞,1,0,1,1,0,1,0,0,0,0,0,0,0,0,0
110,公立,一般大學,0005,國立成功大學,學士班(日間),印度尼西亞共和國,東協,132,74,58,27,14,13,105,60,45,0,0,0,0,0,0
110,公立,一般大學,0005,國立成功大學,學士班(日間),西班牙王國,歐洲,2,1,1,0,0,0,2,1,1,0,0,0,0,0,0
110,公立,一般大學,0005,國立成功大學,學士班(日間),宏都拉斯共和國,中南美洲,5,4,1,5,4,1,0,0,0,0,0,0,0,0,0
110,公立,一般大學,0005,國立成功大學,學士班(日間),貝里斯,中南美洲,6,5,1,6,5,1,0,0,0,0,0,0,0,0,0
110,公立,一般大學,0005,國立成功大學,學士班(日間),約旦哈什米王國,其他亞洲地區,1,1,0,1,1,0,0,0,0,0,0,0,0,0,0
110,公立,一般大學,0005,國立成功大學,學士班(日間),迦納共和國,非洲,1,1,0,1,1,0,0,0,0,0,0,0,0,0,0
110,公立,一般大學,0005,國立成功大學,學士班(日間),香港,港澳,156,94,62,0,0,0,0,0,0,156,94,62,0,0,0
110,公立,一般大學,0005,國立成功大學,學士班(日間),海地共和國,中南美洲,4,4,0,4,4,0,0,0,0,0,0,0,0,0,0
110,公立,一般大學,0005,國立成功大學,學士班(日間),新加坡共和國,東協,4,3,1,1,1,0,3,2,1,0,0,0,0,0,0
110,公立,一般大學,0005,國立成功大學,學士班(日間),葡萄牙共和國,歐洲,1,1,0,1,1,0,0,0,0,0,0,0,0,0,0
110,公立,一般大學,0005,國立成功大學,學士班(日間),緬甸,東協,16,7,9,0,0,0,16,7,9,0,0,0,0,0,0
110,公立,一般大學,0005,國立成功大學,學士班(日間),墨西哥合眾國,中南美洲,2,1,1,2,1,1,0,0,0,0,0,0,0,0,0
110,公立,一般大學,0005,國立成功大學,學士班(日間),諾魯共和國,其他亞洲地區,1,1,0,1,1,0,0,0,0,0,0,0,0,0,0
110,公立,一般大學,0005,國立成功大學,學士班(日間),大韓民國(南韓),其他亞洲地區,8,3,5,7,2,5,1,1,0,0,0,0,0,0,0
110,公立,一般大學,0005,國立成功大學,學士班(日間),巴西聯邦共和國,中南美洲,3,3,0,0,0,0,3,3,0,0,0,0,0,0,0
110,公立,一般大學,0005,國立成功大學,學士班(日間),巴拉圭,中南美洲,31,19,12,28,17,11,3,2,1,0,0,0,0,0,0
110,公立,一般大學,0005,國立成功大學,學士班(日間),加拿大,北美洲,4,2,2,0,0,0,4,2,2,0,0,0,0,0,0
110,公立,一般大學,0005,國立成功大學,學士班(日間),尼加拉瓜,中南美洲,7,7,0,7,7,0,0,0,0,0,0,0,0,0,0
110,公立,一般大學,0005,國立成功大學,學士班(日間),瓜地馬拉共和國,中南美洲,1,1,0,1,1,0,0,0,0,0,0,0,0,0,0
110,公立,一般大學,0005,國立成功大學,學士班(日間),俄羅斯聯邦,其他亞洲地區,4,0,4,4,0,4,0,0,0,0,0,0,0,0,0
110,公立,一般大學,0005,國立成功大學,學士班(日間),南非共和國,非洲,4,2,2,2,1,1,2,1,1,0,0,0,0,0,0
110,公立,一般大學,0005,國立成功大學,學士班(日間),美國,北美洲,7,5,2,3,2,1,4,3,1,0,0,0,0,0,0
110,公立,一般大學,0005,國立成功大學,學士班(日間),哥倫比亞共和國,中南美洲,1,1,0,1,1,0,0,0,0,0,0,0,0,0,0
110,公立,一般大學,0005,國立成功大學,學士班(日間),泰國,東協,27,14,13,7,2,5,20,12,8,0,0,0,0,0,0
110,公立,一般大學,0005,國立成功大學,學士班(日間),索羅門群島,其他亞洲地區,1,1,0,1,1,0,0,0,0,0,0,0,0,0,0
110,公立,一般大學,0005,國立成功大學,學士班(日間),紐西蘭,其他亞洲地區,1,1,0,0,0,0,1,1,0,0,0,0,0,0,0
110,公立,一般大學,0005,國立成功大學,學士班(日間),馬來西亞,東協,352,213,139,49,28,21,303,185,118,0,0,0,0,0,0
110,公立,一般大學,0005,國立成功大學,學士班(日間),馬紹爾群島共和國,其他亞洲地區,1,0,1,1,0,1,0,0,0,0,0,0,0,0,0
110,公立,一般大學,0005,國立成功大學,學士班(日間),菲律賓共和國,東協,4,3,1,3,2,1,1,1,0,0,0,0,0,0,0
110,公立,一般大學,0005,國立成功大學,學士班(日間),越南社會主義共和國,東協,40,17,23,27,10,17,13,7,6,0,0,0,0,0,0
110,公立,一般大學,0005,國立成功大學,學士班(日間),聖文森(及格瑞那丁),中南美洲,1,0,1,1,0,1,0,0,0,0,0,0,0,0,0
110,公立,一般大學,0005,國立成功大學,學士班(日間),聖露西亞,中南美洲,6,2,4,6,2,4,0,0,0,0,0,0,0,0,0
110,公立,一般大學,0005,國立成功大學,學士班(日間),蒙古國,其他亞洲地區,8,3,5,8,3,5,0,0,0,0,0,0,0,0,0
110,公立,一般大學,0005,國立成功大學,學士班(日間),澳門,港澳,90,65,25,0,0,0,0,0,0,90,65,25,0,0,0
110,公立,一般大學,0005,國立成功大學,學士班(日間),薩爾瓦多,中南美洲,4,2,2,3,2,1,1,0,1,0,0,0,0,0,0
110,公立,一般大學,0005,國立成功大學,碩士班(日間),土耳其共和國,其他亞洲地區,3,1,2,3,1,2,0,0,0,0,0,0,0,0,0
110,公立,一般大學,0005,國立成功大學,碩士班(日間),大韓民國(南韓),其他亞洲地區,4,2,2,4,2,2,0,0,0,0,0,0,0,0,0
110,公立,一般大學,0005,國立成功大學,碩士班(日間),巴基斯坦,南亞,2,2,0,2,2,0,0,0,0,0,0,0,0,0,0
110,公立,一般大學,0005,國立成功大學,碩士班(日間),尼加拉瓜,中南美洲,2,1,1,2,1,1,0,0,0,0,0,0,0,0,0
110,公立,一般大學,0005,國立成功大學,碩士班(日間),尼泊爾聯邦民主共和國,南亞,1,1,0,1,1,0,0,0,0,0,0,0,0,0,0
110,公立,一般大學,0005,國立成功大學,碩士班(日間),瓜地馬拉共和國,中南美洲,2,1,1,2,1,1,0,0,0,0,0,0,0,0,0
110,公立,一般大學,0005,國立成功大學,碩士班(日間),匈牙利共和國,歐洲,1,1,0,1,1,0,0,0,0,0,0,0,0,0,0
110,公立,一般大學,0005,國立成功大學,碩士班(日間),坦尚尼亞聯合共和國,非洲,1,1,0,1,1,0,0,0,0,0,0,0,0,0,0
110,公立,一般大學,0005,國立成功大學,碩士班(日間),孟加拉人民共和國,南亞,3,2,1,3,2,1,0,0,0,0,0,0,0,0,0
110,公立,一般大學,0005,國立成功大學,碩士班(日間),俄羅斯聯邦,其他亞洲地區,1,0,1,1,0,1,0,0,0,0,0,0,0,0,0
110,公立,一般大學,0005,國立成功大學,碩士班(日間),南非共和國,非洲,2,2,0,0,0,0,2,2,0,0,0,0,0,0,0
110,公立,一般大學,0005,國立成功大學,碩士班(日間),玻利維亞共和國,中南美洲,1,0,1,0,0,0,1,0,1,0,0,0,0,0,0
110,公立,一般大學,0005,國立成功大學,碩士班(日間),英國,歐洲,1,1,0,1,1,0,0,0,0,0,0,0,0,0,0
110,公立,一般大學,0005,國立成功大學,碩士班(日間),哥倫比亞共和國,中南美洲,2,1,1,2,1,1,0,0,0,0,0,0,0,0,0
110,公立,一般大學,0005,國立成功大學,碩士班(日間),埃及阿拉伯共和國,非洲,1,1,0,1,1,0,0,0,0,0,0,0,0,0,0
110,公立,一般大學,0005,國立成功大學,碩士班(日間),泰國,東協,56,16,40,54,14,40,2,2,0,0,0,0,0,0,0
110,公立,一般大學,0005,國立成功大學,碩士班(日間),海地共和國,中南美洲,2,2,0,2,2,0,0,0,0,0,0,0,0,0,0
110,公立,一般大學,0005,國立成功大學,碩士班(日間),索馬利蘭共和國,非洲,2,2,0,2,2,0,0,0,0,0,0,0,0,0,0
110,公立,一般大學,0005,國立成功大學,碩士班(日間),馬來西亞,東協,98,53,45,43,25,18,55,28,27,0,0,0,0,0,0
110,公立,一般大學,0005,國立成功大學,碩士班(日間),斯洛伐克共和國,歐洲,1,1,0,1,1,0,0,0,0,0,0,0,0,0,0
110,公立,一般大學,0005,國立成功大學,碩士班(日間),菲律賓共和國,東協,10,6,4,10,6,4,0,0,0,0,0,0,0,0,0
110,公立,一般大學,0005,國立成功大學,碩士班(日間),越南社會主義共和國,東協,99,35,64,97,34,63,2,1,1,0,0,0,0,0,0
110,公立,一般大學,0005,國立成功大學,碩士班(日間),塞爾維亞共和國,歐洲,2,1,1,2,1,1,0,0,0,0,0,0,0,0,0
110,公立,一般大學,0005,國立成功大學,碩士班(日間),奧地利共和國,歐洲,1,0,1,1,0,1,0,0,0,0,0,0,0,0,0
110,公立,一般大學,0005,國立成功大學,碩士班(日間),瑞士聯邦,歐洲,1,1,0,1,1,0,0,0,0,0,0,0,0,0,0
110,公立,一般大學,0005,國立成功大學,碩士班(日間),聖文森(及格瑞那丁),中南美洲,2,1,1,2,1,1,0,0,0,0,0,0,0,0,0
110,公立,一般大學,0005,國立成功大學,碩士班(日間),聖露西亞,中南美洲,1,0,1,1,0,1,0,0,0,0,0,0,0,0,0
110,公立,一般大學,0005,國立成功大學,碩士班(日間),蒙古國,其他亞洲地區,4,2,2,4,2,2,0,0,0,0,0,0,0,0,0
110,公立,一般大學,0005,國立成功大學,碩士班(日間),摩洛哥王國,非洲,1,1,0,1,1,0,0,0,0,0,0,0,0,0,0
110,公立,一般大學,0005,國立成功大學,碩士班(日間),澳門,港澳,19,11,8,0,0,0,0,0,0,19,11,8,0,0,0
110,公立,一般大學,0005,國立成功大學,碩士班(日間),薩爾瓦多,中南美洲,1,0,1,1,0,1,0,0,0,0,0,0,0,0,0
110,公立,一般大學,0005,國立成功大學,碩士班(日間),大陸地區,大陸地區,91,46,45,0,0,0,0,0,0,0,0,0,91,46,45
110,公立,一般大學,0005,國立成功大學,碩士班(日間),厄瓜多共和國,中南美洲,2,2,0,1,1,0,1,1,0,0,0,0,0,0,0
110,公立,一般大學,0005,國立成功大學,碩士班(日間),巴拿馬共和國,中南美洲,1,1,0,1,1,0,0,0,0,0,0,0,0,0,0
110,公立,一般大學,0005,國立成功大學,碩士班(日間),日本,其他亞洲地區,7,3,4,7,3,4,0,0,0,0,0,0,0,0,0
110,公立,一般大學,0005,國立成功大學,碩士班(日間),比利時王國,歐洲,1,1,0,1,1,0,0,0,0,0,0,0,0,0,0
110,公立,一般大學,0005,國立成功大學,碩士班(日間),加拿大,北美洲,1,1,0,0,0,0,1,1,0,0,0,0,0,0,0
110,公立,一般大學,0005,國立成功大學,碩士班(日間),史瓦帝尼王國,非洲,6,0,6,6,0,6,0,0,0,0,0,0,0,0,0
110,公立,一般大學,0005,國立成功大學,碩士班(日間),布吉納法索,非洲,1,1,0,1,1,0,0,0,0,0,0,0,0,0,0
110,公立,一般大學,0005,國立成功大學,碩士班(日間),伊朗伊斯蘭共和國,其他亞洲地區,1,0,1,1,0,1,0,0,0,0,0,0,0,0,0
110,公立,一般大學,0005,國立成功大學,碩士班(日間),印度,南亞,32,25,7,32,25,7,0,0,0,0,0,0,0,0,0
110,公立,一般大學,0005,國立成功大學,碩士班(日間),印度尼西亞共和國,東協,115,59,56,112,57,55,3,2,1,0,0,0,0,0,0
110,公立,一般大學,0005,國立成功大學,碩士班(日間),西班牙王國,歐洲,1,1,0,1,1,0,0,0,0,0,0,0,0,0,0
110,公立,一般大學,0005,國立成功大學,碩士班(日間),克羅埃西亞共和國,歐洲,1,1,0,1,1,0,0,0,0,0,0,0,0,0,0
110,公立,一般大學,0005,國立成功大學,碩士班(日間),宏都拉斯共和國,中南美洲,4,3,1,4,3,1,0,0,0,0,0,0,0,0,0
110,公立,一般大學,0005,國立成功大學,碩士班(日間),貝里斯,中南美洲,8,5,3,7,4,3,1,1,0,0,0,0,0,0,0
110,公立,一般大學,0005,國立成功大學,碩士班(日間),辛巴威共和國,非洲,1,0,1,1,0,1,0,0,0,0,0,0,0,0,0
110,公立,一般大學,0005,國立成功大學,碩士班(日間),波蘭共和國,歐洲,3,3,0,3,3,0,0,0,0,0,0,0,0,0,0
110,公立,一般大學,0005,國立成功大學,碩士班(日間),柬埔寨王國,東協,12,4,8,12,4,8,0,0,0,0,0,0,0,0,0
110,公立,一般大學,0005,國立成功大學,碩士班(日間),美國,北美洲,9,4,5,6,2,4,3,2,1,0,0,0,0,0,0
110,公立,一般大學,0005,國立成功大學,碩士班(日間),香港,港澳,61,34,27,0,0,0,0,0,0,61,34,27,0,0,0
110,公立,一般大學,0005,國立成功大學,碩士班(日間),荷蘭王國,歐洲,2,2,0,2,2,0,0,0,0,0,0,0,0,0,0
110,公立,一般大學,0005,國立成功大學,碩士班(日間),智利,中南美洲,1,1,0,0,0,0,1,1,0,0,0,0,0,0,0
110,公立,一般大學,0005,國立成功大學,碩士班(日間),愛沙尼亞共和國,歐洲,1,1,0,1,1,0,0,0,0,0,0,0,0,0,0
110,公立,一般大學,0005,國立成功大學,碩士班(日間),愛爾蘭共和國,歐洲,1,1,0,1,1,0,0,0,0,0,0,0,0,0,0
110,公立,一般大學,0005,國立成功大學,碩士班(日間),義大利共和國,歐洲,1,1,0,1,1,0,0,0,0,0,0,0,0,0,0
110,公立,一般大學,0005,國立成功大學,碩士班(日間),葡萄牙共和國,歐洲,1,1,0,1,1,0,0,0,0,0,0,0,0,0,0
110,公立,一般大學,0005,國立成功大學,碩士班(日間),寮人民民主共和國(寮國),東協,4,2,2,4,2,2,0,0,0,0,0,0,0,0,0
110,公立,一般大學,0005,國立成功大學,碩士班(日間),德意志聯邦共和國,歐洲,1,1,0,1,1,0,0,0,0,0,0,0,0,0,0
110,公立,一般大學,0005,國立成功大學,碩士班(日間),緬甸,東協,4,2,2,3,2,1,1,0,1,0,0,0,0,0,0
110,公立,一般大學,0005,國立成功大學,碩士班(日間),墨西哥合眾國,中南美洲,2,2,0,2,2,0,0,0,0,0,0,0,0,0,0
110,公立,一般大學,0005,國立成功大學,博士班,土耳其共和國,其他亞洲地區,2,1,1,2,1,1,0,0,0,0,0,0,0,0,0
110,公立,一般大學,0005,國立成功大學,博士班,大陸地區,大陸地區,51,29,22,0,0,0,0,0,0,0,0,0,51,29,22
110,公立,一般大學,0005,國立成功大學,博士班,史瓦帝尼王國,非洲,3,2,1,3,2,1,0,0,0,0,0,0,0,0,0
110,公立,一般大學,0005,國立成功大學,博士班,瓜地馬拉共和國,中南美洲,1,1,0,1,1,0,0,0,0,0,0,0,0,0,0
110,公立,一般大學,0005,國立成功大學,博士班,伊朗伊斯蘭共和國,其他亞洲地區,3,2,1,3,2,1,0,0,0,0,0,0,0,0,0
110,公立,一般大學,0005,國立成功大學,博士班,匈牙利共和國,歐洲,1,0,1,1,0,1,0,0,0,0,0,0,0,0,0
110,公立,一般大學,0005,國立成功大學,博士班,印度尼西亞共和國,東協,110,69,41,110,69,41,0,0,0,0,0,0,0,0,0
110,公立,一般大學,0005,國立成功大學,博士班,衣索比亞聯邦民主共和國,非洲,3,3,0,3,3,0,0,0,0,0,0,0,0,0,0
110,公立,一般大學,0005,國立成功大學,博士班,貝里斯,中南美洲,5,2,3,5,2,3,0,0,0,0,0,0,0,0,0
110,公立,一般大學,0005,國立成功大學,博士班,孟加拉人民共和國,南亞,2,1,1,2,1,1,0,0,0,0,0,0,0,0,0
110,公立,一般大學,0005,國立成功大學,博士班,波蘭共和國,歐洲,1,0,1,1,0,1,0,0,0,0,0,0,0,0,0
110,公立,一般大學,0005,國立成功大學,博士班,法國,歐洲,2,1,1,2,1,1,0,0,0,0,0,0,0,0,0
110,公立,一般大學,0005,國立成功大學,博士班,哥倫比亞共和國,中南美洲,3,2,1,3,2,1,0,0,0,0,0,0,0,0,0
110,公立,一般大學,0005,國立成功大學,博士班,埃及阿拉伯共和國,非洲,1,1,0,1,1,0,0,0,0,0,0,0,0,0,0
110,公立,一般大學,0005,國立成功大學,博士班,泰國,東協,26,12,14,26,12,14,0,0,0,0,0,0,0,0,0
110,公立,一般大學,0005,國立成功大學,博士班,智利,中南美洲,1,1,0,1,1,0,0,0,0,0,0,0,0,0,0
110,公立,一般大學,0005,國立成功大學,博士班,菲律賓共和國,東協,16,12,4,16,12,4,0,0,0,0,0,0,0,0,0
110,公立,一般大學,0005,國立成功大學,博士班,越南社會主義共和國,東協,87,44,43,87,44,43,0,0,0,0,0,0,0,0,0
110,公立,一般大學,0005,國立成功大學,博士班,奧地利共和國,歐洲,1,0,1,1,0,1,0,0,0,0,0,0,0,0,0
110,公立,一般大學,0005,國立成功大學,博士班,瑞士聯邦,歐洲,1,1,0,1,1,0,0,0,0,0,0,0,0,0,0
110,公立,一般大學,0005,國立成功大學,博士班,葉門共和國,其他亞洲地區,1,1,0,1,1,0,0,0,0,0,0,0,0,0,0
110,公立,一般大學,0005,國立成功大學,博士班,澳門,港澳,2,0,2,0,0,0,0,0,0,2,0,2,0,0,0
110,公立,一般大學,0005,國立成功大學,博士班,大韓民國(南韓),其他亞洲地區,2,1,1,2,1,1,0,0,0,0,0,0,0,0,0
110,公立,一般大學,0005,國立成功大學,博士班,厄瓜多共和國,中南美洲,1,1,0,1,1,0,0,0,0,0,0,0,0,0,0
110,公立,一般大學,0005,國立成功大學,博士班,巴基斯坦,南亞,8,6,2,8,6,2,0,0,0,0,0,0,0,0,0
110,公立,一般大學,0005,國立成功大學,博士班,日本,其他亞洲地區,3,3,0,3,3,0,0,0,0,0,0,0,0,0,0
110,公立,一般大學,0005,國立成功大學,博士班,印度,南亞,49,40,9,49,40,9,0,0,0,0,0,0,0,0,0
110,公立,一般大學,0005,國立成功大學,博士班,西班牙王國,歐洲,1,1,0,1,1,0,0,0,0,0,0,0,0,0,0
110,公立,一般大學,0005,國立成功大學,博士班,宏都拉斯共和國,中南美洲,3,3,0,3,3,0,0,0,0,0,0,0,0,0,0
110,公立,一般大學,0005,國立成功大學,博士班,辛巴威共和國,非洲,1,1,0,1,1,0,0,0,0,0,0,0,0,0,0
110,公立,一般大學,0005,國立成功大學,博士班,奈及利亞聯邦共和國,非洲,1,1,0,1,1,0,0,0,0,0,0,0,0,0,0
110,公立,一般大學,0005,國立成功大學,博士班,約旦哈什米王國,其他亞洲地區,1,0,1,1,0,1,0,0,0,0,0,0,0,0,0
110,公立,一般大學,0005,國立成功大學,博士班,美國,北美洲,2,2,0,2,2,0,0,0,0,0,0,0,0,0,0
110,公立,一般大學,0005,國立成功大學,博士班,英國,歐洲,1,1,0,1,1,0,0,0,0,0,0,0,0,0,0
110,公立,一般大學,0005,國立成功大學,博士班,香港,港澳,7,7,0,0,0,0,0,0,0,7,7,0,0,0,0
110,公立,一般大學,0005,國立成功大學,博士班,海地共和國,中南美洲,1,0,1,1,0,1,0,0,0,0,0,0,0,0,0
110,公立,一般大學,0005,國立成功大學,博士班,索馬利蘭共和國,非洲,1,1,0,1,1,0,0,0,0,0,0,0,0,0,0
110,公立,一般大學,0005,國立成功大學,博士班,馬來西亞,東協,13,9,4,8,5,3,5,4,1,0,0,0,0,0,0
110,公立,一般大學,0005,國立成功大學,博士班,馬拉威共和國,非洲,1,0,1,1,0,1,0,0,0,0,0,0,0,0,0
110,公立,一般大學,0005,國立成功大學,博士班,斯里蘭卡民主社會主義共和國,南亞,2,0,2,2,0,2,0,0,0,0,0,0,0,0,0
110,公立,一般大學,0005,國立成功大學,博士班,斯洛伐克共和國,歐洲,1,0,1,1,0,1,0,0,0,0,0,0,0,0,0
110,公立,一般大學,0005,國立成功大學,博士班,聖文森(及格瑞那丁),中南美洲,1,0,1,1,0,1,0,0,0,0,0,0,0,0,0
110,公立,一般大學,0005,國立成功大學,博士班,葡萄牙共和國,歐洲,1,1,0,1,1,0,0,0,0,0,0,0,0,0,0
110,公立,一般大學,0005,國立成功大學,博士班,蒙古國,其他亞洲地區,1,1,0,1,1,0,0,0,0,0,0,0,0,0,0
110,公立,一般大學,0005,國立成功大學,博士班,德意志聯邦共和國,歐洲,2,2,0,2,2,0,0,0,0,0,0,0,0,0,0
110,公立,一般大學,0005,國立成功大學,博士班,緬甸,東協,1,0,1,1,0,1,0,0,0,0,0,0,0,0,0
110,公立,一般大學,0005,國立成功大學,博士班,澳大利亞,其他亞洲地區,2,1,1,1,1,0,1,0,1,0,0,0,0,0,0
110,公立,一般大學,0005,國立成功大學,博士班,薩爾瓦多,中南美洲,1,1,0,1,1,0,0,0,0,0,0,0,0,0,0
110,公立,一般大學,0006,國立中興大學,學士班(日間),日本,其他亞洲地區,20,10,10,18,8,10,2,2,0,0,0,0,0,0,0
110,公立,一般大學,0006,國立中興大學,學士班(日間),史瓦帝尼王國,非洲,3,2,1,3,2,1,0,0,0,0,0,0,0,0,0
110,公立,一般大學,0006,國立中興大學,學士班(日間),布吉納法索,非洲,1,1,0,1,1,0,0,0,0,0,0,0,0,0,0
110,公立,一般大學,0006,國立中興大學,學士班(日間),吉里巴斯共和國,其他亞洲地區,1,0,1,1,0,1,0,0,0,0,0,0,0,0,0
110,公立,一般大學,0006,國立中興大學,學士班(日間),帛琉共和國,其他亞洲地區,2,0,2,2,0,2,0,0,0,0,0,0,0,0,0
110,公立,一般大學,0006,國立中興大學,學士班(日間),俄羅斯聯邦,其他亞洲地區,1,1,0,1,1,0,0,0,0,0,0,0,0,0,0
110,公立,一般大學,0006,國立中興大學,學士班(日間),約旦哈什米王國,其他亞洲地區,1,1,0,1,1,0,0,0,0,0,0,0,0,0,0
110,公立,一般大學,0006,國立中興大學,學士班(日間),泰國,東協,1,1,0,1,1,0,0,0,0,0,0,0,0,0,0
110,公立,一般大學,0006,國立中興大學,學士班(日間),海地共和國,中南美洲,7,5,2,7,5,2,0,0,0,0,0,0,0,0,0
110,公立,一般大學,0006,國立中興大學,學士班(日間),斯里蘭卡民主社會主義共和國,南亞,1,0,1,1,0,1,0,0,0,0,0,0,0,0,0
110,公立,一般大學,0006,國立中興大學,學士班(日間),智利,中南美洲,1,1,0,0,0,0,1,1,0,0,0,0,0,0,0
110,公立,一般大學,0006,國立中興大學,學士班(日間),菲律賓共和國,東協,2,1,1,1,0,1,1,1,0,0,0,0,0,0,0
110,公立,一般大學,0006,國立中興大學,學士班(日間),聖露西亞,中南美洲,1,0,1,1,0,1,0,0,0,0,0,0,0,0,0
110,公立,一般大學,0006,國立中興大學,學士班(日間),蒙古國,其他亞洲地區,2,2,0,2,2,0,0,0,0,0,0,0,0,0,0
110,公立,一般大學,0006,國立中興大學,學士班(日間),大陸地區,大陸地區,10,7,3,0,0,0,0,0,0,0,0,0,10,7,3
110,公立,一般大學,0006,國立中興大學,學士班(日間),大韓民國(南韓),其他亞洲地區,7,5,2,5,3,2,2,2,0,0,0,0,0,0,0
110,公立,一般大學,0006,國立中興大學,學士班(日間),加拿大,北美洲,2,1,1,1,0,1,1,1,0,0,0,0,0,0,0
110,公立,一般大學,0006,國立中興大學,學士班(日間),瓜地馬拉共和國,中南美洲,3,3,0,3,3,0,0,0,0,0,0,0,0,0,0
110,公立,一般大學,0006,國立中興大學,學士班(日間),印度尼西亞共和國,東協,93,46,47,17,12,5,76,34,42,0,0,0,0,0,0
110,公立,一般大學,0006,國立中興大學,學士班(日間),多明尼加共和國,中南美洲,1,0,1,0,0,0,1,0,1,0,0,0,0,0,0
110,公立,一般大學,0006,國立中興大學,學士班(日間),宏都拉斯共和國,中南美洲,3,2,1,3,2,1,0,0,0,0,0,0,0,0,0
110,公立,一般大學,0006,國立中興大學,學士班(日間),貝里斯,中南美洲,2,2,0,2,2,0,0,0,0,0,0,0,0,0,0
110,公立,一般大學,0006,國立中興大學,學士班(日間),貝南共和國,非洲,1,1,0,1,1,0,0,0,0,0,0,0,0,0,0
110,公立,一般大學,0006,國立中興大學,學士班(日間),法國,歐洲,2,0,2,2,0,2,0,0,0,0,0,0,0,0,0
110,公立,一般大學,0006,國立中興大學,學士班(日間),南非共和國,非洲,2,2,0,0,0,0,2,2,0,0,0,0,0,0,0
110,公立,一般大學,0006,國立中興大學,學士班(日間),香港,港澳,71,42,29,0,0,0,0,0,0,71,42,29,0,0,0
110,公立,一般大學,0006,國立中興大學,學士班(日間),哥倫比亞共和國,中南美洲,1,1,0,1,1,0,0,0,0,0,0,0,0,0,0
110,公立,一般大學,0006,國立中興大學,學士班(日間),馬來西亞,東協,128,65,63,19,10,9,109,55,54,0,0,0,0,0,0
110,公立,一般大學,0006,國立中興大學,學士班(日間),越南社會主義共和國,東協,30,11,19,21,7,14,9,4,5,0,0,0,0,0,0
110,公立,一般大學,0006,國立中興大學,學士班(日間),瑞士聯邦,歐洲,1,1,0,1,1,0,0,0,0,0,0,0,0,0,0
110,公立,一般大學,0006,國立中興大學,學士班(日間),聖文森(及格瑞那丁),中南美洲,3,2,1,3,2,1,0,0,0,0,0,0,0,0,0
110,公立,一般大學,0006,國立中興大學,學士班(日間),緬甸,東協,3,1,2,0,0,0,3,1,2,0,0,0,0,0,0
110,公立,一般大學,0006,國立中興大學,學士班(日間),澳門,港澳,27,14,13,0,0,0,0,0,0,27,14,13,0,0,0
110,公立,一般大學,0006,國立中興大學,碩士班(日間),土耳其共和國,其他亞洲地區,2,1,1,2,1,1,0,0,0,0,0,0,0,0,0
110,公立,一般大學,0006,國立中興大學,碩士班(日間),大陸地區,大陸地區,13,6,7,0,0,0,0,0,0,0,0,0,13,6,7
110,公立,一般大學,0006,國立中興大學,碩士班(日間),印度,南亞,7,7,0,7,7,0,0,0,0,0,0,0,0,0,0
110,公立,一般大學,0006,國立中興大學,碩士班(日間),印度尼西亞共和國,東協,13,6,7,12,5,7,1,1,0,0,0,0,0,0,0
110,公立,一般大學,0006,國立中興大學,碩士班(日間),貝里斯,中南美洲,2,1,1,2,1,1,0,0,0,0,0,0,0,0,0
110,公立,一般大學,0006,國立中興大學,碩士班(日間),波蘭共和國,歐洲,1,0,1,1,0,1,0,0,0,0,0,0,0,0,0
110,公立,一般大學,0006,國立中興大學,碩士班(日間),英國,歐洲,1,0,1,1,0,1,0,0,0,0,0,0,0,0,0
110,公立,一般大學,0006,國立中興大學,碩士班(日間),香港,港澳,32,18,14,0,0,0,0,0,0,32,18,14,0,0,0
110,公立,一般大學,0006,國立中興大學,碩士班(日間),馬來西亞,東協,42,25,17,11,5,6,31,20,11,0,0,0,0,0,0
110,公立,一般大學,0006,國立中興大學,碩士班(日間),馬拉威共和國,非洲,1,0,1,1,0,1,0,0,0,0,0,0,0,0,0
110,公立,一般大學,0006,國立中興大學,碩士班(日間),荷蘭王國,歐洲,1,1,0,0,0,0,1,1,0,0,0,0,0,0,0
110,公立,一般大學,0006,國立中興大學,碩士班(日間),越南社會主義共和國,東協,15,6,9,14,5,9,1,1,0,0,0,0,0,0,0
110,公立,一般大學,0006,國立中興大學,碩士班(日間),摩洛哥王國,非洲,1,1,0,1,1,0,0,0,0,0,0,0,0,0,0
110,公立,一般大學,0006,國立中興大學,碩士班(日間),緬甸,東協,1,0,1,1,0,1,0,0,0,0,0,0,0,0,0
110,公立,一般大學,0006,國立中興大學,碩士班(日間),澳門,港澳,5,4,1,0,0,0,0,0,0,5,4,1,0,0,0
110,公立,一般大學,0006,國立中興大學,碩士班(日間),薩爾瓦多,中南美洲,1,0,1,1,0,1,0,0,0,0,0,0,0,0,0
110,公立,一般大學,0006,國立中興大學,碩士班(日間),日本,其他亞洲地區,5,1,4,4,1,3,1,0,1,0,0,0,0,0,0
110,公立,一般大學,0006,國立中興大學,碩士班(日間),史瓦帝尼王國,非洲,3,3,0,3,3,0,0,0,0,0,0,0,0,0,0
110,公立,一般大學,0006,國立中興大學,碩士班(日間),尼泊爾聯邦民主共和國,南亞,3,1,2,3,1,2,0,0,0,0,0,0,0,0,0
110,公立,一般大學,0006,國立中興大學,碩士班(日間),吉里巴斯共和國,其他亞洲地區,1,0,1,1,0,1,0,0,0,0,0,0,0,0,0
110,公立,一般大學,0006,國立中興大學,碩士班(日間),奈及利亞聯邦共和國,非洲,1,0,1,1,0,1,0,0,0,0,0,0,0,0,0
110,公立,一般大學,0006,國立中興大學,碩士班(日間),孟加拉人民共和國,南亞,1,1,0,1,1,0,0,0,0,0,0,0,0,0,0
110,公立,一般大學,0006,國立中興大學,碩士班(日間),迦納共和國,非洲,1,0,1,1,0,1,0,0,0,0,0,0,0,0,0
110,公立,一般大學,0006,國立中興大學,碩士班(日間),泰國,東協,16,2,14,16,2,14,0,0,0,0,0,0,0,0,0
110,公立,一般大學,0006,國立中興大學,碩士班(日間),海地共和國,中南美洲,1,1,0,1,1,0,0,0,0,0,0,0,0,0,0
110,公立,一般大學,0006,國立中興大學,碩士班(日間),斯里蘭卡民主社會主義共和國,南亞,6,2,4,6,2,4,0,0,0,0,0,0,0,0,0
110,公立,一般大學,0006,國立中興大學,碩士班(日間),菲律賓共和國,東協,4,2,2,4,2,2,0,0,0,0,0,0,0,0,0
110,公立,一般大學,0006,國立中興大學,碩士班(日間),塞內加爾共和國,非洲,1,1,0,1,1,0,0,0,0,0,0,0,0,0,0
110,公立,一般大學,0006,國立中興大學,碩士班(日間),蒙古國,其他亞洲地區,2,1,1,2,1,1,0,0,0,0,0,0,0,0,0
110,公立,一般大學,0006,國立中興大學,碩士班(日間),德意志聯邦共和國,歐洲,21,7,14,21,7,14,0,0,0,0,0,0,0,0,0
110,公立,一般大學,0006,國立中興大學,碩士班(日間),墨西哥合眾國,中南美洲,1,0,1,1,0,1,0,0,0,0,0,0,0,0,0
110,公立,一般大學,0006,國立中興大學,博士班,土耳其共和國,其他亞洲地區,6,5,1,6,5,1,0,0,0,0,0,0,0,0,0
110,公立,一般大學,0006,國立中興大學,博士班,大韓民國(南韓),其他亞洲地區,2,2,0,1,1,0,1,1,0,0,0,0,0,0,0
110,公立,一般大學,0006,國立中興大學,博士班,巴基斯坦,南亞,8,3,5,8,3,5,0,0,0,0,0,0,0,0,0
110,公立,一般大學,0006,國立中興大學,博士班,尼泊爾聯邦民主共和國,南亞,4,2,2,4,2,2,0,0,0,0,0,0,0,0,0
110,公立,一般大學,0006,國立中興大學,博士班,印度尼西亞共和國,東協,12,6,6,12,6,6,0,0,0,0,0,0,0,0,0
110,公立,一般大學,0006,國立中興大學,博士班,西班牙王國,歐洲,1,1,0,1,1,0,0,0,0,0,0,0,0,0,0
110,公立,一般大學,0006,國立中興大學,博士班,南非共和國,非洲,1,1,0,1,1,0,0,0,0,0,0,0,0,0,0
110,公立,一般大學,0006,國立中興大學,博士班,埃及阿拉伯共和國,非洲,6,5,1,6,5,1,0,0,0,0,0,0,0,0,0
110,公立,一般大學,0006,國立中興大學,博士班,馬來西亞,東協,10,4,6,6,2,4,4,2,2,0,0,0,0,0,0
110,公立,一般大學,0006,國立中興大學,博士班,菲律賓共和國,東協,12,7,5,12,7,5,0,0,0,0,0,0,0,0,0
110,公立,一般大學,0006,國立中興大學,博士班,聖文森(及格瑞那丁),中南美洲,1,1,0,1,1,0,0,0,0,0,0,0,0,0,0
110,公立,一般大學,0006,國立中興大學,博士班,聖露西亞,中南美洲,1,1,0,1,1,0,0,0,0,0,0,0,0,0,0
110,公立,一般大學,0006,國立中興大學,博士班,大陸地區,大陸地區,10,5,5,0,0,0,0,0,0,0,0,0,10,5,5
110,公立,一般大學,0006,國立中興大學,博士班,史瓦帝尼王國,非洲,1,0,1,1,0,1,0,0,0,0,0,0,0,0,0
110,公立,一般大學,0006,國立中興大學,博士班,甘比亞共和國,非洲,2,2,0,2,2,0,0,0,0,0,0,0,0,0,0
110,公立,一般大學,0006,國立中興大學,博士班,伊朗伊斯蘭共和國,其他亞洲地區,1,1,0,1,1,0,0,0,0,0,0,0,0,0,0
110,公立,一般大學,0006,國立中興大學,博士班,印度,南亞,42,25,17,42,25,17,0,0,0,0,0,0,0,0,0
110,公立,一般大學,0006,國立中興大學,博士班,衣索比亞聯邦民主共和國,非洲,6,5,1,6,5,1,0,0,0,0,0,0,0,0,0
110,公立,一般大學,0006,國立中興大學,博士班,貝里斯,中南美洲,2,1,1,2,1,1,0,0,0,0,0,0,0,0,0
110,公立,一般大學,0006,國立中興大學,博士班,孟加拉人民共和國,南亞,7,4,3,7,4,3,0,0,0,0,0,0,0,0,0
110,公立,一般大學,0006,國立中興大學,博士班,美國,北美洲,1,1,0,1,1,0,0,0,0,0,0,0,0,0,0
110,公立,一般大學,0006,國立中興大學,博士班,香港,港澳,1,1,0,0,0,0,0,0,0,1,1,0,0,0,0
110,公立,一般大學,0006,國立中興大學,博士班,哥倫比亞共和國,中南美洲,1,1,0,1,1,0,0,0,0,0,0,0,0,0,0
110,公立,一般大學,0006,國立中興大學,博士班,泰國,東協,29,8,21,29,8,21,0,0,0,0,0,0,0,0,0
110,公立,一般大學,0006,國立中興大學,博士班,斯里蘭卡民主社會主義共和國,南亞,6,4,2,6,4,2,0,0,0,0,0,0,0,0,0
110,公立,一般大學,0006,國立中興大學,博士班,越南社會主義共和國,東協,20,9,11,20,9,11,0,0,0,0,0,0,0,0,0
110,公立,一般大學,0007,國立陽明交通大學,學士班(日間),大陸地區,大陸地區,14,10,4,0,0,0,0,0,0,0,0,0,14,10,4
110,公立,一般大學,0007,國立陽明交通大學,學士班(日間),大韓民國(南韓),其他亞洲地區,12,7,5,4,1,3,8,6,2,0,0,0,0,0,0
110,公立,一般大學,0007,國立陽明交通大學,學士班(日間),巴西聯邦共和國,中南美洲,2,2,0,1,1,0,1,1,0,0,0,0,0,0,0
110,公立,一般大學,0007,國立陽明交通大學,學士班(日間),巴拉圭,中南美洲,11,5,6,9,4,5,2,1,1,0,0,0,0,0,0
110,公立,一般大學,0007,國立陽明交通大學,學士班(日間),日本,其他亞洲地區,8,6,2,6,5,1,2,1,1,0,0,0,0,0,0
110,公立,一般大學,0007,國立陽明交通大學,學士班(日間),加拿大,北美洲,3,2,1,0,0,0,3,2,1,0,0,0,0,0,0
110,公立,一般大學,0007,國立陽明交通大學,學士班(日間),伊朗伊斯蘭共和國,其他亞洲地區,2,0,2,0,0,0,2,0,2,0,0,0,0,0,0
110,公立,一般大學,0007,國立陽明交通大學,學士班(日間),印度,南亞,1,0,1,1,0,1,0,0,0,0,0,0,0,0,0
110,公立,一般大學,0007,國立陽明交通大學,學士班(日間),印度尼西亞共和國,東協,90,57,33,30,19,11,60,38,22,0,0,0,0,0,0
110,公立,一般大學,0007,國立陽明交通大學,學士班(日間),多明尼加共和國,中南美洲,2,1,1,0,0,0,2,1,1,0,0,0,0,0,0
110,公立,一般大學,0007,國立陽明交通大學,學士班(日間),香港,港澳,71,44,27,0,0,0,0,0,0,71,44,27,0,0,0
110,公立,一般大學,0007,國立陽明交通大學,學士班(日間),埃及阿拉伯共和國,非洲,1,0,1,1,0,1,0,0,0,0,0,0,0,0,0
110,公立,一般大學,0007,國立陽明交通大學,學士班(日間),泰國,東協,9,7,2,2,1,1,7,6,1,0,0,0,0,0,0
110,公立,一般大學,0007,國立陽明交通大學,學士班(日間),馬來西亞,東協,188,107,81,13,5,8,175,102,73,0,0,0,0,0,0
110,公立,一般大學,0007,國立陽明交通大學,學士班(日間),荷蘭王國,歐洲,1,0,1,0,0,0,1,0,1,0,0,0,0,0,0
110,公立,一般大學,0007,國立陽明交通大學,學士班(日間),菲律賓共和國,東協,6,3,3,5,2,3,1,1,0,0,0,0,0,0,0
110,公立,一般大學,0007,國立陽明交通大學,學士班(日間),越南社會主義共和國,東協,14,5,9,7,3,4,7,2,5,0,0,0,0,0,0
110,公立,一般大學,0007,國立陽明交通大學,學士班(日間),澳門,港澳,31,24,7,0,0,0,0,0,0,31,24,7,0,0,0
110,公立,一般大學,0007,國立陽明交通大學,學士班(日間),厄瓜多共和國,中南美洲,2,0,2,0,0,0,2,0,2,0,0,0,0,0,0
110,公立,一般大學,0007,國立陽明交通大學,學士班(日間),巴拿馬共和國,中南美洲,1,0,1,0,0,0,1,0,1,0,0,0,0,0,0
110,公立,一般大學,0007,國立陽明交通大學,學士班(日間),尼加拉瓜,中南美洲,1,1,0,1,1,0,0,0,0,0,0,0,0,0,0
110,公立,一般大學,0007,國立陽明交通大學,學士班(日間),瓜地馬拉共和國,中南美洲,1,1,0,0,0,0,1,1,0,0,0,0,0,0,0
110,公立,一般大學,0007,國立陽明交通大學,學士班(日間),哈薩克共和國,其他亞洲地區,1,1,0,1,1,0,0,0,0,0,0,0,0,0,0
110,公立,一般大學,0007,國立陽明交通大學,學士班(日間),美國,北美洲,10,7,3,4,3,1,6,4,2,0,0,0,0,0,0
110,公立,一般大學,0007,國立陽明交通大學,學士班(日間),海地共和國,中南美洲,6,5,1,6,5,1,0,0,0,0,0,0,0,0,0
110,公立,一般大學,0007,國立陽明交通大學,學士班(日間),烏克蘭,其他亞洲地區,3,2,1,3,2,1,0,0,0,0,0,0,0,0,0
110,公立,一般大學,0007,國立陽明交通大學,學士班(日間),新加坡共和國,東協,5,3,2,0,0,0,5,3,2,0,0,0,0,0,0
110,公立,一般大學,0007,國立陽明交通大學,學士班(日間),聖露西亞,中南美洲,4,2,2,4,2,2,0,0,0,0,0,0,0,0,0
110,公立,一般大學,0007,國立陽明交通大學,學士班(日間),蒙古國,其他亞洲地區,2,1,1,2,1,1,0,0,0,0,0,0,0,0,0
110,公立,一般大學,0007,國立陽明交通大學,學士班(日間),緬甸,東協,14,5,9,1,0,1,13,5,8,0,0,0,0,0,0
110,公立,一般大學,0007,國立陽明交通大學,碩士班(日間),巴基斯坦,南亞,3,3,0,3,3,0,0,0,0,0,0,0,0,0,0
110,公立,一般大學,0007,國立陽明交通大學,碩士班(日間),史瓦帝尼王國,非洲,5,1,4,5,1,4,0,0,0,0,0,0,0,0,0
110,公立,一般大學,0007,國立陽明交通大學,碩士班(日間),尼加拉瓜,中南美洲,1,1,0,1,1,0,0,0,0,0,0,0,0,0,0
110,公立,一般大學,0007,國立陽明交通大學,碩士班(日間),瓜地馬拉共和國,中南美洲,4,1,3,4,1,3,0,0,0,0,0,0,0,0,0
110,公立,一般大學,0007,國立陽明交通大學,碩士班(日間),衣索比亞聯邦民主共和國,非洲,1,1,0,1,1,0,0,0,0,0,0,0,0,0,0
110,公立,一般大學,0007,國立陽明交通大學,碩士班(日間),奈及利亞聯邦共和國,非洲,1,0,1,1,0,1,0,0,0,0,0,0,0,0,0
110,公立,一般大學,0007,國立陽明交通大學,碩士班(日間),孟加拉人民共和國,南亞,1,1,0,1,1,0,0,0,0,0,0,0,0,0,0
110,公立,一般大學,0007,國立陽明交通大學,碩士班(日間),俄羅斯聯邦,其他亞洲地區,5,2,3,5,2,3,0,0,0,0,0,0,0,0,0
110,公立,一般大學,0007,國立陽明交通大學,碩士班(日間),哈薩克共和國,其他亞洲地區,1,1,0,1,1,0,0,0,0,0,0,0,0,0,0
110,公立,一般大學,0007,國立陽明交通大學,碩士班(日間),美國,北美洲,2,2,0,1,1,0,1,1,0,0,0,0,0,0,0
110,公立,一般大學,0007,國立陽明交通大學,碩士班(日間),埃及阿拉伯共和國,非洲,3,1,2,3,1,2,0,0,0,0,0,0,0,0,0
110,公立,一般大學,0007,國立陽明交通大學,碩士班(日間),泰國,東協,8,3,5,5,2,3,3,1,2,0,0,0,0,0,0
110,公立,一般大學,0007,國立陽明交通大學,碩士班(日間),海地共和國,中南美洲,5,1,4,5,1,4,0,0,0,0,0,0,0,0,0
110,公立,一般大學,0007,國立陽明交通大學,碩士班(日間),索馬利蘭共和國,非洲,3,2,1,3,2,1,0,0,0,0,0,0,0,0,0
110,公立,一般大學,0007,國立陽明交通大學,碩士班(日間),紐西蘭,其他亞洲地區,1,1,0,0,0,0,1,1,0,0,0,0,0,0,0
110,公立,一般大學,0007,國立陽明交通大學,碩士班(日間),聖露西亞,中南美洲,1,0,1,1,0,1,0,0,0,0,0,0,0,0,0
110,公立,一般大學,0007,國立陽明交通大學,碩士班(日間),葉門共和國,其他亞洲地區,1,0,1,0,0,0,1,0,1,0,0,0,0,0,0
110,公立,一般大學,0007,國立陽明交通大學,碩士班(日間),蓋亞那共和國,中南美洲,1,1,0,1,1,0,0,0,0,0,0,0,0,0,0
110,公立,一般大學,0007,國立陽明交通大學,碩士班(日間),緬甸,東協,1,1,0,0,0,0,1,1,0,0,0,0,0,0,0
110,公立,一般大學,0007,國立陽明交通大學,碩士班(日間),墨西哥合眾國,中南美洲,1,1,0,1,1,0,0,0,0,0,0,0,0,0,0
110,公立,一般大學,0007,國立陽明交通大學,碩士班(日間),土耳其共和國,其他亞洲地區,3,3,0,3,3,0,0,0,0,0,0,0,0,0,0
110,公立,一般大學,0007,國立陽明交通大學,碩士班(日間),大陸地區,大陸地區,107,66,41,0,0,0,0,0,0,0,0,0,107,66,41
110,公立,一般大學,0007,國立陽明交通大學,碩士班(日間),大韓民國(南韓),其他亞洲地區,1,0,1,1,0,1,0,0,0,0,0,0,0,0,0
110,公立,一般大學,0007,國立陽明交通大學,碩士班(日間),厄瓜多共和國,中南美洲,1,1,0,1,1,0,0,0,0,0,0,0,0,0,0
110,公立,一般大學,0007,國立陽明交通大學,碩士班(日間),巴拿馬共和國,中南美洲,1,1,0,1,1,0,0,0,0,0,0,0,0,0,0
110,公立,一般大學,0007,國立陽明交通大學,碩士班(日間),日本,其他亞洲地區,7,5,2,5,4,1,2,1,1,0,0,0,0,0,0
110,公立,一般大學,0007,國立陽明交通大學,碩士班(日間),加拿大,北美洲,2,2,0,2,2,0,0,0,0,0,0,0,0,0,0
110,公立,一般大學,0007,國立陽明交通大學,碩士班(日間),伊朗伊斯蘭共和國,其他亞洲地區,2,0,2,2,0,2,0,0,0,0,0,0,0,0,0
110,公立,一般大學,0007,國立陽明交通大學,碩士班(日間),印度,南亞,33,21,12,33,21,12,0,0,0,0,0,0,0,0,0
110,公立,一般大學,0007,國立陽明交通大學,碩士班(日間),印度尼西亞共和國,東協,40,27,13,29,18,11,11,9,2,0,0,0,0,0,0
110,公立,一般大學,0007,國立陽明交通大學,碩士班(日間),宏都拉斯共和國,中南美洲,8,5,3,8,5,3,0,0,0,0,0,0,0,0,0
110,公立,一般大學,0007,國立陽明交通大學,碩士班(日間),貝里斯,中南美洲,5,1,4,4,1,3,1,0,1,0,0,0,0,0,0
110,公立,一般大學,0007,國立陽明交通大學,碩士班(日間),波蘭共和國,歐洲,5,4,1,5,4,1,0,0,0,0,0,0,0,0,0
110,公立,一般大學,0007,國立陽明交通大學,碩士班(日間),法國,歐洲,1,1,0,1,1,0,0,0,0,0,0,0,0,0,0
110,公立,一般大學,0007,國立陽明交通大學,碩士班(日間),柬埔寨王國,東協,1,1,0,1,1,0,0,0,0,0,0,0,0,0,0
110,公立,一般大學,0007,國立陽明交通大學,碩士班(日間),英國,歐洲,1,0,1,1,0,1,0,0,0,0,0,0,0,0,0
110,公立,一般大學,0007,國立陽明交通大學,碩士班(日間),香港,港澳,48,31,17,0,0,0,0,0,0,48,31,17,0,0,0
110,公立,一般大學,0007,國立陽明交通大學,碩士班(日間),烏克蘭,其他亞洲地區,2,2,0,2,2,0,0,0,0,0,0,0,0,0,0
110,公立,一般大學,0007,國立陽明交通大學,碩士班(日間),納米比亞共和國,非洲,1,0,1,0,0,0,1,0,1,0,0,0,0,0,0
110,公立,一般大學,0007,國立陽明交通大學,碩士班(日間),馬來西亞,東協,67,42,25,14,7,7,53,35,18,0,0,0,0,0,0
110,公立,一般大學,0007,國立陽明交通大學,碩士班(日間),菲律賓共和國,東協,5,4,1,4,3,1,1,1,0,0,0,0,0,0,0
110,公立,一般大學,0007,國立陽明交通大學,碩士班(日間),越南社會主義共和國,東協,50,17,33,49,16,33,1,1,0,0,0,0,0,0,0
110,公立,一般大學,0007,國立陽明交通大學,碩士班(日間),塔吉克共和國,其他亞洲地區,1,1,0,1,1,0,0,0,0,0,0,0,0,0,0
110,公立,一般大學,0007,國立陽明交通大學,碩士班(日間),聖文森(及格瑞那丁),中南美洲,2,2,0,2,2,0,0,0,0,0,0,0,0,0,0
110,公立,一般大學,0007,國立陽明交通大學,碩士班(日間),澳門,港澳,15,14,1,0,0,0,0,0,0,15,14,1,0,0,0
110,公立,一般大學,0007,國立陽明交通大學,博士班,大陸地區,大陸地區,50,22,28,0,0,0,0,0,0,0,0,0,50,22,28
110,公立,一般大學,0007,國立陽明交通大學,博士班,巴布亞紐幾內亞獨立國,其他亞洲地區,1,1,0,1,1,0,0,0,0,0,0,0,0,0,0
110,公立,一般大學,0007,國立陽明交通大學,博士班,巴拿馬共和國,中南美洲,1,1,0,1,1,0,0,0,0,0,0,0,0,0,0
110,公立,一般大學,0007,國立陽明交通大學,博士班,巴基斯坦,南亞,23,19,4,23,19,4,0,0,0,0,0,0,0,0,0
110,公立,一般大學,0007,國立陽明交通大學,博士班,瓜地馬拉共和國,中南美洲,1,1,0,1,1,0,0,0,0,0,0,0,0,0,0
110,公立,一般大學,0007,國立陽明交通大學,博士班,甘比亞共和國,非洲,2,1,1,2,1,1,0,0,0,0,0,0,0,0,0
110,公立,一般大學,0007,國立陽明交通大學,博士班,伊朗伊斯蘭共和國,其他亞洲地區,2,1,1,2,1,1,0,0,0,0,0,0,0,0,0
110,公立,一般大學,0007,國立陽明交通大學,博士班,匈牙利共和國,歐洲,1,0,1,1,0,1,0,0,0,0,0,0,0,0,0
110,公立,一般大學,0007,國立陽明交通大學,博士班,印度,南亞,157,125,32,157,125,32,0,0,0,0,0,0,0,0,0
110,公立,一般大學,0007,國立陽明交通大學,博士班,衣索比亞聯邦民主共和國,非洲,15,15,0,15,15,0,0,0,0,0,0,0,0,0,0
110,公立,一般大學,0007,國立陽明交通大學,博士班,宏都拉斯共和國,中南美洲,1,0,1,1,0,1,0,0,0,0,0,0,0,0,0
110,公立,一般大學,0007,國立陽明交通大學,博士班,貝里斯,中南美洲,1,0,1,1,0,1,0,0,0,0,0,0,0,0,0
110,公立,一般大學,0007,國立陽明交通大學,博士班,奈及利亞聯邦共和國,非洲,7,6,1,7,6,1,0,0,0,0,0,0,0,0,0
110,公立,一般大學,0007,國立陽明交通大學,博士班,孟加拉人民共和國,南亞,3,3,0,3,3,0,0,0,0,0,0,0,0,0,0
110,公立,一般大學,0007,國立陽明交通大學,博士班,波蘭共和國,歐洲,1,0,1,1,0,1,0,0,0,0,0,0,0,0,0
110,公立,一般大學,0007,國立陽明交通大學,博士班,南非共和國,非洲,1,1,0,1,1,0,0,0,0,0,0,0,0,0,0
110,公立,一般大學,0007,國立陽明交通大學,博士班,哈薩克共和國,其他亞洲地區,1,1,0,1,1,0,0,0,0,0,0,0,0,0,0
110,公立,一般大學,0007,國立陽明交通大學,博士班,香港,港澳,3,1,2,0,0,0,0,0,0,3,1,2,0,0,0
110,公立,一般大學,0007,國立陽明交通大學,博士班,哥倫比亞共和國,中南美洲,1,1,0,1,1,0,0,0,0,0,0,0,0,0,0
110,公立,一般大學,0007,國立陽明交通大學,博士班,越南社會主義共和國,東協,57,24,33,57,24,33,0,0,0,0,0,0,0,0,0
110,公立,一般大學,0007,國立陽明交通大學,博士班,新加坡共和國,東協,1,0,1,0,0,0,1,0,1,0,0,0,0,0,0
110,公立,一般大學,0007,國立陽明交通大學,博士班,瑞士聯邦,歐洲,1,1,0,1,1,0,0,0,0,0,0,0,0,0,0
110,公立,一般大學,0007,國立陽明交通大學,博士班,葉門共和國,其他亞洲地區,1,1,0,1,1,0,0,0,0,0,0,0,0,0,0
110,公立,一般大學,0007,國立陽明交通大學,博士班,德意志聯邦共和國,歐洲,3,1,2,3,1,2,0,0,0,0,0,0,0,0,0
110,公立,一般大學,0007,國立陽明交通大學,博士班,澳門,港澳,1,0,1,0,0,0,0,0,0,1,0,1,0,0,0
110,公立,一般大學,0007,國立陽明交通大學,博士班,蘇丹共和國,非洲,2,2,0,2,2,0,0,0,0,0,0,0,0,0,0
110,公立,一般大學,0007,國立陽明交通大學,博士班,大韓民國(南韓),其他亞洲地區,2,2,0,2,2,0,0,0,0,0,0,0,0,0,0
110,公立,一般大學,0007,國立陽明交通大學,博士班,巴勒斯坦,其他亞洲地區,1,1,0,1,1,0,0,0,0,0,0,0,0,0,0
110,公立,一般大學,0007,國立陽明交通大學,博士班,日本,其他亞洲地區,1,1,0,1,1,0,0,0,0,0,0,0,0,0,0
110,公立,一般大學,0007,國立陽明交通大學,博士班,史瓦帝尼王國,非洲,4,3,1,4,3,1,0,0,0,0,0,0,0,0,0
110,公立,一般大學,0007,國立陽明交通大學,博士班,尼泊爾聯邦民主共和國,南亞,2,2,0,2,2,0,0,0,0,0,0,0,0,0,0
110,公立,一般大學,0007,國立陽明交通大學,博士班,印度尼西亞共和國,東協,46,32,14,46,32,14,0,0,0,0,0,0,0,0,0
110,公立,一般大學,0007,國立陽明交通大學,博士班,多哥共和國,非洲,1,1,0,1,1,0,0,0,0,0,0,0,0,0,0
110,公立,一般大學,0007,國立陽明交通大學,博士班,西班牙王國,歐洲,1,1,0,1,1,0,0,0,0,0,0,0,0,0,0
110,公立,一般大學,0007,國立陽明交通大學,博士班,汶萊和平之國,東協,1,1,0,1,1,0,0,0,0,0,0,0,0,0,0
110,公立,一般大學,0007,國立陽明交通大學,博士班,法國,歐洲,2,2,0,2,2,0,0,0,0,0,0,0,0,0,0
110,公立,一般大學,0007,國立陽明交通大學,博士班,肯亞共和國,非洲,1,1,0,1,1,0,0,0,0,0,0,0,0,0,0
110,公立,一般大學,0007,國立陽明交通大學,博士班,俄羅斯聯邦,其他亞洲地區,1,1,0,1,1,0,0,0,0,0,0,0,0,0,0
110,公立,一般大學,0007,國立陽明交通大學,博士班,玻利維亞共和國,中南美洲,1,1,0,1,1,0,0,0,0,0,0,0,0,0,0
110,公立,一般大學,0007,國立陽明交通大學,博士班,約旦哈什米王國,其他亞洲地區,1,1,0,1,1,0,0,0,0,0,0,0,0,0,0
110,公立,一般大學,0007,國立陽明交通大學,博士班,美國,北美洲,3,3,0,3,3,0,0,0,0,0,0,0,0,0,0
110,公立,一般大學,0007,國立陽明交通大學,博士班,剛果共和國,非洲,1,1,0,1,1,0,0,0,0,0,0,0,0,0,0
110,公立,一般大學,0007,國立陽明交通大學,博士班,埃及阿拉伯共和國,非洲,8,8,0,8,8,0,0,0,0,0,0,0,0,0,0
110,公立,一般大學,0007,國立陽明交通大學,博士班,泰國,東協,6,5,1,5,4,1,1,1,0,0,0,0,0,0,0
110,公立,一般大學,0007,國立陽明交通大學,博士班,烏克蘭,其他亞洲地區,1,1,0,1,1,0,0,0,0,0,0,0,0,0,0
110,公立,一般大學,0007,國立陽明交通大學,博士班,馬來西亞,東協,35,20,15,22,12,10,13,8,5,0,0,0,0,0,0
110,公立,一般大學,0007,國立陽明交通大學,博士班,菲律賓共和國,東協,15,10,5,15,10,5,0,0,0,0,0,0,0,0,0
110,公立,一般大學,0007,國立陽明交通大學,博士班,聖克里斯多福及尼維斯,中南美洲,2,2,0,2,2,0,0,0,0,0,0,0,0,0,0
110,公立,一般大學,0007,國立陽明交通大學,博士班,蒙古國,其他亞洲地區,1,0,1,1,0,1,0,0,0,0,0,0,0,0,0
110,公立,一般大學,0007,國立陽明交通大學,博士班,墨西哥合眾國,中南美洲,1,0,1,1,0,1,0,0,0,0,0,0,0,0,0
110,公立,一般大學,0008,國立中央大學,學士班(日間),大陸地區,大陸地區,7,4,3,0,0,0,0,0,0,0,0,0,7,4,3
110,公立,一般大學,0008,國立中央大學,學士班(日間),香港,港澳,47,30,17,0,0,0,0,0,0,47,30,17,0,0,0
110,公立,一般大學,0008,國立中央大學,學士班(日間),越南社會主義共和國,東協,6,3,3,3,0,3,3,3,0,0,0,0,0,0,0
110,公立,一般大學,0008,國立中央大學,學士班(日間),緬甸,東協,5,2,3,0,0,0,5,2,3,0,0,0,0,0,0
110,公立,一般大學,0008,國立中央大學,學士班(日間),澳門,港澳,14,14,0,0,0,0,0,0,0,14,14,0,0,0,0
110,公立,一般大學,0008,國立中央大學,學士班(日間),大韓民國(南韓),其他亞洲地區,1,1,0,1,1,0,0,0,0,0,0,0,0,0,0
110,公立,一般大學,0008,國立中央大學,學士班(日間),巴西聯邦共和國,中南美洲,1,1,0,0,0,0,1,1,0,0,0,0,0,0,0
110,公立,一般大學,0008,國立中央大學,學士班(日間),日本,其他亞洲地區,3,1,2,3,1,2,0,0,0,0,0,0,0,0,0
110,公立,一般大學,0008,國立中央大學,學士班(日間),印度尼西亞共和國,東協,30,18,12,1,1,0,29,17,12,0,0,0,0,0,0
110,公立,一般大學,0008,國立中央大學,學士班(日間),阿根廷,中南美洲,2,1,1,0,0,0,2,1,1,0,0,0,0,0,0
110,公立,一般大學,0008,國立中央大學,學士班(日間),南非共和國,非洲,2,1,1,0,0,0,2,1,1,0,0,0,0,0,0
110,公立,一般大學,0008,國立中央大學,學士班(日間),泰國,東協,2,2,0,0,0,0,2,2,0,0,0,0,0,0,0
110,公立,一般大學,0008,國立中央大學,學士班(日間),馬來西亞,東協,44,22,22,2,0,2,42,22,20,0,0,0,0,0,0
110,公立,一般大學,0008,國立中央大學,碩士班(日間),土耳其共和國,其他亞洲地區,1,1,0,1,1,0,0,0,0,0,0,0,0,0,0
110,公立,一般大學,0008,國立中央大學,碩士班(日間),巴基斯坦,南亞,3,1,2,3,1,2,0,0,0,0,0,0,0,0,0
110,公立,一般大學,0008,國立中央大學,碩士班(日間),加拿大,北美洲,1,1,0,0,0,0,1,1,0,0,0,0,0,0,0
110,公立,一般大學,0008,國立中央大學,碩士班(日間),尼泊爾聯邦民主共和國,南亞,4,4,0,4,4,0,0,0,0,0,0,0,0,0,0
110,公立,一般大學,0008,國立中央大學,碩士班(日間),印度尼西亞共和國,東協,68,32,36,68,32,36,0,0,0,0,0,0,0,0,0
110,公立,一般大學,0008,國立中央大學,碩士班(日間),泰國,東協,3,0,3,3,0,3,0,0,0,0,0,0,0,0,0
110,公立,一般大學,0008,國立中央大學,碩士班(日間),馬來西亞,東協,15,10,5,2,1,1,13,9,4,0,0,0,0,0,0
110,公立,一般大學,0008,國立中央大學,碩士班(日間),菲律賓共和國,東協,9,6,3,9,6,3,0,0,0,0,0,0,0,0,0
110,公立,一般大學,0008,國立中央大學,碩士班(日間),蒙古國,其他亞洲地區,1,0,1,1,0,1,0,0,0,0,0,0,0,0,0
110,公立,一般大學,0008,國立中央大學,碩士班(日間),大陸地區,大陸地區,43,29,14,0,0,0,0,0,0,0,0,0,43,29,14
110,公立,一般大學,0008,國立中央大學,碩士班(日間),巴拉圭,中南美洲,1,1,0,1,1,0,0,0,0,0,0,0,0,0,0
110,公立,一般大學,0008,國立中央大學,碩士班(日間),史瓦帝尼王國,非洲,2,0,2,2,0,2,0,0,0,0,0,0,0,0,0
110,公立,一般大學,0008,國立中央大學,碩士班(日間),伊朗伊斯蘭共和國,其他亞洲地區,1,0,1,1,0,1,0,0,0,0,0,0,0,0,0
110,公立,一般大學,0008,國立中央大學,碩士班(日間),印度,南亞,3,2,1,3,2,1,0,0,0,0,0,0,0,0,0
110,公立,一般大學,0008,國立中央大學,碩士班(日間),貝里斯,中南美洲,1,1,0,1,1,0,0,0,0,0,0,0,0,0,0
110,公立,一般大學,0008,國立中央大學,碩士班(日間),孟加拉人民共和國,南亞,1,0,1,1,0,1,0,0,0,0,0,0,0,0,0
110,公立,一般大學,0008,國立中央大學,碩士班(日間),香港,港澳,23,15,8,0,0,0,0,0,0,23,15,8,0,0,0
110,公立,一般大學,0008,國立中央大學,碩士班(日間),海地共和國,中南美洲,1,1,0,1,1,0,0,0,0,0,0,0,0,0,0
110,公立,一般大學,0008,國立中央大學,碩士班(日間),斯里蘭卡民主社會主義共和國,南亞,1,0,1,1,0,1,0,0,0,0,0,0,0,0,0
110,公立,一般大學,0008,國立中央大學,碩士班(日間),越南社會主義共和國,東協,56,27,29,55,26,29,1,1,0,0,0,0,0,0,0
110,公立,一般大學,0008,國立中央大學,碩士班(日間),墨西哥合眾國,中南美洲,1,1,0,1,1,0,0,0,0,0,0,0,0,0,0
110,公立,一般大學,0008,國立中央大學,碩士班(日間),澳門,港澳,3,1,2,0,0,0,0,0,0,3,1,2,0,0,0
110,公立,一般大學,0008,國立中央大學,博士班,巴拉圭,中南美洲,1,1,0,1,1,0,0,0,0,0,0,0,0,0,0
110,公立,一般大學,0008,國立中央大學,博士班,匈牙利共和國,歐洲,1,1,0,1,1,0,0,0,0,0,0,0,0,0,0
110,公立,一般大學,0008,國立中央大學,博士班,奈及利亞聯邦共和國,非洲,1,1,0,1,1,0,0,0,0,0,0,0,0,0,0
110,公立,一般大學,0008,國立中央大學,博士班,波蘭共和國,歐洲,1,0,1,1,0,1,0,0,0,0,0,0,0,0,0
110,公立,一般大學,0008,國立中央大學,博士班,法國,歐洲,1,1,0,1,1,0,0,0,0,0,0,0,0,0,0
110,公立,一般大學,0008,國立中央大學,博士班,俄羅斯聯邦,其他亞洲地區,1,1,0,1,1,0,0,0,0,0,0,0,0,0,0
110,公立,一般大學,0008,國立中央大學,博士班,泰國,東協,6,2,4,6,2,4,0,0,0,0,0,0,0,0,0
110,公立,一般大學,0008,國立中央大學,博士班,喀麥隆共和國,非洲,1,0,1,1,0,1,0,0,0,0,0,0,0,0,0
110,公立,一般大學,0008,國立中央大學,博士班,菲律賓共和國,東協,8,4,4,8,4,4,0,0,0,0,0,0,0,0,0
110,公立,一般大學,0008,國立中央大學,博士班,越南社會主義共和國,東協,112,72,40,112,72,40,0,0,0,0,0,0,0,0,0
110,公立,一般大學,0008,國立中央大學,博士班,德意志聯邦共和國,歐洲,1,0,1,1,0,1,0,0,0,0,0,0,0,0,0
110,公立,一般大學,0008,國立中央大學,博士班,大陸地區,大陸地區,22,11,11,0,0,0,0,0,0,0,0,0,22,11,11
110,公立,一般大學,0008,國立中央大學,博士班,大韓民國(南韓),其他亞洲地區,1,1,0,1,1,0,0,0,0,0,0,0,0,0,0
110,公立,一般大學,0008,國立中央大學,博士班,巴基斯坦,南亞,12,8,4,12,8,4,0,0,0,0,0,0,0,0,0
110,公立,一般大學,0008,國立中央大學,博士班,日本,其他亞洲地區,1,1,0,1,1,0,0,0,0,0,0,0,0,0,0
110,公立,一般大學,0008,國立中央大學,博士班,加拿大,北美洲,1,1,0,1,1,0,0,0,0,0,0,0,0,0,0
110,公立,一般大學,0008,國立中央大學,博士班,尼加拉瓜,中南美洲,1,1,0,1,1,0,0,0,0,0,0,0,0,0,0
110,公立,一般大學,0008,國立中央大學,博士班,尼泊爾聯邦民主共和國,南亞,4,4,0,4,4,0,0,0,0,0,0,0,0,0,0
110,公立,一般大學,0008,國立中央大學,博士班,伊朗伊斯蘭共和國,其他亞洲地區,2,2,0,2,2,0,0,0,0,0,0,0,0,0,0
110,公立,一般大學,0008,國立中央大學,博士班,印度,南亞,43,29,14,43,29,14,0,0,0,0,0,0,0,0,0
110,公立,一般大學,0008,國立中央大學,博士班,印度尼西亞共和國,東協,110,66,44,110,66,44,0,0,0,0,0,0,0,0,0
110,公立,一般大學,0008,國立中央大學,博士班,衣索比亞聯邦民主共和國,非洲,6,6,0,6,6,0,0,0,0,0,0,0,0,0,0
110,公立,一般大學,0008,國立中央大學,博士班,孟加拉人民共和國,南亞,3,2,1,3,2,1,0,0,0,0,0,0,0,0,0
110,公立,一般大學,0008,國立中央大學,博士班,阿爾巴尼亞共和國,歐洲,1,0,1,1,0,1,0,0,0,0,0,0,0,0,0
110,公立,一般大學,0008,國立中央大學,博士班,柬埔寨王國,東協,1,0,1,1,0,1,0,0,0,0,0,0,0,0,0
110,公立,一般大學,0008,國立中央大學,博士班,哥倫比亞共和國,中南美洲,1,0,1,1,0,1,0,0,0,0,0,0,0,0,0
110,公立,一般大學,0008,國立中央大學,博士班,海地共和國,中南美洲,3,3,0,3,3,0,0,0,0,0,0,0,0,0,0
110,公立,一般大學,0008,國立中央大學,博士班,秘魯共和國,中南美洲,2,2,0,2,2,0,0,0,0,0,0,0,0,0,0
110,公立,一般大學,0008,國立中央大學,博士班,馬來西亞,東協,9,7,2,7,5,2,2,2,0,0,0,0,0,0,0
110,公立,一般大學,0008,國立中央大學,博士班,斯里蘭卡民主社會主義共和國,南亞,2,1,1,2,1,1,0,0,0,0,0,0,0,0,0
110,公立,一般大學,0008,國立中央大學,博士班,葉門共和國,其他亞洲地區,1,1,0,1,1,0,0,0,0,0,0,0,0,0,0
110,公立,一般大學,0008,國立中央大學,博士班,蒙古國,其他亞洲地區,4,2,2,4,2,2,0,0,0,0,0,0,0,0,0
110,公立,一般大學,0008,國立中央大學,博士班,緬甸,東協,1,0,1,1,0,1,0,0,0,0,0,0,0,0,0
110,公立,一般大學,0008,國立中央大學,博士班,澳大利亞,其他亞洲地區,1,1,0,1,1,0,0,0,0,0,0,0,0,0,0
110,公立,一般大學,0009,國立中山大學,學士班(日間),土庫曼,其他亞洲地區,1,0,1,1,0,1,0,0,0,0,0,0,0,0,0
110,公立,一般大學,0009,國立中山大學,學士班(日間),加拿大,北美洲,1,0,1,1,0,1,0,0,0,0,0,0,0,0,0
110,公立,一般大學,0009,國立中山大學,學士班(日間),印度尼西亞共和國,東協,36,18,18,1,0,1,35,18,17,0,0,0,0,0,0
110,公立,一般大學,0009,國立中山大學,學士班(日間),俄羅斯聯邦,其他亞洲地區,1,0,1,1,0,1,0,0,0,0,0,0,0,0,0
110,公立,一般大學,0009,國立中山大學,學士班(日間),美國,北美洲,3,2,1,2,2,0,1,0,1,0,0,0,0,0,0
110,公立,一般大學,0009,國立中山大學,學士班(日間),哥倫比亞共和國,中南美洲,1,1,0,0,0,0,1,1,0,0,0,0,0,0,0
110,公立,一般大學,0009,國立中山大學,學士班(日間),泰國,東協,6,4,2,0,0,0,6,4,2,0,0,0,0,0,0
110,公立,一般大學,0009,國立中山大學,學士班(日間),越南社會主義共和國,東協,9,3,6,6,1,5,3,2,1,0,0,0,0,0,0
110,公立,一般大學,0009,國立中山大學,學士班(日間),澳門,港澳,9,9,0,0,0,0,0,0,0,9,9,0,0,0,0
110,公立,一般大學,0009,國立中山大學,學士班(日間),羅馬尼亞,歐洲,1,1,0,1,1,0,0,0,0,0,0,0,0,0,0
110,公立,一般大學,0009,國立中山大學,學士班(日間),大陸地區,大陸地區,9,4,5,0,0,0,0,0,0,0,0,0,9,4,5
110,公立,一般大學,0009,國立中山大學,學士班(日間),大韓民國(南韓),其他亞洲地區,3,3,0,2,2,0,1,1,0,0,0,0,0,0,0
110,公立,一般大學,0009,國立中山大學,學士班(日間),日本,其他亞洲地區,16,7,9,11,3,8,5,4,1,0,0,0,0,0,0
110,公立,一般大學,0009,國立中山大學,學士班(日間),奈及利亞聯邦共和國,非洲,1,0,1,0,0,0,1,0,1,0,0,0,0,0,0
110,公立,一般大學,0009,國立中山大學,學士班(日間),南非共和國,非洲,3,2,1,0,0,0,3,2,1,0,0,0,0,0,0
110,公立,一般大學,0009,國立中山大學,學士班(日間),英國,歐洲,1,1,0,0,0,0,1,1,0,0,0,0,0,0,0
110,公立,一般大學,0009,國立中山大學,學士班(日間),香港,港澳,77,41,36,0,0,0,0,0,0,77,41,36,0,0,0
110,公立,一般大學,0009,國立中山大學,學士班(日間),馬來西亞,東協,91,45,46,1,1,0,90,44,46,0,0,0,0,0,0
110,公立,一般大學,0009,國立中山大學,學士班(日間),緬甸,東協,3,2,1,0,0,0,3,2,1,0,0,0,0,0,0
110,公立,一般大學,0009,國立中山大學,碩士班(日間),大陸地區,大陸地區,32,20,12,0,0,0,0,0,0,0,0,0,32,20,12
110,公立,一般大學,0009,國立中山大學,碩士班(日間),大韓民國(南韓),其他亞洲地區,2,1,1,2,1,1,0,0,0,0,0,0,0,0,0
110,公立,一般大學,0009,國立中山大學,碩士班(日間),巴拿馬共和國,中南美洲,1,1,0,1,1,0,0,0,0,0,0,0,0,0,0
110,公立,一般大學,0009,國立中山大學,碩士班(日間),日本,其他亞洲地區,1,1,0,0,0,0,1,1,0,0,0,0,0,0,0
110,公立,一般大學,0009,國立中山大學,碩士班(日間),印度,南亞,21,14,7,21,14,7,0,0,0,0,0,0,0,0,0
110,公立,一般大學,0009,國立中山大學,碩士班(日間),多明尼加共和國,中南美洲,1,0,1,1,0,1,0,0,0,0,0,0,0,0,0
110,公立,一般大學,0009,國立中山大學,碩士班(日間),西班牙王國,歐洲,2,0,2,2,0,2,0,0,0,0,0,0,0,0,0
110,公立,一般大學,0009,國立中山大學,碩士班(日間),宏都拉斯共和國,中南美洲,4,3,1,4,3,1,0,0,0,0,0,0,0,0,0
110,公立,一般大學,0009,國立中山大學,碩士班(日間),亞美尼亞共和國,其他亞洲地區,1,0,1,1,0,1,0,0,0,0,0,0,0,0,0
110,公立,一般大學,0009,國立中山大學,碩士班(日間),帛琉共和國,其他亞洲地區,1,1,0,1,1,0,0,0,0,0,0,0,0,0,0
110,公立,一般大學,0009,國立中山大學,碩士班(日間),美國,北美洲,12,9,3,12,9,3,0,0,0,0,0,0,0,0,0
110,公立,一般大學,0009,國立中山大學,碩士班(日間),英國,歐洲,3,3,0,3,3,0,0,0,0,0,0,0,0,0,0
110,公立,一般大學,0009,國立中山大學,碩士班(日間),香港,港澳,33,21,12,0,0,0,0,0,0,33,21,12,0,0,0
110,公立,一般大學,0009,國立中山大學,碩士班(日間),烏克蘭,其他亞洲地區,2,1,1,2,1,1,0,0,0,0,0,0,0,0,0
110,公立,一般大學,0009,國立中山大學,碩士班(日間),秘魯共和國,中南美洲,1,0,1,1,0,1,0,0,0,0,0,0,0,0,0
110,公立,一般大學,0009,國立中山大學,碩士班(日間),馬來西亞,東協,22,14,8,5,4,1,17,10,7,0,0,0,0,0,0
110,公立,一般大學,0009,國立中山大學,碩士班(日間),捷克共和國,歐洲,5,4,1,5,4,1,0,0,0,0,0,0,0,0,0
110,公立,一般大學,0009,國立中山大學,碩士班(日間),斯里蘭卡民主社會主義共和國,南亞,20,9,11,20,9,11,0,0,0,0,0,0,0,0,0
110,公立,一般大學,0009,國立中山大學,碩士班(日間),斯洛伐克共和國,歐洲,1,0,1,1,0,1,0,0,0,0,0,0,0,0,0
110,公立,一般大學,0009,國立中山大學,碩士班(日間),新加坡共和國,東協,2,2,0,2,2,0,0,0,0,0,0,0,0,0,0
110,公立,一般大學,0009,國立中山大學,碩士班(日間),德意志聯邦共和國,歐洲,5,2,3,5,2,3,0,0,0,0,0,0,0,0,0
110,公立,一般大學,0009,國立中山大學,碩士班(日間),緬甸,東協,2,1,1,1,1,0,1,0,1,0,0,0,0,0,0
110,公立,一般大學,0009,國立中山大學,碩士班(日間),土耳其共和國,其他亞洲地區,1,1,0,1,1,0,0,0,0,0,0,0,0,0,0
110,公立,一般大學,0009,國立中山大學,碩士班(日間),巴拉圭,中南美洲,1,1,0,1,1,0,0,0,0,0,0,0,0,0,0
110,公立,一般大學,0009,國立中山大學,碩士班(日間),加拿大,北美洲,3,2,1,3,2,1,0,0,0,0,0,0,0,0,0
110,公立,一般大學,0009,國立中山大學,碩士班(日間),尼加拉瓜,中南美洲,1,0,1,1,0,1,0,0,0,0,0,0,0,0,0
110,公立,一般大學,0009,國立中山大學,碩士班(日間),瓜地馬拉共和國,中南美洲,1,0,1,1,0,1,0,0,0,0,0,0,0,0,0
110,公立,一般大學,0009,國立中山大學,碩士班(日間),伊朗伊斯蘭共和國,其他亞洲地區,1,0,1,1,0,1,0,0,0,0,0,0,0,0,0
110,公立,一般大學,0009,國立中山大學,碩士班(日間),印度尼西亞共和國,東協,14,8,6,13,7,6,1,1,0,0,0,0,0,0,0
110,公立,一般大學,0009,國立中山大學,碩士班(日間),貝里斯,中南美洲,1,0,1,1,0,1,0,0,0,0,0,0,0,0,0
110,公立,一般大學,0009,國立中山大學,碩士班(日間),波蘭共和國,歐洲,1,0,1,1,0,1,0,0,0,0,0,0,0,0,0
110,公立,一般大學,0009,國立中山大學,碩士班(日間),法國,歐洲,10,4,6,10,4,6,0,0,0,0,0,0,0,0,0
110,公立,一般大學,0009,國立中山大學,碩士班(日間),俄羅斯聯邦,其他亞洲地區,5,3,2,5,3,2,0,0,0,0,0,0,0,0,0
110,公立,一般大學,0009,國立中山大學,碩士班(日間),南非共和國,非洲,2,1,1,0,0,0,2,1,1,0,0,0,0,0,0
110,公立,一般大學,0009,國立中山大學,碩士班(日間),哥倫比亞共和國,中南美洲,1,0,1,1,0,1,0,0,0,0,0,0,0,0,0
110,公立,一般大學,0009,國立中山大學,碩士班(日間),泰國,東協,17,9,8,16,9,7,1,0,1,0,0,0,0,0,0
110,公立,一般大學,0009,國立中山大學,碩士班(日間),索馬利蘭共和國,非洲,1,1,0,1,1,0,0,0,0,0,0,0,0,0,0
110,公立,一般大學,0009,國立中山大學,碩士班(日間),索羅門群島,其他亞洲地區,1,1,0,1,1,0,0,0,0,0,0,0,0,0,0
110,公立,一般大學,0009,國立中山大學,碩士班(日間),荷蘭王國,歐洲,1,0,1,1,0,1,0,0,0,0,0,0,0,0,0
110,公立,一般大學,0009,國立中山大學,碩士班(日間),菲律賓共和國,東協,10,4,6,10,4,6,0,0,0,0,0,0,0,0,0
110,公立,一般大學,0009,國立中山大學,碩士班(日間),越南社會主義共和國,東協,14,3,11,13,2,11,1,1,0,0,0,0,0,0,0
110,公立,一般大學,0009,國立中山大學,碩士班(日間),奧地利共和國,歐洲,9,5,4,9,5,4,0,0,0,0,0,0,0,0,0
110,公立,一般大學,0009,國立中山大學,碩士班(日間),澳門,港澳,3,2,1,0,0,0,0,0,0,3,2,1,0,0,0
110,公立,一般大學,0009,國立中山大學,博士班,土耳其共和國,其他亞洲地區,2,2,0,2,2,0,0,0,0,0,0,0,0,0,0
110,公立,一般大學,0009,國立中山大學,博士班,土庫曼,其他亞洲地區,3,1,2,3,1,2,0,0,0,0,0,0,0,0,0
110,公立,一般大學,0009,國立中山大學,博士班,大陸地區,大陸地區,12,5,7,0,0,0,0,0,0,0,0,0,12,5,7
110,公立,一般大學,0009,國立中山大學,博士班,大韓民國(南韓),其他亞洲地區,1,0,1,1,0,1,0,0,0,0,0,0,0,0,0
110,公立,一般大學,0009,國立中山大學,博士班,巴基斯坦,南亞,3,3,0,3,3,0,0,0,0,0,0,0,0,0,0
110,公立,一般大學,0009,國立中山大學,博士班,尼泊爾聯邦民主共和國,南亞,1,1,0,1,1,0,0,0,0,0,0,0,0,0,0
110,公立,一般大學,0009,國立中山大學,博士班,伊朗伊斯蘭共和國,其他亞洲地區,3,1,2,3,1,2,0,0,0,0,0,0,0,0,0
110,公立,一般大學,0009,國立中山大學,博士班,匈牙利共和國,歐洲,1,1,0,1,1,0,0,0,0,0,0,0,0,0,0
110,公立,一般大學,0009,國立中山大學,博士班,美國,北美洲,3,3,0,3,3,0,0,0,0,0,0,0,0,0,0
110,公立,一般大學,0009,國立中山大學,博士班,香港,港澳,5,3,2,0,0,0,0,0,0,5,3,2,0,0,0
110,公立,一般大學,0009,國立中山大學,博士班,剛果共和國,非洲,1,1,0,1,1,0,0,0,0,0,0,0,0,0,0
110,公立,一般大學,0009,國立中山大學,博士班,哥倫比亞共和國,中南美洲,1,0,1,1,0,1,0,0,0,0,0,0,0,0,0
110,公立,一般大學,0009,國立中山大學,博士班,埃及阿拉伯共和國,非洲,7,5,2,7,5,2,0,0,0,0,0,0,0,0,0
110,公立,一般大學,0009,國立中山大學,博士班,烏克蘭,其他亞洲地區,1,0,1,1,0,1,0,0,0,0,0,0,0,0,0
110,公立,一般大學,0009,國立中山大學,博士班,智利,中南美洲,1,0,1,1,0,1,0,0,0,0,0,0,0,0,0
110,公立,一般大學,0009,國立中山大學,博士班,菲律賓共和國,東協,24,16,8,24,16,8,0,0,0,0,0,0,0,0,0
110,公立,一般大學,0009,國立中山大學,博士班,越南社會主義共和國,東協,19,11,8,19,11,8,0,0,0,0,0,0,0,0,0
110,公立,一般大學,0009,國立中山大學,博士班,義大利共和國,歐洲,1,1,0,1,1,0,0,0,0,0,0,0,0,0,0
110,公立,一般大學,0009,國立中山大學,博士班,德意志聯邦共和國,歐洲,2,2,0,2,2,0,0,0,0,0,0,0,0,0,0
110,公立,一般大學,0009,國立中山大學,博士班,澳門,港澳,1,1,0,0,0,0,0,0,0,1,1,0,0,0,0
110,公立,一般大學,0009,國立中山大學,博士班,牙買加,中南美洲,1,0,1,1,0,1,0,0,0,0,0,0,0,0,0
110,公立,一般大學,0009,國立中山大學,博士班,加拿大,北美洲,2,2,0,2,2,0,0,0,0,0,0,0,0,0,0
110,公立,一般大學,0009,國立中山大學,博士班,史瓦帝尼王國,非洲,1,0,1,1,0,1,0,0,0,0,0,0,0,0,0
110,公立,一般大學,0009,國立中山大學,博士班,印度,南亞,44,25,19,44,25,19,0,0,0,0,0,0,0,0,0
110,公立,一般大學,0009,國立中山大學,博士班,印度尼西亞共和國,東協,33,16,17,32,16,16,1,0,1,0,0,0,0,0,0
110,公立,一般大學,0009,國立中山大學,博士班,俄羅斯聯邦,其他亞洲地區,1,1,0,1,1,0,0,0,0,0,0,0,0,0,0
110,公立,一般大學,0009,國立中山大學,博士班,南非共和國,非洲,1,1,0,1,1,0,0,0,0,0,0,0,0,0,0
110,公立,一般大學,0009,國立中山大學,博士班,英國,歐洲,2,2,0,2,2,0,0,0,0,0,0,0,0,0,0
110,公立,一般大學,0009,國立中山大學,博士班,泰國,東協,6,4,2,6,4,2,0,0,0,0,0,0,0,0,0
110,公立,一般大學,0009,國立中山大學,博士班,納米比亞共和國,非洲,1,1,0,1,1,0,0,0,0,0,0,0,0,0,0
110,公立,一般大學,0009,國立中山大學,博士班,馬來西亞,東協,6,3,3,5,2,3,1,1,0,0,0,0,0,0,0
110,公立,一般大學,0009,國立中山大學,博士班,敘利亞阿拉伯共和國,其他亞洲地區,1,1,0,1,1,0,0,0,0,0,0,0,0,0,0
110,公立,一般大學,0009,國立中山大學,博士班,莫三比克共和國,非洲,1,1,0,1,1,0,0,0,0,0,0,0,0,0,0
110,公立,一般大學,0009,國立中山大學,博士班,斯里蘭卡民主社會主義共和國,南亞,8,6,2,8,6,2,0,0,0,0,0,0,0,0,0
110,公立,一般大學,0009,國立中山大學,博士班,新加坡共和國,東協,2,1,1,1,0,1,1,1,0,0,0,0,0,0,0
110,公立,一般大學,0012,國立臺灣海洋大學,學士班(日間),大陸地區,大陸地區,4,4,0,0,0,0,0,0,0,0,0,0,4,4,0
110,公立,一般大學,0012,國立臺灣海洋大學,學士班(日間),大韓民國(南韓),其他亞洲地區,1,1,0,0,0,0,1,1,0,0,0,0,0,0,0
110,公立,一般大學,0012,國立臺灣海洋大學,學士班(日間),日本,其他亞洲地區,1,1,0,1,1,0,0,0,0,0,0,0,0,0,0
110,公立,一般大學,0012,國立臺灣海洋大學,學士班(日間),印度尼西亞共和國,東協,116,61,55,6,4,2,110,57,53,0,0,0,0,0,0
110,公立,一般大學,0012,國立臺灣海洋大學,學士班(日間),多明尼加共和國,中南美洲,1,0,1,0,0,0,1,0,1,0,0,0,0,0,0
110,公立,一般大學,0012,國立臺灣海洋大學,學士班(日間),香港,港澳,90,72,18,0,0,0,0,0,0,90,72,18,0,0,0
110,公立,一般大學,0012,國立臺灣海洋大學,學士班(日間),新加坡共和國,東協,1,0,1,0,0,0,1,0,1,0,0,0,0,0,0
110,公立,一般大學,0012,國立臺灣海洋大學,學士班(日間),緬甸,東協,21,16,5,0,0,0,21,16,5,0,0,0,0,0,0
110,公立,一般大學,0012,國立臺灣海洋大學,學士班(日間),澳門,港澳,10,9,1,0,0,0,0,0,0,10,9,1,0,0,0
110,公立,一般大學,0012,國立臺灣海洋大學,學士班(日間),瓜地馬拉共和國,中南美洲,1,0,1,1,0,1,0,0,0,0,0,0,0,0,0
110,公立,一般大學,0012,國立臺灣海洋大學,學士班(日間),俄羅斯聯邦,其他亞洲地區,1,0,1,1,0,1,0,0,0,0,0,0,0,0,0
110,公立,一般大學,0012,國立臺灣海洋大學,學士班(日間),美國,北美洲,1,1,0,1,1,0,0,0,0,0,0,0,0,0,0
110,公立,一般大學,0012,國立臺灣海洋大學,學士班(日間),馬來西亞,東協,210,143,67,17,14,3,193,129,64,0,0,0,0,0,0
110,公立,一般大學,0012,國立臺灣海洋大學,學士班(日間),菲律賓共和國,東協,1,1,0,0,0,0,1,1,0,0,0,0,0,0,0
110,公立,一般大學,0012,國立臺灣海洋大學,學士班(日間),越南社會主義共和國,東協,9,4,5,2,1,1,7,3,4,0,0,0,0,0,0
110,公立,一般大學,0012,國立臺灣海洋大學,碩士班(日間),加拿大,北美洲,1,0,1,1,0,1,0,0,0,0,0,0,0,0,0
110,公立,一般大學,0012,國立臺灣海洋大學,碩士班(日間),印度尼西亞共和國,東協,13,6,7,11,5,6,2,1,1,0,0,0,0,0,0
110,公立,一般大學,0012,國立臺灣海洋大學,碩士班(日間),美國,北美洲,1,0,1,1,0,1,0,0,0,0,0,0,0,0,0
110,公立,一般大學,0012,國立臺灣海洋大學,碩士班(日間),泰國,東協,1,0,1,1,0,1,0,0,0,0,0,0,0,0,0
110,公立,一般大學,0012,國立臺灣海洋大學,碩士班(日間),海地共和國,中南美洲,3,3,0,3,3,0,0,0,0,0,0,0,0,0,0
110,公立,一般大學,0012,國立臺灣海洋大學,碩士班(日間),索馬利亞民主共和國,非洲,1,1,0,1,1,0,0,0,0,0,0,0,0,0,0
110,公立,一般大學,0012,國立臺灣海洋大學,碩士班(日間),馬來西亞,東協,25,13,12,8,5,3,17,8,9,0,0,0,0,0,0
110,公立,一般大學,0012,國立臺灣海洋大學,碩士班(日間),菲律賓共和國,東協,8,8,0,8,8,0,0,0,0,0,0,0,0,0,0
110,公立,一般大學,0012,國立臺灣海洋大學,碩士班(日間),越南社會主義共和國,東協,5,1,4,5,1,4,0,0,0,0,0,0,0,0,0
110,公立,一般大學,0012,國立臺灣海洋大學,碩士班(日間),聖露西亞,中南美洲,1,0,1,1,0,1,0,0,0,0,0,0,0,0,0
110,公立,一般大學,0012,國立臺灣海洋大學,碩士班(日間),澳門,港澳,3,3,0,0,0,0,0,0,0,3,3,0,0,0,0
110,公立,一般大學,0012,國立臺灣海洋大學,碩士班(日間),大陸地區,大陸地區,1,1,0,0,0,0,0,0,0,0,0,0,1,1,0
110,公立,一般大學,0012,國立臺灣海洋大學,碩士班(日間),巴拿馬共和國,中南美洲,1,0,1,1,0,1,0,0,0,0,0,0,0,0,0
110,公立,一般大學,0012,國立臺灣海洋大學,碩士班(日間),日本,其他亞洲地區,2,1,1,2,1,1,0,0,0,0,0,0,0,0,0
110,公立,一般大學,0012,國立臺灣海洋大學,碩士班(日間),印度,南亞,1,1,0,1,1,0,0,0,0,0,0,0,0,0,0
110,公立,一般大學,0012,國立臺灣海洋大學,碩士班(日間),香港,港澳,10,7,3,0,0,0,0,0,0,10,7,3,0,0,0
110,公立,一般大學,0012,國立臺灣海洋大學,碩士班(日間),聖文森(及格瑞那丁),中南美洲,1,0,1,1,0,1,0,0,0,0,0,0,0,0,0
110,公立,一般大學,0012,國立臺灣海洋大學,碩士班(日間),緬甸,東協,2,2,0,0,0,0,2,2,0,0,0,0,0,0,0
110,公立,一般大學,0012,國立臺灣海洋大學,碩士班(日間),澳大利亞,其他亞洲地區,1,1,0,1,1,0,0,0,0,0,0,0,0,0,0
110,公立,一般大學,0012,國立臺灣海洋大學,博士班,加拿大,北美洲,1,1,0,1,1,0,0,0,0,0,0,0,0,0,0
110,公立,一般大學,0012,國立臺灣海洋大學,博士班,印度尼西亞共和國,東協,16,9,7,16,9,7,0,0,0,0,0,0,0,0,0
110,公立,一般大學,0012,國立臺灣海洋大學,博士班,突尼西亞共和國,非洲,1,0,1,1,0,1,0,0,0,0,0,0,0,0,0
110,公立,一般大學,0012,國立臺灣海洋大學,博士班,泰國,東協,1,1,0,1,1,0,0,0,0,0,0,0,0,0,0
110,公立,一般大學,0012,國立臺灣海洋大學,博士班,越南社會主義共和國,東協,5,4,1,5,4,1,0,0,0,0,0,0,0,0,0
110,公立,一般大學,0012,國立臺灣海洋大學,博士班,德意志聯邦共和國,歐洲,1,1,0,1,1,0,0,0,0,0,0,0,0,0,0
110,公立,一般大學,0012,國立臺灣海洋大學,博士班,土耳其共和國,其他亞洲地區,1,1,0,1,1,0,0,0,0,0,0,0,0,0,0
110,公立,一般大學,0012,國立臺灣海洋大學,博士班,大陸地區,大陸地區,7,4,3,0,0,0,0,0,0,0,0,0,7,4,3
110,公立,一般大學,0012,國立臺灣海洋大學,博士班,大韓民國(南韓),其他亞洲地區,2,0,2,2,0,2,0,0,0,0,0,0,0,0,0
110,公立,一般大學,0012,國立臺灣海洋大學,博士班,印度,南亞,11,5,6,11,5,6,0,0,0,0,0,0,0,0,0
110,公立,一般大學,0012,國立臺灣海洋大學,博士班,香港,港澳,2,1,1,0,0,0,0,0,0,2,1,1,0,0,0
110,公立,一般大學,0012,國立臺灣海洋大學,博士班,海地共和國,中南美洲,1,1,0,1,1,0,0,0,0,0,0,0,0,0,0
110,公立,一般大學,0012,國立臺灣海洋大學,博士班,馬來西亞,東協,2,1,1,2,1,1,0,0,0,0,0,0,0,0,0
110,公立,一般大學,0012,國立臺灣海洋大學,博士班,菲律賓共和國,東協,4,2,2,4,2,2,0,0,0,0,0,0,0,0,0
110,公立,一般大學,0013,國立中正大學,學士班(日間),大陸地區,大陸地區,7,5,2,0,0,0,0,0,0,0,0,0,7,5,2
110,公立,一般大學,0013,國立中正大學,學士班(日間),日本,其他亞洲地區,7,1,6,7,1,6,0,0,0,0,0,0,0,0,0
110,公立,一般大學,0013,國立中正大學,學士班(日間),印度尼西亞共和國,東協,36,16,20,1,0,1,35,16,19,0,0,0,0,0,0
110,公立,一般大學,0013,國立中正大學,學士班(日間),香港,港澳,53,38,15,0,0,0,0,0,0,53,38,15,0,0,0
110,公立,一般大學,0013,國立中正大學,學士班(日間),馬來西亞,東協,63,36,27,5,3,2,58,33,25,0,0,0,0,0,0
110,公立,一般大學,0013,國立中正大學,學士班(日間),越南社會主義共和國,東協,7,3,4,5,2,3,2,1,1,0,0,0,0,0,0
110,公立,一般大學,0013,國立中正大學,學士班(日間),摩洛哥王國,非洲,1,1,0,1,1,0,0,0,0,0,0,0,0,0,0
110,公立,一般大學,0013,國立中正大學,學士班(日間),澳門,港澳,17,12,5,0,0,0,0,0,0,17,12,5,0,0,0
110,公立,一般大學,0013,國立中正大學,學士班(日間),俄羅斯聯邦,其他亞洲地區,8,1,7,8,1,7,0,0,0,0,0,0,0,0,0
110,公立,一般大學,0013,國立中正大學,學士班(日間),新加坡共和國,東協,1,0,1,0,0,0,1,0,1,0,0,0,0,0,0
110,公立,一般大學,0013,國立中正大學,學士班(日間),緬甸,東協,4,2,2,0,0,0,4,2,2,0,0,0,0,0,0
110,公立,一般大學,0013,國立中正大學,碩士班(日間),巴西聯邦共和國,中南美洲,1,0,1,1,0,1,0,0,0,0,0,0,0,0,0
110,公立,一般大學,0013,國立中正大學,碩士班(日間),巴基斯坦,南亞,2,2,0,2,2,0,0,0,0,0,0,0,0,0,0
110,公立,一般大學,0013,國立中正大學,碩士班(日間),美國,北美洲,1,1,0,1,1,0,0,0,0,0,0,0,0,0,0
110,公立,一般大學,0013,國立中正大學,碩士班(日間),泰國,東協,1,0,1,1,0,1,0,0,0,0,0,0,0,0,0
110,公立,一般大學,0013,國立中正大學,碩士班(日間),墨西哥合眾國,中南美洲,1,0,1,1,0,1,0,0,0,0,0,0,0,0,0
110,公立,一般大學,0013,國立中正大學,碩士班(日間),大陸地區,大陸地區,3,2,1,0,0,0,0,0,0,0,0,0,3,2,1
110,公立,一般大學,0013,國立中正大學,碩士班(日間),大韓民國(南韓),其他亞洲地區,1,0,1,1,0,1,0,0,0,0,0,0,0,0,0
110,公立,一般大學,0013,國立中正大學,碩士班(日間),伊朗伊斯蘭共和國,其他亞洲地區,1,1,0,1,1,0,0,0,0,0,0,0,0,0,0
110,公立,一般大學,0013,國立中正大學,碩士班(日間),印度,南亞,4,3,1,4,3,1,0,0,0,0,0,0,0,0,0
110,公立,一般大學,0013,國立中正大學,碩士班(日間),印度尼西亞共和國,東協,9,2,7,8,2,6,1,0,1,0,0,0,0,0,0
110,公立,一般大學,0013,國立中正大學,碩士班(日間),宏都拉斯共和國,中南美洲,2,1,1,2,1,1,0,0,0,0,0,0,0,0,0
110,公立,一般大學,0013,國立中正大學,碩士班(日間),貝里斯,中南美洲,1,0,1,1,0,1,0,0,0,0,0,0,0,0,0
110,公立,一般大學,0013,國立中正大學,碩士班(日間),南非共和國,非洲,1,1,0,1,1,0,0,0,0,0,0,0,0,0,0
110,公立,一般大學,0013,國立中正大學,碩士班(日間),柬埔寨王國,東協,2,2,0,2,2,0,0,0,0,0,0,0,0,0,0
110,公立,一般大學,0013,國立中正大學,碩士班(日間),香港,港澳,15,11,4,0,0,0,0,0,0,15,11,4,0,0,0
110,公立,一般大學,0013,國立中正大學,碩士班(日間),哥倫比亞共和國,中南美洲,1,1,0,1,1,0,0,0,0,0,0,0,0,0,0
110,公立,一般大學,0013,國立中正大學,碩士班(日間),馬來西亞,東協,11,5,6,5,1,4,6,4,2,0,0,0,0,0,0
110,公立,一般大學,0013,國立中正大學,碩士班(日間),越南社會主義共和國,東協,17,8,9,17,8,9,0,0,0,0,0,0,0,0,0
110,公立,一般大學,0013,國立中正大學,碩士班(日間),新加坡共和國,東協,1,1,0,1,1,0,0,0,0,0,0,0,0,0,0
110,公立,一般大學,0013,國立中正大學,碩士班(日間),聖露西亞,中南美洲,1,1,0,1,1,0,0,0,0,0,0,0,0,0,0
110,公立,一般大學,0013,國立中正大學,碩士班(日間),緬甸,東協,1,0,1,1,0,1,0,0,0,0,0,0,0,0,0
110,公立,一般大學,0013,國立中正大學,碩士班(日間),澳門,港澳,2,0,2,0,0,0,0,0,0,2,0,2,0,0,0
110,公立,一般大學,0013,國立中正大學,博士班,大陸地區,大陸地區,8,6,2,0,0,0,0,0,0,0,0,0,8,6,2
110,公立,一般大學,0013,國立中正大學,博士班,甘比亞共和國,非洲,1,1,0,1,1,0,0,0,0,0,0,0,0,0,0
110,公立,一般大學,0013,國立中正大學,博士班,印度,南亞,19,12,7,19,12,7,0,0,0,0,0,0,0,0,0
110,公立,一般大學,0013,國立中正大學,博士班,貝里斯,中南美洲,2,1,1,2,1,1,0,0,0,0,0,0,0,0,0
110,公立,一般大學,0013,國立中正大學,博士班,香港,港澳,4,4,0,0,0,0,0,0,0,4,4,0,0,0,0
110,公立,一般大學,0013,國立中正大學,博士班,越南社會主義共和國,東協,21,9,12,21,9,12,0,0,0,0,0,0,0,0,0
110,公立,一般大學,0013,國立中正大學,博士班,澳門,港澳,3,3,0,0,0,0,0,0,0,3,3,0,0,0,0
110,公立,一般大學,0013,國立中正大學,博士班,巴基斯坦,南亞,5,4,1,5,4,1,0,0,0,0,0,0,0,0,0
110,公立,一般大學,0013,國立中正大學,博士班,布吉納法索,非洲,1,1,0,1,1,0,0,0,0,0,0,0,0,0,0
110,公立,一般大學,0013,國立中正大學,博士班,印度尼西亞共和國,東協,8,5,3,8,5,3,0,0,0,0,0,0,0,0,0
110,公立,一般大學,0013,國立中正大學,博士班,柬埔寨王國,東協,1,1,0,1,1,0,0,0,0,0,0,0,0,0,0
110,公立,一般大學,0013,國立中正大學,博士班,泰國,東協,3,2,1,3,2,1,0,0,0,0,0,0,0,0,0
110,公立,一般大學,0013,國立中正大學,博士班,馬來西亞,東協,6,4,2,6,4,2,0,0,0,0,0,0,0,0,0
110,公立,一般大學,0013,國立中正大學,博士班,義大利共和國,歐洲,1,0,1,1,0,1,0,0,0,0,0,0,0,0,0
110,公立,一般大學,0014,國立高雄師範大學,學士班(日間),大韓民國(南韓),其他亞洲地區,2,1,1,2,1,1,0,0,0,0,0,0,0,0,0
110,公立,一般大學,0014,國立高雄師範大學,學士班(日間),日本,其他亞洲地區,3,0,3,1,0,1,2,0,2,0,0,0,0,0,0
110,公立,一般大學,0014,國立高雄師範大學,學士班(日間),印度,南亞,1,1,0,1,1,0,0,0,0,0,0,0,0,0,0
110,公立,一般大學,0014,國立高雄師範大學,學士班(日間),印度尼西亞共和國,東協,7,1,6,1,0,1,6,1,5,0,0,0,0,0,0
110,公立,一般大學,0014,國立高雄師範大學,學士班(日間),馬來西亞,東協,33,12,21,3,2,1,30,10,20,0,0,0,0,0,0
110,公立,一般大學,0014,國立高雄師範大學,學士班(日間),大陸地區,大陸地區,8,1,7,0,0,0,0,0,0,0,0,0,8,1,7
110,公立,一般大學,0014,國立高雄師範大學,學士班(日間),阿根廷,中南美洲,2,2,0,1,1,0,1,1,0,0,0,0,0,0,0
110,公立,一般大學,0014,國立高雄師範大學,學士班(日間),香港,港澳,17,9,8,0,0,0,0,0,0,17,9,8,0,0,0
110,公立,一般大學,0014,國立高雄師範大學,學士班(日間),越南社會主義共和國,東協,11,0,11,10,0,10,1,0,1,0,0,0,0,0,0
110,公立,一般大學,0014,國立高雄師範大學,學士班(日間),澳門,港澳,23,13,10,0,0,0,0,0,0,23,13,10,0,0,0
110,公立,一般大學,0014,國立高雄師範大學,碩士班(日間),大陸地區,大陸地區,5,2,3,0,0,0,0,0,0,0,0,0,5,2,3
110,公立,一般大學,0014,國立高雄師範大學,碩士班(日間),匈牙利共和國,歐洲,1,1,0,1,1,0,0,0,0,0,0,0,0,0,0
110,公立,一般大學,0014,國立高雄師範大學,碩士班(日間),印度,南亞,1,1,0,1,1,0,0,0,0,0,0,0,0,0,0
110,公立,一般大學,0014,國立高雄師範大學,碩士班(日間),阿根廷,中南美洲,1,0,1,0,0,0,1,0,1,0,0,0,0,0,0
110,公立,一般大學,0014,國立高雄師範大學,碩士班(日間),香港,港澳,9,3,6,0,0,0,0,0,0,9,3,6,0,0,0
110,公立,一般大學,0014,國立高雄師範大學,碩士班(日間),越南社會主義共和國,東協,3,0,3,3,0,3,0,0,0,0,0,0,0,0,0
110,公立,一般大學,0014,國立高雄師範大學,碩士班(日間),澳門,港澳,5,1,4,0,0,0,0,0,0,5,1,4,0,0,0
110,公立,一般大學,0014,國立高雄師範大學,碩士班(日間),大韓民國(南韓),其他亞洲地區,2,1,1,2,1,1,0,0,0,0,0,0,0,0,0
110,公立,一般大學,0014,國立高雄師範大學,碩士班(日間),日本,其他亞洲地區,3,1,2,2,1,1,1,0,1,0,0,0,0,0,0
110,公立,一般大學,0014,國立高雄師範大學,碩士班(日間),印度尼西亞共和國,東協,4,3,1,2,1,1,2,2,0,0,0,0,0,0,0
110,公立,一般大學,0014,國立高雄師範大學,碩士班(日間),美國,北美洲,2,2,0,2,2,0,0,0,0,0,0,0,0,0,0
110,公立,一般大學,0014,國立高雄師範大學,碩士班(日間),泰國,東協,1,0,1,1,0,1,0,0,0,0,0,0,0,0,0
110,公立,一般大學,0014,國立高雄師範大學,碩士班(日間),馬來西亞,東協,9,2,7,3,1,2,6,1,5,0,0,0,0,0,0
110,公立,一般大學,0014,國立高雄師範大學,博士班,大陸地區,大陸地區,10,4,6,0,0,0,0,0,0,0,0,0,10,4,6
110,公立,一般大學,0014,國立高雄師範大學,博士班,大韓民國(南韓),其他亞洲地區,1,0,1,1,0,1,0,0,0,0,0,0,0,0,0
110,公立,一般大學,0014,國立高雄師範大學,博士班,南非共和國,非洲,1,1,0,1,1,0,0,0,0,0,0,0,0,0,0
110,公立,一般大學,0014,國立高雄師範大學,博士班,越南社會主義共和國,東協,3,3,0,3,3,0,0,0,0,0,0,0,0,0,0
110,公立,一般大學,0014,國立高雄師範大學,博士班,美國,北美洲,1,0,1,1,0,1,0,0,0,0,0,0,0,0,0
110,公立,一般大學,0014,國立高雄師範大學,博士班,德意志聯邦共和國,歐洲,1,1,0,1,1,0,0,0,0,0,0,0,0,0,0
110,公立,一般大學,0015,國立彰化師範大學,學士班(日間),大陸地區,大陸地區,8,4,4,0,0,0,0,0,0,0,0,0,8,4,4
110,公立,一般大學,0015,國立彰化師範大學,學士班(日間),大韓民國(南韓),其他亞洲地區,1,0,1,1,0,1,0,0,0,0,0,0,0,0,0
110,公立,一般大學,0015,國立彰化師範大學,學士班(日間),日本,其他亞洲地區,3,2,1,3,2,1,0,0,0,0,0,0,0,0,0
110,公立,一般大學,0015,國立彰化師範大學,學士班(日間),印度尼西亞共和國,東協,4,1,3,1,0,1,3,1,2,0,0,0,0,0,0
110,公立,一般大學,0015,國立彰化師範大學,學士班(日間),南非共和國,非洲,2,1,1,2,1,1,0,0,0,0,0,0,0,0,0
110,公立,一般大學,0015,國立彰化師範大學,學士班(日間),香港,港澳,56,34,22,0,0,0,0,0,0,56,34,22,0,0,0
110,公立,一般大學,0015,國立彰化師範大學,學士班(日間),越南社會主義共和國,東協,11,4,7,8,2,6,3,2,1,0,0,0,0,0,0
110,公立,一般大學,0015,國立彰化師範大學,學士班(日間),蒙古國,其他亞洲地區,1,1,0,1,1,0,0,0,0,0,0,0,0,0,0
110,公立,一般大學,0015,國立彰化師範大學,學士班(日間),澳門,港澳,39,16,23,0,0,0,0,0,0,39,16,23,0,0,0
110,公立,一般大學,0015,國立彰化師範大學,學士班(日間),美國,北美洲,1,0,1,0,0,0,1,0,1,0,0,0,0,0,0
110,公立,一般大學,0015,國立彰化師範大學,學士班(日間),馬來西亞,東協,107,42,65,11,3,8,96,39,57,0,0,0,0,0,0
110,公立,一般大學,0015,國立彰化師範大學,學士班(日間),菲律賓共和國,東協,1,0,1,0,0,0,1,0,1,0,0,0,0,0,0
110,公立,一般大學,0015,國立彰化師範大學,碩士班(日間),馬來西亞,東協,23,12,11,9,5,4,14,7,7,0,0,0,0,0,0
110,公立,一般大學,0015,國立彰化師範大學,碩士班(日間),越南社會主義共和國,東協,1,0,1,1,0,1,0,0,0,0,0,0,0,0,0
110,公立,一般大學,0015,國立彰化師範大學,碩士班(日間),大陸地區,大陸地區,2,0,2,0,0,0,0,0,0,0,0,0,2,0,2
110,公立,一般大學,0015,國立彰化師範大學,碩士班(日間),巴基斯坦,南亞,1,1,0,1,1,0,0,0,0,0,0,0,0,0,0
110,公立,一般大學,0015,國立彰化師範大學,碩士班(日間),日本,其他亞洲地區,1,0,1,1,0,1,0,0,0,0,0,0,0,0,0
110,公立,一般大學,0015,國立彰化師範大學,碩士班(日間),伊朗伊斯蘭共和國,其他亞洲地區,1,1,0,1,1,0,0,0,0,0,0,0,0,0,0
110,公立,一般大學,0015,國立彰化師範大學,碩士班(日間),香港,港澳,6,5,1,0,0,0,0,0,0,6,5,1,0,0,0
110,公立,一般大學,0015,國立彰化師範大學,碩士班(日間),新加坡共和國,東協,1,1,0,0,0,0,1,1,0,0,0,0,0,0,0
110,公立,一般大學,0015,國立彰化師範大學,碩士班(日間),澳門,港澳,5,1,4,0,0,0,0,0,0,5,1,4,0,0,0
110,公立,一般大學,0015,國立彰化師範大學,博士班,美國,北美洲,1,0,1,1,0,1,0,0,0,0,0,0,0,0,0
110,公立,一般大學,0015,國立彰化師範大學,博士班,越南社會主義共和國,東協,3,3,0,3,3,0,0,0,0,0,0,0,0,0,0
110,公立,一般大學,0015,國立彰化師範大學,博士班,大陸地區,大陸地區,13,3,10,0,0,0,0,0,0,0,0,0,13,3,10
110,公立,一般大學,0015,國立彰化師範大學,博士班,印度,南亞,10,6,4,10,6,4,0,0,0,0,0,0,0,0,0
110,公立,一般大學,0015,國立彰化師範大學,博士班,英國,歐洲,1,1,0,1,1,0,0,0,0,0,0,0,0,0,0
110,公立,一般大學,0015,國立彰化師範大學,博士班,馬來西亞,東協,2,0,2,1,0,1,1,0,1,0,0,0,0,0,0
110,公立,一般大學,0015,國立彰化師範大學,博士班,新加坡共和國,東協,1,1,0,1,1,0,0,0,0,0,0,0,0,0,0
110,公立,一般大學,0015,國立彰化師範大學,博士班,蒙古國,其他亞洲地區,1,0,1,1,0,1,0,0,0,0,0,0,0,0,0
110,公立,一般大學,0017,國立臺北大學,學士班(日間),大陸地區,大陸地區,8,4,4,0,0,0,0,0,0,0,0,0,8,4,4
110,公立,一般大學,0017,國立臺北大學,學士班(日間),厄瓜多共和國,中南美洲,1,0,1,0,0,0,1,0,1,0,0,0,0,0,0
110,公立,一般大學,0017,國立臺北大學,學士班(日間),巴拉圭,中南美洲,3,1,2,2,0,2,1,1,0,0,0,0,0,0,0
110,公立,一般大學,0017,國立臺北大學,學士班(日間),日本,其他亞洲地區,15,6,9,8,3,5,7,3,4,0,0,0,0,0,0
110,公立,一般大學,0017,國立臺北大學,學士班(日間),瓜地馬拉共和國,中南美洲,1,1,0,1,1,0,0,0,0,0,0,0,0,0,0
110,公立,一般大學,0017,國立臺北大學,學士班(日間),香港,港澳,104,56,48,0,0,0,0,0,0,104,56,48,0,0,0
110,公立,一般大學,0017,國立臺北大學,學士班(日間),越南社會主義共和國,東協,14,5,9,2,0,2,12,5,7,0,0,0,0,0,0
110,公立,一般大學,0017,國立臺北大學,學士班(日間),新加坡共和國,東協,2,0,2,0,0,0,2,0,2,0,0,0,0,0,0
110,公立,一般大學,0017,國立臺北大學,學士班(日間),緬甸,東協,37,10,27,0,0,0,37,10,27,0,0,0,0,0,0
110,公立,一般大學,0017,國立臺北大學,學士班(日間),澳門,港澳,25,13,12,0,0,0,0,0,0,25,13,12,0,0,0
110,公立,一般大學,0017,國立臺北大學,學士班(日間),大韓民國(南韓),其他亞洲地區,2,0,2,0,0,0,2,0,2,0,0,0,0,0,0
110,公立,一般大學,0017,國立臺北大學,學士班(日間),巴西聯邦共和國,中南美洲,1,1,0,0,0,0,1,1,0,0,0,0,0,0,0
110,公立,一般大學,0017,國立臺北大學,學士班(日間),加拿大,北美洲,1,1,0,0,0,0,1,1,0,0,0,0,0,0,0
110,公立,一般大學,0017,國立臺北大學,學士班(日間),印度尼西亞共和國,東協,31,16,15,5,3,2,26,13,13,0,0,0,0,0,0
110,公立,一般大學,0017,國立臺北大學,學士班(日間),汶萊和平之國,東協,1,0,1,0,0,0,1,0,1,0,0,0,0,0,0
110,公立,一般大學,0017,國立臺北大學,學士班(日間),俄羅斯聯邦,其他亞洲地區,1,1,0,1,1,0,0,0,0,0,0,0,0,0,0
110,公立,一般大學,0017,國立臺北大學,學士班(日間),南非共和國,非洲,1,0,1,0,0,0,1,0,1,0,0,0,0,0,0
110,公立,一般大學,0017,國立臺北大學,學士班(日間),約旦哈什米王國,其他亞洲地區,1,1,0,0,0,0,1,1,0,0,0,0,0,0,0
110,公立,一般大學,0017,國立臺北大學,學士班(日間),泰國,東協,3,1,2,0,0,0,3,1,2,0,0,0,0,0,0
110,公立,一般大學,0017,國立臺北大學,學士班(日間),烏克蘭,其他亞洲地區,1,0,1,1,0,1,0,0,0,0,0,0,0,0,0
110,公立,一般大學,0017,國立臺北大學,學士班(日間),秘魯共和國,中南美洲,1,0,1,0,0,0,1,0,1,0,0,0,0,0,0
110,公立,一般大學,0017,國立臺北大學,學士班(日間),馬來西亞,東協,104,61,43,2,2,0,102,59,43,0,0,0,0,0,0
110,公立,一般大學,0017,國立臺北大學,學士班(日間),菲律賓共和國,東協,1,0,1,0,0,0,1,0,1,0,0,0,0,0,0
110,公立,一般大學,0017,國立臺北大學,學士班(日間),蒙古國,其他亞洲地區,2,0,2,2,0,2,0,0,0,0,0,0,0,0,0
110,公立,一般大學,0017,國立臺北大學,碩士班(日間),土耳其共和國,其他亞洲地區,1,0,1,1,0,1,0,0,0,0,0,0,0,0,0
110,公立,一般大學,0017,國立臺北大學,碩士班(日間),印度尼西亞共和國,東協,7,2,5,6,2,4,1,0,1,0,0,0,0,0,0
110,公立,一般大學,0017,國立臺北大學,碩士班(日間),泰國,東協,6,2,4,6,2,4,0,0,0,0,0,0,0,0,0
110,公立,一般大學,0017,國立臺北大學,碩士班(日間),馬來西亞,東協,10,6,4,1,0,1,9,6,3,0,0,0,0,0,0
110,公立,一般大學,0017,國立臺北大學,碩士班(日間),菲律賓共和國,東協,1,1,0,1,1,0,0,0,0,0,0,0,0,0,0
110,公立,一般大學,0017,國立臺北大學,碩士班(日間),越南社會主義共和國,東協,13,6,7,13,6,7,0,0,0,0,0,0,0,0,0
110,公立,一般大學,0017,國立臺北大學,碩士班(日間),聖露西亞,中南美洲,1,0,1,1,0,1,0,0,0,0,0,0,0,0,0
110,公立,一般大學,0017,國立臺北大學,碩士班(日間),蒙古國,其他亞洲地區,4,0,4,4,0,4,0,0,0,0,0,0,0,0,0
110,公立,一般大學,0017,國立臺北大學,碩士班(日間),大陸地區,大陸地區,10,5,5,0,0,0,0,0,0,0,0,0,10,5,5
110,公立,一般大學,0017,國立臺北大學,碩士班(日間),巴布亞紐幾內亞獨立國,其他亞洲地區,1,1,0,1,1,0,0,0,0,0,0,0,0,0,0
110,公立,一般大學,0017,國立臺北大學,碩士班(日間),日本,其他亞洲地區,1,1,0,1,1,0,0,0,0,0,0,0,0,0,0
110,公立,一般大學,0017,國立臺北大學,碩士班(日間),印度,南亞,1,0,1,1,0,1,0,0,0,0,0,0,0,0,0
110,公立,一般大學,0017,國立臺北大學,碩士班(日間),貝里斯,中南美洲,2,2,0,2,2,0,0,0,0,0,0,0,0,0,0
110,公立,一般大學,0017,國立臺北大學,碩士班(日間),香港,港澳,17,12,5,0,0,0,0,0,0,17,12,5,0,0,0
110,公立,一般大學,0017,國立臺北大學,碩士班(日間),海地共和國,中南美洲,1,1,0,1,1,0,0,0,0,0,0,0,0,0,0
110,公立,一般大學,0017,國立臺北大學,碩士班(日間),莫三比克共和國,非洲,1,0,1,1,0,1,0,0,0,0,0,0,0,0,0
110,公立,一般大學,0017,國立臺北大學,碩士班(日間),德意志聯邦共和國,歐洲,2,1,1,2,1,1,0,0,0,0,0,0,0,0,0
110,公立,一般大學,0017,國立臺北大學,碩士班(日間),緬甸,東協,3,0,3,0,0,0,3,0,3,0,0,0,0,0,0
110,公立,一般大學,0017,國立臺北大學,碩士班(日間),澳門,港澳,5,3,2,0,0,0,0,0,0,5,3,2,0,0,0
110,公立,一般大學,0017,國立臺北大學,博士班,俄羅斯聯邦,其他亞洲地區,1,1,0,1,1,0,0,0,0,0,0,0,0,0,0
110,公立,一般大學,0017,國立臺北大學,博士班,菲律賓共和國,東協,3,1,2,3,1,2,0,0,0,0,0,0,0,0,0
110,公立,一般大學,0017,國立臺北大學,博士班,越南社會主義共和國,東協,1,1,0,1,1,0,0,0,0,0,0,0,0,0,0
110,公立,一般大學,0017,國立臺北大學,博士班,大陸地區,大陸地區,14,8,6,0,0,0,0,0,0,0,0,0,14,8,6
110,公立,一般大學,0017,國立臺北大學,博士班,馬來西亞,東協,1,1,0,0,0,0,1,1,0,0,0,0,0,0,0
110,公立,一般大學,0017,國立臺北大學,博士班,澳門,港澳,2,1,1,0,0,0,0,0,0,2,1,1,0,0,0
110,公立,一般大學,0018,國立嘉義大學,學士班(日間),大陸地區,大陸地區,1,1,0,0,0,0,0,0,0,0,0,0,1,1,0
110,公立,一般大學,0018,國立嘉義大學,學士班(日間),日本,其他亞洲地區,7,4,3,7,4,3,0,0,0,0,0,0,0,0,0
110,公立,一般大學,0018,國立嘉義大學,學士班(日間),史瓦帝尼王國,非洲,1,0,1,1,0,1,0,0,0,0,0,0,0,0,0
110,公立,一般大學,0018,國立嘉義大學,學士班(日間),印度尼西亞共和國,東協,29,10,19,5,2,3,24,8,16,0,0,0,0,0,0
110,公立,一般大學,0018,國立嘉義大學,學士班(日間),南非共和國,非洲,3,2,1,0,0,0,3,2,1,0,0,0,0,0,0
110,公立,一般大學,0018,國立嘉義大學,學士班(日間),香港,港澳,76,31,45,0,0,0,0,0,0,76,31,45,0,0,0
110,公立,一般大學,0018,國立嘉義大學,學士班(日間),大韓民國(南韓),其他亞洲地區,1,1,0,0,0,0,1,1,0,0,0,0,0,0,0
110,公立,一般大學,0018,國立嘉義大學,學士班(日間),巴西聯邦共和國,中南美洲,1,0,1,0,0,0,1,0,1,0,0,0,0,0,0
110,公立,一般大學,0018,國立嘉義大學,學士班(日間),阿富汗伊斯蘭共和國,其他亞洲地區,1,0,1,0,0,0,1,0,1,0,0,0,0,0,0
110,公立,一般大學,0018,國立嘉義大學,學士班(日間),馬來西亞,東協,107,46,61,5,0,5,102,46,56,0,0,0,0,0,0
110,公立,一般大學,0018,國立嘉義大學,學士班(日間),菲律賓共和國,東協,1,0,1,1,0,1,0,0,0,0,0,0,0,0,0
110,公立,一般大學,0018,國立嘉義大學,學士班(日間),越南社會主義共和國,東協,5,1,4,4,0,4,1,1,0,0,0,0,0,0,0
110,公立,一般大學,0018,國立嘉義大學,學士班(日間),新加坡共和國,東協,1,0,1,1,0,1,0,0,0,0,0,0,0,0,0
110,公立,一般大學,0018,國立嘉義大學,學士班(日間),聖露西亞,中南美洲,1,1,0,1,1,0,0,0,0,0,0,0,0,0,0
110,公立,一般大學,0018,國立嘉義大學,學士班(日間),澳門,港澳,15,8,7,0,0,0,0,0,0,15,8,7,0,0,0
110,公立,一般大學,0018,國立嘉義大學,碩士班(日間),厄瓜多共和國,中南美洲,1,0,1,1,0,1,0,0,0,0,0,0,0,0,0
110,公立,一般大學,0018,國立嘉義大學,碩士班(日間),印度,南亞,1,1,0,1,1,0,0,0,0,0,0,0,0,0,0
110,公立,一般大學,0018,國立嘉義大學,碩士班(日間),香港,港澳,10,7,3,0,0,0,0,0,0,10,7,3,0,0,0
110,公立,一般大學,0018,國立嘉義大學,碩士班(日間),捷克共和國,歐洲,1,0,1,1,0,1,0,0,0,0,0,0,0,0,0
110,公立,一般大學,0018,國立嘉義大學,碩士班(日間),菲律賓共和國,東協,1,1,0,1,1,0,0,0,0,0,0,0,0,0,0
110,公立,一般大學,0018,國立嘉義大學,碩士班(日間),越南社會主義共和國,東協,2,1,1,2,1,1,0,0,0,0,0,0,0,0,0
110,公立,一般大學,0018,國立嘉義大學,碩士班(日間),蒙古國,其他亞洲地區,1,0,1,1,0,1,0,0,0,0,0,0,0,0,0
110,公立,一般大學,0018,國立嘉義大學,碩士班(日間),澳門,港澳,3,1,2,0,0,0,0,0,0,3,1,2,0,0,0
110,公立,一般大學,0018,國立嘉義大學,碩士班(日間),印度尼西亞共和國,東協,13,4,9,13,4,9,0,0,0,0,0,0,0,0,0
110,公立,一般大學,0018,國立嘉義大學,碩士班(日間),約旦哈什米王國,其他亞洲地區,1,0,1,1,0,1,0,0,0,0,0,0,0,0,0
110,公立,一般大學,0018,國立嘉義大學,碩士班(日間),泰國,東協,3,1,2,3,1,2,0,0,0,0,0,0,0,0,0
110,公立,一般大學,0018,國立嘉義大學,碩士班(日間),馬來西亞,東協,7,2,5,0,0,0,7,2,5,0,0,0,0,0,0
110,公立,一般大學,0018,國立嘉義大學,博士班,大陸地區,大陸地區,1,0,1,0,0,0,0,0,0,0,0,0,1,0,1
110,公立,一般大學,0018,國立嘉義大學,博士班,印度尼西亞共和國,東協,3,0,3,3,0,3,0,0,0,0,0,0,0,0,0
110,公立,一般大學,0018,國立嘉義大學,博士班,泰國,東協,2,0,2,2,0,2,0,0,0,0,0,0,0,0,0
110,公立,一般大學,0018,國立嘉義大學,博士班,秘魯共和國,中南美洲,1,0,1,1,0,1,0,0,0,0,0,0,0,0,0
110,公立,一般大學,0018,國立嘉義大學,博士班,澳門,港澳,1,1,0,0,0,0,0,0,0,1,1,0,0,0,0
110,公立,一般大學,0018,國立嘉義大學,博士班,日本,其他亞洲地區,1,1,0,1,1,0,0,0,0,0,0,0,0,0,0
110,公立,一般大學,0018,國立嘉義大學,博士班,菲律賓共和國,東協,1,0,1,1,0,1,0,0,0,0,0,0,0,0,0
110,公立,一般大學,0019,國立高雄大學,學士班(日間),大韓民國(南韓),其他亞洲地區,1,0,1,1,0,1,0,0,0,0,0,0,0,0,0
110,公立,一般大學,0019,國立高雄大學,學士班(日間),厄瓜多共和國,中南美洲,1,0,1,1,0,1,0,0,0,0,0,0,0,0,0
110,公立,一般大學,0019,國立高雄大學,學士班(日間),美國,北美洲,1,1,0,1,1,0,0,0,0,0,0,0,0,0,0
110,公立,一般大學,0019,國立高雄大學,學士班(日間),菲律賓共和國,東協,2,2,0,2,2,0,0,0,0,0,0,0,0,0,0
110,公立,一般大學,0019,國立高雄大學,學士班(日間),聖露西亞,中南美洲,2,1,1,2,1,1,0,0,0,0,0,0,0,0,0
110,公立,一般大學,0019,國立高雄大學,學士班(日間),大陸地區,大陸地區,3,1,2,0,0,0,0,0,0,0,0,0,3,1,2
110,公立,一般大學,0019,國立高雄大學,學士班(日間),巴拉圭,中南美洲,1,1,0,1,1,0,0,0,0,0,0,0,0,0,0
110,公立,一般大學,0019,國立高雄大學,學士班(日間),日本,其他亞洲地區,18,8,10,18,8,10,0,0,0,0,0,0,0,0,0
110,公立,一般大學,0019,國立高雄大學,學士班(日間),瓜地馬拉共和國,中南美洲,1,0,1,1,0,1,0,0,0,0,0,0,0,0,0
110,公立,一般大學,0019,國立高雄大學,學士班(日間),印度尼西亞共和國,東協,90,53,37,7,4,3,83,49,34,0,0,0,0,0,0
110,公立,一般大學,0019,國立高雄大學,學士班(日間),香港,港澳,33,23,10,0,0,0,0,0,0,33,23,10,0,0,0
110,公立,一般大學,0019,國立高雄大學,學士班(日間),泰國,東協,1,0,1,0,0,0,1,0,1,0,0,0,0,0,0
110,公立,一般大學,0019,國立高雄大學,學士班(日間),馬來西亞,東協,38,17,21,0,0,0,38,17,21,0,0,0,0,0,0
110,公立,一般大學,0019,國立高雄大學,學士班(日間),越南社會主義共和國,東協,13,3,10,7,1,6,6,2,4,0,0,0,0,0,0
110,公立,一般大學,0019,國立高雄大學,學士班(日間),緬甸,東協,2,0,2,0,0,0,2,0,2,0,0,0,0,0,0
110,公立,一般大學,0019,國立高雄大學,學士班(日間),澳門,港澳,11,6,5,0,0,0,0,0,0,11,6,5,0,0,0
110,公立,一般大學,0019,國立高雄大學,碩士班(日間),土耳其共和國,其他亞洲地區,2,1,1,2,1,1,0,0,0,0,0,0,0,0,0
110,公立,一般大學,0019,國立高雄大學,碩士班(日間),日本,其他亞洲地區,1,0,1,1,0,1,0,0,0,0,0,0,0,0,0
110,公立,一般大學,0019,國立高雄大學,碩士班(日間),波蘭共和國,歐洲,1,1,0,1,1,0,0,0,0,0,0,0,0,0,0
110,公立,一般大學,0019,國立高雄大學,碩士班(日間),香港,港澳,4,2,2,0,0,0,0,0,0,4,2,2,0,0,0
110,公立,一般大學,0019,國立高雄大學,碩士班(日間),哥倫比亞共和國,中南美洲,4,1,3,4,1,3,0,0,0,0,0,0,0,0,0
110,公立,一般大學,0019,國立高雄大學,碩士班(日間),泰國,東協,6,1,5,6,1,5,0,0,0,0,0,0,0,0,0
110,公立,一般大學,0019,國立高雄大學,碩士班(日間),馬來西亞,東協,2,2,0,0,0,0,2,2,0,0,0,0,0,0,0
110,公立,一般大學,0019,國立高雄大學,碩士班(日間),菲律賓共和國,東協,1,0,1,1,0,1,0,0,0,0,0,0,0,0,0
110,公立,一般大學,0019,國立高雄大學,碩士班(日間),越南社會主義共和國,東協,6,0,6,6,0,6,0,0,0,0,0,0,0,0,0
110,公立,一般大學,0019,國立高雄大學,碩士班(日間),大韓民國(南韓),其他亞洲地區,1,0,1,1,0,1,0,0,0,0,0,0,0,0,0
110,公立,一般大學,0019,國立高雄大學,碩士班(日間),俄羅斯聯邦,其他亞洲地區,2,2,0,2,2,0,0,0,0,0,0,0,0,0,0
110,公立,一般大學,0019,國立高雄大學,碩士班(日間),美國,北美洲,1,1,0,1,1,0,0,0,0,0,0,0,0,0,0
110,公立,一般大學,0019,國立高雄大學,碩士班(日間),蒙古國,其他亞洲地區,1,0,1,1,0,1,0,0,0,0,0,0,0,0,0
110,公立,一般大學,0019,國立高雄大學,博士班,大陸地區,大陸地區,2,1,1,0,0,0,0,0,0,0,0,0,2,1,1
110,公立,一般大學,0020,國立東華大學,學士班(日間),大陸地區,大陸地區,9,4,5,0,0,0,0,0,0,0,0,0,9,4,5
110,公立,一般大學,0020,國立東華大學,學士班(日間),巴布亞紐幾內亞獨立國,其他亞洲地區,1,1,0,1,1,0,0,0,0,0,0,0,0,0,0
110,公立,一般大學,0020,國立東華大學,學士班(日間),巴西聯邦共和國,中南美洲,1,1,0,0,0,0,1,1,0,0,0,0,0,0,0
110,公立,一般大學,0020,國立東華大學,學士班(日間),巴拉圭,中南美洲,2,2,0,2,2,0,0,0,0,0,0,0,0,0,0
110,公立,一般大學,0020,國立東華大學,學士班(日間),史瓦帝尼王國,非洲,18,14,4,18,14,4,0,0,0,0,0,0,0,0,0
110,公立,一般大學,0020,國立東華大學,學士班(日間),瓜地馬拉共和國,中南美洲,4,2,2,4,2,2,0,0,0,0,0,0,0,0,0
110,公立,一般大學,0020,國立東華大學,學士班(日間),印度尼西亞共和國,東協,93,35,58,41,17,24,52,18,34,0,0,0,0,0,0
110,公立,一般大學,0020,國立東華大學,學士班(日間),宏都拉斯共和國,中南美洲,12,8,4,12,8,4,0,0,0,0,0,0,0,0,0
110,公立,一般大學,0020,國立東華大學,學士班(日間),貝里斯,中南美洲,11,8,3,11,8,3,0,0,0,0,0,0,0,0,0
110,公立,一般大學,0020,國立東華大學,學士班(日間),香港,港澳,109,54,55,0,0,0,0,0,0,109,54,55,0,0,0
110,公立,一般大學,0020,國立東華大學,學士班(日間),哥斯大黎加共和國,中南美洲,1,0,1,0,0,0,1,0,1,0,0,0,0,0,0
110,公立,一般大學,0020,國立東華大學,學士班(日間),泰國,東協,14,10,4,13,10,3,1,0,1,0,0,0,0,0,0
110,公立,一般大學,0020,國立東華大學,學士班(日間),秘魯共和國,中南美洲,2,1,1,2,1,1,0,0,0,0,0,0,0,0,0
110,公立,一般大學,0020,國立東華大學,學士班(日間),馬來西亞,東協,144,65,79,3,0,3,141,65,76,0,0,0,0,0,0
110,公立,一般大學,0020,國立東華大學,學士班(日間),馬紹爾群島共和國,其他亞洲地區,1,1,0,1,1,0,0,0,0,0,0,0,0,0,0
110,公立,一般大學,0020,國立東華大學,學士班(日間),越南社會主義共和國,東協,16,4,12,15,3,12,1,1,0,0,0,0,0,0,0
110,公立,一般大學,0020,國立東華大學,學士班(日間),聖文森(及格瑞那丁),中南美洲,12,8,4,12,8,4,0,0,0,0,0,0,0,0,0
110,公立,一般大學,0020,國立東華大學,學士班(日間),緬甸,東協,2,1,1,0,0,0,2,1,1,0,0,0,0,0,0
110,公立,一般大學,0020,國立東華大學,學士班(日間),澳門,港澳,24,7,17,0,0,0,0,0,0,24,7,17,0,0,0
110,公立,一般大學,0020,國立東華大學,學士班(日間),日本,其他亞洲地區,6,1,5,5,1,4,1,0,1,0,0,0,0,0,0
110,公立,一般大學,0020,國立東華大學,學士班(日間),甘比亞共和國,非洲,1,1,0,1,1,0,0,0,0,0,0,0,0,0,0
110,公立,一般大學,0020,國立東華大學,學士班(日間),印度,南亞,1,1,0,1,1,0,0,0,0,0,0,0,0,0,0
110,公立,一般大學,0020,國立東華大學,學士班(日間),吉爾吉斯,其他亞洲地區,26,18,8,26,18,8,0,0,0,0,0,0,0,0,0
110,公立,一般大學,0020,國立東華大學,學士班(日間),吐瓦魯,其他亞洲地區,1,1,0,1,1,0,0,0,0,0,0,0,0,0,0
110,公立,一般大學,0020,國立東華大學,學士班(日間),帛琉共和國,其他亞洲地區,1,0,1,1,0,1,0,0,0,0,0,0,0,0,0
110,公立,一般大學,0020,國立東華大學,學士班(日間),查德共和國,非洲,1,1,0,1,1,0,0,0,0,0,0,0,0,0,0
110,公立,一般大學,0020,國立東華大學,學士班(日間),美國,北美洲,4,4,0,2,2,0,2,2,0,0,0,0,0,0,0
110,公立,一般大學,0020,國立東華大學,學士班(日間),烏克蘭,其他亞洲地區,2,2,0,2,2,0,0,0,0,0,0,0,0,0,0
110,公立,一般大學,0020,國立東華大學,學士班(日間),馬拉威共和國,非洲,1,0,1,1,0,1,0,0,0,0,0,0,0,0,0
110,公立,一般大學,0020,國立東華大學,學士班(日間),菲律賓共和國,東協,1,1,0,0,0,0,1,1,0,0,0,0,0,0,0
110,公立,一般大學,0020,國立東華大學,學士班(日間),聖克里斯多福及尼維斯,中南美洲,9,6,3,9,6,3,0,0,0,0,0,0,0,0,0
110,公立,一般大學,0020,國立東華大學,學士班(日間),聖露西亞,中南美洲,3,1,2,3,1,2,0,0,0,0,0,0,0,0,0
110,公立,一般大學,0020,國立東華大學,學士班(日間),蒙古國,其他亞洲地區,13,5,8,13,5,8,0,0,0,0,0,0,0,0,0
110,公立,一般大學,0020,國立東華大學,學士班(日間),諾魯共和國,其他亞洲地區,1,0,1,1,0,1,0,0,0,0,0,0,0,0,0
110,公立,一般大學,0020,國立東華大學,學士班(日間),薩爾瓦多,中南美洲,1,1,0,0,0,0,1,1,0,0,0,0,0,0,0
110,公立,一般大學,0020,國立東華大學,碩士班(日間),不丹王國,南亞,1,0,1,1,0,1,0,0,0,0,0,0,0,0,0
110,公立,一般大學,0020,國立東華大學,碩士班(日間),史瓦帝尼王國,非洲,3,1,2,3,1,2,0,0,0,0,0,0,0,0,0
110,公立,一般大學,0020,國立東華大學,碩士班(日間),吉爾吉斯,其他亞洲地區,1,0,1,1,0,1,0,0,0,0,0,0,0,0,0
110,公立,一般大學,0020,國立東華大學,碩士班(日間),俄羅斯聯邦,其他亞洲地區,4,1,3,4,1,3,0,0,0,0,0,0,0,0,0
110,公立,一般大學,0020,國立東華大學,碩士班(日間),美國,北美洲,6,5,1,6,5,1,0,0,0,0,0,0,0,0,0
110,公立,一般大學,0020,國立東華大學,碩士班(日間),泰國,東協,15,10,5,15,10,5,0,0,0,0,0,0,0,0,0
110,公立,一般大學,0020,國立東華大學,碩士班(日間),索馬利蘭共和國,非洲,3,2,1,3,2,1,0,0,0,0,0,0,0,0,0
110,公立,一般大學,0020,國立東華大學,碩士班(日間),索羅門群島,其他亞洲地區,1,1,0,1,1,0,0,0,0,0,0,0,0,0,0
110,公立,一般大學,0020,國立東華大學,碩士班(日間),馬拉威共和國,非洲,7,5,2,7,5,2,0,0,0,0,0,0,0,0,0
110,公立,一般大學,0020,國立東華大學,碩士班(日間),斯里蘭卡民主社會主義共和國,南亞,2,0,2,2,0,2,0,0,0,0,0,0,0,0,0
110,公立,一般大學,0020,國立東華大學,碩士班(日間),斯洛伐克共和國,歐洲,1,0,1,1,0,1,0,0,0,0,0,0,0,0,0
110,公立,一般大學,0020,國立東華大學,碩士班(日間),菲律賓共和國,東協,2,1,1,2,1,1,0,0,0,0,0,0,0,0,0
110,公立,一般大學,0020,國立東華大學,碩士班(日間),新加坡共和國,東協,2,1,1,1,0,1,1,1,0,0,0,0,0,0,0
110,公立,一般大學,0020,國立東華大學,碩士班(日間),聖克里斯多福及尼維斯,中南美洲,2,1,1,2,1,1,0,0,0,0,0,0,0,0,0
110,公立,一般大學,0020,國立東華大學,碩士班(日間),聖露西亞,中南美洲,1,0,1,1,0,1,0,0,0,0,0,0,0,0,0
110,公立,一般大學,0020,國立東華大學,碩士班(日間),蒙古國,其他亞洲地區,13,5,8,13,5,8,0,0,0,0,0,0,0,0,0
110,公立,一般大學,0020,國立東華大學,碩士班(日間),土耳其共和國,其他亞洲地區,1,1,0,1,1,0,0,0,0,0,0,0,0,0,0
110,公立,一般大學,0020,國立東華大學,碩士班(日間),土庫曼,其他亞洲地區,1,1,0,1,1,0,0,0,0,0,0,0,0,0,0
110,公立,一般大學,0020,國立東華大學,碩士班(日間),大陸地區,大陸地區,3,2,1,0,0,0,0,0,0,0,0,0,3,2,1
110,公立,一般大學,0020,國立東華大學,碩士班(日間),白俄羅斯共和國,其他亞洲地區,1,0,1,1,0,1,0,0,0,0,0,0,0,0,0
110,公立,一般大學,0020,國立東華大學,碩士班(日間),印度,南亞,6,5,1,6,5,1,0,0,0,0,0,0,0,0,0
110,公立,一般大學,0020,國立東華大學,碩士班(日間),印度尼西亞共和國,東協,29,16,13,28,15,13,1,1,0,0,0,0,0,0,0
110,公立,一般大學,0020,國立東華大學,碩士班(日間),貝里斯,中南美洲,3,1,2,3,1,2,0,0,0,0,0,0,0,0,0
110,公立,一般大學,0020,國立東華大學,碩士班(日間),法國,歐洲,1,0,1,1,0,1,0,0,0,0,0,0,0,0,0
110,公立,一般大學,0020,國立東華大學,碩士班(日間),香港,港澳,15,10,5,0,0,0,0,0,0,15,10,5,0,0,0
110,公立,一般大學,0020,國立東華大學,碩士班(日間),秘魯共和國,中南美洲,1,1,0,1,1,0,0,0,0,0,0,0,0,0,0
110,公立,一般大學,0020,國立東華大學,碩士班(日間),馬來西亞,東協,34,16,18,8,4,4,26,12,14,0,0,0,0,0,0
110,公立,一般大學,0020,國立東華大學,碩士班(日間),荷蘭王國,歐洲,1,0,1,1,0,1,0,0,0,0,0,0,0,0,0
110,公立,一般大學,0020,國立東華大學,碩士班(日間),越南社會主義共和國,東協,22,4,18,22,4,18,0,0,0,0,0,0,0,0,0
110,公立,一般大學,0020,國立東華大學,碩士班(日間),緬甸,東協,1,1,0,0,0,0,1,1,0,0,0,0,0,0,0
110,公立,一般大學,0020,國立東華大學,碩士班(日間),墨西哥合眾國,中南美洲,1,1,0,1,1,0,0,0,0,0,0,0,0,0,0
110,公立,一般大學,0020,國立東華大學,碩士班(日間),澳門,港澳,4,2,2,0,0,0,0,0,0,4,2,2,0,0,0
110,公立,一般大學,0020,國立東華大學,博士班,土耳其共和國,其他亞洲地區,1,1,0,1,1,0,0,0,0,0,0,0,0,0,0
110,公立,一般大學,0020,國立東華大學,博士班,大陸地區,大陸地區,7,1,6,0,0,0,0,0,0,0,0,0,7,1,6
110,公立,一般大學,0020,國立東華大學,博士班,史瓦帝尼王國,非洲,1,1,0,1,1,0,0,0,0,0,0,0,0,0,0
110,公立,一般大學,0020,國立東華大學,博士班,尼泊爾聯邦民主共和國,南亞,1,1,0,1,1,0,0,0,0,0,0,0,0,0,0
110,公立,一般大學,0020,國立東華大學,博士班,印度,南亞,27,21,6,27,21,6,0,0,0,0,0,0,0,0,0
110,公立,一般大學,0020,國立東華大學,博士班,法國,歐洲,2,1,1,2,1,1,0,0,0,0,0,0,0,0,0
110,公立,一般大學,0020,國立東華大學,博士班,美國,北美洲,2,2,0,2,2,0,0,0,0,0,0,0,0,0,0
110,公立,一般大學,0020,國立東華大學,博士班,越南社會主義共和國,東協,16,7,9,16,7,9,0,0,0,0,0,0,0,0,0
110,公立,一般大學,0020,國立東華大學,博士班,聖露西亞,中南美洲,1,0,1,1,0,1,0,0,0,0,0,0,0,0,0
110,公立,一般大學,0020,國立東華大學,博士班,蒙古國,其他亞洲地區,2,2,0,2,2,0,0,0,0,0,0,0,0,0,0
110,公立,一般大學,0020,國立東華大學,博士班,加拿大,北美洲,2,0,2,2,0,2,0,0,0,0,0,0,0,0,0
110,公立,一般大學,0020,國立東華大學,博士班,印度尼西亞共和國,東協,44,25,19,44,25,19,0,0,0,0,0,0,0,0,0
110,公立,一般大學,0020,國立東華大學,博士班,西班牙王國,歐洲,1,1,0,1,1,0,0,0,0,0,0,0,0,0,0
110,公立,一般大學,0020,國立東華大學,博士班,俄羅斯聯邦,其他亞洲地區,2,1,1,2,1,1,0,0,0,0,0,0,0,0,0
110,公立,一般大學,0020,國立東華大學,博士班,英國,歐洲,2,2,0,2,2,0,0,0,0,0,0,0,0,0,0
110,公立,一般大學,0020,國立東華大學,博士班,泰國,東協,13,4,9,13,4,9,0,0,0,0,0,0,0,0,0
110,公立,一般大學,0020,國立東華大學,博士班,秘魯共和國,中南美洲,1,1,0,1,1,0,0,0,0,0,0,0,0,0,0
110,公立,一般大學,0020,國立東華大學,博士班,馬來西亞,東協,1,1,0,0,0,0,1,1,0,0,0,0,0,0,0
110,公立,一般大學,0020,國立東華大學,博士班,馬拉威共和國,非洲,7,7,0,7,7,0,0,0,0,0,0,0,0,0,0
110,公立,一般大學,0020,國立東華大學,博士班,荷蘭王國,歐洲,1,1,0,1,1,0,0,0,0,0,0,0,0,0,0
110,公立,一般大學,0020,國立東華大學,博士班,菲律賓共和國,東協,4,3,1,4,3,1,0,0,0,0,0,0,0,0,0
110,公立,一般大學,0020,國立東華大學,博士班,薩爾瓦多,中南美洲,1,1,0,1,1,0,0,0,0,0,0,0,0,0,0
110,公立,一般大學,0021,國立暨南國際大學,學士班(日間),日本,其他亞洲地區,2,0,2,1,0,1,1,0,1,0,0,0,0,0,0
110,公立,一般大學,0021,國立暨南國際大學,學士班(日間),瓜地馬拉共和國,中南美洲,1,0,1,0,0,0,1,0,1,0,0,0,0,0,0
110,公立,一般大學,0021,國立暨南國際大學,學士班(日間),印度尼西亞共和國,東協,81,39,42,0,0,0,81,39,42,0,0,0,0,0,0
110,公立,一般大學,0021,國立暨南國際大學,學士班(日間),柬埔寨王國,東協,1,1,0,0,0,0,1,1,0,0,0,0,0,0,0
110,公立,一般大學,0021,國立暨南國際大學,學士班(日間),香港,港澳,132,81,51,0,0,0,0,0,0,132,81,51,0,0,0
110,公立,一般大學,0021,國立暨南國際大學,學士班(日間),馬來西亞,東協,168,78,90,3,1,2,165,77,88,0,0,0,0,0,0
110,公立,一般大學,0021,國立暨南國際大學,學士班(日間),越南社會主義共和國,東協,9,4,5,1,0,1,8,4,4,0,0,0,0,0,0
110,公立,一般大學,0021,國立暨南國際大學,學士班(日間),緬甸,東協,8,4,4,0,0,0,8,4,4,0,0,0,0,0,0
110,公立,一般大學,0021,國立暨南國際大學,學士班(日間),澳門,港澳,33,19,14,0,0,0,0,0,0,33,19,14,0,0,0
110,公立,一般大學,0021,國立暨南國際大學,學士班(日間),巴西聯邦共和國,中南美洲,1,0,1,0,0,0,1,0,1,0,0,0,0,0,0
110,公立,一般大學,0021,國立暨南國際大學,學士班(日間),約旦哈什米王國,其他亞洲地區,1,0,1,0,0,0,1,0,1,0,0,0,0,0,0
110,公立,一般大學,0021,國立暨南國際大學,學士班(日間),泰國,東協,4,0,4,0,0,0,4,0,4,0,0,0,0,0,0
110,公立,一般大學,0021,國立暨南國際大學,碩士班(日間),俄羅斯聯邦,其他亞洲地區,1,0,1,1,0,1,0,0,0,0,0,0,0,0,0
110,公立,一般大學,0021,國立暨南國際大學,碩士班(日間),菲律賓共和國,東協,1,0,1,1,0,1,0,0,0,0,0,0,0,0,0
110,公立,一般大學,0021,國立暨南國際大學,碩士班(日間),越南社會主義共和國,東協,8,3,5,8,3,5,0,0,0,0,0,0,0,0,0
110,公立,一般大學,0021,國立暨南國際大學,碩士班(日間),大陸地區,大陸地區,1,0,1,0,0,0,0,0,0,0,0,0,1,0,1
110,公立,一般大學,0021,國立暨南國際大學,碩士班(日間),大韓民國(南韓),其他亞洲地區,1,0,1,1,0,1,0,0,0,0,0,0,0,0,0
110,公立,一般大學,0021,國立暨南國際大學,碩士班(日間),日本,其他亞洲地區,1,1,0,1,1,0,0,0,0,0,0,0,0,0,0
110,公立,一般大學,0021,國立暨南國際大學,碩士班(日間),尼泊爾聯邦民主共和國,南亞,1,0,1,1,0,1,0,0,0,0,0,0,0,0,0
110,公立,一般大學,0021,國立暨南國際大學,碩士班(日間),印度,南亞,1,0,1,1,0,1,0,0,0,0,0,0,0,0,0
110,公立,一般大學,0021,國立暨南國際大學,碩士班(日間),印度尼西亞共和國,東協,2,2,0,1,1,0,1,1,0,0,0,0,0,0,0
110,公立,一般大學,0021,國立暨南國際大學,碩士班(日間),香港,港澳,24,15,9,0,0,0,0,0,0,24,15,9,0,0,0
110,公立,一般大學,0021,國立暨南國際大學,碩士班(日間),烏克蘭,其他亞洲地區,1,1,0,1,1,0,0,0,0,0,0,0,0,0,0
110,公立,一般大學,0021,國立暨南國際大學,碩士班(日間),馬來西亞,東協,28,17,11,3,1,2,25,16,9,0,0,0,0,0,0
110,公立,一般大學,0021,國立暨南國際大學,碩士班(日間),蒙古國,其他亞洲地區,3,0,3,3,0,3,0,0,0,0,0,0,0,0,0
110,公立,一般大學,0021,國立暨南國際大學,碩士班(日間),緬甸,東協,21,6,15,20,6,14,1,0,1,0,0,0,0,0,0
110,公立,一般大學,0021,國立暨南國際大學,碩士班(日間),澳門,港澳,5,3,2,0,0,0,0,0,0,5,3,2,0,0,0
110,公立,一般大學,0021,國立暨南國際大學,博士班,印度,南亞,1,1,0,1,1,0,0,0,0,0,0,0,0,0,0
110,公立,一般大學,0021,國立暨南國際大學,博士班,美國,北美洲,1,1,0,1,1,0,0,0,0,0,0,0,0,0,0
110,公立,一般大學,0021,國立暨南國際大學,博士班,香港,港澳,2,1,1,0,0,0,0,0,0,2,1,1,0,0,0
110,公立,一般大學,0021,國立暨南國際大學,博士班,泰國,東協,1,0,1,1,0,1,0,0,0,0,0,0,0,0,0
110,公立,一般大學,0021,國立暨南國際大學,博士班,緬甸,東協,10,2,8,9,2,7,1,0,1,0,0,0,0,0,0
110,公立,一般大學,0021,國立暨南國際大學,博士班,澳門,港澳,1,0,1,0,0,0,0,0,0,1,0,1,0,0,0
110,公立,一般大學,0021,國立暨南國際大學,博士班,大陸地區,大陸地區,9,4,5,0,0,0,0,0,0,0,0,0,9,4,5
110,公立,一般大學,0021,國立暨南國際大學,博士班,大韓民國(南韓),其他亞洲地區,1,0,1,1,0,1,0,0,0,0,0,0,0,0,0
110,公立,一般大學,0021,國立暨南國際大學,博士班,俄羅斯聯邦,其他亞洲地區,2,1,1,2,1,1,0,0,0,0,0,0,0,0,0
110,公立,一般大學,0021,國立暨南國際大學,博士班,馬來西亞,東協,3,3,0,3,3,0,0,0,0,0,0,0,0,0,0
110,公立,一般大學,0021,國立暨南國際大學,博士班,越南社會主義共和國,東協,24,11,13,24,11,13,0,0,0,0,0,0,0,0,0
110,公立,技專校院,0022,國立臺灣科技大學,學士班(日間),大韓民國(南韓),其他亞洲地區,3,2,1,2,1,1,1,1,0,0,0,0,0,0,0
110,公立,技專校院,0022,國立臺灣科技大學,學士班(日間),日本,其他亞洲地區,9,2,7,7,2,5,2,0,2,0,0,0,0,0,0
110,公立,技專校院,0022,國立臺灣科技大學,學士班(日間),西班牙王國,歐洲,1,1,0,1,1,0,0,0,0,0,0,0,0,0,0
110,公立,技專校院,0022,國立臺灣科技大學,學士班(日間),宏都拉斯共和國,中南美洲,5,3,2,5,3,2,0,0,0,0,0,0,0,0,0
110,公立,技專校院,0022,國立臺灣科技大學,學士班(日間),約旦哈什米王國,其他亞洲地區,1,1,0,0,0,0,1,1,0,0,0,0,0,0,0
110,公立,技專校院,0022,國立臺灣科技大學,學士班(日間),美國,北美洲,3,2,1,0,0,0,3,2,1,0,0,0,0,0,0
110,公立,技專校院,0022,國立臺灣科技大學,學士班(日間),海地共和國,中南美洲,2,1,1,2,1,1,0,0,0,0,0,0,0,0,0
110,公立,技專校院,0022,國立臺灣科技大學,學士班(日間),新加坡共和國,東協,2,0,2,0,0,0,2,0,2,0,0,0,0,0,0
110,公立,技專校院,0022,國立臺灣科技大學,學士班(日間),聖文森(及格瑞那丁),中南美洲,2,1,1,2,1,1,0,0,0,0,0,0,0,0,0
110,公立,技專校院,0022,國立臺灣科技大學,學士班(日間),聖露西亞,中南美洲,3,2,1,3,2,1,0,0,0,0,0,0,0,0,0
110,公立,技專校院,0022,國立臺灣科技大學,學士班(日間),蒙古國,其他亞洲地區,2,1,1,2,1,1,0,0,0,0,0,0,0,0,0
110,公立,技專校院,0022,國立臺灣科技大學,學士班(日間),薩爾瓦多,中南美洲,1,0,1,1,0,1,0,0,0,0,0,0,0,0,0
110,公立,技專校院,0022,國立臺灣科技大學,學士班(日間),大陸地區,大陸地區,8,6,2,0,0,0,0,0,0,0,0,0,8,6,2
110,公立,技專校院,0022,國立臺灣科技大學,學士班(日間),巴布亞紐幾內亞獨立國,其他亞洲地區,2,2,0,2,2,0,0,0,0,0,0,0,0,0,0
110,公立,技專校院,0022,國立臺灣科技大學,學士班(日間),巴西聯邦共和國,中南美洲,1,1,0,1,1,0,0,0,0,0,0,0,0,0,0
110,公立,技專校院,0022,國立臺灣科技大學,學士班(日間),巴拉圭,中南美洲,14,7,7,13,6,7,1,1,0,0,0,0,0,0,0
110,公立,技專校院,0022,國立臺灣科技大學,學士班(日間),加拿大,北美洲,1,1,0,0,0,0,1,1,0,0,0,0,0,0,0
110,公立,技專校院,0022,國立臺灣科技大學,學士班(日間),尼加拉瓜,中南美洲,4,2,2,4,2,2,0,0,0,0,0,0,0,0,0
110,公立,技專校院,0022,國立臺灣科技大學,學士班(日間),瓜地馬拉共和國,中南美洲,1,0,1,1,0,1,0,0,0,0,0,0,0,0,0
110,公立,技專校院,0022,國立臺灣科技大學,學士班(日間),印度尼西亞共和國,東協,195,124,71,77,55,22,118,69,49,0,0,0,0,0,0
110,公立,技專校院,0022,國立臺灣科技大學,學士班(日間),阿根廷,中南美洲,3,3,0,0,0,0,3,3,0,0,0,0,0,0,0
110,公立,技專校院,0022,國立臺灣科技大學,學士班(日間),香港,港澳,38,24,14,0,0,0,0,0,0,38,24,14,0,0,0
110,公立,技專校院,0022,國立臺灣科技大學,學士班(日間),泰國,東協,11,6,5,9,4,5,2,2,0,0,0,0,0,0,0
110,公立,技專校院,0022,國立臺灣科技大學,學士班(日間),馬來西亞,東協,81,56,25,2,1,1,79,55,24,0,0,0,0,0,0
110,公立,技專校院,0022,國立臺灣科技大學,學士班(日間),馬紹爾群島共和國,其他亞洲地區,1,1,0,0,0,0,1,1,0,0,0,0,0,0,0
110,公立,技專校院,0022,國立臺灣科技大學,學士班(日間),菲律賓共和國,東協,4,2,2,3,2,1,1,0,1,0,0,0,0,0,0
110,公立,技專校院,0022,國立臺灣科技大學,學士班(日間),越南社會主義共和國,東協,32,21,11,20,15,5,12,6,6,0,0,0,0,0,0
110,公立,技專校院,0022,國立臺灣科技大學,學士班(日間),緬甸,東協,20,9,11,0,0,0,20,9,11,0,0,0,0,0,0
110,公立,技專校院,0022,國立臺灣科技大學,學士班(日間),墨西哥合眾國,中南美洲,1,0,1,1,0,1,0,0,0,0,0,0,0,0,0
110,公立,技專校院,0022,國立臺灣科技大學,學士班(日間),澳門,港澳,24,15,9,0,0,0,0,0,0,24,15,9,0,0,0
110,公立,技專校院,0022,國立臺灣科技大學,碩士班(日間),土耳其共和國,其他亞洲地區,1,1,0,1,1,0,0,0,0,0,0,0,0,0,0
110,公立,技專校院,0022,國立臺灣科技大學,碩士班(日間),大陸地區,大陸地區,45,28,17,0,0,0,0,0,0,0,0,0,45,28,17
110,公立,技專校院,0022,國立臺灣科技大學,碩士班(日間),巴西聯邦共和國,中南美洲,1,0,1,0,0,0,1,0,1,0,0,0,0,0,0
110,公立,技專校院,0022,國立臺灣科技大學,碩士班(日間),巴拉圭,中南美洲,7,7,0,7,7,0,0,0,0,0,0,0,0,0,0
110,公立,技專校院,0022,國立臺灣科技大學,碩士班(日間),加拿大,北美洲,1,1,0,0,0,0,1,1,0,0,0,0,0,0,0
110,公立,技專校院,0022,國立臺灣科技大學,碩士班(日間),史瓦帝尼王國,非洲,1,1,0,1,1,0,0,0,0,0,0,0,0,0,0
110,公立,技專校院,0022,國立臺灣科技大學,碩士班(日間),尼加拉瓜,中南美洲,5,5,0,5,5,0,0,0,0,0,0,0,0,0,0
110,公立,技專校院,0022,國立臺灣科技大學,碩士班(日間),印度尼西亞共和國,東協,213,124,89,208,120,88,5,4,1,0,0,0,0,0,0
110,公立,技專校院,0022,國立臺灣科技大學,碩士班(日間),衣索比亞聯邦民主共和國,非洲,3,3,0,3,3,0,0,0,0,0,0,0,0,0,0
110,公立,技專校院,0022,國立臺灣科技大學,碩士班(日間),宏都拉斯共和國,中南美洲,1,1,0,1,1,0,0,0,0,0,0,0,0,0,0
110,公立,技專校院,0022,國立臺灣科技大學,碩士班(日間),委內瑞拉共和國,中南美洲,1,1,0,1,1,0,0,0,0,0,0,0,0,0,0
110,公立,技專校院,0022,國立臺灣科技大學,碩士班(日間),孟加拉人民共和國,南亞,1,1,0,1,1,0,0,0,0,0,0,0,0,0,0
110,公立,技專校院,0022,國立臺灣科技大學,碩士班(日間),拉脫維亞共和國,歐洲,1,1,0,1,1,0,0,0,0,0,0,0,0,0,0
110,公立,技專校院,0022,國立臺灣科技大學,碩士班(日間),波蘭共和國,歐洲,2,1,1,2,1,1,0,0,0,0,0,0,0,0,0
110,公立,技專校院,0022,國立臺灣科技大學,碩士班(日間),法國,歐洲,3,2,1,3,2,1,0,0,0,0,0,0,0,0,0
110,公立,技專校院,0022,國立臺灣科技大學,碩士班(日間),肯亞共和國,非洲,1,0,1,1,0,1,0,0,0,0,0,0,0,0,0
110,公立,技專校院,0022,國立臺灣科技大學,碩士班(日間),英國,歐洲,1,0,1,1,0,1,0,0,0,0,0,0,0,0,0
110,公立,技專校院,0022,國立臺灣科技大學,碩士班(日間),香港,港澳,6,5,1,0,0,0,0,0,0,6,5,1,0,0,0
110,公立,技專校院,0022,國立臺灣科技大學,碩士班(日間),哥倫比亞共和國,中南美洲,1,1,0,1,1,0,0,0,0,0,0,0,0,0,0
110,公立,技專校院,0022,國立臺灣科技大學,碩士班(日間),埃及阿拉伯共和國,非洲,2,1,1,2,1,1,0,0,0,0,0,0,0,0,0
110,公立,技專校院,0022,國立臺灣科技大學,碩士班(日間),泰國,東協,32,4,28,32,4,28,0,0,0,0,0,0,0,0,0
110,公立,技專校院,0022,國立臺灣科技大學,碩士班(日間),烏干達共和國,非洲,1,1,0,1,1,0,0,0,0,0,0,0,0,0,0
110,公立,技專校院,0022,國立臺灣科技大學,碩士班(日間),馬來西亞,東協,20,16,4,5,5,0,15,11,4,0,0,0,0,0,0
110,公立,技專校院,0022,國立臺灣科技大學,碩士班(日間),智利,中南美洲,3,1,2,2,0,2,1,1,0,0,0,0,0,0,0
110,公立,技專校院,0022,國立臺灣科技大學,碩士班(日間),越南社會主義共和國,東協,69,32,37,69,32,37,0,0,0,0,0,0,0,0,0
110,公立,技專校院,0022,國立臺灣科技大學,碩士班(日間),緬甸,東協,2,2,0,1,1,0,1,1,0,0,0,0,0,0,0
110,公立,技專校院,0022,國立臺灣科技大學,碩士班(日間),墨西哥合眾國,中南美洲,3,3,0,3,3,0,0,0,0,0,0,0,0,0,0
110,公立,技專校院,0022,國立臺灣科技大學,碩士班(日間),澳門,港澳,2,2,0,0,0,0,0,0,0,2,2,0,0,0,0
110,公立,技專校院,0022,國立臺灣科技大學,碩士班(日間),薩爾瓦多,中南美洲,1,1,0,1,1,0,0,0,0,0,0,0,0,0,0
110,公立,技專校院,0022,國立臺灣科技大學,碩士班(日間),大韓民國(南韓),其他亞洲地區,3,2,1,2,1,1,1,1,0,0,0,0,0,0,0
110,公立,技專校院,0022,國立臺灣科技大學,碩士班(日間),巴拿馬共和國,中南美洲,1,1,0,1,1,0,0,0,0,0,0,0,0,0,0
110,公立,技專校院,0022,國立臺灣科技大學,碩士班(日間),巴基斯坦,南亞,5,5,0,5,5,0,0,0,0,0,0,0,0,0,0
110,公立,技專校院,0022,國立臺灣科技大學,碩士班(日間),日本,其他亞洲地區,5,4,1,5,4,1,0,0,0,0,0,0,0,0,0
110,公立,技專校院,0022,國立臺灣科技大學,碩士班(日間),尼泊爾聯邦民主共和國,南亞,1,1,0,1,1,0,0,0,0,0,0,0,0,0,0
110,公立,技專校院,0022,國立臺灣科技大學,碩士班(日間),印度,南亞,15,11,4,15,11,4,0,0,0,0,0,0,0,0,0
110,公立,技專校院,0022,國立臺灣科技大學,碩士班(日間),西班牙王國,歐洲,1,0,1,1,0,1,0,0,0,0,0,0,0,0,0
110,公立,技專校院,0022,國立臺灣科技大學,碩士班(日間),俄羅斯聯邦,其他亞洲地區,8,2,6,8,2,6,0,0,0,0,0,0,0,0,0
110,公立,技專校院,0022,國立臺灣科技大學,碩士班(日間),美國,北美洲,3,3,0,2,2,0,1,1,0,0,0,0,0,0,0
110,公立,技專校院,0022,國立臺灣科技大學,碩士班(日間),索馬利亞民主共和國,非洲,1,1,0,1,1,0,0,0,0,0,0,0,0,0,0
110,公立,技專校院,0022,國立臺灣科技大學,碩士班(日間),捷克共和國,歐洲,4,4,0,4,4,0,0,0,0,0,0,0,0,0,0
110,公立,技專校院,0022,國立臺灣科技大學,碩士班(日間),斯洛伐克共和國,歐洲,2,2,0,2,2,0,0,0,0,0,0,0,0,0,0
110,公立,技專校院,0022,國立臺灣科技大學,碩士班(日間),菲律賓共和國,東協,14,7,7,14,7,7,0,0,0,0,0,0,0,0,0
110,公立,技專校院,0022,國立臺灣科技大學,碩士班(日間),愛爾蘭共和國,歐洲,1,1,0,1,1,0,0,0,0,0,0,0,0,0,0
110,公立,技專校院,0022,國立臺灣科技大學,碩士班(日間),新加坡共和國,東協,1,1,0,1,1,0,0,0,0,0,0,0,0,0,0
110,公立,技專校院,0022,國立臺灣科技大學,碩士班(日間),義大利共和國,歐洲,1,1,0,1,1,0,0,0,0,0,0,0,0,0,0
110,公立,技專校院,0022,國立臺灣科技大學,碩士班(日間),聖克里斯多福及尼維斯,中南美洲,1,0,1,1,0,1,0,0,0,0,0,0,0,0,0
110,公立,技專校院,0022,國立臺灣科技大學,碩士班(日間),聖露西亞,中南美洲,2,2,0,2,2,0,0,0,0,0,0,0,0,0,0
110,公立,技專校院,0022,國立臺灣科技大學,碩士班(日間),蒙古國,其他亞洲地區,2,0,2,2,0,2,0,0,0,0,0,0,0,0,0
110,公立,技專校院,0022,國立臺灣科技大學,碩士班(日間),德意志聯邦共和國,歐洲,6,6,0,6,6,0,0,0,0,0,0,0,0,0,0
110,公立,技專校院,0022,國立臺灣科技大學,碩士班(日間),澳大利亞,其他亞洲地區,1,1,0,1,1,0,0,0,0,0,0,0,0,0,0
110,公立,技專校院,0022,國立臺灣科技大學,博士班,大陸地區,大陸地區,33,20,13,0,0,0,0,0,0,0,0,0,33,20,13
110,公立,技專校院,0022,國立臺灣科技大學,博士班,巴拿馬共和國,中南美洲,1,1,0,1,1,0,0,0,0,0,0,0,0,0,0
110,公立,技專校院,0022,國立臺灣科技大學,博士班,日本,其他亞洲地區,2,2,0,2,2,0,0,0,0,0,0,0,0,0,0
110,公立,技專校院,0022,國立臺灣科技大學,博士班,伊朗伊斯蘭共和國,其他亞洲地區,4,4,0,4,4,0,0,0,0,0,0,0,0,0,0
110,公立,技專校院,0022,國立臺灣科技大學,博士班,印度尼西亞共和國,東協,144,100,44,144,100,44,0,0,0,0,0,0,0,0,0
110,公立,技專校院,0022,國立臺灣科技大學,博士班,西班牙王國,歐洲,1,1,0,1,1,0,0,0,0,0,0,0,0,0,0
110,公立,技專校院,0022,國立臺灣科技大學,博士班,辛巴威共和國,非洲,1,1,0,1,1,0,0,0,0,0,0,0,0,0,0
110,公立,技專校院,0022,國立臺灣科技大學,博士班,委內瑞拉共和國,中南美洲,1,1,0,1,1,0,0,0,0,0,0,0,0,0,0
110,公立,技專校院,0022,國立臺灣科技大學,博士班,肯亞共和國,非洲,11,10,1,11,10,1,0,0,0,0,0,0,0,0,0
110,公立,技專校院,0022,國立臺灣科技大學,博士班,俄羅斯聯邦,其他亞洲地區,2,0,2,2,0,2,0,0,0,0,0,0,0,0,0
110,公立,技專校院,0022,國立臺灣科技大學,博士班,英國,歐洲,1,1,0,1,1,0,0,0,0,0,0,0,0,0,0
110,公立,技專校院,0022,國立臺灣科技大學,博士班,馬來西亞,東協,3,3,0,1,1,0,2,2,0,0,0,0,0,0,0
110,公立,技專校院,0022,國立臺灣科技大學,博士班,荷蘭王國,歐洲,1,1,0,1,1,0,0,0,0,0,0,0,0,0,0
110,公立,技專校院,0022,國立臺灣科技大學,博士班,菲律賓共和國,東協,9,3,6,9,3,6,0,0,0,0,0,0,0,0,0
110,公立,技專校院,0022,國立臺灣科技大學,博士班,墨西哥合眾國,中南美洲,2,2,0,2,2,0,0,0,0,0,0,0,0,0,0
110,公立,技專校院,0022,國立臺灣科技大學,博士班,土耳其共和國,其他亞洲地區,1,0,1,1,0,1,0,0,0,0,0,0,0,0,0
110,公立,技專校院,0022,國立臺灣科技大學,博士班,巴拉圭,中南美洲,1,0,1,1,0,1,0,0,0,0,0,0,0,0,0
110,公立,技專校院,0022,國立臺灣科技大學,博士班,巴基斯坦,南亞,9,8,1,9,8,1,0,0,0,0,0,0,0,0,0
110,公立,技專校院,0022,國立臺灣科技大學,博士班,史瓦帝尼王國,非洲,1,1,0,1,1,0,0,0,0,0,0,0,0,0,0
110,公立,技專校院,0022,國立臺灣科技大學,博士班,甘比亞共和國,非洲,2,2,0,2,2,0,0,0,0,0,0,0,0,0,0
110,公立,技專校院,0022,國立臺灣科技大學,博士班,印度,南亞,63,46,17,63,46,17,0,0,0,0,0,0,0,0,0
110,公立,技專校院,0022,國立臺灣科技大學,博士班,衣索比亞聯邦民主共和國,非洲,96,92,4,96,92,4,0,0,0,0,0,0,0,0,0
110,公立,技專校院,0022,國立臺灣科技大學,博士班,貝里斯,中南美洲,2,1,1,2,1,1,0,0,0,0,0,0,0,0,0
110,公立,技專校院,0022,國立臺灣科技大學,博士班,孟加拉人民共和國,南亞,1,1,0,1,1,0,0,0,0,0,0,0,0,0,0
110,公立,技專校院,0022,國立臺灣科技大學,博士班,美國,北美洲,1,0,1,1,0,1,0,0,0,0,0,0,0,0,0
110,公立,技專校院,0022,國立臺灣科技大學,博士班,泰國,東協,14,9,5,14,9,5,0,0,0,0,0,0,0,0,0
110,公立,技專校院,0022,國立臺灣科技大學,博士班,海地共和國,中南美洲,1,1,0,1,1,0,0,0,0,0,0,0,0,0,0
110,公立,技專校院,0022,國立臺灣科技大學,博士班,捷克共和國,歐洲,1,1,0,1,1,0,0,0,0,0,0,0,0,0,0
110,公立,技專校院,0022,國立臺灣科技大學,博士班,越南社會主義共和國,東協,49,29,20,49,29,20,0,0,0,0,0,0,0,0,0
110,公立,技專校院,0022,國立臺灣科技大學,博士班,義大利共和國,歐洲,1,1,0,1,1,0,0,0,0,0,0,0,0,0,0
110,公立,技專校院,0022,國立臺灣科技大學,博士班,聖克里斯多福及尼維斯,中南美洲,1,0,1,1,0,1,0,0,0,0,0,0,0,0,0
110,公立,技專校院,0022,國立臺灣科技大學,博士班,聖露西亞,中南美洲,1,0,1,1,0,1,0,0,0,0,0,0,0,0,0
110,公立,技專校院,0022,國立臺灣科技大學,博士班,葡萄牙共和國,歐洲,1,0,1,1,0,1,0,0,0,0,0,0,0,0,0
110,公立,技專校院,0022,國立臺灣科技大學,博士班,蒙古國,其他亞洲地區,2,0,2,2,0,2,0,0,0,0,0,0,0,0,0
110,公立,技專校院,0022,國立臺灣科技大學,博士班,德意志聯邦共和國,歐洲,1,1,0,1,1,0,0,0,0,0,0,0,0,0,0
110,公立,技專校院,0022,國立臺灣科技大學,博士班,澳大利亞,其他亞洲地區,1,1,0,1,1,0,0,0,0,0,0,0,0,0,0
110,公立,技專校院,0023,國立雲林科技大學,學士班(日間),美國,北美洲,2,1,1,0,0,0,2,1,1,0,0,0,0,0,0
110,公立,技專校院,0023,國立雲林科技大學,學士班(日間),香港,港澳,54,28,26,0,0,0,0,0,0,54,28,26,0,0,0
110,公立,技專校院,0023,國立雲林科技大學,學士班(日間),越南社會主義共和國,東協,15,8,7,5,1,4,10,7,3,0,0,0,0,0,0
110,公立,技專校院,0023,國立雲林科技大學,學士班(日間),緬甸,東協,3,1,2,0,0,0,3,1,2,0,0,0,0,0,0
110,公立,技專校院,0023,國立雲林科技大學,學士班(日間),澳門,港澳,10,2,8,0,0,0,0,0,0,10,2,8,0,0,0
110,公立,技專校院,0023,國立雲林科技大學,學士班(日間),大陸地區,大陸地區,13,6,7,0,0,0,0,0,0,0,0,0,13,6,7
110,公立,技專校院,0023,國立雲林科技大學,學士班(日間),日本,其他亞洲地區,8,6,2,8,6,2,0,0,0,0,0,0,0,0,0
110,公立,技專校院,0023,國立雲林科技大學,學士班(日間),印度尼西亞共和國,東協,46,23,23,7,1,6,39,22,17,0,0,0,0,0,0
110,公立,技專校院,0023,國立雲林科技大學,學士班(日間),馬來西亞,東協,112,65,47,9,5,4,103,60,43,0,0,0,0,0,0
110,公立,技專校院,0023,國立雲林科技大學,碩士班(日間),大陸地區,大陸地區,20,14,6,0,0,0,0,0,0,0,0,0,20,14,6
110,公立,技專校院,0023,國立雲林科技大學,碩士班(日間),伊朗伊斯蘭共和國,其他亞洲地區,2,1,1,2,1,1,0,0,0,0,0,0,0,0,0
110,公立,技專校院,0023,國立雲林科技大學,碩士班(日間),印度尼西亞共和國,東協,37,16,21,36,15,21,1,1,0,0,0,0,0,0,0
110,公立,技專校院,0023,國立雲林科技大學,碩士班(日間),烏干達共和國,非洲,1,0,1,1,0,1,0,0,0,0,0,0,0,0,0
110,公立,技專校院,0023,國立雲林科技大學,碩士班(日間),馬來西亞,東協,12,5,7,8,3,5,4,2,2,0,0,0,0,0,0
110,公立,技專校院,0023,國立雲林科技大學,碩士班(日間),菲律賓共和國,東協,1,0,1,1,0,1,0,0,0,0,0,0,0,0,0
110,公立,技專校院,0023,國立雲林科技大學,碩士班(日間),新加坡共和國,東協,1,0,1,1,0,1,0,0,0,0,0,0,0,0,0
110,公立,技專校院,0023,國立雲林科技大學,碩士班(日間),印度,南亞,4,3,1,4,3,1,0,0,0,0,0,0,0,0,0
110,公立,技專校院,0023,國立雲林科技大學,碩士班(日間),香港,港澳,4,1,3,0,0,0,0,0,0,4,1,3,0,0,0
110,公立,技專校院,0023,國立雲林科技大學,碩士班(日間),泰國,東協,7,1,6,7,1,6,0,0,0,0,0,0,0,0,0
110,公立,技專校院,0023,國立雲林科技大學,碩士班(日間),越南社會主義共和國,東協,6,1,5,6,1,5,0,0,0,0,0,0,0,0,0
110,公立,技專校院,0023,國立雲林科技大學,博士班,巴基斯坦,南亞,5,5,0,5,5,0,0,0,0,0,0,0,0,0,0
110,公立,技專校院,0023,國立雲林科技大學,博士班,約旦哈什米王國,其他亞洲地區,1,1,0,1,1,0,0,0,0,0,0,0,0,0,0
110,公立,技專校院,0023,國立雲林科技大學,博士班,泰國,東協,2,1,1,2,1,1,0,0,0,0,0,0,0,0,0
110,公立,技專校院,0023,國立雲林科技大學,博士班,馬來西亞,東協,2,2,0,2,2,0,0,0,0,0,0,0,0,0,0
110,公立,技專校院,0023,國立雲林科技大學,博士班,德意志聯邦共和國,歐洲,1,0,1,1,0,1,0,0,0,0,0,0,0,0,0
110,公立,技專校院,0023,國立雲林科技大學,博士班,大陸地區,大陸地區,23,11,12,0,0,0,0,0,0,0,0,0,23,11,12
110,公立,技專校院,0023,國立雲林科技大學,博士班,伊朗伊斯蘭共和國,其他亞洲地區,1,1,0,1,1,0,0,0,0,0,0,0,0,0,0
110,公立,技專校院,0023,國立雲林科技大學,博士班,印度尼西亞共和國,東協,38,14,24,38,14,24,0,0,0,0,0,0,0,0,0
110,公立,技專校院,0023,國立雲林科技大學,博士班,孟加拉人民共和國,南亞,1,1,0,1,1,0,0,0,0,0,0,0,0,0,0
110,公立,技專校院,0023,國立雲林科技大學,博士班,烏干達共和國,非洲,1,1,0,1,1,0,0,0,0,0,0,0,0,0,0
110,公立,技專校院,0023,國立雲林科技大學,博士班,越南社會主義共和國,東協,6,2,4,6,2,4,0,0,0,0,0,0,0,0,0
110,公立,技專校院,0024,國立屏東科技大學,學士班(日間),史瓦帝尼王國,非洲,3,2,1,3,2,1,0,0,0,0,0,0,0,0,0
110,公立,技專校院,0024,國立屏東科技大學,學士班(日間),甘比亞共和國,非洲,2,1,1,2,1,1,0,0,0,0,0,0,0,0,0
110,公立,技專校院,0024,國立屏東科技大學,學士班(日間),汶萊和平之國,東協,2,1,1,1,0,1,1,1,0,0,0,0,0,0,0
110,公立,技專校院,0024,國立屏東科技大學,學士班(日間),帛琉共和國,其他亞洲地區,3,0,3,3,0,3,0,0,0,0,0,0,0,0,0
110,公立,技專校院,0024,國立屏東科技大學,學士班(日間),美國,北美洲,1,0,1,0,0,0,1,0,1,0,0,0,0,0,0
110,公立,技專校院,0024,國立屏東科技大學,學士班(日間),泰國,東協,1,1,0,1,1,0,0,0,0,0,0,0,0,0,0
110,公立,技專校院,0024,國立屏東科技大學,學士班(日間),海地共和國,中南美洲,3,2,1,3,2,1,0,0,0,0,0,0,0,0,0
110,公立,技專校院,0024,國立屏東科技大學,學士班(日間),馬拉威共和國,非洲,1,1,0,1,1,0,0,0,0,0,0,0,0,0,0
110,公立,技專校院,0024,國立屏東科技大學,學士班(日間),馬紹爾群島共和國,其他亞洲地區,1,1,0,1,1,0,0,0,0,0,0,0,0,0,0
110,公立,技專校院,0024,國立屏東科技大學,學士班(日間),新加坡共和國,東協,2,0,2,2,0,2,0,0,0,0,0,0,0,0,0
110,公立,技專校院,0024,國立屏東科技大學,學士班(日間),聖克里斯多福及尼維斯,中南美洲,2,2,0,2,2,0,0,0,0,0,0,0,0,0,0
110,公立,技專校院,0024,國立屏東科技大學,學士班(日間),聖露西亞,中南美洲,4,2,2,4,2,2,0,0,0,0,0,0,0,0,0
110,公立,技專校院,0024,國立屏東科技大學,學士班(日間),蒙古國,其他亞洲地區,1,0,1,1,0,1,0,0,0,0,0,0,0,0,0
110,公立,技專校院,0024,國立屏東科技大學,學士班(日間),大韓民國(南韓),其他亞洲地區,2,2,0,0,0,0,2,2,0,0,0,0,0,0,0
110,公立,技專校院,0024,國立屏東科技大學,學士班(日間),巴布亞紐幾內亞獨立國,其他亞洲地區,1,0,1,1,0,1,0,0,0,0,0,0,0,0,0
110,公立,技專校院,0024,國立屏東科技大學,學士班(日間),日本,其他亞洲地區,2,0,2,1,0,1,1,0,1,0,0,0,0,0,0
110,公立,技專校院,0024,國立屏東科技大學,學士班(日間),瓜地馬拉共和國,中南美洲,1,1,0,1,1,0,0,0,0,0,0,0,0,0,0
110,公立,技專校院,0024,國立屏東科技大學,學士班(日間),印度,南亞,1,1,0,1,1,0,0,0,0,0,0,0,0,0,0
110,公立,技專校院,0024,國立屏東科技大學,學士班(日間),印度尼西亞共和國,東協,15,6,9,3,3,0,12,3,9,0,0,0,0,0,0
110,公立,技專校院,0024,國立屏東科技大學,學士班(日間),宏都拉斯共和國,中南美洲,6,3,3,6,3,3,0,0,0,0,0,0,0,0,0
110,公立,技專校院,0024,國立屏東科技大學,學士班(日間),貝里斯,中南美洲,10,4,6,10,4,6,0,0,0,0,0,0,0,0,0
110,公立,技專校院,0024,國立屏東科技大學,學士班(日間),委內瑞拉共和國,中南美洲,1,1,0,1,1,0,0,0,0,0,0,0,0,0,0
110,公立,技專校院,0024,國立屏東科技大學,學士班(日間),英國,歐洲,1,1,0,1,1,0,0,0,0,0,0,0,0,0,0
110,公立,技專校院,0024,國立屏東科技大學,學士班(日間),香港,港澳,32,20,12,0,0,0,0,0,0,32,20,12,0,0,0
110,公立,技專校院,0024,國立屏東科技大學,學士班(日間),馬來西亞,東協,135,81,54,19,16,3,116,65,51,0,0,0,0,0,0
110,公立,技專校院,0024,國立屏東科技大學,學士班(日間),越南社會主義共和國,東協,4,2,2,3,1,2,1,1,0,0,0,0,0,0,0
110,公立,技專校院,0024,國立屏東科技大學,學士班(日間),聖文森(及格瑞那丁),中南美洲,1,0,1,1,0,1,0,0,0,0,0,0,0,0,0
110,公立,技專校院,0024,國立屏東科技大學,學士班(日間),緬甸,東協,4,2,2,0,0,0,4,2,2,0,0,0,0,0,0
110,公立,技專校院,0024,國立屏東科技大學,學士班(日間),澳門,港澳,17,6,11,0,0,0,0,0,0,17,6,11,0,0,0
110,公立,技專校院,0024,國立屏東科技大學,碩士班(日間),巴布亞紐幾內亞獨立國,其他亞洲地區,2,2,0,2,2,0,0,0,0,0,0,0,0,0,0
110,公立,技專校院,0024,國立屏東科技大學,碩士班(日間),日本,其他亞洲地區,1,0,1,1,0,1,0,0,0,0,0,0,0,0,0
110,公立,技專校院,0024,國立屏東科技大學,碩士班(日間),印度,南亞,4,3,1,4,3,1,0,0,0,0,0,0,0,0,0
110,公立,技專校院,0024,國立屏東科技大學,碩士班(日間),印度尼西亞共和國,東協,25,10,15,24,9,15,1,1,0,0,0,0,0,0,0
110,公立,技專校院,0024,國立屏東科技大學,碩士班(日間),宏都拉斯共和國,中南美洲,1,0,1,1,0,1,0,0,0,0,0,0,0,0,0
110,公立,技專校院,0024,國立屏東科技大學,碩士班(日間),貝里斯,中南美洲,5,3,2,5,3,2,0,0,0,0,0,0,0,0,0
110,公立,技專校院,0024,國立屏東科技大學,碩士班(日間),香港,港澳,12,6,6,0,0,0,0,0,0,12,6,6,0,0,0
110,公立,技專校院,0024,國立屏東科技大學,碩士班(日間),馬來西亞,東協,22,12,10,8,5,3,14,7,7,0,0,0,0,0,0
110,公立,技專校院,0024,國立屏東科技大學,碩士班(日間),斐濟群島共和國,其他亞洲地區,1,0,1,1,0,1,0,0,0,0,0,0,0,0,0
110,公立,技專校院,0024,國立屏東科技大學,碩士班(日間),菲律賓共和國,東協,1,1,0,1,1,0,0,0,0,0,0,0,0,0,0
110,公立,技專校院,0024,國立屏東科技大學,碩士班(日間),越南社會主義共和國,東協,17,5,12,17,5,12,0,0,0,0,0,0,0,0,0
110,公立,技專校院,0024,國立屏東科技大學,碩士班(日間),聖克里斯多福及尼維斯,中南美洲,2,1,1,2,1,1,0,0,0,0,0,0,0,0,0
110,公立,技專校院,0024,國立屏東科技大學,碩士班(日間),緬甸,東協,1,0,1,0,0,0,1,0,1,0,0,0,0,0,0
110,公立,技專校院,0024,國立屏東科技大學,碩士班(日間),薩爾瓦多,中南美洲,2,1,1,2,1,1,0,0,0,0,0,0,0,0,0
110,公立,技專校院,0024,國立屏東科技大學,碩士班(日間),巴基斯坦,南亞,1,1,0,1,1,0,0,0,0,0,0,0,0,0,0
110,公立,技專校院,0024,國立屏東科技大學,碩士班(日間),史瓦帝尼王國,非洲,2,1,1,2,1,1,0,0,0,0,0,0,0,0,0
110,公立,技專校院,0024,國立屏東科技大學,碩士班(日間),尼加拉瓜,中南美洲,1,1,0,1,1,0,0,0,0,0,0,0,0,0,0
110,公立,技專校院,0024,國立屏東科技大學,碩士班(日間),尼泊爾聯邦民主共和國,南亞,18,8,10,18,8,10,0,0,0,0,0,0,0,0,0
110,公立,技專校院,0024,國立屏東科技大學,碩士班(日間),甘比亞共和國,非洲,1,0,1,1,0,1,0,0,0,0,0,0,0,0,0
110,公立,技專校院,0024,國立屏東科技大學,碩士班(日間),泰國,東協,8,3,5,8,3,5,0,0,0,0,0,0,0,0,0
110,公立,技專校院,0024,國立屏東科技大學,碩士班(日間),海地共和國,中南美洲,3,3,0,3,3,0,0,0,0,0,0,0,0,0,0
110,公立,技專校院,0024,國立屏東科技大學,碩士班(日間),索馬利蘭共和國,非洲,2,2,0,2,2,0,0,0,0,0,0,0,0,0,0
110,公立,技專校院,0024,國立屏東科技大學,碩士班(日間),蒙古國,其他亞洲地區,1,0,1,1,0,1,0,0,0,0,0,0,0,0,0
110,公立,技專校院,0024,國立屏東科技大學,博士班,巴基斯坦,南亞,3,3,0,3,3,0,0,0,0,0,0,0,0,0,0
110,公立,技專校院,0024,國立屏東科技大學,博士班,尼泊爾聯邦民主共和國,南亞,2,1,1,2,1,1,0,0,0,0,0,0,0,0,0
110,公立,技專校院,0024,國立屏東科技大學,博士班,印度尼西亞共和國,東協,31,14,17,31,14,17,0,0,0,0,0,0,0,0,0
110,公立,技專校院,0024,國立屏東科技大學,博士班,英國,歐洲,2,2,0,2,2,0,0,0,0,0,0,0,0,0,0
110,公立,技專校院,0024,國立屏東科技大學,博士班,泰國,東協,22,7,15,22,7,15,0,0,0,0,0,0,0,0,0
110,公立,技專校院,0024,國立屏東科技大學,博士班,馬來西亞,東協,1,1,0,0,0,0,1,1,0,0,0,0,0,0,0
110,公立,技專校院,0024,國立屏東科技大學,博士班,蒙古國,其他亞洲地區,2,0,2,2,0,2,0,0,0,0,0,0,0,0,0
110,公立,技專校院,0024,國立屏東科技大學,博士班,巴布亞紐幾內亞獨立國,其他亞洲地區,1,1,0,1,1,0,0,0,0,0,0,0,0,0,0
110,公立,技專校院,0024,國立屏東科技大學,博士班,史瓦帝尼王國,非洲,4,4,0,4,4,0,0,0,0,0,0,0,0,0,0
110,公立,技專校院,0024,國立屏東科技大學,博士班,甘比亞共和國,非洲,1,1,0,1,1,0,0,0,0,0,0,0,0,0,0
110,公立,技專校院,0024,國立屏東科技大學,博士班,伊朗伊斯蘭共和國,其他亞洲地區,1,0,1,1,0,1,0,0,0,0,0,0,0,0,0
110,公立,技專校院,0024,國立屏東科技大學,博士班,印度,南亞,9,5,4,9,5,4,0,0,0,0,0,0,0,0,0
110,公立,技專校院,0024,國立屏東科技大學,博士班,衣索比亞聯邦民主共和國,非洲,1,1,0,1,1,0,0,0,0,0,0,0,0,0,0
110,公立,技專校院,0024,國立屏東科技大學,博士班,貝里斯,中南美洲,3,2,1,3,2,1,0,0,0,0,0,0,0,0,0
110,公立,技專校院,0024,國立屏東科技大學,博士班,辛巴威共和國,非洲,1,1,0,1,1,0,0,0,0,0,0,0,0,0,0
110,公立,技專校院,0024,國立屏東科技大學,博士班,南非共和國,非洲,1,0,1,1,0,1,0,0,0,0,0,0,0,0,0
110,公立,技專校院,0024,國立屏東科技大學,博士班,香港,港澳,1,1,0,0,0,0,0,0,0,1,1,0,0,0,0
110,公立,技專校院,0024,國立屏東科技大學,博士班,海地共和國,中南美洲,1,0,1,1,0,1,0,0,0,0,0,0,0,0,0
110,公立,技專校院,0024,國立屏東科技大學,博士班,索羅門群島,其他亞洲地區,2,1,1,2,1,1,0,0,0,0,0,0,0,0,0
110,公立,技專校院,0024,國立屏東科技大學,博士班,斐濟群島共和國,其他亞洲地區,1,1,0,1,1,0,0,0,0,0,0,0,0,0,0
110,公立,技專校院,0024,國立屏東科技大學,博士班,越南社會主義共和國,東協,14,7,7,14,7,7,0,0,0,0,0,0,0,0,0
110,公立,技專校院,0024,國立屏東科技大學,博士班,聖文森(及格瑞那丁),中南美洲,1,0,1,1,0,1,0,0,0,0,0,0,0,0,0
110,公立,技專校院,0025,國立臺北科技大學,五專,印度尼西亞共和國,東協,1,1,0,0,0,0,1,1,0,0,0,0,0,0,0
110,公立,技專校院,0025,國立臺北科技大學,五專,泰國,東協,1,1,0,0,0,0,1,1,0,0,0,0,0,0,0
110,公立,技專校院,0025,國立臺北科技大學,學士班(日間),大陸地區,大陸地區,11,9,2,0,0,0,0,0,0,0,0,0,11,9,2
110,公立,技專校院,0025,國立臺北科技大學,學士班(日間),巴拉圭,中南美洲,15,6,9,15,6,9,0,0,0,0,0,0,0,0,0
110,公立,技專校院,0025,國立臺北科技大學,學士班(日間),史瓦帝尼王國,非洲,1,0,1,1,0,1,0,0,0,0,0,0,0,0,0
110,公立,技專校院,0025,國立臺北科技大學,學士班(日間),尼加拉瓜,中南美洲,4,4,0,4,4,0,0,0,0,0,0,0,0,0,0
110,公立,技專校院,0025,國立臺北科技大學,學士班(日間),瓜地馬拉共和國,中南美洲,3,1,2,2,1,1,1,0,1,0,0,0,0,0,0
110,公立,技專校院,0025,國立臺北科技大學,學士班(日間),伊朗伊斯蘭共和國,其他亞洲地區,1,0,1,0,0,0,1,0,1,0,0,0,0,0,0
110,公立,技專校院,0025,國立臺北科技大學,學士班(日間),宏都拉斯共和國,中南美洲,6,4,2,6,4,2,0,0,0,0,0,0,0,0,0
110,公立,技專校院,0025,國立臺北科技大學,學士班(日間),貝里斯,中南美洲,2,0,2,2,0,2,0,0,0,0,0,0,0,0,0
110,公立,技專校院,0025,國立臺北科技大學,學士班(日間),奈及利亞聯邦共和國,非洲,1,1,0,1,1,0,0,0,0,0,0,0,0,0,0
110,公立,技專校院,0025,國立臺北科技大學,學士班(日間),帛琉共和國,其他亞洲地區,2,2,0,2,2,0,0,0,0,0,0,0,0,0,0
110,公立,技專校院,0025,國立臺北科技大學,學士班(日間),阿根廷,中南美洲,1,0,1,0,0,0,1,0,1,0,0,0,0,0,0
110,公立,技專校院,0025,國立臺北科技大學,學士班(日間),美國,北美洲,3,2,1,2,2,0,1,0,1,0,0,0,0,0,0
110,公立,技專校院,0025,國立臺北科技大學,學士班(日間),香港,港澳,108,62,46,0,0,0,0,0,0,108,62,46,0,0,0
110,公立,技專校院,0025,國立臺北科技大學,學士班(日間),海地共和國,中南美洲,2,2,0,2,2,0,0,0,0,0,0,0,0,0,0
110,公立,技專校院,0025,國立臺北科技大學,學士班(日間),馬紹爾群島共和國,其他亞洲地區,4,4,0,4,4,0,0,0,0,0,0,0,0,0,0
110,公立,技專校院,0025,國立臺北科技大學,學士班(日間),越南社會主義共和國,東協,47,18,29,26,7,19,21,11,10,0,0,0,0,0,0
110,公立,技專校院,0025,國立臺北科技大學,學士班(日間),聖克里斯多福及尼維斯,中南美洲,1,0,1,1,0,1,0,0,0,0,0,0,0,0,0
110,公立,技專校院,0025,國立臺北科技大學,學士班(日間),聖露西亞,中南美洲,4,1,3,4,1,3,0,0,0,0,0,0,0,0,0
110,公立,技專校院,0025,國立臺北科技大學,學士班(日間),蒙古國,其他亞洲地區,1,1,0,1,1,0,0,0,0,0,0,0,0,0,0
110,公立,技專校院,0025,國立臺北科技大學,學士班(日間),模里西斯共和國,非洲,1,1,0,1,1,0,0,0,0,0,0,0,0,0,0
110,公立,技專校院,0025,國立臺北科技大學,學士班(日間),緬甸,東協,22,14,8,0,0,0,22,14,8,0,0,0,0,0,0
110,公立,技專校院,0025,國立臺北科技大學,學士班(日間),澳門,港澳,28,20,8,0,0,0,0,0,0,28,20,8,0,0,0
110,公立,技專校院,0025,國立臺北科技大學,學士班(日間),大韓民國(南韓),其他亞洲地區,5,1,4,4,1,3,1,0,1,0,0,0,0,0,0
110,公立,技專校院,0025,國立臺北科技大學,學士班(日間),巴西聯邦共和國,中南美洲,1,0,1,0,0,0,1,0,1,0,0,0,0,0,0
110,公立,技專校院,0025,國立臺北科技大學,學士班(日間),巴拿馬共和國,中南美洲,1,1,0,1,1,0,0,0,0,0,0,0,0,0,0
110,公立,技專校院,0025,國立臺北科技大學,學士班(日間),日本,其他亞洲地區,10,5,5,7,4,3,3,1,2,0,0,0,0,0,0
110,公立,技專校院,0025,國立臺北科技大學,學士班(日間),加拿大,北美洲,3,3,0,1,1,0,2,2,0,0,0,0,0,0,0
110,公立,技專校院,0025,國立臺北科技大學,學士班(日間),印度尼西亞共和國,東協,69,36,33,22,13,9,47,23,24,0,0,0,0,0,0
110,公立,技專校院,0025,國立臺北科技大學,學士班(日間),西班牙王國,歐洲,1,1,0,1,1,0,0,0,0,0,0,0,0,0,0
110,公立,技專校院,0025,國立臺北科技大學,學士班(日間),委內瑞拉共和國,中南美洲,1,0,1,0,0,0,1,0,1,0,0,0,0,0,0
110,公立,技專校院,0025,國立臺北科技大學,學士班(日間),泰國,東協,20,9,11,11,6,5,9,3,6,0,0,0,0,0,0
110,公立,技專校院,0025,國立臺北科技大學,學士班(日間),馬來西亞,東協,108,72,36,23,13,10,85,59,26,0,0,0,0,0,0
110,公立,技專校院,0025,國立臺北科技大學,學士班(日間),菲律賓共和國,東協,3,3,0,2,2,0,1,1,0,0,0,0,0,0,0
110,公立,技專校院,0025,國立臺北科技大學,學士班(日間),新加坡共和國,東協,2,0,2,1,0,1,1,0,1,0,0,0,0,0,0
110,公立,技專校院,0025,國立臺北科技大學,學士班(日間),聖文森(及格瑞那丁),中南美洲,2,2,0,2,2,0,0,0,0,0,0,0,0,0,0
110,公立,技專校院,0025,國立臺北科技大學,碩士班(日間),厄瓜多共和國,中南美洲,1,1,0,1,1,0,0,0,0,0,0,0,0,0,0
110,公立,技專校院,0025,國立臺北科技大學,碩士班(日間),加拿大,北美洲,3,3,0,2,2,0,1,1,0,0,0,0,0,0,0
110,公立,技專校院,0025,國立臺北科技大學,碩士班(日間),布吉納法索,非洲,3,3,0,3,3,0,0,0,0,0,0,0,0,0,0
110,公立,技專校院,0025,國立臺北科技大學,碩士班(日間),伊拉克共和國,其他亞洲地區,1,1,0,1,1,0,0,0,0,0,0,0,0,0,0
110,公立,技專校院,0025,國立臺北科技大學,碩士班(日間),印度尼西亞共和國,東協,30,15,15,30,15,15,0,0,0,0,0,0,0,0,0
110,公立,技專校院,0025,國立臺北科技大學,碩士班(日間),西班牙王國,歐洲,3,2,1,3,2,1,0,0,0,0,0,0,0,0,0
110,公立,技專校院,0025,國立臺北科技大學,碩士班(日間),波蘭共和國,歐洲,1,0,1,1,0,1,0,0,0,0,0,0,0,0,0
110,公立,技專校院,0025,國立臺北科技大學,碩士班(日間),俄羅斯聯邦,其他亞洲地區,2,1,1,2,1,1,0,0,0,0,0,0,0,0,0
110,公立,技專校院,0025,國立臺北科技大學,碩士班(日間),埃及阿拉伯共和國,非洲,1,1,0,1,1,0,0,0,0,0,0,0,0,0,0
110,公立,技專校院,0025,國立臺北科技大學,碩士班(日間),泰國,東協,33,13,20,32,12,20,1,1,0,0,0,0,0,0,0
110,公立,技專校院,0025,國立臺北科技大學,碩士班(日間),秘魯共和國,中南美洲,1,0,1,1,0,1,0,0,0,0,0,0,0,0,0
110,公立,技專校院,0025,國立臺北科技大學,碩士班(日間),索馬利蘭共和國,非洲,4,4,0,4,4,0,0,0,0,0,0,0,0,0,0
110,公立,技專校院,0025,國立臺北科技大學,碩士班(日間),馬來西亞,東協,12,10,2,5,4,1,7,6,1,0,0,0,0,0,0
110,公立,技專校院,0025,國立臺北科技大學,碩士班(日間),馬拉威共和國,非洲,1,1,0,1,1,0,0,0,0,0,0,0,0,0,0
110,公立,技專校院,0025,國立臺北科技大學,碩士班(日間),菲律賓共和國,東協,2,2,0,2,2,0,0,0,0,0,0,0,0,0,0
110,公立,技專校院,0025,國立臺北科技大學,碩士班(日間),奧地利共和國,歐洲,2,2,0,2,2,0,0,0,0,0,0,0,0,0,0
110,公立,技專校院,0025,國立臺北科技大學,碩士班(日間),聖文森(及格瑞那丁),中南美洲,3,2,1,3,2,1,0,0,0,0,0,0,0,0,0
110,公立,技專校院,0025,國立臺北科技大學,碩士班(日間),薩爾瓦多,中南美洲,3,2,1,3,2,1,0,0,0,0,0,0,0,0,0
110,公立,技專校院,0025,國立臺北科技大學,碩士班(日間),土耳其共和國,其他亞洲地區,2,2,0,2,2,0,0,0,0,0,0,0,0,0,0
110,公立,技專校院,0025,國立臺北科技大學,碩士班(日間),大陸地區,大陸地區,41,25,16,0,0,0,0,0,0,0,0,0,41,25,16
110,公立,技專校院,0025,國立臺北科技大學,碩士班(日間),巴拉圭,中南美洲,5,2,3,5,2,3,0,0,0,0,0,0,0,0,0
110,公立,技專校院,0025,國立臺北科技大學,碩士班(日間),巴拿馬共和國,中南美洲,3,1,2,3,1,2,0,0,0,0,0,0,0,0,0
110,公立,技專校院,0025,國立臺北科技大學,碩士班(日間),比利時王國,歐洲,1,0,1,1,0,1,0,0,0,0,0,0,0,0,0
110,公立,技專校院,0025,國立臺北科技大學,碩士班(日間),史瓦帝尼王國,非洲,1,1,0,1,1,0,0,0,0,0,0,0,0,0,0
110,公立,技專校院,0025,國立臺北科技大學,碩士班(日間),尼加拉瓜,中南美洲,3,3,0,3,3,0,0,0,0,0,0,0,0,0,0
110,公立,技專校院,0025,國立臺北科技大學,碩士班(日間),尼泊爾聯邦民主共和國,南亞,1,1,0,1,1,0,0,0,0,0,0,0,0,0,0
110,公立,技專校院,0025,國立臺北科技大學,碩士班(日間),瓜地馬拉共和國,中南美洲,1,1,0,1,1,0,0,0,0,0,0,0,0,0,0
110,公立,技專校院,0025,國立臺北科技大學,碩士班(日間),印度,南亞,38,27,11,38,27,11,0,0,0,0,0,0,0,0,0
110,公立,技專校院,0025,國立臺北科技大學,碩士班(日間),衣索比亞聯邦民主共和國,非洲,2,2,0,2,2,0,0,0,0,0,0,0,0,0,0
110,公立,技專校院,0025,國立臺北科技大學,碩士班(日間),宏都拉斯共和國,中南美洲,4,4,0,4,4,0,0,0,0,0,0,0,0,0,0
110,公立,技專校院,0025,國立臺北科技大學,碩士班(日間),辛巴威共和國,非洲,1,1,0,1,1,0,0,0,0,0,0,0,0,0,0
110,公立,技專校院,0025,國立臺北科技大學,碩士班(日間),坦尚尼亞聯合共和國,非洲,1,1,0,1,1,0,0,0,0,0,0,0,0,0,0
110,公立,技專校院,0025,國立臺北科技大學,碩士班(日間),美國,北美洲,1,1,0,0,0,0,1,1,0,0,0,0,0,0,0
110,公立,技專校院,0025,國立臺北科技大學,碩士班(日間),香港,港澳,8,5,3,0,0,0,0,0,0,8,5,3,0,0,0
110,公立,技專校院,0025,國立臺北科技大學,碩士班(日間),哥倫比亞共和國,中南美洲,3,2,1,3,2,1,0,0,0,0,0,0,0,0,0
110,公立,技專校院,0025,國立臺北科技大學,碩士班(日間),索馬利亞民主共和國,非洲,1,1,0,1,1,0,0,0,0,0,0,0,0,0,0
110,公立,技專校院,0025,國立臺北科技大學,碩士班(日間),捷克共和國,歐洲,1,1,0,1,1,0,0,0,0,0,0,0,0,0,0
110,公立,技專校院,0025,國立臺北科技大學,碩士班(日間),斯洛伐克共和國,歐洲,1,1,0,1,1,0,0,0,0,0,0,0,0,0,0
110,公立,技專校院,0025,國立臺北科技大學,碩士班(日間),越南社會主義共和國,東協,53,12,41,53,12,41,0,0,0,0,0,0,0,0,0
110,公立,技專校院,0025,國立臺北科技大學,碩士班(日間),聖露西亞,中南美洲,1,1,0,1,1,0,0,0,0,0,0,0,0,0,0
110,公立,技專校院,0025,國立臺北科技大學,碩士班(日間),蒙古國,其他亞洲地區,6,2,4,6,2,4,0,0,0,0,0,0,0,0,0
110,公立,技專校院,0025,國立臺北科技大學,碩士班(日間),德意志聯邦共和國,歐洲,2,2,0,2,2,0,0,0,0,0,0,0,0,0,0
110,公立,技專校院,0025,國立臺北科技大學,碩士班(日間),緬甸,東協,2,2,0,1,1,0,1,1,0,0,0,0,0,0,0
110,公立,技專校院,0025,國立臺北科技大學,碩士班(日間),墨西哥合眾國,中南美洲,1,1,0,1,1,0,0,0,0,0,0,0,0,0,0
110,公立,技專校院,0025,國立臺北科技大學,博士班,布吉納法索,非洲,1,1,0,1,1,0,0,0,0,0,0,0,0,0,0
110,公立,技專校院,0025,國立臺北科技大學,博士班,西班牙王國,歐洲,1,1,0,1,1,0,0,0,0,0,0,0,0,0,0
110,公立,技專校院,0025,國立臺北科技大學,博士班,法國,歐洲,1,1,0,1,1,0,0,0,0,0,0,0,0,0,0
110,公立,技專校院,0025,國立臺北科技大學,博士班,俄羅斯聯邦,其他亞洲地區,1,1,0,1,1,0,0,0,0,0,0,0,0,0,0
110,公立,技專校院,0025,國立臺北科技大學,博士班,埃及阿拉伯共和國,非洲,3,3,0,3,3,0,0,0,0,0,0,0,0,0,0
110,公立,技專校院,0025,國立臺北科技大學,博士班,泰國,東協,7,2,5,7,2,5,0,0,0,0,0,0,0,0,0
110,公立,技專校院,0025,國立臺北科技大學,博士班,菲律賓共和國,東協,1,1,0,1,1,0,0,0,0,0,0,0,0,0,0
110,公立,技專校院,0025,國立臺北科技大學,博士班,大陸地區,大陸地區,28,18,10,0,0,0,0,0,0,0,0,0,28,18,10
110,公立,技專校院,0025,國立臺北科技大學,博士班,厄瓜多共和國,中南美洲,2,2,0,2,2,0,0,0,0,0,0,0,0,0,0
110,公立,技專校院,0025,國立臺北科技大學,博士班,巴基斯坦,南亞,1,1,0,1,1,0,0,0,0,0,0,0,0,0,0
110,公立,技專校院,0025,國立臺北科技大學,博士班,尼加拉瓜,中南美洲,2,2,0,2,2,0,0,0,0,0,0,0,0,0,0
110,公立,技專校院,0025,國立臺北科技大學,博士班,瓜地馬拉共和國,中南美洲,2,1,1,2,1,1,0,0,0,0,0,0,0,0,0
110,公立,技專校院,0025,國立臺北科技大學,博士班,伊朗伊斯蘭共和國,其他亞洲地區,3,2,1,3,2,1,0,0,0,0,0,0,0,0,0
110,公立,技專校院,0025,國立臺北科技大學,博士班,印度,南亞,73,52,21,73,52,21,0,0,0,0,0,0,0,0,0
110,公立,技專校院,0025,國立臺北科技大學,博士班,印度尼西亞共和國,東協,13,11,2,13,11,2,0,0,0,0,0,0,0,0,0
110,公立,技專校院,0025,國立臺北科技大學,博士班,衣索比亞聯邦民主共和國,非洲,8,8,0,8,8,0,0,0,0,0,0,0,0,0,0
110,公立,技專校院,0025,國立臺北科技大學,博士班,貝里斯,中南美洲,1,1,0,1,1,0,0,0,0,0,0,0,0,0,0
110,公立,技專校院,0025,國立臺北科技大學,博士班,坦尚尼亞聯合共和國,非洲,2,2,0,2,2,0,0,0,0,0,0,0,0,0,0
110,公立,技專校院,0025,國立臺北科技大學,博士班,香港,港澳,1,0,1,0,0,0,0,0,0,1,0,1,0,0,0
110,公立,技專校院,0025,國立臺北科技大學,博士班,馬來西亞,東協,3,2,1,2,1,1,1,1,0,0,0,0,0,0,0
110,公立,技專校院,0025,國立臺北科技大學,博士班,越南社會主義共和國,東協,25,17,8,25,17,8,0,0,0,0,0,0,0,0,0
110,公立,一般大學,0028,國立臺北藝術大學,學士班(日間),巴西聯邦共和國,中南美洲,1,0,1,1,0,1,0,0,0,0,0,0,0,0,0
110,公立,一般大學,0028,國立臺北藝術大學,學士班(日間),日本,其他亞洲地區,2,1,1,2,1,1,0,0,0,0,0,0,0,0,0
110,公立,一般大學,0028,國立臺北藝術大學,學士班(日間),美國,北美洲,1,1,0,1,1,0,0,0,0,0,0,0,0,0,0
110,公立,一般大學,0028,國立臺北藝術大學,學士班(日間),馬來西亞,東協,25,10,15,13,4,9,12,6,6,0,0,0,0,0,0
110,公立,一般大學,0028,國立臺北藝術大學,學士班(日間),新加坡共和國,東協,3,1,2,3,1,2,0,0,0,0,0,0,0,0,0
110,公立,一般大學,0028,國立臺北藝術大學,學士班(日間),大陸地區,大陸地區,6,0,6,0,0,0,0,0,0,0,0,0,6,0,6
110,公立,一般大學,0028,國立臺北藝術大學,學士班(日間),瓜地馬拉共和國,中南美洲,1,0,1,1,0,1,0,0,0,0,0,0,0,0,0
110,公立,一般大學,0028,國立臺北藝術大學,學士班(日間),法國,歐洲,1,0,1,1,0,1,0,0,0,0,0,0,0,0,0
110,公立,一般大學,0028,國立臺北藝術大學,學士班(日間),香港,港澳,43,10,33,0,0,0,0,0,0,43,10,33,0,0,0
110,公立,一般大學,0028,國立臺北藝術大學,學士班(日間),秘魯共和國,中南美洲,1,0,1,1,0,1,0,0,0,0,0,0,0,0,0
110,公立,一般大學,0028,國立臺北藝術大學,學士班(日間),瑞士聯邦,歐洲,1,1,0,1,1,0,0,0,0,0,0,0,0,0,0
110,公立,一般大學,0028,國立臺北藝術大學,學士班(日間),澳門,港澳,8,3,5,0,0,0,0,0,0,8,3,5,0,0,0
110,公立,一般大學,0028,國立臺北藝術大學,碩士班(日間),大陸地區,大陸地區,23,10,13,0,0,0,0,0,0,0,0,0,23,10,13
110,公立,一般大學,0028,國立臺北藝術大學,碩士班(日間),大韓民國(南韓),其他亞洲地區,1,0,1,1,0,1,0,0,0,0,0,0,0,0,0
110,公立,一般大學,0028,國立臺北藝術大學,碩士班(日間),比利時王國,歐洲,1,0,1,1,0,1,0,0,0,0,0,0,0,0,0
110,公立,一般大學,0028,國立臺北藝術大學,碩士班(日間),加拿大,北美洲,1,0,1,1,0,1,0,0,0,0,0,0,0,0,0
110,公立,一般大學,0028,國立臺北藝術大學,碩士班(日間),瓜地馬拉共和國,中南美洲,1,0,1,1,0,1,0,0,0,0,0,0,0,0,0
110,公立,一般大學,0028,國立臺北藝術大學,碩士班(日間),香港,港澳,23,10,13,0,0,0,0,0,0,23,10,13,0,0,0
110,公立,一般大學,0028,國立臺北藝術大學,碩士班(日間),越南社會主義共和國,東協,1,0,1,1,0,1,0,0,0,0,0,0,0,0,0
110,公立,一般大學,0028,國立臺北藝術大學,碩士班(日間),新加坡共和國,東協,2,2,0,2,2,0,0,0,0,0,0,0,0,0,0
110,公立,一般大學,0028,國立臺北藝術大學,碩士班(日間),瑞士聯邦,歐洲,1,1,0,1,1,0,0,0,0,0,0,0,0,0,0
110,公立,一般大學,0028,國立臺北藝術大學,碩士班(日間),緬甸,東協,1,1,0,0,0,0,1,1,0,0,0,0,0,0,0
110,公立,一般大學,0028,國立臺北藝術大學,碩士班(日間),澳門,港澳,11,5,6,0,0,0,0,0,0,11,5,6,0,0,0
110,公立,一般大學,0028,國立臺北藝術大學,碩士班(日間),日本,其他亞洲地區,5,1,4,5,1,4,0,0,0,0,0,0,0,0,0
110,公立,一般大學,0028,國立臺北藝術大學,碩士班(日間),法國,歐洲,1,0,1,1,0,1,0,0,0,0,0,0,0,0,0
110,公立,一般大學,0028,國立臺北藝術大學,碩士班(日間),美國,北美洲,2,2,0,2,2,0,0,0,0,0,0,0,0,0,0
110,公立,一般大學,0028,國立臺北藝術大學,碩士班(日間),泰國,東協,2,0,2,2,0,2,0,0,0,0,0,0,0,0,0
110,公立,一般大學,0028,國立臺北藝術大學,碩士班(日間),馬來西亞,東協,19,9,10,12,6,6,7,3,4,0,0,0,0,0,0
110,公立,一般大學,0028,國立臺北藝術大學,碩士班(日間),菲律賓共和國,東協,2,1,1,2,1,1,0,0,0,0,0,0,0,0,0
110,公立,一般大學,0028,國立臺北藝術大學,碩士班(日間),蒙古國,其他亞洲地區,1,0,1,1,0,1,0,0,0,0,0,0,0,0,0
110,公立,一般大學,0028,國立臺北藝術大學,碩士班(日間),墨西哥合眾國,中南美洲,2,1,1,2,1,1,0,0,0,0,0,0,0,0,0
110,公立,一般大學,0028,國立臺北藝術大學,博士班,大陸地區,大陸地區,13,6,7,0,0,0,0,0,0,0,0,0,13,6,7
110,公立,一般大學,0028,國立臺北藝術大學,博士班,印度尼西亞共和國,東協,1,0,1,1,0,1,0,0,0,0,0,0,0,0,0
110,公立,一般大學,0028,國立臺北藝術大學,博士班,香港,港澳,1,1,0,0,0,0,0,0,0,1,1,0,0,0,0
110,公立,一般大學,0028,國立臺北藝術大學,博士班,馬來西亞,東協,3,1,2,1,0,1,2,1,1,0,0,0,0,0,0
110,公立,一般大學,0028,國立臺北藝術大學,博士班,波蘭共和國,歐洲,1,1,0,1,1,0,0,0,0,0,0,0,0,0,0
110,公立,一般大學,0029,國立臺灣藝術大學,學士班(日間),大陸地區,大陸地區,6,3,3,0,0,0,0,0,0,0,0,0,6,3,3
110,公立,一般大學,0029,國立臺灣藝術大學,學士班(日間),大韓民國(南韓),其他亞洲地區,3,1,2,3,1,2,0,0,0,0,0,0,0,0,0
110,公立,一般大學,0029,國立臺灣藝術大學,學士班(日間),瓜地馬拉共和國,中南美洲,2,0,2,2,0,2,0,0,0,0,0,0,0,0,0
110,公立,一般大學,0029,國立臺灣藝術大學,學士班(日間),印度尼西亞共和國,東協,4,1,3,0,0,0,4,1,3,0,0,0,0,0,0
110,公立,一般大學,0029,國立臺灣藝術大學,學士班(日間),宏都拉斯共和國,中南美洲,2,1,1,2,1,1,0,0,0,0,0,0,0,0,0
110,公立,一般大學,0029,國立臺灣藝術大學,學士班(日間),南非共和國,非洲,1,1,0,1,1,0,0,0,0,0,0,0,0,0,0
110,公立,一般大學,0029,國立臺灣藝術大學,學士班(日間),玻利維亞共和國,中南美洲,1,0,1,1,0,1,0,0,0,0,0,0,0,0,0
110,公立,一般大學,0029,國立臺灣藝術大學,學士班(日間),香港,港澳,54,20,34,0,0,0,0,0,0,54,20,34,0,0,0
110,公立,一般大學,0029,國立臺灣藝術大學,學士班(日間),馬來西亞,東協,55,27,28,21,11,10,34,16,18,0,0,0,0,0,0
110,公立,一般大學,0029,國立臺灣藝術大學,學士班(日間),新加坡共和國,東協,5,1,4,5,1,4,0,0,0,0,0,0,0,0,0
110,公立,一般大學,0029,國立臺灣藝術大學,學士班(日間),聖文森(及格瑞那丁),中南美洲,1,0,1,1,0,1,0,0,0,0,0,0,0,0,0
110,公立,一般大學,0029,國立臺灣藝術大學,學士班(日間),澳門,港澳,16,11,5,0,0,0,0,0,0,16,11,5,0,0,0
110,公立,一般大學,0029,國立臺灣藝術大學,學士班(日間),日本,其他亞洲地區,9,3,6,9,3,6,0,0,0,0,0,0,0,0,0
110,公立,一般大學,0029,國立臺灣藝術大學,學士班(日間),美國,北美洲,1,0,1,0,0,0,1,0,1,0,0,0,0,0,0
110,公立,一般大學,0029,國立臺灣藝術大學,學士班(日間),越南社會主義共和國,東協,2,0,2,1,0,1,1,0,1,0,0,0,0,0,0
110,公立,一般大學,0029,國立臺灣藝術大學,碩士班(日間),日本,其他亞洲地區,3,1,2,3,1,2,0,0,0,0,0,0,0,0,0
110,公立,一般大學,0029,國立臺灣藝術大學,碩士班(日間),法國,歐洲,1,1,0,1,1,0,0,0,0,0,0,0,0,0,0
110,公立,一般大學,0029,國立臺灣藝術大學,碩士班(日間),美國,北美洲,2,0,2,2,0,2,0,0,0,0,0,0,0,0,0
110,公立,一般大學,0029,國立臺灣藝術大學,碩士班(日間),泰國,東協,1,0,1,0,0,0,1,0,1,0,0,0,0,0,0
110,公立,一般大學,0029,國立臺灣藝術大學,碩士班(日間),越南社會主義共和國,東協,1,0,1,1,0,1,0,0,0,0,0,0,0,0,0
110,公立,一般大學,0029,國立臺灣藝術大學,碩士班(日間),大陸地區,大陸地區,30,15,15,0,0,0,0,0,0,0,0,0,30,15,15
110,公立,一般大學,0029,國立臺灣藝術大學,碩士班(日間),英國,歐洲,1,0,1,1,0,1,0,0,0,0,0,0,0,0,0
110,公立,一般大學,0029,國立臺灣藝術大學,碩士班(日間),香港,港澳,21,7,14,0,0,0,0,0,0,21,7,14,0,0,0
110,公立,一般大學,0029,國立臺灣藝術大學,碩士班(日間),馬來西亞,東協,11,3,8,4,1,3,7,2,5,0,0,0,0,0,0
110,公立,一般大學,0029,國立臺灣藝術大學,碩士班(日間),新加坡共和國,東協,4,1,3,4,1,3,0,0,0,0,0,0,0,0,0
110,公立,一般大學,0029,國立臺灣藝術大學,碩士班(日間),義大利共和國,歐洲,1,1,0,1,1,0,0,0,0,0,0,0,0,0,0
110,公立,一般大學,0029,國立臺灣藝術大學,碩士班(日間),澳門,港澳,12,8,4,0,0,0,0,0,0,12,8,4,0,0,0
110,公立,一般大學,0029,國立臺灣藝術大學,博士班,大陸地區,大陸地區,33,17,16,0,0,0,0,0,0,0,0,0,33,17,16
110,公立,一般大學,0029,國立臺灣藝術大學,博士班,加拿大,北美洲,1,1,0,1,1,0,0,0,0,0,0,0,0,0,0
110,公立,一般大學,0029,國立臺灣藝術大學,博士班,香港,港澳,2,1,1,0,0,0,0,0,0,2,1,1,0,0,0
110,公立,一般大學,0029,國立臺灣藝術大學,博士班,法國,歐洲,1,0,1,1,0,1,0,0,0,0,0,0,0,0,0
110,公立,一般大學,0029,國立臺灣藝術大學,博士班,俄羅斯聯邦,其他亞洲地區,1,0,1,1,0,1,0,0,0,0,0,0,0,0,0
110,公立,一般大學,0029,國立臺灣藝術大學,博士班,泰國,東協,2,2,0,0,0,0,2,2,0,0,0,0,0,0,0
110,公立,一般大學,0029,國立臺灣藝術大學,博士班,馬來西亞,東協,3,2,1,1,0,1,2,2,0,0,0,0,0,0,0
110,公立,一般大學,0030,國立臺東大學,學士班(日間),越南社會主義共和國,東協,5,1,4,5,1,4,0,0,0,0,0,0,0,0,0
110,公立,一般大學,0030,國立臺東大學,學士班(日間),德意志聯邦共和國,歐洲,1,1,0,1,1,0,0,0,0,0,0,0,0,0,0
110,公立,一般大學,0030,國立臺東大學,學士班(日間),大韓民國(南韓),其他亞洲地區,2,1,1,2,1,1,0,0,0,0,0,0,0,0,0
110,公立,一般大學,0030,國立臺東大學,學士班(日間),日本,其他亞洲地區,1,1,0,1,1,0,0,0,0,0,0,0,0,0,0
110,公立,一般大學,0030,國立臺東大學,學士班(日間),印度尼西亞共和國,東協,1,1,0,0,0,0,1,1,0,0,0,0,0,0,0
110,公立,一般大學,0030,國立臺東大學,學士班(日間),香港,港澳,14,7,7,0,0,0,0,0,0,14,7,7,0,0,0
110,公立,一般大學,0030,國立臺東大學,學士班(日間),馬來西亞,東協,7,5,2,0,0,0,7,5,2,0,0,0,0,0,0
110,公立,一般大學,0030,國立臺東大學,學士班(日間),緬甸,東協,1,1,0,0,0,0,1,1,0,0,0,0,0,0,0
110,公立,一般大學,0030,國立臺東大學,學士班(日間),澳門,港澳,4,1,3,0,0,0,0,0,0,4,1,3,0,0,0
110,公立,一般大學,0030,國立臺東大學,碩士班(日間),香港,港澳,4,1,3,0,0,0,0,0,0,4,1,3,0,0,0
110,公立,一般大學,0030,國立臺東大學,碩士班(日間),馬來西亞,東協,6,2,4,3,0,3,3,2,1,0,0,0,0,0,0
110,公立,一般大學,0030,國立臺東大學,碩士班(日間),美國,北美洲,1,1,0,1,1,0,0,0,0,0,0,0,0,0,0
110,公立,一般大學,0030,國立臺東大學,碩士班(日間),泰國,東協,1,0,1,1,0,1,0,0,0,0,0,0,0,0,0
110,公立,一般大學,0030,國立臺東大學,碩士班(日間),越南社會主義共和國,東協,4,0,4,4,0,4,0,0,0,0,0,0,0,0,0
110,公立,一般大學,0030,國立臺東大學,碩士班(日間),澳門,港澳,2,0,2,0,0,0,0,0,0,2,0,2,0,0,0
110,公立,一般大學,0030,國立臺東大學,博士班,美國,北美洲,1,1,0,1,1,0,0,0,0,0,0,0,0,0,0
110,公立,一般大學,0030,國立臺東大學,博士班,大陸地區,大陸地區,2,0,2,0,0,0,0,0,0,0,0,0,2,0,2
110,公立,一般大學,0031,國立宜蘭大學,學士班(日間),大陸地區,大陸地區,1,0,1,0,0,0,0,0,0,0,0,0,1,0,1
110,公立,一般大學,0031,國立宜蘭大學,學士班(日間),日本,其他亞洲地區,1,0,1,1,0,1,0,0,0,0,0,0,0,0,0
110,公立,一般大學,0031,國立宜蘭大學,學士班(日間),史瓦帝尼王國,非洲,3,2,1,3,2,1,0,0,0,0,0,0,0,0,0
110,公立,一般大學,0031,國立宜蘭大學,學士班(日間),印度,南亞,1,1,0,1,1,0,0,0,0,0,0,0,0,0,0
110,公立,一般大學,0031,國立宜蘭大學,學士班(日間),美國,北美洲,1,1,0,0,0,0,1,1,0,0,0,0,0,0,0
110,公立,一般大學,0031,國立宜蘭大學,學士班(日間),香港,港澳,43,28,15,0,0,0,0,0,0,43,28,15,0,0,0
110,公立,一般大學,0031,國立宜蘭大學,學士班(日間),葉門共和國,其他亞洲地區,1,1,0,1,1,0,0,0,0,0,0,0,0,0,0
110,公立,一般大學,0031,國立宜蘭大學,學士班(日間),緬甸,東協,2,1,1,0,0,0,2,1,1,0,0,0,0,0,0
110,公立,一般大學,0031,國立宜蘭大學,學士班(日間),澳門,港澳,5,3,2,0,0,0,0,0,0,5,3,2,0,0,0
110,公立,一般大學,0031,國立宜蘭大學,學士班(日間),印度尼西亞共和國,東協,7,3,4,0,0,0,7,3,4,0,0,0,0,0,0
110,公立,一般大學,0031,國立宜蘭大學,學士班(日間),阿根廷,中南美洲,1,1,0,0,0,0,1,1,0,0,0,0,0,0,0
110,公立,一般大學,0031,國立宜蘭大學,學士班(日間),泰國,東協,1,0,1,1,0,1,0,0,0,0,0,0,0,0,0
110,公立,一般大學,0031,國立宜蘭大學,學士班(日間),馬來西亞,東協,33,16,17,1,1,0,32,15,17,0,0,0,0,0,0
110,公立,一般大學,0031,國立宜蘭大學,學士班(日間),菲律賓共和國,東協,1,1,0,1,1,0,0,0,0,0,0,0,0,0,0
110,公立,一般大學,0031,國立宜蘭大學,學士班(日間),越南社會主義共和國,東協,3,1,2,1,0,1,2,1,1,0,0,0,0,0,0
110,公立,一般大學,0031,國立宜蘭大學,學士班(日間),聖文森(及格瑞那丁),中南美洲,2,0,2,2,0,2,0,0,0,0,0,0,0,0,0
110,公立,一般大學,0031,國立宜蘭大學,學士班(日間),聖克里斯多福及尼維斯,中南美洲,1,1,0,1,1,0,0,0,0,0,0,0,0,0,0
110,公立,一般大學,0031,國立宜蘭大學,碩士班(日間),法國,歐洲,1,0,1,1,0,1,0,0,0,0,0,0,0,0,0
110,公立,一般大學,0031,國立宜蘭大學,碩士班(日間),馬來西亞,東協,6,3,3,0,0,0,6,3,3,0,0,0,0,0,0
110,公立,一般大學,0031,國立宜蘭大學,碩士班(日間),幾內亞共和國,非洲,1,1,0,1,1,0,0,0,0,0,0,0,0,0,0
110,公立,一般大學,0031,國立宜蘭大學,碩士班(日間),越南社會主義共和國,東協,5,3,2,4,2,2,1,1,0,0,0,0,0,0,0
110,公立,一般大學,0031,國立宜蘭大學,碩士班(日間),蒙古國,其他亞洲地區,1,0,1,1,0,1,0,0,0,0,0,0,0,0,0
110,公立,一般大學,0031,國立宜蘭大學,碩士班(日間),印度,南亞,2,2,0,2,2,0,0,0,0,0,0,0,0,0,0
110,公立,一般大學,0031,國立宜蘭大學,碩士班(日間),美國,北美洲,1,1,0,1,1,0,0,0,0,0,0,0,0,0,0
110,公立,一般大學,0031,國立宜蘭大學,碩士班(日間),香港,港澳,2,2,0,0,0,0,0,0,0,2,2,0,0,0,0
110,公立,一般大學,0031,國立宜蘭大學,博士班,巴基斯坦,南亞,1,1,0,1,1,0,0,0,0,0,0,0,0,0,0
110,公立,一般大學,0031,國立宜蘭大學,博士班,印度,南亞,3,1,2,3,1,2,0,0,0,0,0,0,0,0,0
110,公立,一般大學,0032,國立聯合大學,學士班(日間),香港,港澳,8,5,3,0,0,0,0,0,0,8,5,3,0,0,0
110,公立,一般大學,0032,國立聯合大學,學士班(日間),泰國,東協,1,0,1,0,0,0,1,0,1,0,0,0,0,0,0
110,公立,一般大學,0032,國立聯合大學,學士班(日間),越南社會主義共和國,東協,1,0,1,1,0,1,0,0,0,0,0,0,0,0,0
110,公立,一般大學,0032,國立聯合大學,學士班(日間),緬甸,東協,4,1,3,0,0,0,4,1,3,0,0,0,0,0,0
110,公立,一般大學,0032,國立聯合大學,學士班(日間),澳門,港澳,1,1,0,0,0,0,0,0,0,1,1,0,0,0,0
110,公立,一般大學,0032,國立聯合大學,學士班(日間),大陸地區,大陸地區,8,6,2,0,0,0,0,0,0,0,0,0,8,6,2
110,公立,一般大學,0032,國立聯合大學,學士班(日間),印度尼西亞共和國,東協,11,5,6,0,0,0,11,5,6,0,0,0,0,0,0
110,公立,一般大學,0032,國立聯合大學,學士班(日間),馬來西亞,東協,21,11,10,0,0,0,21,11,10,0,0,0,0,0,0
110,公立,一般大學,0032,國立聯合大學,碩士班(日間),巴基斯坦,南亞,1,1,0,1,1,0,0,0,0,0,0,0,0,0,0
110,公立,一般大學,0032,國立聯合大學,碩士班(日間),印度尼西亞共和國,東協,3,3,0,3,3,0,0,0,0,0,0,0,0,0,0
110,公立,一般大學,0032,國立聯合大學,碩士班(日間),越南社會主義共和國,東協,4,4,0,4,4,0,0,0,0,0,0,0,0,0,0
110,公立,技專校院,0033,國立虎尾科技大學,學士班(日間),大陸地區,大陸地區,6,5,1,0,0,0,0,0,0,0,0,0,6,5,1
110,公立,技專校院,0033,國立虎尾科技大學,學士班(日間),印度尼西亞共和國,東協,2,2,0,1,1,0,1,1,0,0,0,0,0,0,0
110,公立,技專校院,0033,國立虎尾科技大學,學士班(日間),馬來西亞,東協,22,16,6,5,4,1,17,12,5,0,0,0,0,0,0
110,公立,技專校院,0033,國立虎尾科技大學,學士班(日間),越南社會主義共和國,東協,3,2,1,0,0,0,3,2,1,0,0,0,0,0,0
110,公立,技專校院,0033,國立虎尾科技大學,學士班(日間),日本,其他亞洲地區,3,3,0,2,2,0,1,1,0,0,0,0,0,0,0
110,公立,技專校院,0033,國立虎尾科技大學,學士班(日間),貝里斯,中南美洲,1,1,0,0,0,0,1,1,0,0,0,0,0,0,0
110,公立,技專校院,0033,國立虎尾科技大學,學士班(日間),香港,港澳,13,6,7,0,0,0,0,0,0,13,6,7,0,0,0
110,公立,技專校院,0033,國立虎尾科技大學,碩士班(日間),泰國,東協,7,1,6,7,1,6,0,0,0,0,0,0,0,0,0
110,公立,技專校院,0033,國立虎尾科技大學,碩士班(日間),巴基斯坦,南亞,12,10,2,12,10,2,0,0,0,0,0,0,0,0,0
110,公立,技專校院,0033,國立虎尾科技大學,碩士班(日間),印度,南亞,22,19,3,22,19,3,0,0,0,0,0,0,0,0,0
110,公立,技專校院,0033,國立虎尾科技大學,碩士班(日間),印度尼西亞共和國,東協,20,11,9,19,11,8,1,0,1,0,0,0,0,0,0
110,公立,技專校院,0033,國立虎尾科技大學,碩士班(日間),香港,港澳,1,0,1,0,0,0,0,0,0,1,0,1,0,0,0
110,公立,技專校院,0033,國立虎尾科技大學,碩士班(日間),馬來西亞,東協,3,2,1,2,2,0,1,0,1,0,0,0,0,0,0
110,公立,技專校院,0033,國立虎尾科技大學,碩士班(日間),越南社會主義共和國,東協,24,10,14,24,10,14,0,0,0,0,0,0,0,0,0
110,公立,技專校院,0033,國立虎尾科技大學,碩士班(日間),蒙古國,其他亞洲地區,7,4,3,7,4,3,0,0,0,0,0,0,0,0,0
110,公立,技專校院,0033,國立虎尾科技大學,博士班,巴基斯坦,南亞,3,3,0,3,3,0,0,0,0,0,0,0,0,0,0
110,公立,技專校院,0033,國立虎尾科技大學,博士班,印度,南亞,5,4,1,5,4,1,0,0,0,0,0,0,0,0,0
110,公立,技專校院,0033,國立虎尾科技大學,博士班,印度尼西亞共和國,東協,4,4,0,4,4,0,0,0,0,0,0,0,0,0,0
110,公立,技專校院,0033,國立虎尾科技大學,博士班,泰國,東協,1,1,0,1,1,0,0,0,0,0,0,0,0,0,0
110,公立,技專校院,0033,國立虎尾科技大學,博士班,越南社會主義共和國,東協,3,3,0,3,3,0,0,0,0,0,0,0,0,0,0
110,公立,一般大學,0035,國立臺南藝術大學,學士班(日間),印度尼西亞共和國,東協,1,0,1,0,0,0,1,0,1,0,0,0,0,0,0
110,公立,一般大學,0035,國立臺南藝術大學,學士班(日間),馬來西亞,東協,14,9,5,3,2,1,11,7,4,0,0,0,0,0,0
110,公立,一般大學,0035,國立臺南藝術大學,學士班(日間),義大利共和國,歐洲,1,0,1,1,0,1,0,0,0,0,0,0,0,0,0
110,公立,一般大學,0035,國立臺南藝術大學,學士班(日間),大陸地區,大陸地區,6,1,5,0,0,0,0,0,0,0,0,0,6,1,5
110,公立,一般大學,0035,國立臺南藝術大學,學士班(日間),香港,港澳,14,3,11,0,0,0,0,0,0,14,3,11,0,0,0
110,公立,一般大學,0035,國立臺南藝術大學,學士班(日間),澳門,港澳,2,1,1,0,0,0,0,0,0,2,1,1,0,0,0
110,公立,一般大學,0035,國立臺南藝術大學,碩士班(日間),日本,其他亞洲地區,1,0,1,1,0,1,0,0,0,0,0,0,0,0,0
110,公立,一般大學,0035,國立臺南藝術大學,碩士班(日間),美國,北美洲,1,0,1,1,0,1,0,0,0,0,0,0,0,0,0
110,公立,一般大學,0035,國立臺南藝術大學,碩士班(日間),香港,港澳,9,3,6,0,0,0,0,0,0,9,3,6,0,0,0
110,公立,一般大學,0035,國立臺南藝術大學,碩士班(日間),新加坡共和國,東協,4,2,2,4,2,2,0,0,0,0,0,0,0,0,0
110,公立,一般大學,0035,國立臺南藝術大學,碩士班(日間),大韓民國(南韓),其他亞洲地區,3,1,2,3,1,2,0,0,0,0,0,0,0,0,0
110,公立,一般大學,0035,國立臺南藝術大學,碩士班(日間),馬來西亞,東協,4,2,2,0,0,0,4,2,2,0,0,0,0,0,0
110,公立,一般大學,0035,國立臺南藝術大學,碩士班(日間),澳門,港澳,3,1,2,0,0,0,0,0,0,3,1,2,0,0,0
110,公立,一般大學,0035,國立臺南藝術大學,博士班,大韓民國(南韓),其他亞洲地區,1,0,1,1,0,1,0,0,0,0,0,0,0,0,0
110,公立,一般大學,0035,國立臺南藝術大學,博士班,日本,其他亞洲地區,2,0,2,2,0,2,0,0,0,0,0,0,0,0,0
110,公立,一般大學,0035,國立臺南藝術大學,博士班,香港,港澳,1,1,0,0,0,0,0,0,0,1,1,0,0,0,0
110,公立,一般大學,0035,國立臺南藝術大學,博士班,新加坡共和國,東協,1,1,0,1,1,0,0,0,0,0,0,0,0,0,0
110,公立,一般大學,0035,國立臺南藝術大學,博士班,大陸地區,大陸地區,6,2,4,0,0,0,0,0,0,0,0,0,6,2,4
110,公立,一般大學,0035,國立臺南藝術大學,博士班,馬來西亞,東協,2,1,1,1,1,0,1,0,1,0,0,0,0,0,0
110,公立,一般大學,0036,國立臺南大學,學士班(日間),俄羅斯聯邦,其他亞洲地區,2,0,2,2,0,2,0,0,0,0,0,0,0,0,0
110,公立,一般大學,0036,國立臺南大學,學士班(日間),馬來西亞,東協,36,18,18,3,1,2,33,17,16,0,0,0,0,0,0
110,公立,一般大學,0036,國立臺南大學,學士班(日間),越南社會主義共和國,東協,8,1,7,8,1,7,0,0,0,0,0,0,0,0,0
110,公立,一般大學,0036,國立臺南大學,學士班(日間),蒙古國,其他亞洲地區,1,0,1,1,0,1,0,0,0,0,0,0,0,0,0
110,公立,一般大學,0036,國立臺南大學,學士班(日間),大陸地區,大陸地區,7,4,3,0,0,0,0,0,0,0,0,0,7,4,3
110,公立,一般大學,0036,國立臺南大學,學士班(日間),大韓民國(南韓),其他亞洲地區,1,0,1,1,0,1,0,0,0,0,0,0,0,0,0
110,公立,一般大學,0036,國立臺南大學,學士班(日間),日本,其他亞洲地區,10,2,8,9,2,7,1,0,1,0,0,0,0,0,0
110,公立,一般大學,0036,國立臺南大學,學士班(日間),印度,南亞,1,0,1,1,0,1,0,0,0,0,0,0,0,0,0
110,公立,一般大學,0036,國立臺南大學,學士班(日間),印度尼西亞共和國,東協,14,6,8,2,0,2,12,6,6,0,0,0,0,0,0
110,公立,一般大學,0036,國立臺南大學,學士班(日間),南非共和國,非洲,1,0,1,1,0,1,0,0,0,0,0,0,0,0,0
110,公立,一般大學,0036,國立臺南大學,學士班(日間),香港,港澳,29,10,19,0,0,0,0,0,0,29,10,19,0,0,0
110,公立,一般大學,0036,國立臺南大學,學士班(日間),愛爾蘭共和國,歐洲,1,0,1,0,0,0,1,0,1,0,0,0,0,0,0
110,公立,一般大學,0036,國立臺南大學,學士班(日間),新加坡共和國,東協,1,1,0,1,1,0,0,0,0,0,0,0,0,0,0
110,公立,一般大學,0036,國立臺南大學,學士班(日間),聖文森(及格瑞那丁),中南美洲,1,0,1,1,0,1,0,0,0,0,0,0,0,0,0
110,公立,一般大學,0036,國立臺南大學,學士班(日間),緬甸,東協,1,0,1,0,0,0,1,0,1,0,0,0,0,0,0
110,公立,一般大學,0036,國立臺南大學,學士班(日間),澳門,港澳,5,1,4,0,0,0,0,0,0,5,1,4,0,0,0
110,公立,一般大學,0036,國立臺南大學,碩士班(日間),香港,港澳,12,3,9,0,0,0,0,0,0,12,3,9,0,0,0
110,公立,一般大學,0036,國立臺南大學,碩士班(日間),加拿大,北美洲,1,1,0,1,1,0,0,0,0,0,0,0,0,0,0
110,公立,一般大學,0036,國立臺南大學,碩士班(日間),印度尼西亞共和國,東協,1,1,0,1,1,0,0,0,0,0,0,0,0,0,0
110,公立,一般大學,0036,國立臺南大學,碩士班(日間),美國,北美洲,3,3,0,3,3,0,0,0,0,0,0,0,0,0,0
110,公立,一般大學,0036,國立臺南大學,碩士班(日間),泰國,東協,5,3,2,5,3,2,0,0,0,0,0,0,0,0,0
110,公立,一般大學,0036,國立臺南大學,碩士班(日間),馬來西亞,東協,10,2,8,2,0,2,8,2,6,0,0,0,0,0,0
110,公立,一般大學,0036,國立臺南大學,碩士班(日間),越南社會主義共和國,東協,3,0,3,3,0,3,0,0,0,0,0,0,0,0,0
110,公立,一般大學,0036,國立臺南大學,碩士班(日間),澳門,港澳,1,0,1,0,0,0,0,0,0,1,0,1,0,0,0
110,公立,一般大學,0036,國立臺南大學,博士班,大陸地區,大陸地區,3,1,2,0,0,0,0,0,0,0,0,0,3,1,2
110,公立,一般大學,0036,國立臺南大學,博士班,印度,南亞,1,1,0,1,1,0,0,0,0,0,0,0,0,0,0
110,公立,一般大學,0036,國立臺南大學,博士班,菲律賓共和國,東協,1,1,0,1,1,0,0,0,0,0,0,0,0,0,0
110,公立,一般大學,0036,國立臺南大學,博士班,印度尼西亞共和國,東協,1,0,1,1,0,1,0,0,0,0,0,0,0,0,0
110,公立,一般大學,0036,國立臺南大學,博士班,越南社會主義共和國,東協,1,0,1,1,0,1,0,0,0,0,0,0,0,0,0
110,公立,一般大學,0037,國立臺北教育大學,學士班(日間),大陸地區,大陸地區,1,0,1,0,0,0,0,0,0,0,0,0,1,0,1
110,公立,一般大學,0037,國立臺北教育大學,學士班(日間),大韓民國(南韓),其他亞洲地區,1,0,1,1,0,1,0,0,0,0,0,0,0,0,0
110,公立,一般大學,0037,國立臺北教育大學,學士班(日間),巴拉圭,中南美洲,1,0,1,1,0,1,0,0,0,0,0,0,0,0,0
110,公立,一般大學,0037,國立臺北教育大學,學士班(日間),瓜地馬拉共和國,中南美洲,1,0,1,1,0,1,0,0,0,0,0,0,0,0,0
110,公立,一般大學,0037,國立臺北教育大學,學士班(日間),印度尼西亞共和國,東協,6,2,4,1,0,1,5,2,3,0,0,0,0,0,0
110,公立,一般大學,0037,國立臺北教育大學,學士班(日間),香港,港澳,31,16,15,0,0,0,0,0,0,31,16,15,0,0,0
110,公立,一般大學,0037,國立臺北教育大學,學士班(日間),馬來西亞,東協,31,9,22,5,1,4,26,8,18,0,0,0,0,0,0
110,公立,一般大學,0037,國立臺北教育大學,學士班(日間),越南社會主義共和國,東協,12,2,10,10,1,9,2,1,1,0,0,0,0,0,0
110,公立,一般大學,0037,國立臺北教育大學,學士班(日間),緬甸,東協,16,4,12,0,0,0,16,4,12,0,0,0,0,0,0
110,公立,一般大學,0037,國立臺北教育大學,學士班(日間),澳門,港澳,24,3,21,0,0,0,0,0,0,24,3,21,0,0,0
110,公立,一般大學,0037,國立臺北教育大學,學士班(日間),日本,其他亞洲地區,3,1,2,1,0,1,2,1,1,0,0,0,0,0,0
110,公立,一般大學,0037,國立臺北教育大學,學士班(日間),俄羅斯聯邦,其他亞洲地區,1,1,0,1,1,0,0,0,0,0,0,0,0,0,0
110,公立,一般大學,0037,國立臺北教育大學,碩士班(日間),日本,其他亞洲地區,3,0,3,3,0,3,0,0,0,0,0,0,0,0,0
110,公立,一般大學,0037,國立臺北教育大學,碩士班(日間),加彭共和國,非洲,1,0,1,1,0,1,0,0,0,0,0,0,0,0,0
110,公立,一般大學,0037,國立臺北教育大學,碩士班(日間),西班牙王國,歐洲,1,1,0,1,1,0,0,0,0,0,0,0,0,0,0
110,公立,一般大學,0037,國立臺北教育大學,碩士班(日間),法國,歐洲,3,0,3,3,0,3,0,0,0,0,0,0,0,0,0
110,公立,一般大學,0037,國立臺北教育大學,碩士班(日間),俄羅斯聯邦,其他亞洲地區,1,0,1,1,0,1,0,0,0,0,0,0,0,0,0
110,公立,一般大學,0037,國立臺北教育大學,碩士班(日間),美國,北美洲,8,3,5,7,3,4,1,0,1,0,0,0,0,0,0
110,公立,一般大學,0037,國立臺北教育大學,碩士班(日間),泰國,東協,5,3,2,5,3,2,0,0,0,0,0,0,0,0,0
110,公立,一般大學,0037,國立臺北教育大學,碩士班(日間),菲律賓共和國,東協,2,2,0,2,2,0,0,0,0,0,0,0,0,0,0
110,公立,一般大學,0037,國立臺北教育大學,碩士班(日間),義大利共和國,歐洲,2,0,2,2,0,2,0,0,0,0,0,0,0,0,0
110,公立,一般大學,0037,國立臺北教育大學,碩士班(日間),德意志聯邦共和國,歐洲,2,1,1,2,1,1,0,0,0,0,0,0,0,0,0
110,公立,一般大學,0037,國立臺北教育大學,碩士班(日間),澳大利亞,其他亞洲地區,1,0,1,1,0,1,0,0,0,0,0,0,0,0,0
110,公立,一般大學,0037,國立臺北教育大學,碩士班(日間),大陸地區,大陸地區,3,1,2,0,0,0,0,0,0,0,0,0,3,1,2
110,公立,一般大學,0037,國立臺北教育大學,碩士班(日間),大韓民國(南韓),其他亞洲地區,5,1,4,5,1,4,0,0,0,0,0,0,0,0,0
110,公立,一般大學,0037,國立臺北教育大學,碩士班(日間),加拿大,北美洲,1,0,1,0,0,0,1,0,1,0,0,0,0,0,0
110,公立,一般大學,0037,國立臺北教育大學,碩士班(日間),瓜地馬拉共和國,中南美洲,1,0,1,1,0,1,0,0,0,0,0,0,0,0,0
110,公立,一般大學,0037,國立臺北教育大學,碩士班(日間),印度尼西亞共和國,東協,3,0,3,2,0,2,1,0,1,0,0,0,0,0,0
110,公立,一般大學,0037,國立臺北教育大學,碩士班(日間),南非共和國,非洲,2,1,1,2,1,1,0,0,0,0,0,0,0,0,0
110,公立,一般大學,0037,國立臺北教育大學,碩士班(日間),英國,歐洲,4,2,2,4,2,2,0,0,0,0,0,0,0,0,0
110,公立,一般大學,0037,國立臺北教育大學,碩士班(日間),香港,港澳,14,5,9,0,0,0,0,0,0,14,5,9,0,0,0
110,公立,一般大學,0037,國立臺北教育大學,碩士班(日間),馬來西亞,東協,17,5,12,7,1,6,10,4,6,0,0,0,0,0,0
110,公立,一般大學,0037,國立臺北教育大學,碩士班(日間),越南社會主義共和國,東協,20,1,19,20,1,19,0,0,0,0,0,0,0,0,0
110,公立,一般大學,0037,國立臺北教育大學,碩士班(日間),愛爾蘭共和國,歐洲,2,1,1,2,1,1,0,0,0,0,0,0,0,0,0
110,公立,一般大學,0037,國立臺北教育大學,碩士班(日間),緬甸,東協,4,0,4,0,0,0,4,0,4,0,0,0,0,0,0
110,公立,一般大學,0037,國立臺北教育大學,碩士班(日間),澳門,港澳,8,4,4,0,0,0,0,0,0,8,4,4,0,0,0
110,公立,一般大學,0037,國立臺北教育大學,博士班,大陸地區,大陸地區,4,4,0,0,0,0,0,0,0,0,0,0,4,4,0
110,公立,一般大學,0037,國立臺北教育大學,博士班,越南社會主義共和國,東協,1,0,1,1,0,1,0,0,0,0,0,0,0,0,0
110,公立,一般大學,0039,國立臺中教育大學,學士班(日間),大陸地區,大陸地區,4,0,4,0,0,0,0,0,0,0,0,0,4,0,4
110,公立,一般大學,0039,國立臺中教育大學,學士班(日間),印度尼西亞共和國,東協,44,19,25,0,0,0,44,19,25,0,0,0,0,0,0
110,公立,一般大學,0039,國立臺中教育大學,學士班(日間),香港,港澳,22,7,15,0,0,0,0,0,0,22,7,15,0,0,0
110,公立,一般大學,0039,國立臺中教育大學,學士班(日間),泰國,東協,3,0,3,2,0,2,1,0,1,0,0,0,0,0,0
110,公立,一般大學,0039,國立臺中教育大學,學士班(日間),越南社會主義共和國,東協,30,2,28,30,2,28,0,0,0,0,0,0,0,0,0
110,公立,一般大學,0039,國立臺中教育大學,學士班(日間),蒙古國,其他亞洲地區,1,0,1,1,0,1,0,0,0,0,0,0,0,0,0
110,公立,一般大學,0039,國立臺中教育大學,學士班(日間),緬甸,東協,3,2,1,0,0,0,3,2,1,0,0,0,0,0,0
110,公立,一般大學,0039,國立臺中教育大學,學士班(日間),澳門,港澳,14,3,11,0,0,0,0,0,0,14,3,11,0,0,0
110,公立,一般大學,0039,國立臺中教育大學,學士班(日間),日本,其他亞洲地區,4,2,2,4,2,2,0,0,0,0,0,0,0,0,0
110,公立,一般大學,0039,國立臺中教育大學,學士班(日間),馬來西亞,東協,45,14,31,5,1,4,40,13,27,0,0,0,0,0,0
110,公立,一般大學,0039,國立臺中教育大學,碩士班(日間),巴基斯坦,南亞,1,1,0,1,1,0,0,0,0,0,0,0,0,0,0
110,公立,一般大學,0039,國立臺中教育大學,碩士班(日間),日本,其他亞洲地區,1,0,1,1,0,1,0,0,0,0,0,0,0,0,0
110,公立,一般大學,0039,國立臺中教育大學,碩士班(日間),俄羅斯聯邦,其他亞洲地區,2,0,2,2,0,2,0,0,0,0,0,0,0,0,0
110,公立,一般大學,0039,國立臺中教育大學,碩士班(日間),馬來西亞,東協,8,3,5,2,0,2,6,3,3,0,0,0,0,0,0
110,公立,一般大學,0039,國立臺中教育大學,碩士班(日間),菲律賓共和國,東協,1,0,1,1,0,1,0,0,0,0,0,0,0,0,0
110,公立,一般大學,0039,國立臺中教育大學,碩士班(日間),印度,南亞,1,0,1,1,0,1,0,0,0,0,0,0,0,0,0
110,公立,一般大學,0039,國立臺中教育大學,碩士班(日間),印度尼西亞共和國,東協,1,0,1,1,0,1,0,0,0,0,0,0,0,0,0
110,公立,一般大學,0039,國立臺中教育大學,碩士班(日間),香港,港澳,6,3,3,0,0,0,0,0,0,6,3,3,0,0,0
110,公立,一般大學,0039,國立臺中教育大學,碩士班(日間),泰國,東協,1,0,1,1,0,1,0,0,0,0,0,0,0,0,0
110,公立,一般大學,0039,國立臺中教育大學,碩士班(日間),越南社會主義共和國,東協,10,2,8,10,2,8,0,0,0,0,0,0,0,0,0
110,公立,一般大學,0039,國立臺中教育大學,碩士班(日間),蒙古國,其他亞洲地區,1,0,1,1,0,1,0,0,0,0,0,0,0,0,0
110,公立,一般大學,0039,國立臺中教育大學,碩士班(日間),澳門,港澳,1,0,1,0,0,0,0,0,0,1,0,1,0,0,0
110,公立,一般大學,0039,國立臺中教育大學,博士班,泰國,東協,1,0,1,1,0,1,0,0,0,0,0,0,0,0,0
110,公立,一般大學,0039,國立臺中教育大學,博士班,大陸地區,大陸地區,2,2,0,0,0,0,0,0,0,0,0,0,2,2,0
110,公立,一般大學,0039,國立臺中教育大學,博士班,大韓民國(南韓),其他亞洲地區,1,0,1,1,0,1,0,0,0,0,0,0,0,0,0
110,公立,一般大學,0039,國立臺中教育大學,博士班,香港,港澳,1,0,1,0,0,0,0,0,0,1,0,1,0,0,0
110,公立,技專校院,0042,國立澎湖科技大學,學士班(日間),香港,港澳,2,1,1,0,0,0,0,0,0,2,1,1,0,0,0
110,公立,技專校院,0042,國立澎湖科技大學,學士班(日間),越南社會主義共和國,東協,8,4,4,8,4,4,0,0,0,0,0,0,0,0,0
110,公立,技專校院,0042,國立澎湖科技大學,學士班(日間),葡萄牙共和國,歐洲,1,1,0,1,1,0,0,0,0,0,0,0,0,0,0
110,公立,技專校院,0042,國立澎湖科技大學,學士班(日間),緬甸,東協,1,1,0,0,0,0,1,1,0,0,0,0,0,0,0
110,公立,技專校院,0042,國立澎湖科技大學,學士班(日間),馬來西亞,東協,5,2,3,1,0,1,4,2,2,0,0,0,0,0,0
110,公立,技專校院,0042,國立澎湖科技大學,學士班(日間),新加坡共和國,東協,1,0,1,1,0,1,0,0,0,0,0,0,0,0,0
110,公立,技專校院,0043,國立勤益科技大學,學士班(日間),日本,其他亞洲地區,1,1,0,0,0,0,1,1,0,0,0,0,0,0,0
110,公立,技專校院,0043,國立勤益科技大學,學士班(日間),大陸地區,大陸地區,8,5,3,0,0,0,0,0,0,0,0,0,8,5,3
110,公立,技專校院,0043,國立勤益科技大學,學士班(日間),印度尼西亞共和國,東協,113,77,36,107,74,33,6,3,3,0,0,0,0,0,0
110,公立,技專校院,0043,國立勤益科技大學,學士班(日間),拉脫維亞共和國,歐洲,1,1,0,1,1,0,0,0,0,0,0,0,0,0,0
110,公立,技專校院,0043,國立勤益科技大學,學士班(日間),香港,港澳,18,15,3,0,0,0,0,0,0,18,15,3,0,0,0
110,公立,技專校院,0043,國立勤益科技大學,學士班(日間),馬來西亞,東協,27,26,1,6,6,0,21,20,1,0,0,0,0,0,0
110,公立,技專校院,0043,國立勤益科技大學,學士班(日間),越南社會主義共和國,東協,166,71,95,161,68,93,5,3,2,0,0,0,0,0,0
110,公立,技專校院,0043,國立勤益科技大學,學士班(日間),蒙古國,其他亞洲地區,1,0,1,1,0,1,0,0,0,0,0,0,0,0,0
110,公立,技專校院,0043,國立勤益科技大學,學士班(日間),寮人民民主共和國(寮國),東協,3,2,1,3,2,1,0,0,0,0,0,0,0,0,0
110,公立,技專校院,0043,國立勤益科技大學,學士班(日間),澳門,港澳,1,1,0,0,0,0,0,0,0,1,1,0,0,0,0
110,公立,技專校院,0043,國立勤益科技大學,碩士班(日間),大韓民國(南韓),其他亞洲地區,1,1,0,1,1,0,0,0,0,0,0,0,0,0,0
110,公立,技專校院,0043,國立勤益科技大學,碩士班(日間),印度,南亞,10,10,0,10,10,0,0,0,0,0,0,0,0,0,0
110,公立,技專校院,0043,國立勤益科技大學,碩士班(日間),俄羅斯聯邦,其他亞洲地區,1,1,0,1,1,0,0,0,0,0,0,0,0,0,0
110,公立,技專校院,0043,國立勤益科技大學,碩士班(日間),香港,港澳,2,1,1,0,0,0,0,0,0,2,1,1,0,0,0
110,公立,技專校院,0043,國立勤益科技大學,碩士班(日間),烏克蘭,其他亞洲地區,1,0,1,1,0,1,0,0,0,0,0,0,0,0,0
110,公立,技專校院,0043,國立勤益科技大學,碩士班(日間),馬來西亞,東協,1,0,1,1,0,1,0,0,0,0,0,0,0,0,0
110,公立,技專校院,0043,國立勤益科技大學,碩士班(日間),蒙古國,其他亞洲地區,3,0,3,3,0,3,0,0,0,0,0,0,0,0,0
110,公立,技專校院,0043,國立勤益科技大學,碩士班(日間),印度尼西亞共和國,東協,32,19,13,32,19,13,0,0,0,0,0,0,0,0,0
110,公立,技專校院,0043,國立勤益科技大學,碩士班(日間),柬埔寨王國,東協,1,0,1,1,0,1,0,0,0,0,0,0,0,0,0
110,公立,技專校院,0043,國立勤益科技大學,碩士班(日間),美國,北美洲,1,1,0,1,1,0,0,0,0,0,0,0,0,0,0
110,公立,技專校院,0043,國立勤益科技大學,碩士班(日間),泰國,東協,5,3,2,5,3,2,0,0,0,0,0,0,0,0,0
110,公立,技專校院,0043,國立勤益科技大學,碩士班(日間),越南社會主義共和國,東協,12,1,11,12,1,11,0,0,0,0,0,0,0,0,0
110,公立,技專校院,0043,國立勤益科技大學,博士班,印度尼西亞共和國,東協,8,6,2,8,6,2,0,0,0,0,0,0,0,0,0
110,公立,技專校院,0043,國立勤益科技大學,博士班,盧安達共和國,非洲,1,1,0,1,1,0,0,0,0,0,0,0,0,0,0
110,公立,技專校院,0043,國立勤益科技大學,博士班,印度,南亞,3,2,1,3,2,1,0,0,0,0,0,0,0,0,0
110,公立,一般大學,0044,國立體育大學,學士班(日間),大韓民國(南韓),其他亞洲地區,2,2,0,2,2,0,0,0,0,0,0,0,0,0,0
110,公立,一般大學,0044,國立體育大學,學士班(日間),日本,其他亞洲地區,2,2,0,2,2,0,0,0,0,0,0,0,0,0,0
110,公立,一般大學,0044,國立體育大學,學士班(日間),美國,北美洲,1,0,1,1,0,1,0,0,0,0,0,0,0,0,0
110,公立,一般大學,0044,國立體育大學,學士班(日間),馬來西亞,東協,13,9,4,1,1,0,12,8,4,0,0,0,0,0,0
110,公立,一般大學,0044,國立體育大學,學士班(日間),馬拉威共和國,非洲,2,2,0,2,2,0,0,0,0,0,0,0,0,0,0
110,公立,一般大學,0044,國立體育大學,學士班(日間),大陸地區,大陸地區,4,3,1,0,0,0,0,0,0,0,0,0,4,3,1
110,公立,一般大學,0044,國立體育大學,學士班(日間),波士尼亞與赫塞哥維納,歐洲,1,0,1,1,0,1,0,0,0,0,0,0,0,0,0
110,公立,一般大學,0044,國立體育大學,學士班(日間),香港,港澳,26,20,6,0,0,0,0,0,0,26,20,6,0,0,0
110,公立,一般大學,0044,國立體育大學,學士班(日間),澳門,港澳,4,1,3,0,0,0,0,0,0,4,1,3,0,0,0
110,公立,一般大學,0044,國立體育大學,碩士班(日間),印度尼西亞共和國,東協,1,0,1,1,0,1,0,0,0,0,0,0,0,0,0
110,公立,一般大學,0044,國立體育大學,碩士班(日間),香港,港澳,11,4,7,0,0,0,0,0,0,11,4,7,0,0,0
110,公立,一般大學,0044,國立體育大學,碩士班(日間),澳門,港澳,1,0,1,0,0,0,0,0,0,1,0,1,0,0,0
110,公立,一般大學,0044,國立體育大學,碩士班(日間),日本,其他亞洲地區,1,0,1,1,0,1,0,0,0,0,0,0,0,0,0
110,公立,一般大學,0044,國立體育大學,碩士班(日間),馬來西亞,東協,4,4,0,0,0,0,4,4,0,0,0,0,0,0,0
110,公立,一般大學,0044,國立體育大學,碩士班(日間),葡萄牙共和國,歐洲,1,1,0,1,1,0,0,0,0,0,0,0,0,0,0
110,公立,一般大學,0044,國立體育大學,博士班,大陸地區,大陸地區,17,13,4,0,0,0,0,0,0,0,0,0,17,13,4
110,公立,一般大學,0044,國立體育大學,博士班,大韓民國(南韓),其他亞洲地區,2,2,0,2,2,0,0,0,0,0,0,0,0,0,0
110,公立,一般大學,0044,國立體育大學,博士班,香港,港澳,1,0,1,0,0,0,0,0,0,1,0,1,0,0,0
110,公立,一般大學,0044,國立體育大學,博士班,馬來西亞,東協,1,1,0,1,1,0,0,0,0,0,0,0,0,0,0
110,公立,一般大學,0044,國立體育大學,博士班,澳門,港澳,1,1,0,0,0,0,0,0,0,1,1,0,0,0,0
110,公立,技專校院,0046,國立臺北護理健康大學,學士班(日間),泰國,東協,2,0,2,0,0,0,2,0,2,0,0,0,0,0,0
110,公立,技專校院,0046,國立臺北護理健康大學,學士班(日間),馬來西亞,東協,30,7,23,1,0,1,29,7,22,0,0,0,0,0,0
110,公立,技專校院,0046,國立臺北護理健康大學,學士班(日間),菲律賓共和國,東協,1,0,1,0,0,0,1,0,1,0,0,0,0,0,0
110,公立,技專校院,0046,國立臺北護理健康大學,學士班(日間),阿根廷,中南美洲,1,1,0,0,0,0,1,1,0,0,0,0,0,0,0
110,公立,技專校院,0046,國立臺北護理健康大學,學士班(日間),香港,港澳,47,24,23,0,0,0,0,0,0,47,24,23,0,0,0
110,公立,技專校院,0046,國立臺北護理健康大學,學士班(日間),越南社會主義共和國,東協,2,0,2,0,0,0,2,0,2,0,0,0,0,0,0
110,公立,技專校院,0046,國立臺北護理健康大學,學士班(日間),緬甸,東協,3,0,3,0,0,0,3,0,3,0,0,0,0,0,0
110,公立,技專校院,0046,國立臺北護理健康大學,學士班(日間),澳門,港澳,23,5,18,0,0,0,0,0,0,23,5,18,0,0,0
110,公立,技專校院,0046,國立臺北護理健康大學,碩士班(日間),巴布亞紐幾內亞獨立國,其他亞洲地區,1,0,1,1,0,1,0,0,0,0,0,0,0,0,0
110,公立,技專校院,0046,國立臺北護理健康大學,碩士班(日間),史瓦帝尼王國,非洲,3,0,3,3,0,3,0,0,0,0,0,0,0,0,0
110,公立,技專校院,0046,國立臺北護理健康大學,碩士班(日間),甘比亞共和國,非洲,3,1,2,3,1,2,0,0,0,0,0,0,0,0,0
110,公立,技專校院,0046,國立臺北護理健康大學,碩士班(日間),帛琉共和國,其他亞洲地區,1,0,1,1,0,1,0,0,0,0,0,0,0,0,0
110,公立,技專校院,0046,國立臺北護理健康大學,碩士班(日間),香港,港澳,4,1,3,0,0,0,0,0,0,4,1,3,0,0,0
110,公立,技專校院,0046,國立臺北護理健康大學,碩士班(日間),智利,中南美洲,1,0,1,1,0,1,0,0,0,0,0,0,0,0,0
110,公立,技專校院,0046,國立臺北護理健康大學,碩士班(日間),越南社會主義共和國,東協,3,0,3,3,0,3,0,0,0,0,0,0,0,0,0
110,公立,技專校院,0046,國立臺北護理健康大學,碩士班(日間),緬甸,東協,1,1,0,0,0,0,1,1,0,0,0,0,0,0,0
110,公立,技專校院,0046,國立臺北護理健康大學,碩士班(日間),澳門,港澳,3,1,2,0,0,0,0,0,0,3,1,2,0,0,0
110,公立,技專校院,0046,國立臺北護理健康大學,碩士班(日間),印度尼西亞共和國,東協,8,3,5,8,3,5,0,0,0,0,0,0,0,0,0
110,公立,技專校院,0046,國立臺北護理健康大學,碩士班(日間),約旦哈什米王國,其他亞洲地區,1,1,0,1,1,0,0,0,0,0,0,0,0,0,0
110,公立,技專校院,0046,國立臺北護理健康大學,碩士班(日間),泰國,東協,1,0,1,1,0,1,0,0,0,0,0,0,0,0,0
110,公立,技專校院,0046,國立臺北護理健康大學,碩士班(日間),馬來西亞,東協,9,3,6,3,1,2,6,2,4,0,0,0,0,0,0
110,公立,技專校院,0046,國立臺北護理健康大學,碩士班(日間),馬拉威共和國,非洲,3,1,2,3,1,2,0,0,0,0,0,0,0,0,0
110,公立,技專校院,0046,國立臺北護理健康大學,博士班,印度尼西亞共和國,東協,15,7,8,15,7,8,0,0,0,0,0,0,0,0,0
110,公立,技專校院,0046,國立臺北護理健康大學,博士班,宏都拉斯共和國,中南美洲,1,1,0,1,1,0,0,0,0,0,0,0,0,0,0
110,公立,技專校院,0046,國立臺北護理健康大學,博士班,孟加拉人民共和國,南亞,1,0,1,1,0,1,0,0,0,0,0,0,0,0,0
110,公立,技專校院,0046,國立臺北護理健康大學,博士班,越南社會主義共和國,東協,2,0,2,2,0,2,0,0,0,0,0,0,0,0,0
110,公立,技專校院,0046,國立臺北護理健康大學,博士班,波蘭共和國,歐洲,1,0,1,1,0,1,0,0,0,0,0,0,0,0,0
110,公立,技專校院,0047,國立高雄餐旅大學,學士班(日間),巴拿馬共和國,中南美洲,1,1,0,1,1,0,0,0,0,0,0,0,0,0,0
110,公立,技專校院,0047,國立高雄餐旅大學,學士班(日間),日本,其他亞洲地區,17,5,12,15,4,11,2,1,1,0,0,0,0,0,0
110,公立,技專校院,0047,國立高雄餐旅大學,學士班(日間),史瓦帝尼王國,非洲,1,0,1,1,0,1,0,0,0,0,0,0,0,0,0
110,公立,技專校院,0047,國立高雄餐旅大學,學士班(日間),法國,歐洲,2,1,1,2,1,1,0,0,0,0,0,0,0,0,0
110,公立,技專校院,0047,國立高雄餐旅大學,學士班(日間),美國,北美洲,2,1,1,1,0,1,1,1,0,0,0,0,0,0,0
110,公立,技專校院,0047,國立高雄餐旅大學,學士班(日間),香港,港澳,17,7,10,0,0,0,0,0,0,17,7,10,0,0,0
110,公立,技專校院,0047,國立高雄餐旅大學,學士班(日間),泰國,東協,8,3,5,5,1,4,3,2,1,0,0,0,0,0,0
110,公立,技專校院,0047,國立高雄餐旅大學,學士班(日間),緬甸,東協,3,0,3,0,0,0,3,0,3,0,0,0,0,0,0
110,公立,技專校院,0047,國立高雄餐旅大學,學士班(日間),澳門,港澳,11,7,4,0,0,0,0,0,0,11,7,4,0,0,0
110,公立,技專校院,0047,國立高雄餐旅大學,學士班(日間),大韓民國(南韓),其他亞洲地區,4,1,3,4,1,3,0,0,0,0,0,0,0,0,0
110,公立,技專校院,0047,國立高雄餐旅大學,學士班(日間),巴拉圭,中南美洲,3,3,0,3,3,0,0,0,0,0,0,0,0,0,0
110,公立,技專校院,0047,國立高雄餐旅大學,學士班(日間),印度尼西亞共和國,東協,128,36,92,73,20,53,55,16,39,0,0,0,0,0,0
110,公立,技專校院,0047,國立高雄餐旅大學,學士班(日間),多明尼加共和國,中南美洲,1,1,0,0,0,0,1,1,0,0,0,0,0,0,0
110,公立,技專校院,0047,國立高雄餐旅大學,學士班(日間),阿拉伯聯合大公國,其他亞洲地區,1,1,0,0,0,0,1,1,0,0,0,0,0,0,0
110,公立,技專校院,0047,國立高雄餐旅大學,學士班(日間),馬來西亞,東協,97,39,58,34,17,17,63,22,41,0,0,0,0,0,0
110,公立,技專校院,0047,國立高雄餐旅大學,學士班(日間),菲律賓共和國,東協,6,3,3,5,3,2,1,0,1,0,0,0,0,0,0
110,公立,技專校院,0047,國立高雄餐旅大學,學士班(日間),越南社會主義共和國,東協,14,5,9,11,4,7,3,1,2,0,0,0,0,0,0
110,公立,技專校院,0047,國立高雄餐旅大學,學士班(日間),新加坡共和國,東協,1,0,1,1,0,1,0,0,0,0,0,0,0,0,0
110,公立,技專校院,0047,國立高雄餐旅大學,學士班(日間),聖文森(及格瑞那丁),中南美洲,3,0,3,3,0,3,0,0,0,0,0,0,0,0,0
110,公立,技專校院,0047,國立高雄餐旅大學,學士班(日間),聖露西亞,中南美洲,1,0,1,1,0,1,0,0,0,0,0,0,0,0,0
110,公立,技專校院,0047,國立高雄餐旅大學,學士班(日間),薩爾瓦多,中南美洲,2,2,0,1,1,0,1,1,0,0,0,0,0,0,0
110,公立,技專校院,0047,國立高雄餐旅大學,碩士班(日間),馬來西亞,東協,4,0,4,3,0,3,1,0,1,0,0,0,0,0,0
110,公立,技專校院,0047,國立高雄餐旅大學,碩士班(日間),越南社會主義共和國,東協,2,1,1,2,1,1,0,0,0,0,0,0,0,0,0
110,公立,技專校院,0047,國立高雄餐旅大學,碩士班(日間),印度尼西亞共和國,東協,7,3,4,5,1,4,2,2,0,0,0,0,0,0,0
110,公立,技專校院,0047,國立高雄餐旅大學,碩士班(日間),阿根廷,中南美洲,1,1,0,0,0,0,1,1,0,0,0,0,0,0,0
110,公立,技專校院,0047,國立高雄餐旅大學,碩士班(日間),美國,北美洲,1,1,0,1,1,0,0,0,0,0,0,0,0,0,0
110,公立,技專校院,0047,國立高雄餐旅大學,碩士班(日間),迦納共和國,非洲,1,1,0,1,1,0,0,0,0,0,0,0,0,0,0
110,公立,技專校院,0047,國立高雄餐旅大學,碩士班(日間),香港,港澳,4,1,3,0,0,0,0,0,0,4,1,3,0,0,0
110,公立,技專校院,0047,國立高雄餐旅大學,碩士班(日間),泰國,東協,2,0,2,2,0,2,0,0,0,0,0,0,0,0,0
110,公立,技專校院,0047,國立高雄餐旅大學,碩士班(日間),斯里蘭卡民主社會主義共和國,南亞,1,1,0,1,1,0,0,0,0,0,0,0,0,0,0
110,公立,技專校院,0047,國立高雄餐旅大學,博士班,泰國,東協,2,2,0,2,2,0,0,0,0,0,0,0,0,0,0
110,公立,技專校院,0047,國立高雄餐旅大學,博士班,菲律賓共和國,東協,1,0,1,1,0,1,0,0,0,0,0,0,0,0,0
110,公立,技專校院,0047,國立高雄餐旅大學,博士班,越南社會主義共和國,東協,3,2,1,3,2,1,0,0,0,0,0,0,0,0,0
110,公立,技專校院,0047,國立高雄餐旅大學,博士班,大陸地區,大陸地區,4,0,4,0,0,0,0,0,0,0,0,0,4,0,4
110,公立,一般大學,0048,國立金門大學,學士班(日間),巴布亞紐幾內亞獨立國,其他亞洲地區,1,1,0,0,0,0,1,1,0,0,0,0,0,0,0
110,公立,一般大學,0048,國立金門大學,學士班(日間),印度尼西亞共和國,東協,54,24,30,9,2,7,45,22,23,0,0,0,0,0,0
110,公立,一般大學,0048,國立金門大學,學士班(日間),阿根廷,中南美洲,1,1,0,0,0,0,1,1,0,0,0,0,0,0,0
110,公立,一般大學,0048,國立金門大學,學士班(日間),泰國,東協,1,0,1,1,0,1,0,0,0,0,0,0,0,0,0
110,公立,一般大學,0048,國立金門大學,學士班(日間),越南社會主義共和國,東協,2,1,1,2,1,1,0,0,0,0,0,0,0,0,0
110,公立,一般大學,0048,國立金門大學,學士班(日間),澳門,港澳,1,1,0,0,0,0,0,0,0,1,1,0,0,0,0
110,公立,一般大學,0048,國立金門大學,學士班(日間),大陸地區,大陸地區,35,19,16,0,0,0,0,0,0,0,0,0,35,19,16
110,公立,一般大學,0048,國立金門大學,學士班(日間),大韓民國(南韓),其他亞洲地區,2,1,1,2,1,1,0,0,0,0,0,0,0,0,0
110,公立,一般大學,0048,國立金門大學,學士班(日間),香港,港澳,7,3,4,0,0,0,0,0,0,7,3,4,0,0,0
110,公立,一般大學,0048,國立金門大學,學士班(日間),馬來西亞,東協,22,16,6,0,0,0,22,16,6,0,0,0,0,0,0
110,公立,一般大學,0048,國立金門大學,碩士班(日間),香港,港澳,2,2,0,0,0,0,0,0,0,2,2,0,0,0,0
110,公立,一般大學,0048,國立金門大學,碩士班(日間),馬來西亞,東協,4,2,2,0,0,0,4,2,2,0,0,0,0,0,0
110,公立,一般大學,0048,國立金門大學,碩士班(日間),菲律賓共和國,東協,1,0,1,1,0,1,0,0,0,0,0,0,0,0,0
110,公立,一般大學,0048,國立金門大學,碩士班(日間),大陸地區,大陸地區,12,8,4,0,0,0,0,0,0,0,0,0,12,8,4
110,公立,一般大學,0048,國立金門大學,碩士班(日間),印度尼西亞共和國,東協,10,3,7,3,0,3,7,3,4,0,0,0,0,0,0
110,公立,一般大學,0048,國立金門大學,碩士班(日間),泰國,東協,1,0,1,1,0,1,0,0,0,0,0,0,0,0,0
110,公立,一般大學,0048,國立金門大學,碩士班(日間),越南社會主義共和國,東協,6,0,6,6,0,6,0,0,0,0,0,0,0,0,0
110,公立,一般大學,0049,國立臺灣體育運動大學,學士班(日間),大韓民國(南韓),其他亞洲地區,7,4,3,7,4,3,0,0,0,0,0,0,0,0,0
110,公立,一般大學,0049,國立臺灣體育運動大學,學士班(日間),印度尼西亞共和國,東協,2,2,0,1,1,0,1,1,0,0,0,0,0,0,0
110,公立,一般大學,0049,國立臺灣體育運動大學,學士班(日間),馬來西亞,東協,28,15,13,2,1,1,26,14,12,0,0,0,0,0,0
110,公立,一般大學,0049,國立臺灣體育運動大學,學士班(日間),巴拉圭,中南美洲,1,1,0,1,1,0,0,0,0,0,0,0,0,0,0
110,公立,一般大學,0049,國立臺灣體育運動大學,學士班(日間),日本,其他亞洲地區,4,1,3,4,1,3,0,0,0,0,0,0,0,0,0
110,公立,一般大學,0049,國立臺灣體育運動大學,學士班(日間),香港,港澳,33,23,10,0,0,0,0,0,0,33,23,10,0,0,0
110,公立,一般大學,0049,國立臺灣體育運動大學,學士班(日間),越南社會主義共和國,東協,1,0,1,0,0,0,1,0,1,0,0,0,0,0,0
110,公立,一般大學,0049,國立臺灣體育運動大學,學士班(日間),澳門,港澳,8,6,2,0,0,0,0,0,0,8,6,2,0,0,0
110,公立,一般大學,0049,國立臺灣體育運動大學,碩士班(日間),日本,其他亞洲地區,1,1,0,1,1,0,0,0,0,0,0,0,0,0,0
110,公立,一般大學,0049,國立臺灣體育運動大學,碩士班(日間),香港,港澳,6,3,3,0,0,0,0,0,0,6,3,3,0,0,0
110,公立,一般大學,0049,國立臺灣體育運動大學,碩士班(日間),澳門,港澳,1,1,0,0,0,0,0,0,0,1,1,0,0,0,0
110,公立,一般大學,0049,國立臺灣體育運動大學,碩士班(日間),大陸地區,大陸地區,1,0,1,0,0,0,0,0,0,0,0,0,1,0,1
110,公立,一般大學,0049,國立臺灣體育運動大學,碩士班(日間),印度尼西亞共和國,東協,1,0,1,0,0,0,1,0,1,0,0,0,0,0,0
110,公立,一般大學,0049,國立臺灣體育運動大學,碩士班(日間),馬來西亞,東協,5,3,2,1,0,1,4,3,1,0,0,0,0,0,0
110,公立,一般大學,0049,國立臺灣體育運動大學,博士班,馬來西亞,東協,1,0,1,1,0,1,0,0,0,0,0,0,0,0,0
110,公立,一般大學,0049,國立臺灣體育運動大學,博士班,越南社會主義共和國,東協,6,3,3,6,3,3,0,0,0,0,0,0,0,0,0
110,公立,技專校院,0050,國立臺中科技大學,五專,印度尼西亞共和國,東協,2,0,2,0,0,0,2,0,2,0,0,0,0,0,0
110,公立,技專校院,0050,國立臺中科技大學,五專,泰國,東協,1,0,1,0,0,0,1,0,1,0,0,0,0,0,0
110,公立,技專校院,0050,國立臺中科技大學,學士班(日間),印度尼西亞共和國,東協,65,27,38,0,0,0,65,27,38,0,0,0,0,0,0
110,公立,技專校院,0050,國立臺中科技大學,學士班(日間),泰國,東協,4,1,3,0,0,0,4,1,3,0,0,0,0,0,0
110,公立,技專校院,0050,國立臺中科技大學,學士班(日間),馬來西亞,東協,50,37,13,2,2,0,48,35,13,0,0,0,0,0,0
110,公立,技專校院,0050,國立臺中科技大學,學士班(日間),菲律賓共和國,東協,1,0,1,1,0,1,0,0,0,0,0,0,0,0,0
110,公立,技專校院,0050,國立臺中科技大學,學士班(日間),越南社會主義共和國,東協,17,4,13,12,3,9,5,1,4,0,0,0,0,0,0
110,公立,技專校院,0050,國立臺中科技大學,學士班(日間),墨西哥合眾國,中南美洲,1,1,0,0,0,0,1,1,0,0,0,0,0,0,0
110,公立,技專校院,0050,國立臺中科技大學,學士班(日間),澳門,港澳,5,2,3,0,0,0,0,0,0,5,2,3,0,0,0
110,公立,技專校院,0050,國立臺中科技大學,學士班(日間),大陸地區,大陸地區,5,4,1,0,0,0,0,0,0,0,0,0,5,4,1
110,公立,技專校院,0050,國立臺中科技大學,學士班(日間),日本,其他亞洲地區,8,5,3,5,4,1,3,1,2,0,0,0,0,0,0
110,公立,技專校院,0050,國立臺中科技大學,學士班(日間),奈及利亞聯邦共和國,非洲,2,2,0,2,2,0,0,0,0,0,0,0,0,0,0
110,公立,技專校院,0050,國立臺中科技大學,學士班(日間),美國,北美洲,1,0,1,0,0,0,1,0,1,0,0,0,0,0,0
110,公立,技專校院,0050,國立臺中科技大學,學士班(日間),香港,港澳,46,24,22,0,0,0,0,0,0,46,24,22,0,0,0
110,公立,技專校院,0050,國立臺中科技大學,學士班(日間),德意志聯邦共和國,歐洲,1,0,1,0,0,0,1,0,1,0,0,0,0,0,0
110,公立,技專校院,0050,國立臺中科技大學,學士班(日間),緬甸,東協,4,1,3,0,0,0,4,1,3,0,0,0,0,0,0
110,公立,技專校院,0050,國立臺中科技大學,碩士班(日間),布吉納法索,非洲,1,1,0,1,1,0,0,0,0,0,0,0,0,0,0
110,公立,技專校院,0050,國立臺中科技大學,碩士班(日間),馬來西亞,東協,3,2,1,1,1,0,2,1,1,0,0,0,0,0,0
110,公立,技專校院,0050,國立臺中科技大學,碩士班(日間),大陸地區,大陸地區,5,4,1,0,0,0,0,0,0,0,0,0,5,4,1
110,公立,技專校院,0050,國立臺中科技大學,碩士班(日間),香港,港澳,6,3,3,0,0,0,0,0,0,6,3,3,0,0,0
110,公立,技專校院,0051,國立臺北商業大學,五專,阿根廷,中南美洲,2,1,1,0,0,0,2,1,1,0,0,0,0,0,0
110,公立,技專校院,0051,國立臺北商業大學,五專,越南社會主義共和國,東協,2,0,2,0,0,0,2,0,2,0,0,0,0,0,0
110,公立,技專校院,0051,國立臺北商業大學,五專,巴西聯邦共和國,中南美洲,1,0,1,0,0,0,1,0,1,0,0,0,0,0,0
110,公立,技專校院,0051,國立臺北商業大學,五專,印度尼西亞共和國,東協,5,1,4,0,0,0,5,1,4,0,0,0,0,0,0
110,公立,技專校院,0051,國立臺北商業大學,五專,泰國,東協,1,0,1,0,0,0,1,0,1,0,0,0,0,0,0
110,公立,技專校院,0051,國立臺北商業大學,學士班(日間),貝里斯,中南美洲,1,1,0,0,0,0,1,1,0,0,0,0,0,0,0
110,公立,技專校院,0051,國立臺北商業大學,學士班(日間),香港,港澳,5,2,3,0,0,0,0,0,0,5,2,3,0,0,0
110,公立,技專校院,0051,國立臺北商業大學,學士班(日間),馬來西亞,東協,41,24,17,0,0,0,41,24,17,0,0,0,0,0,0
110,公立,技專校院,0051,國立臺北商業大學,學士班(日間),智利,中南美洲,1,0,1,0,0,0,1,0,1,0,0,0,0,0,0
110,公立,技專校院,0051,國立臺北商業大學,學士班(日間),菲律賓共和國,東協,1,0,1,0,0,0,1,0,1,0,0,0,0,0,0
110,公立,技專校院,0051,國立臺北商業大學,學士班(日間),越南社會主義共和國,東協,67,12,55,31,2,29,36,10,26,0,0,0,0,0,0
110,公立,技專校院,0051,國立臺北商業大學,學士班(日間),澳門,港澳,1,1,0,0,0,0,0,0,0,1,1,0,0,0,0
110,公立,技專校院,0051,國立臺北商業大學,學士班(日間),大陸地區,大陸地區,6,2,4,0,0,0,0,0,0,0,0,0,6,2,4
110,公立,技專校院,0051,國立臺北商業大學,學士班(日間),日本,其他亞洲地區,3,1,2,2,1,1,1,0,1,0,0,0,0,0,0
110,公立,技專校院,0051,國立臺北商業大學,學士班(日間),印度尼西亞共和國,東協,34,15,19,3,0,3,31,15,16,0,0,0,0,0,0
110,公立,技專校院,0051,國立臺北商業大學,學士班(日間),阿根廷,中南美洲,1,0,1,0,0,0,1,0,1,0,0,0,0,0,0
110,公立,技專校院,0051,國立臺北商業大學,學士班(日間),南非共和國,非洲,2,1,1,2,1,1,0,0,0,0,0,0,0,0,0
110,公立,技專校院,0051,國立臺北商業大學,學士班(日間),泰國,東協,1,0,1,1,0,1,0,0,0,0,0,0,0,0,0
110,公立,技專校院,0051,國立臺北商業大學,學士班(日間),緬甸,東協,29,7,22,0,0,0,29,7,22,0,0,0,0,0,0
110,公立,技專校院,0051,國立臺北商業大學,碩士班(日間),大陸地區,大陸地區,7,6,1,0,0,0,0,0,0,0,0,0,7,6,1
110,公立,技專校院,0051,國立臺北商業大學,碩士班(日間),日本,其他亞洲地區,1,0,1,1,0,1,0,0,0,0,0,0,0,0,0
110,公立,技專校院,0051,國立臺北商業大學,碩士班(日間),香港,港澳,1,1,0,0,0,0,0,0,0,1,1,0,0,0,0
110,公立,技專校院,0051,國立臺北商業大學,碩士班(日間),澳門,港澳,2,2,0,0,0,0,0,0,0,2,2,0,0,0,0
110,公立,技專校院,0051,國立臺北商業大學,碩士班(日間),越南社會主義共和國,東協,3,0,3,3,0,3,0,0,0,0,0,0,0,0,0
110,公立,技專校院,0051,國立臺北商業大學,碩士班(日間),緬甸,東協,1,0,1,0,0,0,1,0,1,0,0,0,0,0,0
110,公立,一般大學,0052,國立屏東大學,學士班(日間),俄羅斯聯邦,其他亞洲地區,1,0,1,1,0,1,0,0,0,0,0,0,0,0,0
110,公立,一般大學,0052,國立屏東大學,學士班(日間),哥倫比亞共和國,中南美洲,1,0,1,1,0,1,0,0,0,0,0,0,0,0,0
110,公立,一般大學,0052,國立屏東大學,學士班(日間),泰國,東協,2,0,2,2,0,2,0,0,0,0,0,0,0,0,0
110,公立,一般大學,0052,國立屏東大學,學士班(日間),馬來西亞,東協,48,24,24,4,1,3,44,23,21,0,0,0,0,0,0
110,公立,一般大學,0052,國立屏東大學,學士班(日間),越南社會主義共和國,東協,9,3,6,9,3,6,0,0,0,0,0,0,0,0,0
110,公立,一般大學,0052,國立屏東大學,學士班(日間),奧地利共和國,歐洲,1,1,0,1,1,0,0,0,0,0,0,0,0,0,0
110,公立,一般大學,0052,國立屏東大學,學士班(日間),澳門,港澳,15,8,7,0,0,0,0,0,0,15,8,7,0,0,0
110,公立,一般大學,0052,國立屏東大學,學士班(日間),大陸地區,大陸地區,10,9,1,0,0,0,0,0,0,0,0,0,10,9,1
110,公立,一般大學,0052,國立屏東大學,學士班(日間),日本,其他亞洲地區,2,2,0,1,1,0,1,1,0,0,0,0,0,0,0
110,公立,一般大學,0052,國立屏東大學,學士班(日間),印度尼西亞共和國,東協,2,2,0,0,0,0,2,2,0,0,0,0,0,0,0
110,公立,一般大學,0052,國立屏東大學,學士班(日間),西班牙王國,歐洲,1,1,0,1,1,0,0,0,0,0,0,0,0,0,0
110,公立,一般大學,0052,國立屏東大學,學士班(日間),香港,港澳,28,12,16,0,0,0,0,0,0,28,12,16,0,0,0
110,公立,一般大學,0052,國立屏東大學,學士班(日間),義大利共和國,歐洲,1,0,1,1,0,1,0,0,0,0,0,0,0,0,0
110,公立,一般大學,0052,國立屏東大學,學士班(日間),緬甸,東協,1,0,1,0,0,0,1,0,1,0,0,0,0,0,0
110,公立,一般大學,0052,國立屏東大學,碩士班(日間),大陸地區,大陸地區,2,1,1,0,0,0,0,0,0,0,0,0,2,1,1
110,公立,一般大學,0052,國立屏東大學,碩士班(日間),印度尼西亞共和國,東協,11,2,9,9,1,8,2,1,1,0,0,0,0,0,0
110,公立,一般大學,0052,國立屏東大學,碩士班(日間),香港,港澳,1,1,0,0,0,0,0,0,0,1,1,0,0,0,0
110,公立,一般大學,0052,國立屏東大學,碩士班(日間),立陶宛共和國,歐洲,1,0,1,1,0,1,0,0,0,0,0,0,0,0,0
110,公立,一般大學,0052,國立屏東大學,碩士班(日間),泰國,東協,18,9,9,18,9,9,0,0,0,0,0,0,0,0,0
110,公立,一般大學,0052,國立屏東大學,碩士班(日間),索馬利蘭共和國,非洲,1,1,0,1,1,0,0,0,0,0,0,0,0,0,0
110,公立,一般大學,0052,國立屏東大學,碩士班(日間),馬來西亞,東協,10,4,6,6,2,4,4,2,2,0,0,0,0,0,0
110,公立,一般大學,0052,國立屏東大學,碩士班(日間),越南社會主義共和國,東協,4,1,3,4,1,3,0,0,0,0,0,0,0,0,0
110,公立,一般大學,0052,國立屏東大學,博士班,大陸地區,大陸地區,1,1,0,0,0,0,0,0,0,0,0,0,1,1,0
110,公立,一般大學,0052,國立屏東大學,博士班,印度尼西亞共和國,東協,2,2,0,2,2,0,0,0,0,0,0,0,0,0,0
110,公立,技專校院,0053,國立高雄科技大學,學士班(日間),大陸地區,大陸地區,11,8,3,0,0,0,0,0,0,0,0,0,11,8,3
110,公立,技專校院,0053,國立高雄科技大學,學士班(日間),日本,其他亞洲地區,11,5,6,10,4,6,1,1,0,0,0,0,0,0,0
110,公立,技專校院,0053,國立高雄科技大學,學士班(日間),香港,港澳,98,62,36,0,0,0,0,0,0,98,62,36,0,0,0
110,公立,技專校院,0053,國立高雄科技大學,學士班(日間),新加坡共和國,東協,1,1,0,0,0,0,1,1,0,0,0,0,0,0,0
110,公立,技專校院,0053,國立高雄科技大學,學士班(日間),緬甸,東協,4,3,1,0,0,0,4,3,1,0,0,0,0,0,0
110,公立,技專校院,0053,國立高雄科技大學,學士班(日間),澳門,港澳,5,4,1,0,0,0,0,0,0,5,4,1,0,0,0
110,公立,技專校院,0053,國立高雄科技大學,學士班(日間),大韓民國(南韓),其他亞洲地區,1,1,0,0,0,0,1,1,0,0,0,0,0,0,0
110,公立,技專校院,0053,國立高雄科技大學,學士班(日間),巴西聯邦共和國,中南美洲,1,0,1,0,0,0,1,0,1,0,0,0,0,0,0
110,公立,技專校院,0053,國立高雄科技大學,學士班(日間),印度尼西亞共和國,東協,51,32,19,2,1,1,49,31,18,0,0,0,0,0,0
110,公立,技專校院,0053,國立高雄科技大學,學士班(日間),阿根廷,中南美洲,1,0,1,0,0,0,1,0,1,0,0,0,0,0,0
110,公立,技專校院,0053,國立高雄科技大學,學士班(日間),南非共和國,非洲,2,0,2,2,0,2,0,0,0,0,0,0,0,0,0
110,公立,技專校院,0053,國立高雄科技大學,學士班(日間),泰國,東協,1,1,0,0,0,0,1,1,0,0,0,0,0,0,0
110,公立,技專校院,0053,國立高雄科技大學,學士班(日間),馬來西亞,東協,96,60,36,10,7,3,86,53,33,0,0,0,0,0,0
110,公立,技專校院,0053,國立高雄科技大學,學士班(日間),菲律賓共和國,東協,6,3,3,5,3,2,1,0,1,0,0,0,0,0,0
110,公立,技專校院,0053,國立高雄科技大學,學士班(日間),越南社會主義共和國,東協,34,10,24,26,8,18,8,2,6,0,0,0,0,0,0
110,公立,技專校院,0053,國立高雄科技大學,碩士班(日間),巴西聯邦共和國,中南美洲,1,1,0,1,1,0,0,0,0,0,0,0,0,0,0
110,公立,技專校院,0053,國立高雄科技大學,碩士班(日間),巴基斯坦,南亞,1,1,0,1,1,0,0,0,0,0,0,0,0,0,0
110,公立,技專校院,0053,國立高雄科技大學,碩士班(日間),加拿大,北美洲,1,1,0,1,1,0,0,0,0,0,0,0,0,0,0
110,公立,技專校院,0053,國立高雄科技大學,碩士班(日間),尼加拉瓜,中南美洲,2,1,1,2,1,1,0,0,0,0,0,0,0,0,0
110,公立,技專校院,0053,國立高雄科技大學,碩士班(日間),印度尼西亞共和國,東協,29,16,13,27,14,13,2,2,0,0,0,0,0,0,0
110,公立,技專校院,0053,國立高雄科技大學,碩士班(日間),多明尼加共和國,中南美洲,2,1,1,2,1,1,0,0,0,0,0,0,0,0,0
110,公立,技專校院,0053,國立高雄科技大學,碩士班(日間),阿爾及利亞人民民主共和國,非洲,1,1,0,1,1,0,0,0,0,0,0,0,0,0,0
110,公立,技專校院,0053,國立高雄科技大學,碩士班(日間),南非共和國,非洲,2,0,2,2,0,2,0,0,0,0,0,0,0,0,0
110,公立,技專校院,0053,國立高雄科技大學,碩士班(日間),泰國,東協,19,2,17,19,2,17,0,0,0,0,0,0,0,0,0
110,公立,技專校院,0053,國立高雄科技大學,碩士班(日間),馬來西亞,東協,6,3,3,2,0,2,4,3,1,0,0,0,0,0,0
110,公立,技專校院,0053,國立高雄科技大學,碩士班(日間),菲律賓共和國,東協,9,6,3,9,6,3,0,0,0,0,0,0,0,0,0
110,公立,技專校院,0053,國立高雄科技大學,碩士班(日間),越南社會主義共和國,東協,136,65,71,136,65,71,0,0,0,0,0,0,0,0,0
110,公立,技專校院,0053,國立高雄科技大學,碩士班(日間),奧地利共和國,歐洲,3,1,2,3,1,2,0,0,0,0,0,0,0,0,0
110,公立,技專校院,0053,國立高雄科技大學,碩士班(日間),蒙古國,其他亞洲地區,4,1,3,4,1,3,0,0,0,0,0,0,0,0,0
110,公立,技專校院,0053,國立高雄科技大學,碩士班(日間),大陸地區,大陸地區,1,1,0,0,0,0,0,0,0,0,0,0,1,1,0
110,公立,技專校院,0053,國立高雄科技大學,碩士班(日間),日本,其他亞洲地區,2,0,2,2,0,2,0,0,0,0,0,0,0,0,0
110,公立,技專校院,0053,國立高雄科技大學,碩士班(日間),印度,南亞,13,7,6,13,7,6,0,0,0,0,0,0,0,0,0
110,公立,技專校院,0053,國立高雄科技大學,碩士班(日間),貝里斯,中南美洲,1,1,0,1,1,0,0,0,0,0,0,0,0,0,0
110,公立,技專校院,0053,國立高雄科技大學,碩士班(日間),奈及利亞聯邦共和國,非洲,1,1,0,1,1,0,0,0,0,0,0,0,0,0,0
110,公立,技專校院,0053,國立高雄科技大學,碩士班(日間),委內瑞拉共和國,中南美洲,1,0,1,1,0,1,0,0,0,0,0,0,0,0,0
110,公立,技專校院,0053,國立高雄科技大學,碩士班(日間),波蘭共和國,歐洲,1,1,0,1,1,0,0,0,0,0,0,0,0,0,0
110,公立,技專校院,0053,國立高雄科技大學,碩士班(日間),柬埔寨王國,東協,3,3,0,3,3,0,0,0,0,0,0,0,0,0,0
110,公立,技專校院,0053,國立高雄科技大學,碩士班(日間),美國,北美洲,8,5,3,7,4,3,1,1,0,0,0,0,0,0,0
110,公立,技專校院,0053,國立高雄科技大學,碩士班(日間),香港,港澳,19,9,10,0,0,0,0,0,0,19,9,10,0,0,0
110,公立,技專校院,0053,國立高雄科技大學,碩士班(日間),德意志聯邦共和國,歐洲,2,2,0,2,2,0,0,0,0,0,0,0,0,0,0
110,公立,技專校院,0053,國立高雄科技大學,碩士班(日間),緬甸,東協,2,2,0,1,1,0,1,1,0,0,0,0,0,0,0
110,公立,技專校院,0053,國立高雄科技大學,博士班,史瓦帝尼王國,非洲,1,1,0,1,1,0,0,0,0,0,0,0,0,0,0
110,公立,技專校院,0053,國立高雄科技大學,博士班,印度尼西亞共和國,東協,14,13,1,14,13,1,0,0,0,0,0,0,0,0,0
110,公立,技專校院,0053,國立高雄科技大學,博士班,美國,北美洲,1,1,0,1,1,0,0,0,0,0,0,0,0,0,0
110,公立,技專校院,0053,國立高雄科技大學,博士班,埃及阿拉伯共和國,非洲,1,1,0,1,1,0,0,0,0,0,0,0,0,0,0
110,公立,技專校院,0053,國立高雄科技大學,博士班,泰國,東協,2,1,1,2,1,1,0,0,0,0,0,0,0,0,0
110,公立,技專校院,0053,國立高雄科技大學,博士班,菲律賓共和國,東協,9,4,5,9,4,5,0,0,0,0,0,0,0,0,0
110,公立,技專校院,0053,國立高雄科技大學,博士班,越南社會主義共和國,東協,85,52,33,85,52,33,0,0,0,0,0,0,0,0,0
110,公立,技專校院,0053,國立高雄科技大學,博士班,大陸地區,大陸地區,3,1,2,0,0,0,0,0,0,0,0,0,3,1,2
110,公立,技專校院,0053,國立高雄科技大學,博士班,巴基斯坦,南亞,15,12,3,15,12,3,0,0,0,0,0,0,0,0,0
110,公立,技專校院,0053,國立高雄科技大學,博士班,伊朗伊斯蘭共和國,其他亞洲地區,2,2,0,2,2,0,0,0,0,0,0,0,0,0,0
110,公立,技專校院,0053,國立高雄科技大學,博士班,印度,南亞,7,4,3,7,4,3,0,0,0,0,0,0,0,0,0
110,公立,技專校院,0053,國立高雄科技大學,博士班,貝里斯,中南美洲,2,0,2,2,0,2,0,0,0,0,0,0,0,0,0
110,公立,技專校院,0053,國立高雄科技大學,博士班,香港,港澳,3,3,0,0,0,0,0,0,0,3,3,0,0,0,0
110,公立,技專校院,0053,國立高雄科技大學,博士班,馬來西亞,東協,1,0,1,1,0,1,0,0,0,0,0,0,0,0,0
110,公立,技專校院,0053,國立高雄科技大學,博士班,蒙古國,其他亞洲地區,2,1,1,2,1,1,0,0,0,0,0,0,0,0,0
110,公立,技專校院,0144,國立臺灣戲曲學院,學士班(日間),大陸地區,大陸地區,6,0,6,0,0,0,0,0,0,0,0,0,6,0,6
110,公立,技專校院,0144,國立臺灣戲曲學院,學士班(日間),馬來西亞,東協,2,2,0,0,0,0,2,2,0,0,0,0,0,0,0
110,公立,技專校院,0144,國立臺灣戲曲學院,學士班(日間),香港,港澳,1,0,1,0,0,0,0,0,0,1,0,1,0,0,0
110,公立,技專校院,0221,國立臺南護理專科學校,五專,泰國,東協,1,0,1,0,0,0,1,0,1,0,0,0,0,0,0
110,公立,技專校院,0221,國立臺南護理專科學校,五專,印度尼西亞共和國,東協,1,0,1,0,0,0,1,0,1,0,0,0,0,0,0
110,公立,技專校院,0221,國立臺南護理專科學校,五專,阿根廷,中南美洲,1,1,0,0,0,0,1,1,0,0,0,0,0,0,0
110,私立,一般大學,1001,東海大學,學士班(日間),大陸地區,大陸地區,97,42,55,0,0,0,0,0,0,0,0,0,97,42,55
110,私立,一般大學,1001,東海大學,學士班(日間),大韓民國(南韓),其他亞洲地區,10,3,7,8,3,5,2,0,2,0,0,0,0,0,0
110,私立,一般大學,1001,東海大學,學士班(日間),日本,其他亞洲地區,58,18,40,57,18,39,1,0,1,0,0,0,0,0,0
110,私立,一般大學,1001,東海大學,學士班(日間),印度,南亞,1,0,1,1,0,1,0,0,0,0,0,0,0,0,0
110,私立,一般大學,1001,東海大學,學士班(日間),宏都拉斯共和國,中南美洲,2,1,1,2,1,1,0,0,0,0,0,0,0,0,0
110,私立,一般大學,1001,東海大學,學士班(日間),貝里斯,中南美洲,4,1,3,4,1,3,0,0,0,0,0,0,0,0,0
110,私立,一般大學,1001,東海大學,學士班(日間),南非共和國,非洲,3,2,1,3,2,1,0,0,0,0,0,0,0,0,0
110,私立,一般大學,1001,東海大學,學士班(日間),柬埔寨王國,東協,1,1,0,1,1,0,0,0,0,0,0,0,0,0,0
110,私立,一般大學,1001,東海大學,學士班(日間),香港,港澳,191,104,87,0,0,0,0,0,0,191,104,87,0,0,0
110,私立,一般大學,1001,東海大學,學士班(日間),馬拉威共和國,非洲,1,1,0,1,1,0,0,0,0,0,0,0,0,0,0
110,私立,一般大學,1001,東海大學,學士班(日間),智利,中南美洲,1,1,0,1,1,0,0,0,0,0,0,0,0,0,0
110,私立,一般大學,1001,東海大學,學士班(日間),聖克里斯多福及尼維斯,中南美洲,2,2,0,2,2,0,0,0,0,0,0,0,0,0,0
110,私立,一般大學,1001,東海大學,學士班(日間),葉門共和國,其他亞洲地區,1,1,0,1,1,0,0,0,0,0,0,0,0,0,0
110,私立,一般大學,1001,東海大學,學士班(日間),緬甸,東協,1,1,0,0,0,0,1,1,0,0,0,0,0,0,0
110,私立,一般大學,1001,東海大學,學士班(日間),諾魯共和國,其他亞洲地區,4,0,4,4,0,4,0,0,0,0,0,0,0,0,0
110,私立,一般大學,1001,東海大學,學士班(日間),巴西聯邦共和國,中南美洲,1,1,0,0,0,0,1,1,0,0,0,0,0,0,0
110,私立,一般大學,1001,東海大學,學士班(日間),以色列,其他亞洲地區,1,1,0,1,1,0,0,0,0,0,0,0,0,0,0
110,私立,一般大學,1001,東海大學,學士班(日間),加拿大,北美洲,3,3,0,3,3,0,0,0,0,0,0,0,0,0,0
110,私立,一般大學,1001,東海大學,學士班(日間),史瓦帝尼王國,非洲,4,2,2,4,2,2,0,0,0,0,0,0,0,0,0
110,私立,一般大學,1001,東海大學,學士班(日間),印度尼西亞共和國,東協,238,114,124,203,94,109,35,20,15,0,0,0,0,0,0
110,私立,一般大學,1001,東海大學,學士班(日間),吉爾吉斯,其他亞洲地區,5,4,1,5,4,1,0,0,0,0,0,0,0,0,0
110,私立,一般大學,1001,東海大學,學士班(日間),吐瓦魯,其他亞洲地區,1,0,1,1,0,1,0,0,0,0,0,0,0,0,0
110,私立,一般大學,1001,東海大學,學士班(日間),俄羅斯聯邦,其他亞洲地區,3,0,3,3,0,3,0,0,0,0,0,0,0,0,0
110,私立,一般大學,1001,東海大學,學士班(日間),美國,北美洲,3,1,2,2,1,1,1,0,1,0,0,0,0,0,0
110,私立,一般大學,1001,東海大學,學士班(日間),英國,歐洲,1,0,1,1,0,1,0,0,0,0,0,0,0,0,0
110,私立,一般大學,1001,東海大學,學士班(日間),泰國,東協,5,2,3,3,1,2,2,1,1,0,0,0,0,0,0
110,私立,一般大學,1001,東海大學,學士班(日間),馬來西亞,東協,101,55,46,48,29,19,53,26,27,0,0,0,0,0,0
110,私立,一般大學,1001,東海大學,學士班(日間),菲律賓共和國,東協,2,1,1,2,1,1,0,0,0,0,0,0,0,0,0
110,私立,一般大學,1001,東海大學,學士班(日間),越南社會主義共和國,東協,19,4,15,16,4,12,3,0,3,0,0,0,0,0,0
110,私立,一般大學,1001,東海大學,學士班(日間),聖露西亞,中南美洲,2,1,1,2,1,1,0,0,0,0,0,0,0,0,0
110,私立,一般大學,1001,東海大學,學士班(日間),蒙古國,其他亞洲地區,9,7,2,9,7,2,0,0,0,0,0,0,0,0,0
110,私立,一般大學,1001,東海大學,學士班(日間),澳門,港澳,36,23,13,0,0,0,0,0,0,36,23,13,0,0,0
110,私立,一般大學,1001,東海大學,學士班(日間),薩爾瓦多,中南美洲,1,0,1,1,0,1,0,0,0,0,0,0,0,0,0
110,私立,一般大學,1001,東海大學,碩士班(日間),土耳其共和國,其他亞洲地區,1,1,0,1,1,0,0,0,0,0,0,0,0,0,0
110,私立,一般大學,1001,東海大學,碩士班(日間),大陸地區,大陸地區,36,19,17,0,0,0,0,0,0,0,0,0,36,19,17
110,私立,一般大學,1001,東海大學,碩士班(日間),巴西聯邦共和國,中南美洲,1,0,1,1,0,1,0,0,0,0,0,0,0,0,0
110,私立,一般大學,1001,東海大學,碩士班(日間),尼加拉瓜,中南美洲,1,0,1,1,0,1,0,0,0,0,0,0,0,0,0
110,私立,一般大學,1001,東海大學,碩士班(日間),立陶宛共和國,歐洲,1,1,0,1,1,0,0,0,0,0,0,0,0,0,0
110,私立,一般大學,1001,東海大學,碩士班(日間),伊朗伊斯蘭共和國,其他亞洲地區,1,0,1,1,0,1,0,0,0,0,0,0,0,0,0
110,私立,一般大學,1001,東海大學,碩士班(日間),印度尼西亞共和國,東協,25,11,14,24,11,13,1,0,1,0,0,0,0,0,0
110,私立,一般大學,1001,東海大學,碩士班(日間),吉爾吉斯,其他亞洲地區,3,1,2,3,1,2,0,0,0,0,0,0,0,0,0
110,私立,一般大學,1001,東海大學,碩士班(日間),俄羅斯聯邦,其他亞洲地區,1,0,1,1,0,1,0,0,0,0,0,0,0,0,0
110,私立,一般大學,1001,東海大學,碩士班(日間),南非共和國,非洲,1,0,1,1,0,1,0,0,0,0,0,0,0,0,0
110,私立,一般大學,1001,東海大學,碩士班(日間),泰國,東協,5,1,4,5,1,4,0,0,0,0,0,0,0,0,0
110,私立,一般大學,1001,東海大學,碩士班(日間),馬來西亞,東協,20,10,10,13,8,5,7,2,5,0,0,0,0,0,0
110,私立,一般大學,1001,東海大學,碩士班(日間),菲律賓共和國,東協,1,0,1,1,0,1,0,0,0,0,0,0,0,0,0
110,私立,一般大學,1001,東海大學,碩士班(日間),越南社會主義共和國,東協,4,1,3,4,1,3,0,0,0,0,0,0,0,0,0
110,私立,一般大學,1001,東海大學,碩士班(日間),瑞士聯邦,歐洲,1,0,1,1,0,1,0,0,0,0,0,0,0,0,0
110,私立,一般大學,1001,東海大學,碩士班(日間),蒙古國,其他亞洲地區,2,1,1,2,1,1,0,0,0,0,0,0,0,0,0
110,私立,一般大學,1001,東海大學,碩士班(日間),澳門,港澳,7,4,3,0,0,0,0,0,0,7,4,3,0,0,0
110,私立,一般大學,1001,東海大學,碩士班(日間),羅馬尼亞,歐洲,1,0,1,1,0,1,0,0,0,0,0,0,0,0,0
110,私立,一般大學,1001,東海大學,碩士班(日間),大韓民國(南韓),其他亞洲地區,1,0,1,1,0,1,0,0,0,0,0,0,0,0,0
110,私立,一般大學,1001,東海大學,碩士班(日間),日本,其他亞洲地區,4,0,4,4,0,4,0,0,0,0,0,0,0,0,0
110,私立,一般大學,1001,東海大學,碩士班(日間),印度,南亞,4,3,1,4,3,1,0,0,0,0,0,0,0,0,0
110,私立,一般大學,1001,東海大學,碩士班(日間),西班牙王國,歐洲,1,1,0,1,1,0,0,0,0,0,0,0,0,0,0
110,私立,一般大學,1001,東海大學,碩士班(日間),委內瑞拉共和國,中南美洲,1,1,0,0,0,0,1,1,0,0,0,0,0,0,0
110,私立,一般大學,1001,東海大學,碩士班(日間),美國,北美洲,2,1,1,2,1,1,0,0,0,0,0,0,0,0,0
110,私立,一般大學,1001,東海大學,碩士班(日間),香港,港澳,24,17,7,0,0,0,0,0,0,24,17,7,0,0,0
110,私立,一般大學,1001,東海大學,碩士班(日間),馬拉威共和國,非洲,1,1,0,1,1,0,0,0,0,0,0,0,0,0,0
110,私立,一般大學,1001,東海大學,碩士班(日間),新加坡共和國,東協,1,1,0,1,1,0,0,0,0,0,0,0,0,0,0
110,私立,一般大學,1001,東海大學,碩士班(日間),義大利共和國,歐洲,1,1,0,1,1,0,0,0,0,0,0,0,0,0,0
110,私立,一般大學,1001,東海大學,博士班,大陸地區,大陸地區,17,8,9,0,0,0,0,0,0,0,0,0,17,8,9
110,私立,一般大學,1001,東海大學,博士班,巴布亞紐幾內亞獨立國,其他亞洲地區,1,1,0,1,1,0,0,0,0,0,0,0,0,0,0
110,私立,一般大學,1001,東海大學,博士班,加拿大,北美洲,1,1,0,1,1,0,0,0,0,0,0,0,0,0,0
110,私立,一般大學,1001,東海大學,博士班,白俄羅斯共和國,其他亞洲地區,1,0,1,1,0,1,0,0,0,0,0,0,0,0,0
110,私立,一般大學,1001,東海大學,博士班,印度尼西亞共和國,東協,18,7,11,18,7,11,0,0,0,0,0,0,0,0,0
110,私立,一般大學,1001,東海大學,博士班,馬來西亞,東協,2,2,0,0,0,0,2,2,0,0,0,0,0,0,0
110,私立,一般大學,1001,東海大學,博士班,越南社會主義共和國,東協,1,1,0,1,1,0,0,0,0,0,0,0,0,0,0
110,私立,一般大學,1001,東海大學,博士班,巴基斯坦,南亞,1,1,0,1,1,0,0,0,0,0,0,0,0,0,0
110,私立,一般大學,1001,東海大學,博士班,印度,南亞,5,3,2,5,3,2,0,0,0,0,0,0,0,0,0
110,私立,一般大學,1001,東海大學,博士班,衣索比亞聯邦民主共和國,非洲,1,1,0,1,1,0,0,0,0,0,0,0,0,0,0
110,私立,一般大學,1001,東海大學,博士班,新加坡共和國,東協,1,0,1,1,0,1,0,0,0,0,0,0,0,0,0
110,私立,一般大學,1002,輔仁大學,學士班(日間),史瓦帝尼王國,非洲,1,0,1,1,0,1,0,0,0,0,0,0,0,0,0
110,私立,一般大學,1002,輔仁大學,學士班(日間),美國,北美洲,7,4,3,1,1,0,6,3,3,0,0,0,0,0,0
110,私立,一般大學,1002,輔仁大學,學士班(日間),泰國,東協,6,2,4,4,2,2,2,0,2,0,0,0,0,0,0
110,私立,一般大學,1002,輔仁大學,學士班(日間),智利,中南美洲,1,0,1,0,0,0,1,0,1,0,0,0,0,0,0
110,私立,一般大學,1002,輔仁大學,學士班(日間),越南社會主義共和國,東協,48,7,41,41,7,34,7,0,7,0,0,0,0,0,0
110,私立,一般大學,1002,輔仁大學,學士班(日間),義大利共和國,歐洲,1,1,0,1,1,0,0,0,0,0,0,0,0,0,0
110,私立,一般大學,1002,輔仁大學,學士班(日間),蒙古國,其他亞洲地區,1,1,0,1,1,0,0,0,0,0,0,0,0,0,0
110,私立,一般大學,1002,輔仁大學,學士班(日間),緬甸,東協,1,1,0,0,0,0,1,1,0,0,0,0,0,0,0
110,私立,一般大學,1002,輔仁大學,學士班(日間),澳門,港澳,96,59,37,0,0,0,0,0,0,96,59,37,0,0,0
110,私立,一般大學,1002,輔仁大學,學士班(日間),大陸地區,大陸地區,86,31,55,0,0,0,0,0,0,0,0,0,86,31,55
110,私立,一般大學,1002,輔仁大學,學士班(日間),大韓民國(南韓),其他亞洲地區,30,15,15,29,14,15,1,1,0,0,0,0,0,0,0
110,私立,一般大學,1002,輔仁大學,學士班(日間),巴西聯邦共和國,中南美洲,2,1,1,2,1,1,0,0,0,0,0,0,0,0,0
110,私立,一般大學,1002,輔仁大學,學士班(日間),巴拿馬共和國,中南美洲,1,0,1,0,0,0,1,0,1,0,0,0,0,0,0
110,私立,一般大學,1002,輔仁大學,學士班(日間),日本,其他亞洲地區,34,9,25,31,7,24,3,2,1,0,0,0,0,0,0
110,私立,一般大學,1002,輔仁大學,學士班(日間),加拿大,北美洲,1,0,1,0,0,0,1,0,1,0,0,0,0,0,0
110,私立,一般大學,1002,輔仁大學,學士班(日間),布吉納法索,非洲,1,0,1,1,0,1,0,0,0,0,0,0,0,0,0
110,私立,一般大學,1002,輔仁大學,學士班(日間),印度尼西亞共和國,東協,45,9,36,21,4,17,24,5,19,0,0,0,0,0,0
110,私立,一般大學,1002,輔仁大學,學士班(日間),宏都拉斯共和國,中南美洲,1,0,1,1,0,1,0,0,0,0,0,0,0,0,0
110,私立,一般大學,1002,輔仁大學,學士班(日間),俄羅斯聯邦,其他亞洲地區,1,0,1,1,0,1,0,0,0,0,0,0,0,0,0
110,私立,一般大學,1002,輔仁大學,學士班(日間),南非共和國,非洲,1,1,0,0,0,0,1,1,0,0,0,0,0,0,0
110,私立,一般大學,1002,輔仁大學,學士班(日間),香港,港澳,230,120,110,0,0,0,0,0,0,230,120,110,0,0,0
110,私立,一般大學,1002,輔仁大學,學士班(日間),馬來西亞,東協,135,50,85,39,15,24,96,35,61,0,0,0,0,0,0
110,私立,一般大學,1002,輔仁大學,學士班(日間),新加坡共和國,東協,2,1,1,0,0,0,2,1,1,0,0,0,0,0,0
110,私立,一般大學,1002,輔仁大學,碩士班(日間),大陸地區,大陸地區,145,63,82,0,0,0,0,0,0,0,0,0,145,63,82
110,私立,一般大學,1002,輔仁大學,碩士班(日間),大韓民國(南韓),其他亞洲地區,7,4,3,6,3,3,1,1,0,0,0,0,0,0,0
110,私立,一般大學,1002,輔仁大學,碩士班(日間),加拿大,北美洲,2,1,1,1,0,1,1,1,0,0,0,0,0,0,0
110,私立,一般大學,1002,輔仁大學,碩士班(日間),印度,南亞,2,0,2,2,0,2,0,0,0,0,0,0,0,0,0
110,私立,一般大學,1002,輔仁大學,碩士班(日間),印度尼西亞共和國,東協,9,3,6,9,3,6,0,0,0,0,0,0,0,0,0
110,私立,一般大學,1002,輔仁大學,碩士班(日間),波蘭共和國,歐洲,1,1,0,1,1,0,0,0,0,0,0,0,0,0,0
110,私立,一般大學,1002,輔仁大學,碩士班(日間),香港,港澳,47,15,32,0,0,0,0,0,0,47,15,32,0,0,0
110,私立,一般大學,1002,輔仁大學,碩士班(日間),馬來西亞,東協,19,9,10,9,4,5,10,5,5,0,0,0,0,0,0
110,私立,一般大學,1002,輔仁大學,碩士班(日間),荷蘭王國,歐洲,1,1,0,1,1,0,0,0,0,0,0,0,0,0,0
110,私立,一般大學,1002,輔仁大學,碩士班(日間),菲律賓共和國,東協,2,1,1,2,1,1,0,0,0,0,0,0,0,0,0
110,私立,一般大學,1002,輔仁大學,碩士班(日間),瑞士聯邦,歐洲,1,0,1,1,0,1,0,0,0,0,0,0,0,0,0
110,私立,一般大學,1002,輔仁大學,碩士班(日間),澳大利亞,其他亞洲地區,1,1,0,1,1,0,0,0,0,0,0,0,0,0,0
110,私立,一般大學,1002,輔仁大學,碩士班(日間),日本,其他亞洲地區,17,4,13,15,4,11,2,0,2,0,0,0,0,0,0
110,私立,一般大學,1002,輔仁大學,碩士班(日間),西班牙王國,歐洲,1,0,1,1,0,1,0,0,0,0,0,0,0,0,0
110,私立,一般大學,1002,輔仁大學,碩士班(日間),法國,歐洲,4,1,3,4,1,3,0,0,0,0,0,0,0,0,0
110,私立,一般大學,1002,輔仁大學,碩士班(日間),美國,北美洲,2,1,1,2,1,1,0,0,0,0,0,0,0,0,0
110,私立,一般大學,1002,輔仁大學,碩士班(日間),泰國,東協,2,0,2,2,0,2,0,0,0,0,0,0,0,0,0
110,私立,一般大學,1002,輔仁大學,碩士班(日間),越南社會主義共和國,東協,11,3,8,10,3,7,1,0,1,0,0,0,0,0,0
110,私立,一般大學,1002,輔仁大學,碩士班(日間),義大利共和國,歐洲,1,1,0,1,1,0,0,0,0,0,0,0,0,0,0
110,私立,一般大學,1002,輔仁大學,碩士班(日間),澳門,港澳,12,4,8,0,0,0,0,0,0,12,4,8,0,0,0
110,私立,一般大學,1002,輔仁大學,博士班,比利時王國,歐洲,1,1,0,1,1,0,0,0,0,0,0,0,0,0,0
110,私立,一般大學,1002,輔仁大學,博士班,吉里巴斯共和國,其他亞洲地區,1,0,1,1,0,1,0,0,0,0,0,0,0,0,0
110,私立,一般大學,1002,輔仁大學,博士班,坦尚尼亞聯合共和國,非洲,1,0,1,1,0,1,0,0,0,0,0,0,0,0,0
110,私立,一般大學,1002,輔仁大學,博士班,波蘭共和國,歐洲,2,1,1,2,1,1,0,0,0,0,0,0,0,0,0
110,私立,一般大學,1002,輔仁大學,博士班,阿根廷,中南美洲,2,1,1,2,1,1,0,0,0,0,0,0,0,0,0
110,私立,一般大學,1002,輔仁大學,博士班,俄羅斯聯邦,其他亞洲地區,1,0,1,1,0,1,0,0,0,0,0,0,0,0,0
110,私立,一般大學,1002,輔仁大學,博士班,美國,北美洲,1,1,0,1,1,0,0,0,0,0,0,0,0,0,0
110,私立,一般大學,1002,輔仁大學,博士班,馬來西亞,東協,5,2,3,2,0,2,3,2,1,0,0,0,0,0,0
110,私立,一般大學,1002,輔仁大學,博士班,菲律賓共和國,東協,2,1,1,2,1,1,0,0,0,0,0,0,0,0,0
110,私立,一般大學,1002,輔仁大學,博士班,越南社會主義共和國,東協,3,2,1,3,2,1,0,0,0,0,0,0,0,0,0
110,私立,一般大學,1002,輔仁大學,博士班,義大利共和國,歐洲,2,1,1,2,1,1,0,0,0,0,0,0,0,0,0
110,私立,一般大學,1002,輔仁大學,博士班,大陸地區,大陸地區,45,25,20,0,0,0,0,0,0,0,0,0,45,25,20
110,私立,一般大學,1002,輔仁大學,博士班,日本,其他亞洲地區,4,1,3,4,1,3,0,0,0,0,0,0,0,0,0
110,私立,一般大學,1002,輔仁大學,博士班,加拿大,北美洲,1,1,0,0,0,0,1,1,0,0,0,0,0,0,0
110,私立,一般大學,1002,輔仁大學,博士班,印度,南亞,5,2,3,5,2,3,0,0,0,0,0,0,0,0,0
110,私立,一般大學,1002,輔仁大學,博士班,印度尼西亞共和國,東協,1,0,1,1,0,1,0,0,0,0,0,0,0,0,0
110,私立,一般大學,1002,輔仁大學,博士班,香港,港澳,1,1,0,0,0,0,0,0,0,1,1,0,0,0,0
110,私立,一般大學,1002,輔仁大學,博士班,斯里蘭卡民主社會主義共和國,南亞,2,1,1,2,1,1,0,0,0,0,0,0,0,0,0
110,私立,一般大學,1002,輔仁大學,博士班,新加坡共和國,東協,1,1,0,1,1,0,0,0,0,0,0,0,0,0,0
110,私立,一般大學,1003,東吳大學,學士班(日間),大陸地區,大陸地區,48,20,28,0,0,0,0,0,0,0,0,0,48,20,28
110,私立,一般大學,1003,東吳大學,學士班(日間),帛琉共和國,其他亞洲地區,1,0,1,1,0,1,0,0,0,0,0,0,0,0,0
110,私立,一般大學,1003,東吳大學,學士班(日間),美國,北美洲,1,1,0,0,0,0,1,1,0,0,0,0,0,0,0
110,私立,一般大學,1003,東吳大學,學士班(日間),香港,港澳,172,90,82,0,0,0,0,0,0,172,90,82,0,0,0
110,私立,一般大學,1003,東吳大學,學士班(日間),哥倫比亞共和國,中南美洲,1,1,0,1,1,0,0,0,0,0,0,0,0,0,0
110,私立,一般大學,1003,東吳大學,學士班(日間),越南社會主義共和國,東協,12,3,9,10,1,9,2,2,0,0,0,0,0,0,0
110,私立,一般大學,1003,東吳大學,學士班(日間),新加坡共和國,東協,1,0,1,1,0,1,0,0,0,0,0,0,0,0,0
110,私立,一般大學,1003,東吳大學,學士班(日間),澳門,港澳,56,28,28,0,0,0,0,0,0,56,28,28,0,0,0
110,私立,一般大學,1003,東吳大學,學士班(日間),大韓民國(南韓),其他亞洲地區,14,5,9,9,4,5,5,1,4,0,0,0,0,0,0
110,私立,一般大學,1003,東吳大學,學士班(日間),日本,其他亞洲地區,32,16,16,30,15,15,2,1,1,0,0,0,0,0,0
110,私立,一般大學,1003,東吳大學,學士班(日間),印度尼西亞共和國,東協,5,2,3,1,1,0,4,1,3,0,0,0,0,0,0
110,私立,一般大學,1003,東吳大學,學士班(日間),泰國,東協,2,0,2,1,0,1,1,0,1,0,0,0,0,0,0
110,私立,一般大學,1003,東吳大學,學士班(日間),馬來西亞,東協,55,25,30,14,6,8,41,19,22,0,0,0,0,0,0
110,私立,一般大學,1003,東吳大學,學士班(日間),澳大利亞,其他亞洲地區,1,1,0,0,0,0,1,1,0,0,0,0,0,0,0
110,私立,一般大學,1003,東吳大學,碩士班(日間),加拿大,北美洲,1,1,0,0,0,0,1,1,0,0,0,0,0,0,0
110,私立,一般大學,1003,東吳大學,碩士班(日間),俄羅斯聯邦,其他亞洲地區,1,1,0,1,1,0,0,0,0,0,0,0,0,0,0
110,私立,一般大學,1003,東吳大學,碩士班(日間),馬來西亞,東協,8,5,3,5,3,2,3,2,1,0,0,0,0,0,0
110,私立,一般大學,1003,東吳大學,碩士班(日間),越南社會主義共和國,東協,1,1,0,1,1,0,0,0,0,0,0,0,0,0,0
110,私立,一般大學,1003,東吳大學,碩士班(日間),大陸地區,大陸地區,35,15,20,0,0,0,0,0,0,0,0,0,35,15,20
110,私立,一般大學,1003,東吳大學,碩士班(日間),日本,其他亞洲地區,7,3,4,7,3,4,0,0,0,0,0,0,0,0,0
110,私立,一般大學,1003,東吳大學,碩士班(日間),印度,南亞,1,1,0,1,1,0,0,0,0,0,0,0,0,0,0
110,私立,一般大學,1003,東吳大學,碩士班(日間),奈及利亞聯邦共和國,非洲,1,1,0,1,1,0,0,0,0,0,0,0,0,0,0
110,私立,一般大學,1003,東吳大學,碩士班(日間),美國,北美洲,1,0,1,1,0,1,0,0,0,0,0,0,0,0,0
110,私立,一般大學,1003,東吳大學,碩士班(日間),香港,港澳,26,16,10,0,0,0,0,0,0,26,16,10,0,0,0
110,私立,一般大學,1003,東吳大學,碩士班(日間),澳門,港澳,4,2,2,0,0,0,0,0,0,4,2,2,0,0,0
110,私立,一般大學,1003,東吳大學,博士班,大陸地區,大陸地區,13,8,5,0,0,0,0,0,0,0,0,0,13,8,5
110,私立,一般大學,1003,東吳大學,博士班,日本,其他亞洲地區,16,5,11,16,5,11,0,0,0,0,0,0,0,0,0
110,私立,一般大學,1003,東吳大學,博士班,香港,港澳,1,0,1,0,0,0,0,0,0,1,0,1,0,0,0
110,私立,一般大學,1004,中原大學,學士班(日間),大陸地區,大陸地區,85,50,35,0,0,0,0,0,0,0,0,0,85,50,35
110,私立,一般大學,1004,中原大學,學士班(日間),大韓民國(南韓),其他亞洲地區,21,10,11,19,8,11,2,2,0,0,0,0,0,0,0
110,私立,一般大學,1004,中原大學,學士班(日間),厄瓜多共和國,中南美洲,1,0,1,0,0,0,1,0,1,0,0,0,0,0,0
110,私立,一般大學,1004,中原大學,學士班(日間),吉爾吉斯,其他亞洲地區,1,1,0,1,1,0,0,0,0,0,0,0,0,0,0
110,私立,一般大學,1004,中原大學,學士班(日間),多明尼加共和國,中南美洲,1,0,1,0,0,0,1,0,1,0,0,0,0,0,0
110,私立,一般大學,1004,中原大學,學士班(日間),香港,港澳,250,145,105,0,0,0,0,0,0,250,145,105,0,0,0
110,私立,一般大學,1004,中原大學,學士班(日間),海地共和國,中南美洲,1,1,0,1,1,0,0,0,0,0,0,0,0,0,0
110,私立,一般大學,1004,中原大學,學士班(日間),馬來西亞,東協,148,81,67,36,23,13,112,58,54,0,0,0,0,0,0
110,私立,一般大學,1004,中原大學,學士班(日間),菲律賓共和國,東協,4,1,3,3,0,3,1,1,0,0,0,0,0,0,0
110,私立,一般大學,1004,中原大學,學士班(日間),新加坡共和國,東協,2,0,2,0,0,0,2,0,2,0,0,0,0,0,0
110,私立,一般大學,1004,中原大學,學士班(日間),聖文森(及格瑞那丁),中南美洲,2,1,1,2,1,1,0,0,0,0,0,0,0,0,0
110,私立,一般大學,1004,中原大學,學士班(日間),聖克里斯多福及尼維斯,中南美洲,2,1,1,2,1,1,0,0,0,0,0,0,0,0,0
110,私立,一般大學,1004,中原大學,學士班(日間),薩爾瓦多,中南美洲,1,1,0,1,1,0,0,0,0,0,0,0,0,0,0
110,私立,一般大學,1004,中原大學,學士班(日間),日本,其他亞洲地區,87,38,49,86,37,49,1,1,0,0,0,0,0,0,0
110,私立,一般大學,1004,中原大學,學士班(日間),加拿大,北美洲,1,1,0,0,0,0,1,1,0,0,0,0,0,0,0
110,私立,一般大學,1004,中原大學,學士班(日間),史瓦帝尼王國,非洲,2,1,1,0,0,0,2,1,1,0,0,0,0,0,0
110,私立,一般大學,1004,中原大學,學士班(日間),印度尼西亞共和國,東協,118,55,63,59,26,33,59,29,30,0,0,0,0,0,0
110,私立,一般大學,1004,中原大學,學士班(日間),俄羅斯聯邦,其他亞洲地區,1,1,0,1,1,0,0,0,0,0,0,0,0,0,0
110,私立,一般大學,1004,中原大學,學士班(日間),美國,北美洲,2,1,1,1,1,0,1,0,1,0,0,0,0,0,0
110,私立,一般大學,1004,中原大學,學士班(日間),泰國,東協,3,1,2,2,1,1,1,0,1,0,0,0,0,0,0
110,私立,一般大學,1004,中原大學,學士班(日間),越南社會主義共和國,東協,67,20,47,63,19,44,4,1,3,0,0,0,0,0,0
110,私立,一般大學,1004,中原大學,學士班(日間),瑞典王國,歐洲,1,1,0,1,1,0,0,0,0,0,0,0,0,0,0
110,私立,一般大學,1004,中原大學,學士班(日間),寮人民民主共和國(寮國),東協,1,1,0,1,1,0,0,0,0,0,0,0,0,0,0
110,私立,一般大學,1004,中原大學,學士班(日間),澳門,港澳,59,33,26,0,0,0,0,0,0,59,33,26,0,0,0
110,私立,一般大學,1004,中原大學,碩士班(日間),大陸地區,大陸地區,13,11,2,0,0,0,0,0,0,0,0,0,13,11,2
110,私立,一般大學,1004,中原大學,碩士班(日間),日本,其他亞洲地區,1,0,1,1,0,1,0,0,0,0,0,0,0,0,0
110,私立,一般大學,1004,中原大學,碩士班(日間),甘比亞共和國,非洲,1,1,0,1,1,0,0,0,0,0,0,0,0,0,0
110,私立,一般大學,1004,中原大學,碩士班(日間),印度尼西亞共和國,東協,40,16,24,40,16,24,0,0,0,0,0,0,0,0,0
110,私立,一般大學,1004,中原大學,碩士班(日間),法國,歐洲,1,0,1,1,0,1,0,0,0,0,0,0,0,0,0
110,私立,一般大學,1004,中原大學,碩士班(日間),泰國,東協,1,0,1,1,0,1,0,0,0,0,0,0,0,0,0
110,私立,一般大學,1004,中原大學,碩士班(日間),越南社會主義共和國,東協,24,9,15,21,7,14,3,2,1,0,0,0,0,0,0
110,私立,一般大學,1004,中原大學,碩士班(日間),澳門,港澳,6,5,1,0,0,0,0,0,0,6,5,1,0,0,0
110,私立,一般大學,1004,中原大學,碩士班(日間),大韓民國(南韓),其他亞洲地區,1,0,1,1,0,1,0,0,0,0,0,0,0,0,0
110,私立,一般大學,1004,中原大學,碩士班(日間),巴基斯坦,南亞,2,2,0,2,2,0,0,0,0,0,0,0,0,0,0
110,私立,一般大學,1004,中原大學,碩士班(日間),印度,南亞,5,3,2,5,3,2,0,0,0,0,0,0,0,0,0
110,私立,一般大學,1004,中原大學,碩士班(日間),吉爾吉斯,其他亞洲地區,1,1,0,1,1,0,0,0,0,0,0,0,0,0,0
110,私立,一般大學,1004,中原大學,碩士班(日間),美國,北美洲,2,1,1,2,1,1,0,0,0,0,0,0,0,0,0
110,私立,一般大學,1004,中原大學,碩士班(日間),香港,港澳,15,12,3,0,0,0,0,0,0,15,12,3,0,0,0
110,私立,一般大學,1004,中原大學,碩士班(日間),秘魯共和國,中南美洲,1,1,0,1,1,0,0,0,0,0,0,0,0,0,0
110,私立,一般大學,1004,中原大學,碩士班(日間),馬來西亞,東協,8,5,3,2,2,0,6,3,3,0,0,0,0,0,0
110,私立,一般大學,1004,中原大學,碩士班(日間),菲律賓共和國,東協,11,6,5,11,6,5,0,0,0,0,0,0,0,0,0
110,私立,一般大學,1004,中原大學,碩士班(日間),蒙古國,其他亞洲地區,2,2,0,2,2,0,0,0,0,0,0,0,0,0,0
110,私立,一般大學,1004,中原大學,博士班,甘比亞共和國,非洲,2,2,0,2,2,0,0,0,0,0,0,0,0,0,0
110,私立,一般大學,1004,中原大學,博士班,印度,南亞,15,8,7,15,8,7,0,0,0,0,0,0,0,0,0
110,私立,一般大學,1004,中原大學,博士班,印度尼西亞共和國,東協,36,25,11,36,25,11,0,0,0,0,0,0,0,0,0
110,私立,一般大學,1004,中原大學,博士班,約旦哈什米王國,其他亞洲地區,1,1,0,1,1,0,0,0,0,0,0,0,0,0,0
110,私立,一般大學,1004,中原大學,博士班,美國,北美洲,1,1,0,1,1,0,0,0,0,0,0,0,0,0,0
110,私立,一般大學,1004,中原大學,博士班,秘魯共和國,中南美洲,1,0,1,1,0,1,0,0,0,0,0,0,0,0,0
110,私立,一般大學,1004,中原大學,博士班,馬來西亞,東協,1,0,1,0,0,0,1,0,1,0,0,0,0,0,0
110,私立,一般大學,1004,中原大學,博士班,菲律賓共和國,東協,16,12,4,16,12,4,0,0,0,0,0,0,0,0,0
110,私立,一般大學,1004,中原大學,博士班,大陸地區,大陸地區,22,13,9,0,0,0,0,0,0,0,0,0,22,13,9
110,私立,一般大學,1004,中原大學,博士班,大韓民國(南韓),其他亞洲地區,1,0,1,1,0,1,0,0,0,0,0,0,0,0,0
110,私立,一般大學,1004,中原大學,博士班,巴基斯坦,南亞,9,7,2,9,7,2,0,0,0,0,0,0,0,0,0
110,私立,一般大學,1004,中原大學,博士班,海地共和國,中南美洲,1,1,0,1,1,0,0,0,0,0,0,0,0,0,0
110,私立,一般大學,1004,中原大學,博士班,越南社會主義共和國,東協,9,8,1,9,8,1,0,0,0,0,0,0,0,0,0
110,私立,一般大學,1004,中原大學,博士班,蒙古國,其他亞洲地區,1,0,1,1,0,1,0,0,0,0,0,0,0,0,0
110,私立,一般大學,1005,淡江大學學校財團法人淡江大學,學士班(日間),大陸地區,大陸地區,125,58,67,0,0,0,0,0,0,0,0,0,125,58,67
110,私立,一般大學,1005,淡江大學學校財團法人淡江大學,學士班(日間),大韓民國(南韓),其他亞洲地區,25,15,10,18,11,7,7,4,3,0,0,0,0,0,0
110,私立,一般大學,1005,淡江大學學校財團法人淡江大學,學士班(日間),厄瓜多共和國,中南美洲,1,1,0,1,1,0,0,0,0,0,0,0,0,0,0
110,私立,一般大學,1005,淡江大學學校財團法人淡江大學,學士班(日間),巴布亞紐幾內亞獨立國,其他亞洲地區,1,0,1,1,0,1,0,0,0,0,0,0,0,0,0
110,私立,一般大學,1005,淡江大學學校財團法人淡江大學,學士班(日間),巴西聯邦共和國,中南美洲,6,4,2,3,1,2,3,3,0,0,0,0,0,0,0
110,私立,一般大學,1005,淡江大學學校財團法人淡江大學,學士班(日間),巴拉圭,中南美洲,20,9,11,20,9,11,0,0,0,0,0,0,0,0,0
110,私立,一般大學,1005,淡江大學學校財團法人淡江大學,學士班(日間),日本,其他亞洲地區,101,46,55,92,44,48,9,2,7,0,0,0,0,0,0
110,私立,一般大學,1005,淡江大學學校財團法人淡江大學,學士班(日間),印度,南亞,4,1,3,4,1,3,0,0,0,0,0,0,0,0,0
110,私立,一般大學,1005,淡江大學學校財團法人淡江大學,學士班(日間),印度尼西亞共和國,東協,383,179,204,239,104,135,144,75,69,0,0,0,0,0,0
110,私立,一般大學,1005,淡江大學學校財團法人淡江大學,學士班(日間),宏都拉斯共和國,中南美洲,10,5,5,10,5,5,0,0,0,0,0,0,0,0,0
110,私立,一般大學,1005,淡江大學學校財團法人淡江大學,學士班(日間),法國,歐洲,1,0,1,1,0,1,0,0,0,0,0,0,0,0,0
110,私立,一般大學,1005,淡江大學學校財團法人淡江大學,學士班(日間),阿根廷,中南美洲,1,0,1,0,0,0,1,0,1,0,0,0,0,0,0
110,私立,一般大學,1005,淡江大學學校財團法人淡江大學,學士班(日間),柬埔寨王國,東協,1,1,0,1,1,0,0,0,0,0,0,0,0,0,0
110,私立,一般大學,1005,淡江大學學校財團法人淡江大學,學士班(日間),約旦哈什米王國,其他亞洲地區,1,0,1,0,0,0,1,0,1,0,0,0,0,0,0
110,私立,一般大學,1005,淡江大學學校財團法人淡江大學,學士班(日間),香港,港澳,378,209,169,0,0,0,0,0,0,378,209,169,0,0,0
110,私立,一般大學,1005,淡江大學學校財團法人淡江大學,學士班(日間),哥倫比亞共和國,中南美洲,1,0,1,1,0,1,0,0,0,0,0,0,0,0,0
110,私立,一般大學,1005,淡江大學學校財團法人淡江大學,學士班(日間),哥斯大黎加共和國,中南美洲,1,0,1,0,0,0,1,0,1,0,0,0,0,0,0
110,私立,一般大學,1005,淡江大學學校財團法人淡江大學,學士班(日間),烏克蘭,其他亞洲地區,1,0,1,1,0,1,0,0,0,0,0,0,0,0,0
110,私立,一般大學,1005,淡江大學學校財團法人淡江大學,學士班(日間),秘魯共和國,中南美洲,7,3,4,7,3,4,0,0,0,0,0,0,0,0,0
110,私立,一般大學,1005,淡江大學學校財團法人淡江大學,學士班(日間),納米比亞共和國,非洲,1,0,1,0,0,0,1,0,1,0,0,0,0,0,0
110,私立,一般大學,1005,淡江大學學校財團法人淡江大學,學士班(日間),馬來西亞,東協,109,56,53,18,8,10,91,48,43,0,0,0,0,0,0
110,私立,一般大學,1005,淡江大學學校財團法人淡江大學,學士班(日間),荷蘭王國,歐洲,1,1,0,1,1,0,0,0,0,0,0,0,0,0,0
110,私立,一般大學,1005,淡江大學學校財團法人淡江大學,學士班(日間),菲律賓共和國,東協,3,1,2,1,0,1,2,1,1,0,0,0,0,0,0
110,私立,一般大學,1005,淡江大學學校財團法人淡江大學,學士班(日間),越南社會主義共和國,東協,50,16,34,43,13,30,7,3,4,0,0,0,0,0,0
110,私立,一般大學,1005,淡江大學學校財團法人淡江大學,學士班(日間),瑞士聯邦,歐洲,1,1,0,1,1,0,0,0,0,0,0,0,0,0,0
110,私立,一般大學,1005,淡江大學學校財團法人淡江大學,學士班(日間),聖文森(及格瑞那丁),中南美洲,11,4,7,11,4,7,0,0,0,0,0,0,0,0,0
110,私立,一般大學,1005,淡江大學學校財團法人淡江大學,學士班(日間),澳門,港澳,82,54,28,0,0,0,0,0,0,82,54,28,0,0,0
110,私立,一般大學,1005,淡江大學學校財團法人淡江大學,學士班(日間),土耳其共和國,其他亞洲地區,4,4,0,4,4,0,0,0,0,0,0,0,0,0,0
110,私立,一般大學,1005,淡江大學學校財團法人淡江大學,學士班(日間),史瓦帝尼王國,非洲,7,5,2,7,5,2,0,0,0,0,0,0,0,0,0
110,私立,一般大學,1005,淡江大學學校財團法人淡江大學,學士班(日間),尼加拉瓜,中南美洲,7,4,3,7,4,3,0,0,0,0,0,0,0,0,0
110,私立,一般大學,1005,淡江大學學校財團法人淡江大學,學士班(日間),瓜地馬拉共和國,中南美洲,11,5,6,9,4,5,2,1,1,0,0,0,0,0,0
110,私立,一般大學,1005,淡江大學學校財團法人淡江大學,學士班(日間),吐瓦魯,其他亞洲地區,7,2,5,7,2,5,0,0,0,0,0,0,0,0,0
110,私立,一般大學,1005,淡江大學學校財團法人淡江大學,學士班(日間),貝里斯,中南美洲,5,2,3,5,2,3,0,0,0,0,0,0,0,0,0
110,私立,一般大學,1005,淡江大學學校財團法人淡江大學,學士班(日間),帛琉共和國,其他亞洲地區,10,4,6,10,4,6,0,0,0,0,0,0,0,0,0
110,私立,一般大學,1005,淡江大學學校財團法人淡江大學,學士班(日間),俄羅斯聯邦,其他亞洲地區,1,1,0,1,1,0,0,0,0,0,0,0,0,0,0
110,私立,一般大學,1005,淡江大學學校財團法人淡江大學,學士班(日間),美國,北美洲,16,12,4,13,9,4,3,3,0,0,0,0,0,0,0
110,私立,一般大學,1005,淡江大學學校財團法人淡江大學,學士班(日間),泰國,東協,25,9,16,24,9,15,1,0,1,0,0,0,0,0,0
110,私立,一般大學,1005,淡江大學學校財團法人淡江大學,學士班(日間),海地共和國,中南美洲,10,8,2,10,8,2,0,0,0,0,0,0,0,0,0
110,私立,一般大學,1005,淡江大學學校財團法人淡江大學,學士班(日間),索羅門群島,其他亞洲地區,1,1,0,1,1,0,0,0,0,0,0,0,0,0,0
110,私立,一般大學,1005,淡江大學學校財團法人淡江大學,學士班(日間),紐西蘭,其他亞洲地區,1,0,1,0,0,0,1,0,1,0,0,0,0,0,0
110,私立,一般大學,1005,淡江大學學校財團法人淡江大學,學士班(日間),馬紹爾群島共和國,其他亞洲地區,19,4,15,19,4,15,0,0,0,0,0,0,0,0,0
110,私立,一般大學,1005,淡江大學學校財團法人淡江大學,學士班(日間),新加坡共和國,東協,2,0,2,1,0,1,1,0,1,0,0,0,0,0,0
110,私立,一般大學,1005,淡江大學學校財團法人淡江大學,學士班(日間),義大利共和國,歐洲,1,1,0,1,1,0,0,0,0,0,0,0,0,0,0
110,私立,一般大學,1005,淡江大學學校財團法人淡江大學,學士班(日間),聖克里斯多福及尼維斯,中南美洲,3,1,2,3,1,2,0,0,0,0,0,0,0,0,0
110,私立,一般大學,1005,淡江大學學校財團法人淡江大學,學士班(日間),聖露西亞,中南美洲,3,2,1,3,2,1,0,0,0,0,0,0,0,0,0
110,私立,一般大學,1005,淡江大學學校財團法人淡江大學,學士班(日間),蒙古國,其他亞洲地區,6,3,3,6,3,3,0,0,0,0,0,0,0,0,0
110,私立,一般大學,1005,淡江大學學校財團法人淡江大學,學士班(日間),德意志聯邦共和國,歐洲,2,0,2,2,0,2,0,0,0,0,0,0,0,0,0
110,私立,一般大學,1005,淡江大學學校財團法人淡江大學,學士班(日間),緬甸,東協,4,2,2,0,0,0,4,2,2,0,0,0,0,0,0
110,私立,一般大學,1005,淡江大學學校財團法人淡江大學,學士班(日間),墨西哥合眾國,中南美洲,2,1,1,2,1,1,0,0,0,0,0,0,0,0,0
110,私立,一般大學,1005,淡江大學學校財團法人淡江大學,學士班(日間),諾魯共和國,其他亞洲地區,3,1,2,3,1,2,0,0,0,0,0,0,0,0,0
110,私立,一般大學,1005,淡江大學學校財團法人淡江大學,碩士班(日間),巴西聯邦共和國,中南美洲,1,0,1,1,0,1,0,0,0,0,0,0,0,0,0
110,私立,一般大學,1005,淡江大學學校財團法人淡江大學,碩士班(日間),史瓦帝尼王國,非洲,1,1,0,1,1,0,0,0,0,0,0,0,0,0,0
110,私立,一般大學,1005,淡江大學學校財團法人淡江大學,碩士班(日間),尼加拉瓜,中南美洲,3,1,2,3,1,2,0,0,0,0,0,0,0,0,0
110,私立,一般大學,1005,淡江大學學校財團法人淡江大學,碩士班(日間),法國,歐洲,3,0,3,3,0,3,0,0,0,0,0,0,0,0,0
110,私立,一般大學,1005,淡江大學學校財團法人淡江大學,碩士班(日間),俄羅斯聯邦,其他亞洲地區,3,2,1,3,2,1,0,0,0,0,0,0,0,0,0
110,私立,一般大學,1005,淡江大學學校財團法人淡江大學,碩士班(日間),美國,北美洲,4,4,0,3,3,0,1,1,0,0,0,0,0,0,0
110,私立,一般大學,1005,淡江大學學校財團法人淡江大學,碩士班(日間),泰國,東協,6,2,4,6,2,4,0,0,0,0,0,0,0,0,0
110,私立,一般大學,1005,淡江大學學校財團法人淡江大學,碩士班(日間),海地共和國,中南美洲,2,2,0,2,2,0,0,0,0,0,0,0,0,0,0
110,私立,一般大學,1005,淡江大學學校財團法人淡江大學,碩士班(日間),索羅門群島,其他亞洲地區,1,1,0,1,1,0,0,0,0,0,0,0,0,0,0
110,私立,一般大學,1005,淡江大學學校財團法人淡江大學,碩士班(日間),瑞典王國,歐洲,1,1,0,1,1,0,0,0,0,0,0,0,0,0,0
110,私立,一般大學,1005,淡江大學學校財團法人淡江大學,碩士班(日間),墨西哥合眾國,中南美洲,1,1,0,1,1,0,0,0,0,0,0,0,0,0,0
110,私立,一般大學,1005,淡江大學學校財團法人淡江大學,碩士班(日間),土耳其共和國,其他亞洲地區,1,1,0,1,1,0,0,0,0,0,0,0,0,0,0
110,私立,一般大學,1005,淡江大學學校財團法人淡江大學,碩士班(日間),大陸地區,大陸地區,58,37,21,0,0,0,0,0,0,0,0,0,58,37,21
110,私立,一般大學,1005,淡江大學學校財團法人淡江大學,碩士班(日間),大韓民國(南韓),其他亞洲地區,3,1,2,3,1,2,0,0,0,0,0,0,0,0,0
110,私立,一般大學,1005,淡江大學學校財團法人淡江大學,碩士班(日間),厄瓜多共和國,中南美洲,1,1,0,1,1,0,0,0,0,0,0,0,0,0,0
110,私立,一般大學,1005,淡江大學學校財團法人淡江大學,碩士班(日間),日本,其他亞洲地區,9,4,5,9,4,5,0,0,0,0,0,0,0,0,0
110,私立,一般大學,1005,淡江大學學校財團法人淡江大學,碩士班(日間),布吉納法索,非洲,2,2,0,2,2,0,0,0,0,0,0,0,0,0,0
110,私立,一般大學,1005,淡江大學學校財團法人淡江大學,碩士班(日間),伊拉克共和國,其他亞洲地區,1,1,0,1,1,0,0,0,0,0,0,0,0,0,0
110,私立,一般大學,1005,淡江大學學校財團法人淡江大學,碩士班(日間),印度,南亞,5,4,1,5,4,1,0,0,0,0,0,0,0,0,0
110,私立,一般大學,1005,淡江大學學校財團法人淡江大學,碩士班(日間),印度尼西亞共和國,東協,12,5,7,9,4,5,3,1,2,0,0,0,0,0,0
110,私立,一般大學,1005,淡江大學學校財團法人淡江大學,碩士班(日間),宏都拉斯共和國,中南美洲,1,1,0,1,1,0,0,0,0,0,0,0,0,0,0
110,私立,一般大學,1005,淡江大學學校財團法人淡江大學,碩士班(日間),英國,歐洲,2,1,1,2,1,1,0,0,0,0,0,0,0,0,0
110,私立,一般大學,1005,淡江大學學校財團法人淡江大學,碩士班(日間),香港,港澳,28,20,8,0,0,0,0,0,0,28,20,8,0,0,0
110,私立,一般大學,1005,淡江大學學校財團法人淡江大學,碩士班(日間),馬來西亞,東協,11,5,6,4,2,2,7,3,4,0,0,0,0,0,0
110,私立,一般大學,1005,淡江大學學校財團法人淡江大學,碩士班(日間),越南社會主義共和國,東協,10,1,9,10,1,9,0,0,0,0,0,0,0,0,0
110,私立,一般大學,1005,淡江大學學校財團法人淡江大學,碩士班(日間),聖文森(及格瑞那丁),中南美洲,1,0,1,1,0,1,0,0,0,0,0,0,0,0,0
110,私立,一般大學,1005,淡江大學學校財團法人淡江大學,碩士班(日間),蒙古國,其他亞洲地區,2,0,2,2,0,2,0,0,0,0,0,0,0,0,0
110,私立,一般大學,1005,淡江大學學校財團法人淡江大學,碩士班(日間),澳大利亞,其他亞洲地區,1,1,0,1,1,0,0,0,0,0,0,0,0,0,0
110,私立,一般大學,1005,淡江大學學校財團法人淡江大學,碩士班(日間),澳門,港澳,4,3,1,0,0,0,0,0,0,4,3,1,0,0,0
110,私立,一般大學,1005,淡江大學學校財團法人淡江大學,博士班,大陸地區,大陸地區,15,7,8,0,0,0,0,0,0,0,0,0,15,7,8
110,私立,一般大學,1005,淡江大學學校財團法人淡江大學,博士班,日本,其他亞洲地區,2,1,1,2,1,1,0,0,0,0,0,0,0,0,0
110,私立,一般大學,1005,淡江大學學校財團法人淡江大學,博士班,尼加拉瓜,中南美洲,1,1,0,1,1,0,0,0,0,0,0,0,0,0,0
110,私立,一般大學,1005,淡江大學學校財團法人淡江大學,博士班,印度,南亞,5,3,2,5,3,2,0,0,0,0,0,0,0,0,0
110,私立,一般大學,1005,淡江大學學校財團法人淡江大學,博士班,香港,港澳,1,1,0,0,0,0,0,0,0,1,1,0,0,0,0
110,私立,一般大學,1005,淡江大學學校財團法人淡江大學,博士班,越南社會主義共和國,東協,6,3,3,5,2,3,1,1,0,0,0,0,0,0,0
110,私立,一般大學,1005,淡江大學學校財團法人淡江大學,博士班,德意志聯邦共和國,歐洲,1,1,0,1,1,0,0,0,0,0,0,0,0,0,0
110,私立,一般大學,1005,淡江大學學校財團法人淡江大學,博士班,土耳其共和國,其他亞洲地區,1,0,1,1,0,1,0,0,0,0,0,0,0,0,0
110,私立,一般大學,1005,淡江大學學校財團法人淡江大學,博士班,布吉納法索,非洲,2,1,1,2,1,1,0,0,0,0,0,0,0,0,0
110,私立,一般大學,1005,淡江大學學校財團法人淡江大學,博士班,伊拉克共和國,其他亞洲地區,1,1,0,1,1,0,0,0,0,0,0,0,0,0,0
110,私立,一般大學,1005,淡江大學學校財團法人淡江大學,博士班,美國,北美洲,2,1,1,2,1,1,0,0,0,0,0,0,0,0,0
110,私立,一般大學,1005,淡江大學學校財團法人淡江大學,博士班,英國,歐洲,1,1,0,1,1,0,0,0,0,0,0,0,0,0,0
110,私立,一般大學,1005,淡江大學學校財團法人淡江大學,博士班,馬來西亞,東協,6,5,1,6,5,1,0,0,0,0,0,0,0,0,0
110,私立,一般大學,1005,淡江大學學校財團法人淡江大學,博士班,菲律賓共和國,東協,2,2,0,2,2,0,0,0,0,0,0,0,0,0,0
110,私立,一般大學,1006,中國文化大學,學士班(日間),大韓民國(南韓),其他亞洲地區,24,9,15,22,8,14,2,1,1,0,0,0,0,0,0
110,私立,一般大學,1006,中國文化大學,學士班(日間),巴西聯邦共和國,中南美洲,1,0,1,0,0,0,1,0,1,0,0,0,0,0,0
110,私立,一般大學,1006,中國文化大學,學士班(日間),巴拉圭,中南美洲,1,1,0,1,1,0,0,0,0,0,0,0,0,0,0
110,私立,一般大學,1006,中國文化大學,學士班(日間),加拿大,北美洲,1,1,0,0,0,0,1,1,0,0,0,0,0,0,0
110,私立,一般大學,1006,中國文化大學,學士班(日間),印度尼西亞共和國,東協,83,43,40,55,31,24,28,12,16,0,0,0,0,0,0
110,私立,一般大學,1006,中國文化大學,學士班(日間),拉脫維亞共和國,歐洲,1,0,1,1,0,1,0,0,0,0,0,0,0,0,0
110,私立,一般大學,1006,中國文化大學,學士班(日間),法國,歐洲,2,1,1,2,1,1,0,0,0,0,0,0,0,0,0
110,私立,一般大學,1006,中國文化大學,學士班(日間),俄羅斯聯邦,其他亞洲地區,2,0,2,2,0,2,0,0,0,0,0,0,0,0,0
110,私立,一般大學,1006,中國文化大學,學士班(日間),美國,北美洲,2,1,1,1,0,1,1,1,0,0,0,0,0,0,0
110,私立,一般大學,1006,中國文化大學,學士班(日間),剛果共和國,非洲,2,2,0,2,2,0,0,0,0,0,0,0,0,0,0
110,私立,一般大學,1006,中國文化大學,學士班(日間),泰國,東協,5,1,4,3,1,2,2,0,2,0,0,0,0,0,0
110,私立,一般大學,1006,中國文化大學,學士班(日間),烏茲別克共和國,其他亞洲地區,1,1,0,1,1,0,0,0,0,0,0,0,0,0,0
110,私立,一般大學,1006,中國文化大學,學士班(日間),秘魯共和國,中南美洲,1,1,0,1,1,0,0,0,0,0,0,0,0,0,0
110,私立,一般大學,1006,中國文化大學,學士班(日間),馬來西亞,東協,227,119,108,125,72,53,102,47,55,0,0,0,0,0,0
110,私立,一般大學,1006,中國文化大學,學士班(日間),菲律賓共和國,東協,2,1,1,2,1,1,0,0,0,0,0,0,0,0,0
110,私立,一般大學,1006,中國文化大學,學士班(日間),越南社會主義共和國,東協,33,8,25,31,8,23,2,0,2,0,0,0,0,0,0
110,私立,一般大學,1006,中國文化大學,學士班(日間),義大利共和國,歐洲,1,0,1,0,0,0,1,0,1,0,0,0,0,0,0
110,私立,一般大學,1006,中國文化大學,學士班(日間),蒙古國,其他亞洲地區,6,3,3,6,3,3,0,0,0,0,0,0,0,0,0
110,私立,一般大學,1006,中國文化大學,學士班(日間),黎巴嫩共和國,其他亞洲地區,1,0,1,1,0,1,0,0,0,0,0,0,0,0,0
110,私立,一般大學,1006,中國文化大學,學士班(日間),大陸地區,大陸地區,102,43,59,0,0,0,0,0,0,0,0,0,102,43,59
110,私立,一般大學,1006,中國文化大學,學士班(日間),日本,其他亞洲地區,62,26,36,61,26,35,1,0,1,0,0,0,0,0,0
110,私立,一般大學,1006,中國文化大學,學士班(日間),印度,南亞,1,0,1,1,0,1,0,0,0,0,0,0,0,0,0
110,私立,一般大學,1006,中國文化大學,學士班(日間),吐瓦魯,其他亞洲地區,1,0,1,1,0,1,0,0,0,0,0,0,0,0,0
110,私立,一般大學,1006,中國文化大學,學士班(日間),委內瑞拉共和國,中南美洲,1,1,0,1,1,0,0,0,0,0,0,0,0,0,0
110,私立,一般大學,1006,中國文化大學,學士班(日間),南非共和國,非洲,1,0,1,0,0,0,1,0,1,0,0,0,0,0,0
110,私立,一般大學,1006,中國文化大學,學士班(日間),查德共和國,非洲,1,1,0,1,1,0,0,0,0,0,0,0,0,0,0
110,私立,一般大學,1006,中國文化大學,學士班(日間),香港,港澳,265,135,130,0,0,0,0,0,0,265,135,130,0,0,0
110,私立,一般大學,1006,中國文化大學,學士班(日間),哥倫比亞共和國,中南美洲,1,1,0,1,1,0,0,0,0,0,0,0,0,0,0
110,私立,一般大學,1006,中國文化大學,學士班(日間),馬紹爾群島共和國,其他亞洲地區,2,0,2,2,0,2,0,0,0,0,0,0,0,0,0
110,私立,一般大學,1006,中國文化大學,學士班(日間),塞爾維亞共和國,歐洲,1,1,0,1,1,0,0,0,0,0,0,0,0,0,0
110,私立,一般大學,1006,中國文化大學,學士班(日間),新加坡共和國,東協,1,0,1,1,0,1,0,0,0,0,0,0,0,0,0
110,私立,一般大學,1006,中國文化大學,學士班(日間),聖文森(及格瑞那丁),中南美洲,1,1,0,1,1,0,0,0,0,0,0,0,0,0,0
110,私立,一般大學,1006,中國文化大學,學士班(日間),德意志聯邦共和國,歐洲,1,0,1,1,0,1,0,0,0,0,0,0,0,0,0
110,私立,一般大學,1006,中國文化大學,學士班(日間),緬甸,東協,5,1,4,2,1,1,3,0,3,0,0,0,0,0,0
110,私立,一般大學,1006,中國文化大學,學士班(日間),澳門,港澳,47,26,21,0,0,0,0,0,0,47,26,21,0,0,0
110,私立,一般大學,1006,中國文化大學,碩士班(日間),大陸地區,大陸地區,29,15,14,0,0,0,0,0,0,0,0,0,29,15,14
110,私立,一般大學,1006,中國文化大學,碩士班(日間),日本,其他亞洲地區,4,3,1,3,3,0,1,0,1,0,0,0,0,0,0
110,私立,一般大學,1006,中國文化大學,碩士班(日間),印度,南亞,2,2,0,2,2,0,0,0,0,0,0,0,0,0,0
110,私立,一般大學,1006,中國文化大學,碩士班(日間),西班牙王國,歐洲,1,1,0,1,1,0,0,0,0,0,0,0,0,0,0
110,私立,一般大學,1006,中國文化大學,碩士班(日間),香港,港澳,20,11,9,0,0,0,0,0,0,20,11,9,0,0,0
110,私立,一般大學,1006,中國文化大學,碩士班(日間),新加坡共和國,東協,2,0,2,2,0,2,0,0,0,0,0,0,0,0,0
110,私立,一般大學,1006,中國文化大學,碩士班(日間),德意志聯邦共和國,歐洲,1,1,0,1,1,0,0,0,0,0,0,0,0,0,0
110,私立,一般大學,1006,中國文化大學,碩士班(日間),澳門,港澳,7,3,4,0,0,0,0,0,0,7,3,4,0,0,0
110,私立,一般大學,1006,中國文化大學,碩士班(日間),土耳其共和國,其他亞洲地區,1,1,0,1,1,0,0,0,0,0,0,0,0,0,0
110,私立,一般大學,1006,中國文化大學,碩士班(日間),大韓民國(南韓),其他亞洲地區,13,2,11,13,2,11,0,0,0,0,0,0,0,0,0
110,私立,一般大學,1006,中國文化大學,碩士班(日間),匈牙利共和國,歐洲,1,1,0,1,1,0,0,0,0,0,0,0,0,0,0
110,私立,一般大學,1006,中國文化大學,碩士班(日間),印度尼西亞共和國,東協,13,8,5,13,8,5,0,0,0,0,0,0,0,0,0
110,私立,一般大學,1006,中國文化大學,碩士班(日間),奈及利亞聯邦共和國,非洲,1,1,0,1,1,0,0,0,0,0,0,0,0,0,0
110,私立,一般大學,1006,中國文化大學,碩士班(日間),波蘭共和國,歐洲,1,0,1,1,0,1,0,0,0,0,0,0,0,0,0
110,私立,一般大學,1006,中國文化大學,碩士班(日間),法國,歐洲,2,2,0,2,2,0,0,0,0,0,0,0,0,0,0
110,私立,一般大學,1006,中國文化大學,碩士班(日間),俄羅斯聯邦,其他亞洲地區,1,0,1,1,0,1,0,0,0,0,0,0,0,0,0
110,私立,一般大學,1006,中國文化大學,碩士班(日間),美國,北美洲,4,2,2,4,2,2,0,0,0,0,0,0,0,0,0
110,私立,一般大學,1006,中國文化大學,碩士班(日間),泰國,東協,6,3,3,6,3,3,0,0,0,0,0,0,0,0,0
110,私立,一般大學,1006,中國文化大學,碩士班(日間),烏克蘭,其他亞洲地區,1,0,1,1,0,1,0,0,0,0,0,0,0,0,0
110,私立,一般大學,1006,中國文化大學,碩士班(日間),馬來西亞,東協,12,5,7,5,2,3,7,3,4,0,0,0,0,0,0
110,私立,一般大學,1006,中國文化大學,碩士班(日間),菲律賓共和國,東協,1,1,0,1,1,0,0,0,0,0,0,0,0,0,0
110,私立,一般大學,1006,中國文化大學,碩士班(日間),越南社會主義共和國,東協,15,4,11,15,4,11,0,0,0,0,0,0,0,0,0
110,私立,一般大學,1006,中國文化大學,碩士班(日間),蒙古國,其他亞洲地區,6,2,4,6,2,4,0,0,0,0,0,0,0,0,0
110,私立,一般大學,1006,中國文化大學,博士班,大陸地區,大陸地區,14,8,6,0,0,0,0,0,0,0,0,0,14,8,6
110,私立,一般大學,1006,中國文化大學,博士班,大韓民國(南韓),其他亞洲地區,2,0,2,2,0,2,0,0,0,0,0,0,0,0,0
110,私立,一般大學,1006,中國文化大學,博士班,香港,港澳,2,2,0,0,0,0,0,0,0,2,2,0,0,0,0
110,私立,一般大學,1006,中國文化大學,博士班,蒙古國,其他亞洲地區,3,0,3,3,0,3,0,0,0,0,0,0,0,0,0
110,私立,一般大學,1006,中國文化大學,博士班,土庫曼,其他亞洲地區,1,1,0,1,1,0,0,0,0,0,0,0,0,0,0
110,私立,一般大學,1006,中國文化大學,博士班,尼加拉瓜,中南美洲,1,0,1,1,0,1,0,0,0,0,0,0,0,0,0
110,私立,一般大學,1006,中國文化大學,博士班,波蘭共和國,歐洲,1,1,0,1,1,0,0,0,0,0,0,0,0,0,0
110,私立,一般大學,1006,中國文化大學,博士班,俄羅斯聯邦,其他亞洲地區,1,0,1,1,0,1,0,0,0,0,0,0,0,0,0
110,私立,一般大學,1006,中國文化大學,博士班,美國,北美洲,2,1,1,2,1,1,0,0,0,0,0,0,0,0,0
110,私立,一般大學,1006,中國文化大學,博士班,泰國,東協,1,0,1,1,0,1,0,0,0,0,0,0,0,0,0
110,私立,一般大學,1006,中國文化大學,博士班,越南社會主義共和國,東協,5,2,3,5,2,3,0,0,0,0,0,0,0,0,0
110,私立,一般大學,1007,逢甲大學,學士班(日間),巴西聯邦共和國,中南美洲,2,2,0,2,2,0,0,0,0,0,0,0,0,0,0
110,私立,一般大學,1007,逢甲大學,學士班(日間),日本,其他亞洲地區,119,56,63,117,55,62,2,1,1,0,0,0,0,0,0
110,私立,一般大學,1007,逢甲大學,學士班(日間),比利時王國,歐洲,1,1,0,1,1,0,0,0,0,0,0,0,0,0,0
110,私立,一般大學,1007,逢甲大學,學士班(日間),俄羅斯聯邦,其他亞洲地區,1,0,1,1,0,1,0,0,0,0,0,0,0,0,0
110,私立,一般大學,1007,逢甲大學,學士班(日間),美國,北美洲,2,2,0,0,0,0,2,2,0,0,0,0,0,0,0
110,私立,一般大學,1007,逢甲大學,學士班(日間),馬來西亞,東協,181,126,55,73,48,25,108,78,30,0,0,0,0,0,0
110,私立,一般大學,1007,逢甲大學,學士班(日間),荷蘭王國,歐洲,1,1,0,1,1,0,0,0,0,0,0,0,0,0,0
110,私立,一般大學,1007,逢甲大學,學士班(日間),菲律賓共和國,東協,2,0,2,0,0,0,2,0,2,0,0,0,0,0,0
110,私立,一般大學,1007,逢甲大學,學士班(日間),義大利共和國,歐洲,1,1,0,1,1,0,0,0,0,0,0,0,0,0,0
110,私立,一般大學,1007,逢甲大學,學士班(日間),大陸地區,大陸地區,111,69,42,0,0,0,0,0,0,0,0,0,111,69,42
110,私立,一般大學,1007,逢甲大學,學士班(日間),大韓民國(南韓),其他亞洲地區,10,5,5,10,5,5,0,0,0,0,0,0,0,0,0
110,私立,一般大學,1007,逢甲大學,學士班(日間),巴布亞紐幾內亞獨立國,其他亞洲地區,1,1,0,1,1,0,0,0,0,0,0,0,0,0,0
110,私立,一般大學,1007,逢甲大學,學士班(日間),巴拉圭,中南美洲,1,0,1,1,0,1,0,0,0,0,0,0,0,0,0
110,私立,一般大學,1007,逢甲大學,學士班(日間),加拿大,北美洲,1,1,0,0,0,0,1,1,0,0,0,0,0,0,0
110,私立,一般大學,1007,逢甲大學,學士班(日間),尼加拉瓜,中南美洲,1,1,0,1,1,0,0,0,0,0,0,0,0,0,0
110,私立,一般大學,1007,逢甲大學,學士班(日間),印度尼西亞共和國,東協,148,74,74,126,63,63,22,11,11,0,0,0,0,0,0
110,私立,一般大學,1007,逢甲大學,學士班(日間),貝里斯,中南美洲,1,0,1,1,0,1,0,0,0,0,0,0,0,0,0
110,私立,一般大學,1007,逢甲大學,學士班(日間),波蘭共和國,歐洲,1,1,0,1,1,0,0,0,0,0,0,0,0,0,0
110,私立,一般大學,1007,逢甲大學,學士班(日間),法國,歐洲,1,1,0,1,1,0,0,0,0,0,0,0,0,0,0
110,私立,一般大學,1007,逢甲大學,學士班(日間),阿根廷,中南美洲,1,1,0,1,1,0,0,0,0,0,0,0,0,0,0
110,私立,一般大學,1007,逢甲大學,學士班(日間),南非共和國,非洲,7,5,2,3,2,1,4,3,1,0,0,0,0,0,0
110,私立,一般大學,1007,逢甲大學,學士班(日間),香港,港澳,304,221,83,0,0,0,0,0,0,304,221,83,0,0,0
110,私立,一般大學,1007,逢甲大學,學士班(日間),泰國,東協,37,14,23,37,14,23,0,0,0,0,0,0,0,0,0
110,私立,一般大學,1007,逢甲大學,學士班(日間),越南社會主義共和國,東協,35,8,27,31,8,23,4,0,4,0,0,0,0,0,0
110,私立,一般大學,1007,逢甲大學,學士班(日間),聖露西亞,中南美洲,1,1,0,1,1,0,0,0,0,0,0,0,0,0,0
110,私立,一般大學,1007,逢甲大學,學士班(日間),蒙古國,其他亞洲地區,7,5,2,7,5,2,0,0,0,0,0,0,0,0,0
110,私立,一般大學,1007,逢甲大學,學士班(日間),緬甸,東協,1,1,0,0,0,0,1,1,0,0,0,0,0,0,0
110,私立,一般大學,1007,逢甲大學,學士班(日間),墨西哥合眾國,中南美洲,3,2,1,3,2,1,0,0,0,0,0,0,0,0,0
110,私立,一般大學,1007,逢甲大學,學士班(日間),澳門,港澳,31,25,6,0,0,0,0,0,0,31,25,6,0,0,0
110,私立,一般大學,1007,逢甲大學,碩士班(日間),大陸地區,大陸地區,21,17,4,0,0,0,0,0,0,0,0,0,21,17,4
110,私立,一般大學,1007,逢甲大學,碩士班(日間),巴拉圭,中南美洲,1,1,0,1,1,0,0,0,0,0,0,0,0,0,0
110,私立,一般大學,1007,逢甲大學,碩士班(日間),古巴共和國,中南美洲,1,1,0,1,1,0,0,0,0,0,0,0,0,0,0
110,私立,一般大學,1007,逢甲大學,碩士班(日間),尼加拉瓜,中南美洲,1,0,1,1,0,1,0,0,0,0,0,0,0,0,0
110,私立,一般大學,1007,逢甲大學,碩士班(日間),瓜地馬拉共和國,中南美洲,1,0,1,1,0,1,0,0,0,0,0,0,0,0,0
110,私立,一般大學,1007,逢甲大學,碩士班(日間),匈牙利共和國,歐洲,1,1,0,1,1,0,0,0,0,0,0,0,0,0,0
110,私立,一般大學,1007,逢甲大學,碩士班(日間),印度尼西亞共和國,東協,13,5,8,12,5,7,1,0,1,0,0,0,0,0,0
110,私立,一般大學,1007,逢甲大學,碩士班(日間),帛琉共和國,其他亞洲地區,1,1,0,1,1,0,0,0,0,0,0,0,0,0,0
110,私立,一般大學,1007,逢甲大學,碩士班(日間),法國,歐洲,1,1,0,1,1,0,0,0,0,0,0,0,0,0,0
110,私立,一般大學,1007,逢甲大學,碩士班(日間),香港,港澳,37,23,14,0,0,0,0,0,0,37,23,14,0,0,0
110,私立,一般大學,1007,逢甲大學,碩士班(日間),哥倫比亞共和國,中南美洲,1,1,0,1,1,0,0,0,0,0,0,0,0,0,0
110,私立,一般大學,1007,逢甲大學,碩士班(日間),烏克蘭,其他亞洲地區,1,1,0,1,1,0,0,0,0,0,0,0,0,0,0
110,私立,一般大學,1007,逢甲大學,碩士班(日間),越南社會主義共和國,東協,17,5,12,17,5,12,0,0,0,0,0,0,0,0,0
110,私立,一般大學,1007,逢甲大學,碩士班(日間),緬甸,東協,3,0,3,3,0,3,0,0,0,0,0,0,0,0,0
110,私立,一般大學,1007,逢甲大學,碩士班(日間),澳門,港澳,2,2,0,0,0,0,0,0,0,2,2,0,0,0,0
110,私立,一般大學,1007,逢甲大學,碩士班(日間),日本,其他亞洲地區,1,1,0,1,1,0,0,0,0,0,0,0,0,0,0
110,私立,一般大學,1007,逢甲大學,碩士班(日間),美國,北美洲,2,2,0,2,2,0,0,0,0,0,0,0,0,0,0
110,私立,一般大學,1007,逢甲大學,碩士班(日間),英國,歐洲,1,1,0,1,1,0,0,0,0,0,0,0,0,0,0
110,私立,一般大學,1007,逢甲大學,碩士班(日間),泰國,東協,17,5,12,17,5,12,0,0,0,0,0,0,0,0,0
110,私立,一般大學,1007,逢甲大學,碩士班(日間),馬來西亞,東協,30,20,10,21,14,7,9,6,3,0,0,0,0,0,0
110,私立,一般大學,1007,逢甲大學,碩士班(日間),墨西哥合眾國,中南美洲,1,0,1,1,0,1,0,0,0,0,0,0,0,0,0
110,私立,一般大學,1007,逢甲大學,博士班,土耳其共和國,其他亞洲地區,1,1,0,1,1,0,0,0,0,0,0,0,0,0,0
110,私立,一般大學,1007,逢甲大學,博士班,大陸地區,大陸地區,18,12,6,0,0,0,0,0,0,0,0,0,18,12,6
110,私立,一般大學,1007,逢甲大學,博士班,大韓民國(南韓),其他亞洲地區,1,0,1,1,0,1,0,0,0,0,0,0,0,0,0
110,私立,一般大學,1007,逢甲大學,博士班,厄瓜多共和國,中南美洲,1,0,1,1,0,1,0,0,0,0,0,0,0,0,0
110,私立,一般大學,1007,逢甲大學,博士班,布吉納法索,非洲,2,2,0,2,2,0,0,0,0,0,0,0,0,0,0
110,私立,一般大學,1007,逢甲大學,博士班,印度,南亞,4,2,2,4,2,2,0,0,0,0,0,0,0,0,0
110,私立,一般大學,1007,逢甲大學,博士班,印度尼西亞共和國,東協,2,1,1,2,1,1,0,0,0,0,0,0,0,0,0
110,私立,一般大學,1007,逢甲大學,博士班,英國,歐洲,1,1,0,1,1,0,0,0,0,0,0,0,0,0,0
110,私立,一般大學,1007,逢甲大學,博士班,剛果共和國,非洲,1,1,0,1,1,0,0,0,0,0,0,0,0,0,0
110,私立,一般大學,1007,逢甲大學,博士班,秘魯共和國,中南美洲,1,1,0,1,1,0,0,0,0,0,0,0,0,0,0
110,私立,一般大學,1007,逢甲大學,博士班,馬來西亞,東協,4,3,1,4,3,1,0,0,0,0,0,0,0,0,0
110,私立,一般大學,1007,逢甲大學,博士班,菲律賓共和國,東協,2,1,1,2,1,1,0,0,0,0,0,0,0,0,0
110,私立,一般大學,1007,逢甲大學,博士班,越南社會主義共和國,東協,19,14,5,19,14,5,0,0,0,0,0,0,0,0,0
110,私立,一般大學,1007,逢甲大學,博士班,蒙古國,其他亞洲地區,1,0,1,1,0,1,0,0,0,0,0,0,0,0,0
110,私立,一般大學,1007,逢甲大學,博士班,美國,北美洲,2,1,1,2,1,1,0,0,0,0,0,0,0,0,0
110,私立,一般大學,1007,逢甲大學,博士班,泰國,東協,4,2,2,4,2,2,0,0,0,0,0,0,0,0,0
110,私立,一般大學,1008,靜宜大學,學士班(日間),日本,其他亞洲地區,56,17,39,56,17,39,0,0,0,0,0,0,0,0,0
110,私立,一般大學,1008,靜宜大學,學士班(日間),印度尼西亞共和國,東協,37,11,26,27,10,17,10,1,9,0,0,0,0,0,0
110,私立,一般大學,1008,靜宜大學,學士班(日間),法國,歐洲,1,1,0,1,1,0,0,0,0,0,0,0,0,0,0
110,私立,一般大學,1008,靜宜大學,學士班(日間),肯亞共和國,非洲,1,0,1,1,0,1,0,0,0,0,0,0,0,0,0
110,私立,一般大學,1008,靜宜大學,學士班(日間),俄羅斯聯邦,其他亞洲地區,1,1,0,1,1,0,0,0,0,0,0,0,0,0,0
110,私立,一般大學,1008,靜宜大學,學士班(日間),美國,北美洲,2,1,1,2,1,1,0,0,0,0,0,0,0,0,0
110,私立,一般大學,1008,靜宜大學,學士班(日間),泰國,東協,14,3,11,14,3,11,0,0,0,0,0,0,0,0,0
110,私立,一般大學,1008,靜宜大學,學士班(日間),秘魯共和國,中南美洲,2,1,1,2,1,1,0,0,0,0,0,0,0,0,0
110,私立,一般大學,1008,靜宜大學,學士班(日間),馬來西亞,東協,145,83,62,115,70,45,30,13,17,0,0,0,0,0,0
110,私立,一般大學,1008,靜宜大學,學士班(日間),莫三比克共和國,非洲,1,0,1,1,0,1,0,0,0,0,0,0,0,0,0
110,私立,一般大學,1008,靜宜大學,學士班(日間),菲律賓共和國,東協,3,2,1,2,2,0,1,0,1,0,0,0,0,0,0
110,私立,一般大學,1008,靜宜大學,學士班(日間),大陸地區,大陸地區,64,32,32,0,0,0,0,0,0,0,0,0,64,32,32
110,私立,一般大學,1008,靜宜大學,學士班(日間),巴拉圭,中南美洲,1,0,1,0,0,0,1,0,1,0,0,0,0,0,0
110,私立,一般大學,1008,靜宜大學,學士班(日間),史瓦帝尼王國,非洲,9,3,6,9,3,6,0,0,0,0,0,0,0,0,0
110,私立,一般大學,1008,靜宜大學,學士班(日間),印度,南亞,3,2,1,3,2,1,0,0,0,0,0,0,0,0,0
110,私立,一般大學,1008,靜宜大學,學士班(日間),亞美尼亞共和國,其他亞洲地區,1,0,1,1,0,1,0,0,0,0,0,0,0,0,0
110,私立,一般大學,1008,靜宜大學,學士班(日間),奈及利亞聯邦共和國,非洲,2,2,0,2,2,0,0,0,0,0,0,0,0,0,0
110,私立,一般大學,1008,靜宜大學,學士班(日間),阿富汗伊斯蘭共和國,其他亞洲地區,1,1,0,1,1,0,0,0,0,0,0,0,0,0,0
110,私立,一般大學,1008,靜宜大學,學士班(日間),南非共和國,非洲,1,1,0,1,1,0,0,0,0,0,0,0,0,0,0
110,私立,一般大學,1008,靜宜大學,學士班(日間),香港,港澳,66,39,27,0,0,0,0,0,0,66,39,27,0,0,0
110,私立,一般大學,1008,靜宜大學,學士班(日間),烏干達共和國,非洲,2,1,1,2,1,1,0,0,0,0,0,0,0,0,0
110,私立,一般大學,1008,靜宜大學,學士班(日間),智利,中南美洲,1,0,1,1,0,1,0,0,0,0,0,0,0,0,0
110,私立,一般大學,1008,靜宜大學,學士班(日間),越南社會主義共和國,東協,89,22,67,86,21,65,3,1,2,0,0,0,0,0,0
110,私立,一般大學,1008,靜宜大學,學士班(日間),蒙古國,其他亞洲地區,8,1,7,8,1,7,0,0,0,0,0,0,0,0,0
110,私立,一般大學,1008,靜宜大學,學士班(日間),緬甸,東協,1,1,0,0,0,0,1,1,0,0,0,0,0,0,0
110,私立,一般大學,1008,靜宜大學,學士班(日間),澳門,港澳,16,5,11,0,0,0,0,0,0,16,5,11,0,0,0
110,私立,一般大學,1008,靜宜大學,碩士班(日間),大陸地區,大陸地區,8,3,5,0,0,0,0,0,0,0,0,0,8,3,5
110,私立,一般大學,1008,靜宜大學,碩士班(日間),史瓦帝尼王國,非洲,1,0,1,1,0,1,0,0,0,0,0,0,0,0,0
110,私立,一般大學,1008,靜宜大學,碩士班(日間),匈牙利共和國,歐洲,2,1,1,2,1,1,0,0,0,0,0,0,0,0,0
110,私立,一般大學,1008,靜宜大學,碩士班(日間),印度,南亞,3,2,1,3,2,1,0,0,0,0,0,0,0,0,0
110,私立,一般大學,1008,靜宜大學,碩士班(日間),奈及利亞聯邦共和國,非洲,4,3,1,4,3,1,0,0,0,0,0,0,0,0,0
110,私立,一般大學,1008,靜宜大學,碩士班(日間),迦納共和國,非洲,1,1,0,1,1,0,0,0,0,0,0,0,0,0,0
110,私立,一般大學,1008,靜宜大學,碩士班(日間),香港,港澳,3,1,2,0,0,0,0,0,0,3,1,2,0,0,0
110,私立,一般大學,1008,靜宜大學,碩士班(日間),智利,中南美洲,1,0,1,0,0,0,1,0,1,0,0,0,0,0,0
110,私立,一般大學,1008,靜宜大學,碩士班(日間),越南社會主義共和國,東協,25,5,20,25,5,20,0,0,0,0,0,0,0,0,0
110,私立,一般大學,1008,靜宜大學,碩士班(日間),德意志聯邦共和國,歐洲,3,0,3,3,0,3,0,0,0,0,0,0,0,0,0
110,私立,一般大學,1008,靜宜大學,碩士班(日間),羅馬尼亞,歐洲,2,2,0,2,2,0,0,0,0,0,0,0,0,0,0
110,私立,一般大學,1008,靜宜大學,碩士班(日間),日本,其他亞洲地區,2,1,1,2,1,1,0,0,0,0,0,0,0,0,0
110,私立,一般大學,1008,靜宜大學,碩士班(日間),布吉納法索,非洲,1,0,1,1,0,1,0,0,0,0,0,0,0,0,0
110,私立,一般大學,1008,靜宜大學,碩士班(日間),印度尼西亞共和國,東協,17,7,10,16,7,9,1,0,1,0,0,0,0,0,0
110,私立,一般大學,1008,靜宜大學,碩士班(日間),西班牙王國,歐洲,1,0,1,1,0,1,0,0,0,0,0,0,0,0,0
110,私立,一般大學,1008,靜宜大學,碩士班(日間),法國,歐洲,5,3,2,5,3,2,0,0,0,0,0,0,0,0,0
110,私立,一般大學,1008,靜宜大學,碩士班(日間),芬蘭共和國,歐洲,1,1,0,1,1,0,0,0,0,0,0,0,0,0,0
110,私立,一般大學,1008,靜宜大學,碩士班(日間),俄羅斯聯邦,其他亞洲地區,1,1,0,1,1,0,0,0,0,0,0,0,0,0,0
110,私立,一般大學,1008,靜宜大學,碩士班(日間),美國,北美洲,2,1,1,2,1,1,0,0,0,0,0,0,0,0,0
110,私立,一般大學,1008,靜宜大學,碩士班(日間),泰國,東協,8,1,7,8,1,7,0,0,0,0,0,0,0,0,0
110,私立,一般大學,1008,靜宜大學,碩士班(日間),馬來西亞,東協,11,5,6,11,5,6,0,0,0,0,0,0,0,0,0
110,私立,一般大學,1008,靜宜大學,碩士班(日間),菲律賓共和國,東協,5,3,2,5,3,2,0,0,0,0,0,0,0,0,0
110,私立,一般大學,1008,靜宜大學,碩士班(日間),奧地利共和國,歐洲,14,8,6,14,8,6,0,0,0,0,0,0,0,0,0
110,私立,一般大學,1008,靜宜大學,碩士班(日間),蒙古國,其他亞洲地區,3,1,2,3,1,2,0,0,0,0,0,0,0,0,0
110,私立,一般大學,1008,靜宜大學,碩士班(日間),墨西哥合眾國,中南美洲,4,4,0,4,4,0,0,0,0,0,0,0,0,0,0
110,私立,一般大學,1008,靜宜大學,博士班,日本,其他亞洲地區,1,1,0,1,1,0,0,0,0,0,0,0,0,0,0
110,私立,一般大學,1008,靜宜大學,博士班,印度尼西亞共和國,東協,2,2,0,2,2,0,0,0,0,0,0,0,0,0,0
110,私立,一般大學,1008,靜宜大學,博士班,馬來西亞,東協,2,0,2,2,0,2,0,0,0,0,0,0,0,0,0
110,私立,一般大學,1009,長庚大學,學士班(日間),大陸地區,大陸地區,22,15,7,0,0,0,0,0,0,0,0,0,22,15,7
110,私立,一般大學,1009,長庚大學,學士班(日間),大韓民國(南韓),其他亞洲地區,6,3,3,2,2,0,4,1,3,0,0,0,0,0,0
110,私立,一般大學,1009,長庚大學,學士班(日間),日本,其他亞洲地區,2,1,1,0,0,0,2,1,1,0,0,0,0,0,0
110,私立,一般大學,1009,長庚大學,學士班(日間),加拿大,北美洲,2,1,1,0,0,0,2,1,1,0,0,0,0,0,0
110,私立,一般大學,1009,長庚大學,學士班(日間),印度尼西亞共和國,東協,3,3,0,0,0,0,3,3,0,0,0,0,0,0,0
110,私立,一般大學,1009,長庚大學,學士班(日間),香港,港澳,48,25,23,0,0,0,0,0,0,48,25,23,0,0,0
110,私立,一般大學,1009,長庚大學,學士班(日間),馬來西亞,東協,39,13,26,0,0,0,39,13,26,0,0,0,0,0,0
110,私立,一般大學,1009,長庚大學,學士班(日間),新加坡共和國,東協,2,1,1,0,0,0,2,1,1,0,0,0,0,0,0
110,私立,一般大學,1009,長庚大學,學士班(日間),緬甸,東協,2,0,2,0,0,0,2,0,2,0,0,0,0,0,0
110,私立,一般大學,1009,長庚大學,學士班(日間),澳門,港澳,37,18,19,0,0,0,0,0,0,37,18,19,0,0,0
110,私立,一般大學,1009,長庚大學,學士班(日間),美國,北美洲,6,4,2,0,0,0,6,4,2,0,0,0,0,0,0
110,私立,一般大學,1009,長庚大學,學士班(日間),越南社會主義共和國,東協,2,1,1,0,0,0,2,1,1,0,0,0,0,0,0
110,私立,一般大學,1009,長庚大學,碩士班(日間),土耳其共和國,其他亞洲地區,1,1,0,1,1,0,0,0,0,0,0,0,0,0,0
110,私立,一般大學,1009,長庚大學,碩士班(日間),比利時王國,歐洲,1,1,0,1,1,0,0,0,0,0,0,0,0,0,0
110,私立,一般大學,1009,長庚大學,碩士班(日間),甘比亞共和國,非洲,1,1,0,1,1,0,0,0,0,0,0,0,0,0,0
110,私立,一般大學,1009,長庚大學,碩士班(日間),印度尼西亞共和國,東協,9,6,3,9,6,3,0,0,0,0,0,0,0,0,0
110,私立,一般大學,1009,長庚大學,碩士班(日間),阿根廷,中南美洲,1,1,0,1,1,0,0,0,0,0,0,0,0,0,0
110,私立,一般大學,1009,長庚大學,碩士班(日間),美國,北美洲,3,2,1,3,2,1,0,0,0,0,0,0,0,0,0
110,私立,一般大學,1009,長庚大學,碩士班(日間),哥倫比亞共和國,中南美洲,1,1,0,1,1,0,0,0,0,0,0,0,0,0,0
110,私立,一般大學,1009,長庚大學,碩士班(日間),泰國,東協,11,3,8,11,3,8,0,0,0,0,0,0,0,0,0
110,私立,一般大學,1009,長庚大學,碩士班(日間),納米比亞共和國,非洲,1,0,1,1,0,1,0,0,0,0,0,0,0,0,0
110,私立,一般大學,1009,長庚大學,碩士班(日間),菲律賓共和國,東協,1,0,1,1,0,1,0,0,0,0,0,0,0,0,0
110,私立,一般大學,1009,長庚大學,碩士班(日間),越南社會主義共和國,東協,14,1,13,14,1,13,0,0,0,0,0,0,0,0,0
110,私立,一般大學,1009,長庚大學,碩士班(日間),愛爾蘭共和國,歐洲,1,1,0,1,1,0,0,0,0,0,0,0,0,0,0
110,私立,一般大學,1009,長庚大學,碩士班(日間),瑞典王國,歐洲,1,0,1,1,0,1,0,0,0,0,0,0,0,0,0
110,私立,一般大學,1009,長庚大學,碩士班(日間),德意志聯邦共和國,歐洲,2,2,0,2,2,0,0,0,0,0,0,0,0,0,0
110,私立,一般大學,1009,長庚大學,碩士班(日間),墨西哥合眾國,中南美洲,1,0,1,1,0,1,0,0,0,0,0,0,0,0,0
110,私立,一般大學,1009,長庚大學,碩士班(日間),澳門,港澳,3,1,2,0,0,0,0,0,0,3,1,2,0,0,0
110,私立,一般大學,1009,長庚大學,碩士班(日間),大陸地區,大陸地區,4,3,1,0,0,0,0,0,0,0,0,0,4,3,1
110,私立,一般大學,1009,長庚大學,碩士班(日間),大韓民國(南韓),其他亞洲地區,3,3,0,2,2,0,1,1,0,0,0,0,0,0,0
110,私立,一般大學,1009,長庚大學,碩士班(日間),巴基斯坦,南亞,1,1,0,1,1,0,0,0,0,0,0,0,0,0,0
110,私立,一般大學,1009,長庚大學,碩士班(日間),日本,其他亞洲地區,2,2,0,2,2,0,0,0,0,0,0,0,0,0,0
110,私立,一般大學,1009,長庚大學,碩士班(日間),以色列,其他亞洲地區,1,1,0,1,1,0,0,0,0,0,0,0,0,0,0
110,私立,一般大學,1009,長庚大學,碩士班(日間),印度,南亞,10,9,1,10,9,1,0,0,0,0,0,0,0,0,0
110,私立,一般大學,1009,長庚大學,碩士班(日間),衣索比亞聯邦民主共和國,非洲,1,1,0,1,1,0,0,0,0,0,0,0,0,0,0
110,私立,一般大學,1009,長庚大學,碩士班(日間),英國,歐洲,3,3,0,3,3,0,0,0,0,0,0,0,0,0,0
110,私立,一般大學,1009,長庚大學,碩士班(日間),香港,港澳,9,7,2,0,0,0,0,0,0,9,7,2,0,0,0
110,私立,一般大學,1009,長庚大學,碩士班(日間),秘魯共和國,中南美洲,1,1,0,1,1,0,0,0,0,0,0,0,0,0,0
110,私立,一般大學,1009,長庚大學,碩士班(日間),馬來西亞,東協,4,0,4,1,0,1,3,0,3,0,0,0,0,0,0
110,私立,一般大學,1009,長庚大學,碩士班(日間),捷克共和國,歐洲,1,1,0,1,1,0,0,0,0,0,0,0,0,0,0
110,私立,一般大學,1009,長庚大學,碩士班(日間),新加坡共和國,東協,2,2,0,2,2,0,0,0,0,0,0,0,0,0,0
110,私立,一般大學,1009,長庚大學,碩士班(日間),葡萄牙共和國,歐洲,1,1,0,1,1,0,0,0,0,0,0,0,0,0,0
110,私立,一般大學,1009,長庚大學,博士班,大陸地區,大陸地區,6,5,1,0,0,0,0,0,0,0,0,0,6,5,1
110,私立,一般大學,1009,長庚大學,博士班,甘比亞共和國,非洲,1,1,0,1,1,0,0,0,0,0,0,0,0,0,0
110,私立,一般大學,1009,長庚大學,博士班,印度,南亞,26,17,9,26,17,9,0,0,0,0,0,0,0,0,0
110,私立,一般大學,1009,長庚大學,博士班,印度尼西亞共和國,東協,9,6,3,9,6,3,0,0,0,0,0,0,0,0,0
110,私立,一般大學,1009,長庚大學,博士班,沙烏地阿拉伯王國,其他亞洲地區,1,0,1,0,0,0,1,0,1,0,0,0,0,0,0
110,私立,一般大學,1009,長庚大學,博士班,敘利亞阿拉伯共和國,其他亞洲地區,1,1,0,1,1,0,0,0,0,0,0,0,0,0,0
110,私立,一般大學,1009,長庚大學,博士班,大韓民國(南韓),其他亞洲地區,1,1,0,1,1,0,0,0,0,0,0,0,0,0,0
110,私立,一般大學,1009,長庚大學,博士班,巴基斯坦,南亞,3,3,0,3,3,0,0,0,0,0,0,0,0,0,0
110,私立,一般大學,1009,長庚大學,博士班,瓜地馬拉共和國,中南美洲,1,0,1,1,0,1,0,0,0,0,0,0,0,0,0
110,私立,一般大學,1009,長庚大學,博士班,奈及利亞聯邦共和國,非洲,1,1,0,1,1,0,0,0,0,0,0,0,0,0,0
110,私立,一般大學,1009,長庚大學,博士班,馬來西亞,東協,8,3,5,2,0,2,6,3,3,0,0,0,0,0,0
110,私立,一般大學,1009,長庚大學,博士班,越南社會主義共和國,東協,10,3,7,10,3,7,0,0,0,0,0,0,0,0,0
110,私立,一般大學,1009,長庚大學,博士班,澳門,港澳,1,1,0,0,0,0,0,0,0,1,1,0,0,0,0
110,私立,一般大學,1010,元智大學,學士班(日間),大陸地區,大陸地區,50,22,28,0,0,0,0,0,0,0,0,0,50,22,28
110,私立,一般大學,1010,元智大學,學士班(日間),尼加拉瓜,中南美洲,1,0,1,1,0,1,0,0,0,0,0,0,0,0,0
110,私立,一般大學,1010,元智大學,學士班(日間),印度,南亞,2,1,1,2,1,1,0,0,0,0,0,0,0,0,0
110,私立,一般大學,1010,元智大學,學士班(日間),吉爾吉斯,其他亞洲地區,2,2,0,2,2,0,0,0,0,0,0,0,0,0,0
110,私立,一般大學,1010,元智大學,學士班(日間),英國,歐洲,1,0,1,1,0,1,0,0,0,0,0,0,0,0,0
110,私立,一般大學,1010,元智大學,學士班(日間),海地共和國,中南美洲,2,2,0,2,2,0,0,0,0,0,0,0,0,0,0
110,私立,一般大學,1010,元智大學,學士班(日間),秘魯共和國,中南美洲,2,0,2,2,0,2,0,0,0,0,0,0,0,0,0
110,私立,一般大學,1010,元智大學,學士班(日間),馬來西亞,東協,14,6,8,5,0,5,9,6,3,0,0,0,0,0,0
110,私立,一般大學,1010,元智大學,學士班(日間),菲律賓共和國,東協,9,3,6,9,3,6,0,0,0,0,0,0,0,0,0
110,私立,一般大學,1010,元智大學,學士班(日間),越南社會主義共和國,東協,70,24,46,69,23,46,1,1,0,0,0,0,0,0,0
110,私立,一般大學,1010,元智大學,學士班(日間),義大利共和國,歐洲,1,1,0,1,1,0,0,0,0,0,0,0,0,0,0
110,私立,一般大學,1010,元智大學,學士班(日間),聖文森(及格瑞那丁),中南美洲,3,2,1,3,2,1,0,0,0,0,0,0,0,0,0
110,私立,一般大學,1010,元智大學,學士班(日間),聖克里斯多福及尼維斯,中南美洲,1,1,0,1,1,0,0,0,0,0,0,0,0,0,0
110,私立,一般大學,1010,元智大學,學士班(日間),聖露西亞,中南美洲,6,4,2,6,4,2,0,0,0,0,0,0,0,0,0
110,私立,一般大學,1010,元智大學,學士班(日間),蒙古國,其他亞洲地區,6,1,5,6,1,5,0,0,0,0,0,0,0,0,0
110,私立,一般大學,1010,元智大學,學士班(日間),澳門,港澳,4,3,1,0,0,0,0,0,0,4,3,1,0,0,0
110,私立,一般大學,1010,元智大學,學士班(日間),日本,其他亞洲地區,33,17,16,33,17,16,0,0,0,0,0,0,0,0,0
110,私立,一般大學,1010,元智大學,學士班(日間),史瓦帝尼王國,非洲,22,8,14,22,8,14,0,0,0,0,0,0,0,0,0
110,私立,一般大學,1010,元智大學,學士班(日間),甘比亞共和國,非洲,4,3,1,4,3,1,0,0,0,0,0,0,0,0,0
110,私立,一般大學,1010,元智大學,學士班(日間),印度尼西亞共和國,東協,17,9,8,12,7,5,5,2,3,0,0,0,0,0,0
110,私立,一般大學,1010,元智大學,學士班(日間),波蘭共和國,歐洲,1,1,0,1,1,0,0,0,0,0,0,0,0,0,0
110,私立,一般大學,1010,元智大學,學士班(日間),突尼西亞共和國,非洲,1,1,0,1,1,0,0,0,0,0,0,0,0,0,0
110,私立,一般大學,1010,元智大學,學士班(日間),美國,北美洲,2,2,0,2,2,0,0,0,0,0,0,0,0,0,0
110,私立,一般大學,1010,元智大學,學士班(日間),香港,港澳,44,30,14,0,0,0,0,0,0,44,30,14,0,0,0
110,私立,一般大學,1010,元智大學,學士班(日間),泰國,東協,10,3,7,10,3,7,0,0,0,0,0,0,0,0,0
110,私立,一般大學,1010,元智大學,學士班(日間),荷蘭王國,歐洲,1,0,1,1,0,1,0,0,0,0,0,0,0,0,0
110,私立,一般大學,1010,元智大學,學士班(日間),塔吉克共和國,其他亞洲地區,2,2,0,2,2,0,0,0,0,0,0,0,0,0,0
110,私立,一般大學,1010,元智大學,學士班(日間),德意志聯邦共和國,歐洲,2,1,1,2,1,1,0,0,0,0,0,0,0,0,0
110,私立,一般大學,1010,元智大學,學士班(日間),墨西哥合眾國,中南美洲,1,0,1,1,0,1,0,0,0,0,0,0,0,0,0
110,私立,一般大學,1010,元智大學,碩士班(日間),大陸地區,大陸地區,5,3,2,0,0,0,0,0,0,0,0,0,5,3,2
110,私立,一般大學,1010,元智大學,碩士班(日間),加拿大,北美洲,1,0,1,1,0,1,0,0,0,0,0,0,0,0,0
110,私立,一般大學,1010,元智大學,碩士班(日間),史瓦帝尼王國,非洲,3,1,2,3,1,2,0,0,0,0,0,0,0,0,0
110,私立,一般大學,1010,元智大學,碩士班(日間),甘比亞共和國,非洲,8,5,3,8,5,3,0,0,0,0,0,0,0,0,0
110,私立,一般大學,1010,元智大學,碩士班(日間),印度尼西亞共和國,東協,21,10,11,21,10,11,0,0,0,0,0,0,0,0,0
110,私立,一般大學,1010,元智大學,碩士班(日間),法國,歐洲,1,0,1,1,0,1,0,0,0,0,0,0,0,0,0
110,私立,一般大學,1010,元智大學,碩士班(日間),哈薩克共和國,其他亞洲地區,1,0,1,1,0,1,0,0,0,0,0,0,0,0,0
110,私立,一般大學,1010,元智大學,碩士班(日間),約旦哈什米王國,其他亞洲地區,1,1,0,1,1,0,0,0,0,0,0,0,0,0,0
110,私立,一般大學,1010,元智大學,碩士班(日間),香港,港澳,8,6,2,0,0,0,0,0,0,8,6,2,0,0,0
110,私立,一般大學,1010,元智大學,碩士班(日間),泰國,東協,17,3,14,17,3,14,0,0,0,0,0,0,0,0,0
110,私立,一般大學,1010,元智大學,碩士班(日間),塔吉克共和國,其他亞洲地區,1,1,0,1,1,0,0,0,0,0,0,0,0,0,0
110,私立,一般大學,1010,元智大學,碩士班(日間),土耳其共和國,其他亞洲地區,2,2,0,2,2,0,0,0,0,0,0,0,0,0,0
110,私立,一般大學,1010,元智大學,碩士班(日間),厄瓜多共和國,中南美洲,1,0,1,1,0,1,0,0,0,0,0,0,0,0,0
110,私立,一般大學,1010,元智大學,碩士班(日間),巴基斯坦,南亞,8,6,2,8,6,2,0,0,0,0,0,0,0,0,0
110,私立,一般大學,1010,元智大學,碩士班(日間),尼加拉瓜,中南美洲,2,2,0,2,2,0,0,0,0,0,0,0,0,0,0
110,私立,一般大學,1010,元智大學,碩士班(日間),尼泊爾聯邦民主共和國,南亞,1,1,0,1,1,0,0,0,0,0,0,0,0,0,0
110,私立,一般大學,1010,元智大學,碩士班(日間),瓜地馬拉共和國,中南美洲,3,3,0,3,3,0,0,0,0,0,0,0,0,0,0
110,私立,一般大學,1010,元智大學,碩士班(日間),印度,南亞,9,7,2,9,7,2,0,0,0,0,0,0,0,0,0
110,私立,一般大學,1010,元智大學,碩士班(日間),宏都拉斯共和國,中南美洲,3,3,0,3,3,0,0,0,0,0,0,0,0,0,0
110,私立,一般大學,1010,元智大學,碩士班(日間),孟加拉人民共和國,南亞,1,0,1,1,0,1,0,0,0,0,0,0,0,0,0
110,私立,一般大學,1010,元智大學,碩士班(日間),俄羅斯聯邦,其他亞洲地區,1,1,0,1,1,0,0,0,0,0,0,0,0,0,0
110,私立,一般大學,1010,元智大學,碩士班(日間),美國,北美洲,3,2,1,2,2,0,1,0,1,0,0,0,0,0,0
110,私立,一般大學,1010,元智大學,碩士班(日間),哥倫比亞共和國,中南美洲,1,1,0,1,1,0,0,0,0,0,0,0,0,0,0
110,私立,一般大學,1010,元智大學,碩士班(日間),埃及阿拉伯共和國,非洲,1,0,1,1,0,1,0,0,0,0,0,0,0,0,0
110,私立,一般大學,1010,元智大學,碩士班(日間),馬來西亞,東協,12,4,8,9,3,6,3,1,2,0,0,0,0,0,0
110,私立,一般大學,1010,元智大學,碩士班(日間),捷克共和國,歐洲,2,1,1,2,1,1,0,0,0,0,0,0,0,0,0
110,私立,一般大學,1010,元智大學,碩士班(日間),菲律賓共和國,東協,2,1,1,2,1,1,0,0,0,0,0,0,0,0,0
110,私立,一般大學,1010,元智大學,碩士班(日間),越南社會主義共和國,東協,43,8,35,43,8,35,0,0,0,0,0,0,0,0,0
110,私立,一般大學,1010,元智大學,碩士班(日間),聖文森(及格瑞那丁),中南美洲,1,0,1,1,0,1,0,0,0,0,0,0,0,0,0
110,私立,一般大學,1010,元智大學,碩士班(日間),德意志聯邦共和國,歐洲,1,1,0,1,1,0,0,0,0,0,0,0,0,0,0
110,私立,一般大學,1010,元智大學,碩士班(日間),澳門,港澳,1,1,0,0,0,0,0,0,0,1,1,0,0,0,0
110,私立,一般大學,1010,元智大學,博士班,巴基斯坦,南亞,6,6,0,6,6,0,0,0,0,0,0,0,0,0,0
110,私立,一般大學,1010,元智大學,博士班,尼泊爾聯邦民主共和國,南亞,2,2,0,2,2,0,0,0,0,0,0,0,0,0,0
110,私立,一般大學,1010,元智大學,博士班,甘比亞共和國,非洲,3,3,0,3,3,0,0,0,0,0,0,0,0,0,0
110,私立,一般大學,1010,元智大學,博士班,印度,南亞,16,14,2,16,14,2,0,0,0,0,0,0,0,0,0
110,私立,一般大學,1010,元智大學,博士班,宏都拉斯共和國,中南美洲,3,2,1,3,2,1,0,0,0,0,0,0,0,0,0
110,私立,一般大學,1010,元智大學,博士班,俄羅斯聯邦,其他亞洲地區,2,1,1,2,1,1,0,0,0,0,0,0,0,0,0
110,私立,一般大學,1010,元智大學,博士班,蓋亞那共和國,中南美洲,1,0,1,1,0,1,0,0,0,0,0,0,0,0,0
110,私立,一般大學,1010,元智大學,博士班,大陸地區,大陸地區,11,7,4,0,0,0,0,0,0,0,0,0,11,7,4
110,私立,一般大學,1010,元智大學,博士班,史瓦帝尼王國,非洲,7,6,1,7,6,1,0,0,0,0,0,0,0,0,0
110,私立,一般大學,1010,元智大學,博士班,瓜地馬拉共和國,中南美洲,2,2,0,2,2,0,0,0,0,0,0,0,0,0,0
110,私立,一般大學,1010,元智大學,博士班,印度尼西亞共和國,東協,14,9,5,14,9,5,0,0,0,0,0,0,0,0,0
110,私立,一般大學,1010,元智大學,博士班,孟加拉人民共和國,南亞,1,1,0,1,1,0,0,0,0,0,0,0,0,0,0
110,私立,一般大學,1010,元智大學,博士班,香港,港澳,1,1,0,0,0,0,0,0,0,1,1,0,0,0,0
110,私立,一般大學,1010,元智大學,博士班,埃及阿拉伯共和國,非洲,1,1,0,1,1,0,0,0,0,0,0,0,0,0,0
110,私立,一般大學,1010,元智大學,博士班,泰國,東協,4,0,4,4,0,4,0,0,0,0,0,0,0,0,0
110,私立,一般大學,1010,元智大學,博士班,海地共和國,中南美洲,2,2,0,2,2,0,0,0,0,0,0,0,0,0,0
110,私立,一般大學,1010,元智大學,博士班,索羅門群島,其他亞洲地區,1,1,0,1,1,0,0,0,0,0,0,0,0,0,0
110,私立,一般大學,1010,元智大學,博士班,菲律賓共和國,東協,1,0,1,1,0,1,0,0,0,0,0,0,0,0,0
110,私立,一般大學,1010,元智大學,博士班,越南社會主義共和國,東協,15,7,8,15,7,8,0,0,0,0,0,0,0,0,0
110,私立,一般大學,1010,元智大學,博士班,薩爾瓦多,中南美洲,1,1,0,1,1,0,0,0,0,0,0,0,0,0,0
110,私立,一般大學,1011,中華大學學校財團法人中華大學,學士班(日間),大陸地區,大陸地區,5,4,1,0,0,0,0,0,0,0,0,0,5,4,1
110,私立,一般大學,1011,中華大學學校財團法人中華大學,學士班(日間),大韓民國(南韓),其他亞洲地區,1,0,1,1,0,1,0,0,0,0,0,0,0,0,0
110,私立,一般大學,1011,中華大學學校財團法人中華大學,學士班(日間),日本,其他亞洲地區,65,47,18,65,47,18,0,0,0,0,0,0,0,0,0
110,私立,一般大學,1011,中華大學學校財團法人中華大學,學士班(日間),貝里斯,中南美洲,1,1,0,1,1,0,0,0,0,0,0,0,0,0,0
110,私立,一般大學,1011,中華大學學校財團法人中華大學,學士班(日間),香港,港澳,8,6,2,0,0,0,0,0,0,8,6,2,0,0,0
110,私立,一般大學,1011,中華大學學校財團法人中華大學,學士班(日間),海地共和國,中南美洲,1,1,0,1,1,0,0,0,0,0,0,0,0,0,0
110,私立,一般大學,1011,中華大學學校財團法人中華大學,學士班(日間),馬拉威共和國,非洲,2,2,0,2,2,0,0,0,0,0,0,0,0,0,0
110,私立,一般大學,1011,中華大學學校財團法人中華大學,學士班(日間),聖克里斯多福及尼維斯,中南美洲,1,0,1,1,0,1,0,0,0,0,0,0,0,0,0
110,私立,一般大學,1011,中華大學學校財團法人中華大學,學士班(日間),緬甸,東協,3,3,0,3,3,0,0,0,0,0,0,0,0,0,0
110,私立,一般大學,1011,中華大學學校財團法人中華大學,學士班(日間),澳門,港澳,1,1,0,0,0,0,0,0,0,1,1,0,0,0,0
110,私立,一般大學,1011,中華大學學校財團法人中華大學,學士班(日間),史瓦帝尼王國,非洲,1,0,1,1,0,1,0,0,0,0,0,0,0,0,0
110,私立,一般大學,1011,中華大學學校財團法人中華大學,學士班(日間),印度尼西亞共和國,東協,7,2,5,5,1,4,2,1,1,0,0,0,0,0,0
110,私立,一般大學,1011,中華大學學校財團法人中華大學,學士班(日間),泰國,東協,2,1,1,1,0,1,1,1,0,0,0,0,0,0,0
110,私立,一般大學,1011,中華大學學校財團法人中華大學,學士班(日間),馬來西亞,東協,204,145,59,196,139,57,8,6,2,0,0,0,0,0,0
110,私立,一般大學,1011,中華大學學校財團法人中華大學,學士班(日間),菲律賓共和國,東協,61,26,35,61,26,35,0,0,0,0,0,0,0,0,0
110,私立,一般大學,1011,中華大學學校財團法人中華大學,學士班(日間),越南社會主義共和國,東協,60,20,40,58,19,39,2,1,1,0,0,0,0,0,0
110,私立,一般大學,1011,中華大學學校財團法人中華大學,學士班(日間),蒙古國,其他亞洲地區,7,5,2,7,5,2,0,0,0,0,0,0,0,0,0
110,私立,一般大學,1011,中華大學學校財團法人中華大學,碩士班(日間),土耳其共和國,其他亞洲地區,2,1,1,2,1,1,0,0,0,0,0,0,0,0,0
110,私立,一般大學,1011,中華大學學校財團法人中華大學,碩士班(日間),印度尼西亞共和國,東協,1,0,1,1,0,1,0,0,0,0,0,0,0,0,0
110,私立,一般大學,1011,中華大學學校財團法人中華大學,碩士班(日間),孟加拉人民共和國,南亞,1,1,0,1,1,0,0,0,0,0,0,0,0,0,0
110,私立,一般大學,1011,中華大學學校財團法人中華大學,碩士班(日間),美國,北美洲,1,1,0,1,1,0,0,0,0,0,0,0,0,0,0
110,私立,一般大學,1011,中華大學學校財團法人中華大學,碩士班(日間),埃及阿拉伯共和國,非洲,1,1,0,1,1,0,0,0,0,0,0,0,0,0,0
110,私立,一般大學,1011,中華大學學校財團法人中華大學,碩士班(日間),泰國,東協,2,0,2,2,0,2,0,0,0,0,0,0,0,0,0
110,私立,一般大學,1011,中華大學學校財團法人中華大學,碩士班(日間),海地共和國,中南美洲,2,2,0,2,2,0,0,0,0,0,0,0,0,0,0
110,私立,一般大學,1011,中華大學學校財團法人中華大學,碩士班(日間),馬來西亞,東協,3,0,3,3,0,3,0,0,0,0,0,0,0,0,0
110,私立,一般大學,1011,中華大學學校財團法人中華大學,碩士班(日間),菲律賓共和國,東協,3,0,3,3,0,3,0,0,0,0,0,0,0,0,0
110,私立,一般大學,1011,中華大學學校財團法人中華大學,碩士班(日間),越南社會主義共和國,東協,3,0,3,3,0,3,0,0,0,0,0,0,0,0,0
110,私立,一般大學,1011,中華大學學校財團法人中華大學,碩士班(日間),蒙古國,其他亞洲地區,6,1,5,6,1,5,0,0,0,0,0,0,0,0,0
110,私立,一般大學,1011,中華大學學校財團法人中華大學,碩士班(日間),印度,南亞,2,0,2,2,0,2,0,0,0,0,0,0,0,0,0
110,私立,一般大學,1011,中華大學學校財團法人中華大學,碩士班(日間),約旦哈什米王國,其他亞洲地區,1,1,0,1,1,0,0,0,0,0,0,0,0,0,0
110,私立,一般大學,1011,中華大學學校財團法人中華大學,博士班,大陸地區,大陸地區,6,4,2,0,0,0,0,0,0,0,0,0,6,4,2
110,私立,一般大學,1011,中華大學學校財團法人中華大學,博士班,泰國,東協,2,1,1,2,1,1,0,0,0,0,0,0,0,0,0
110,私立,一般大學,1011,中華大學學校財團法人中華大學,博士班,伊拉克共和國,其他亞洲地區,1,1,0,1,1,0,0,0,0,0,0,0,0,0,0
110,私立,一般大學,1011,中華大學學校財團法人中華大學,博士班,印度,南亞,1,0,1,1,0,1,0,0,0,0,0,0,0,0,0
110,私立,一般大學,1011,中華大學學校財團法人中華大學,博士班,約旦哈什米王國,其他亞洲地區,3,3,0,3,3,0,0,0,0,0,0,0,0,0,0
110,私立,一般大學,1011,中華大學學校財團法人中華大學,博士班,蒙古國,其他亞洲地區,1,0,1,1,0,1,0,0,0,0,0,0,0,0,0
110,私立,一般大學,1012,大葉大學,學士班(日間),日本,其他亞洲地區,14,4,10,14,4,10,0,0,0,0,0,0,0,0,0
110,私立,一般大學,1012,大葉大學,學士班(日間),玻利維亞共和國,中南美洲,1,1,0,1,1,0,0,0,0,0,0,0,0,0,0
110,私立,一般大學,1012,大葉大學,學士班(日間),馬來西亞,東協,110,78,32,87,66,21,23,12,11,0,0,0,0,0,0
110,私立,一般大學,1012,大葉大學,學士班(日間),蒙古國,其他亞洲地區,14,5,9,14,5,9,0,0,0,0,0,0,0,0,0
110,私立,一般大學,1012,大葉大學,學士班(日間),大陸地區,大陸地區,13,8,5,0,0,0,0,0,0,0,0,0,13,8,5
110,私立,一般大學,1012,大葉大學,學士班(日間),大韓民國(南韓),其他亞洲地區,2,1,1,2,1,1,0,0,0,0,0,0,0,0,0
110,私立,一般大學,1012,大葉大學,學士班(日間),印度尼西亞共和國,東協,12,4,8,10,3,7,2,1,1,0,0,0,0,0,0
110,私立,一般大學,1012,大葉大學,學士班(日間),香港,港澳,133,66,67,0,0,0,0,0,0,133,66,67,0,0,0
110,私立,一般大學,1012,大葉大學,學士班(日間),越南社會主義共和國,東協,10,7,3,10,7,3,0,0,0,0,0,0,0,0,0
110,私立,一般大學,1012,大葉大學,學士班(日間),澳門,港澳,8,5,3,0,0,0,0,0,0,8,5,3,0,0,0
110,私立,一般大學,1012,大葉大學,碩士班(日間),古巴共和國,中南美洲,1,1,0,1,1,0,0,0,0,0,0,0,0,0,0
110,私立,一般大學,1012,大葉大學,碩士班(日間),印度尼西亞共和國,東協,4,2,2,4,2,2,0,0,0,0,0,0,0,0,0
110,私立,一般大學,1012,大葉大學,碩士班(日間),香港,港澳,15,8,7,0,0,0,0,0,0,15,8,7,0,0,0
110,私立,一般大學,1012,大葉大學,碩士班(日間),越南社會主義共和國,東協,6,1,5,6,1,5,0,0,0,0,0,0,0,0,0
110,私立,一般大學,1012,大葉大學,碩士班(日間),緬甸,東協,1,1,0,0,0,0,1,1,0,0,0,0,0,0,0
110,私立,一般大學,1012,大葉大學,碩士班(日間),馬來西亞,東協,10,7,3,10,7,3,0,0,0,0,0,0,0,0,0
110,私立,一般大學,1012,大葉大學,碩士班(日間),蒙古國,其他亞洲地區,21,6,15,21,6,15,0,0,0,0,0,0,0,0,0
110,私立,一般大學,1012,大葉大學,博士班,大陸地區,大陸地區,1,1,0,0,0,0,0,0,0,0,0,0,1,1,0
110,私立,一般大學,1012,大葉大學,博士班,印度尼西亞共和國,東協,4,3,1,4,3,1,0,0,0,0,0,0,0,0,0
110,私立,一般大學,1012,大葉大學,博士班,馬來西亞,東協,1,0,1,1,0,1,0,0,0,0,0,0,0,0,0
110,私立,一般大學,1012,大葉大學,博士班,蒙古國,其他亞洲地區,2,0,2,2,0,2,0,0,0,0,0,0,0,0,0
110,私立,一般大學,1012,大葉大學,博士班,越南社會主義共和國,東協,6,4,2,6,4,2,0,0,0,0,0,0,0,0,0
110,私立,一般大學,1013,華梵大學,學士班(日間),大韓民國(南韓),其他亞洲地區,1,1,0,1,1,0,0,0,0,0,0,0,0,0,0
110,私立,一般大學,1013,華梵大學,學士班(日間),馬來西亞,東協,3,1,2,2,0,2,1,1,0,0,0,0,0,0,0
110,私立,一般大學,1013,華梵大學,學士班(日間),越南社會主義共和國,東協,4,2,2,4,2,2,0,0,0,0,0,0,0,0,0
110,私立,一般大學,1013,華梵大學,學士班(日間),香港,港澳,30,11,19,0,0,0,0,0,0,30,11,19,0,0,0
110,私立,一般大學,1013,華梵大學,學士班(日間),緬甸,東協,2,2,0,2,2,0,0,0,0,0,0,0,0,0,0
110,私立,一般大學,1013,華梵大學,碩士班(日間),香港,港澳,9,5,4,0,0,0,0,0,0,9,5,4,0,0,0
110,私立,一般大學,1013,華梵大學,碩士班(日間),斯洛維尼亞共和國,歐洲,1,1,0,1,1,0,0,0,0,0,0,0,0,0,0
110,私立,一般大學,1013,華梵大學,碩士班(日間),澳門,港澳,2,2,0,0,0,0,0,0,0,2,2,0,0,0,0
110,私立,一般大學,1013,華梵大學,碩士班(日間),印度尼西亞共和國,東協,1,0,1,0,0,0,1,0,1,0,0,0,0,0,0
110,私立,一般大學,1013,華梵大學,碩士班(日間),法國,歐洲,1,0,1,1,0,1,0,0,0,0,0,0,0,0,0
110,私立,一般大學,1013,華梵大學,碩士班(日間),馬來西亞,東協,3,2,1,2,2,0,1,0,1,0,0,0,0,0,0
110,私立,一般大學,1013,華梵大學,碩士班(日間),越南社會主義共和國,東協,6,1,5,6,1,5,0,0,0,0,0,0,0,0,0
110,私立,一般大學,1013,華梵大學,博士班,大陸地區,大陸地區,5,4,1,0,0,0,0,0,0,0,0,0,5,4,1
110,私立,一般大學,1013,華梵大學,博士班,尼泊爾聯邦民主共和國,南亞,1,1,0,1,1,0,0,0,0,0,0,0,0,0,0
110,私立,一般大學,1013,華梵大學,博士班,馬來西亞,東協,1,0,1,1,0,1,0,0,0,0,0,0,0,0,0
110,私立,一般大學,1013,華梵大學,博士班,越南社會主義共和國,東協,3,1,2,3,1,2,0,0,0,0,0,0,0,0,0
110,私立,一般大學,1014,義守大學,學士班(日間),巴拉圭,中南美洲,3,2,1,3,2,1,0,0,0,0,0,0,0,0,0
110,私立,一般大學,1014,義守大學,學士班(日間),史瓦帝尼王國,非洲,19,3,16,19,3,16,0,0,0,0,0,0,0,0,0
110,私立,一般大學,1014,義守大學,學士班(日間),尼加拉瓜,中南美洲,2,1,1,2,1,1,0,0,0,0,0,0,0,0,0
110,私立,一般大學,1014,義守大學,學士班(日間),貝里斯,中南美洲,20,7,13,20,7,13,0,0,0,0,0,0,0,0,0
110,私立,一般大學,1014,義守大學,學士班(日間),帛琉共和國,其他亞洲地區,2,2,0,2,2,0,0,0,0,0,0,0,0,0,0
110,私立,一般大學,1014,義守大學,學士班(日間),美國,北美洲,4,2,2,3,1,2,1,1,0,0,0,0,0,0,0
110,私立,一般大學,1014,義守大學,學士班(日間),埃及阿拉伯共和國,非洲,1,1,0,1,1,0,0,0,0,0,0,0,0,0,0
110,私立,一般大學,1014,義守大學,學士班(日間),泰國,東協,50,17,33,50,17,33,0,0,0,0,0,0,0,0,0
110,私立,一般大學,1014,義守大學,學士班(日間),烏茲別克共和國,其他亞洲地區,1,1,0,1,1,0,0,0,0,0,0,0,0,0,0
110,私立,一般大學,1014,義守大學,學士班(日間),馬紹爾群島共和國,其他亞洲地區,2,2,0,2,2,0,0,0,0,0,0,0,0,0,0
110,私立,一般大學,1014,義守大學,學士班(日間),義大利共和國,歐洲,1,1,0,1,1,0,0,0,0,0,0,0,0,0,0
110,私立,一般大學,1014,義守大學,學士班(日間),聖露西亞,中南美洲,28,12,16,28,12,16,0,0,0,0,0,0,0,0,0
110,私立,一般大學,1014,義守大學,學士班(日間),蒙古國,其他亞洲地區,14,6,8,14,6,8,0,0,0,0,0,0,0,0,0
110,私立,一般大學,1014,義守大學,學士班(日間),大陸地區,大陸地區,23,13,10,0,0,0,0,0,0,0,0,0,23,13,10
110,私立,一般大學,1014,義守大學,學士班(日間),大韓民國(南韓),其他亞洲地區,5,4,1,1,1,0,4,3,1,0,0,0,0,0,0
110,私立,一般大學,1014,義守大學,學士班(日間),巴勒斯坦,其他亞洲地區,2,0,2,2,0,2,0,0,0,0,0,0,0,0,0
110,私立,一般大學,1014,義守大學,學士班(日間),日本,其他亞洲地區,103,33,70,103,33,70,0,0,0,0,0,0,0,0,0
110,私立,一般大學,1014,義守大學,學士班(日間),加拿大,北美洲,1,1,0,1,1,0,0,0,0,0,0,0,0,0,0
110,私立,一般大學,1014,義守大學,學士班(日間),伊拉克共和國,其他亞洲地區,1,1,0,1,1,0,0,0,0,0,0,0,0,0,0
110,私立,一般大學,1014,義守大學,學士班(日間),印度尼西亞共和國,東協,231,100,131,211,94,117,20,6,14,0,0,0,0,0,0
110,私立,一般大學,1014,義守大學,學士班(日間),吉爾吉斯,其他亞洲地區,4,2,2,4,2,2,0,0,0,0,0,0,0,0,0
110,私立,一般大學,1014,義守大學,學士班(日間),宏都拉斯共和國,中南美洲,17,9,8,17,9,8,0,0,0,0,0,0,0,0,0
110,私立,一般大學,1014,義守大學,學士班(日間),俄羅斯聯邦,其他亞洲地區,1,1,0,1,1,0,0,0,0,0,0,0,0,0,0
110,私立,一般大學,1014,義守大學,學士班(日間),香港,港澳,416,225,191,0,0,0,0,0,0,416,225,191,0,0,0
110,私立,一般大學,1014,義守大學,學士班(日間),秘魯共和國,中南美洲,1,0,1,1,0,1,0,0,0,0,0,0,0,0,0
110,私立,一般大學,1014,義守大學,學士班(日間),索馬利蘭共和國,非洲,1,1,0,1,1,0,0,0,0,0,0,0,0,0,0
110,私立,一般大學,1014,義守大學,學士班(日間),馬來西亞,東協,186,101,85,131,73,58,55,28,27,0,0,0,0,0,0
110,私立,一般大學,1014,義守大學,學士班(日間),馬拉威共和國,非洲,1,1,0,1,1,0,0,0,0,0,0,0,0,0,0
110,私立,一般大學,1014,義守大學,學士班(日間),斐濟群島共和國,其他亞洲地區,1,0,1,1,0,1,0,0,0,0,0,0,0,0,0
110,私立,一般大學,1014,義守大學,學士班(日間),菲律賓共和國,東協,10,8,2,10,8,2,0,0,0,0,0,0,0,0,0
110,私立,一般大學,1014,義守大學,學士班(日間),越南社會主義共和國,東協,113,44,69,112,44,68,1,0,1,0,0,0,0,0,0
110,私立,一般大學,1014,義守大學,學士班(日間),聖文森(及格瑞那丁),中南美洲,5,2,3,5,2,3,0,0,0,0,0,0,0,0,0
110,私立,一般大學,1014,義守大學,學士班(日間),聖克里斯多福及尼維斯,中南美洲,2,0,2,2,0,2,0,0,0,0,0,0,0,0,0
110,私立,一般大學,1014,義守大學,學士班(日間),澳門,港澳,76,49,27,0,0,0,0,0,0,76,49,27,0,0,0
110,私立,一般大學,1014,義守大學,學士班(日間),薩爾瓦多,中南美洲,2,2,0,2,2,0,0,0,0,0,0,0,0,0,0
110,私立,一般大學,1014,義守大學,碩士班(日間),大陸地區,大陸地區,4,2,2,0,0,0,0,0,0,0,0,0,4,2,2
110,私立,一般大學,1014,義守大學,碩士班(日間),印度,南亞,1,1,0,1,1,0,0,0,0,0,0,0,0,0,0
110,私立,一般大學,1014,義守大學,碩士班(日間),印度尼西亞共和國,東協,6,3,3,6,3,3,0,0,0,0,0,0,0,0,0
110,私立,一般大學,1014,義守大學,碩士班(日間),吉爾吉斯,其他亞洲地區,2,0,2,2,0,2,0,0,0,0,0,0,0,0,0
110,私立,一般大學,1014,義守大學,碩士班(日間),香港,港澳,5,4,1,0,0,0,0,0,0,5,4,1,0,0,0
110,私立,一般大學,1014,義守大學,碩士班(日間),馬來西亞,東協,6,4,2,4,3,1,2,1,1,0,0,0,0,0,0
110,私立,一般大學,1014,義守大學,碩士班(日間),越南社會主義共和國,東協,48,20,28,48,20,28,0,0,0,0,0,0,0,0,0
110,私立,一般大學,1014,義守大學,碩士班(日間),蒙古國,其他亞洲地區,1,0,1,1,0,1,0,0,0,0,0,0,0,0,0
110,私立,一般大學,1014,義守大學,碩士班(日間),史瓦帝尼王國,非洲,1,1,0,1,1,0,0,0,0,0,0,0,0,0,0
110,私立,一般大學,1014,義守大學,碩士班(日間),貝里斯,中南美洲,1,1,0,1,1,0,0,0,0,0,0,0,0,0,0
110,私立,一般大學,1014,義守大學,碩士班(日間),泰國,東協,18,5,13,18,5,13,0,0,0,0,0,0,0,0,0
110,私立,一般大學,1014,義守大學,博士班,菲律賓共和國,東協,2,1,1,2,1,1,0,0,0,0,0,0,0,0,0
110,私立,一般大學,1014,義守大學,博士班,越南社會主義共和國,東協,4,2,2,4,2,2,0,0,0,0,0,0,0,0,0
110,私立,一般大學,1014,義守大學,博士班,大陸地區,大陸地區,7,3,4,0,0,0,0,0,0,0,0,0,7,3,4
110,私立,一般大學,1014,義守大學,博士班,印度,南亞,1,1,0,1,1,0,0,0,0,0,0,0,0,0,0
110,私立,一般大學,1014,義守大學,博士班,印度尼西亞共和國,東協,1,1,0,1,1,0,0,0,0,0,0,0,0,0,0
110,私立,一般大學,1014,義守大學,博士班,香港,港澳,1,1,0,0,0,0,0,0,0,1,1,0,0,0,0
110,私立,一般大學,1015,世新大學,學士班(日間),大陸地區,大陸地區,52,13,39,0,0,0,0,0,0,0,0,0,52,13,39
110,私立,一般大學,1015,世新大學,學士班(日間),巴西聯邦共和國,中南美洲,1,0,1,0,0,0,1,0,1,0,0,0,0,0,0
110,私立,一般大學,1015,世新大學,學士班(日間),巴拉圭,中南美洲,2,0,2,2,0,2,0,0,0,0,0,0,0,0,0
110,私立,一般大學,1015,世新大學,學士班(日間),日本,其他亞洲地區,40,9,31,38,8,30,2,1,1,0,0,0,0,0,0
110,私立,一般大學,1015,世新大學,學士班(日間),瓜地馬拉共和國,中南美洲,1,1,0,1,1,0,0,0,0,0,0,0,0,0,0
110,私立,一般大學,1015,世新大學,學士班(日間),印度尼西亞共和國,東協,14,3,11,2,0,2,12,3,9,0,0,0,0,0,0
110,私立,一般大學,1015,世新大學,學士班(日間),香港,港澳,120,39,81,0,0,0,0,0,0,120,39,81,0,0,0
110,私立,一般大學,1015,世新大學,學士班(日間),馬來西亞,東協,202,62,140,85,28,57,117,34,83,0,0,0,0,0,0
110,私立,一般大學,1015,世新大學,學士班(日間),越南社會主義共和國,東協,17,5,12,13,4,9,4,1,3,0,0,0,0,0,0
110,私立,一般大學,1015,世新大學,學士班(日間),瑞士聯邦,歐洲,2,0,2,2,0,2,0,0,0,0,0,0,0,0,0
110,私立,一般大學,1015,世新大學,學士班(日間),緬甸,東協,1,0,1,0,0,0,1,0,1,0,0,0,0,0,0
110,私立,一般大學,1015,世新大學,學士班(日間),澳門,港澳,65,28,37,0,0,0,0,0,0,65,28,37,0,0,0
110,私立,一般大學,1015,世新大學,學士班(日間),大韓民國(南韓),其他亞洲地區,3,0,3,3,0,3,0,0,0,0,0,0,0,0,0
110,私立,一般大學,1015,世新大學,學士班(日間),奈及利亞聯邦共和國,非洲,5,4,1,5,4,1,0,0,0,0,0,0,0,0,0
110,私立,一般大學,1015,世新大學,學士班(日間),俄羅斯聯邦,其他亞洲地區,2,0,2,2,0,2,0,0,0,0,0,0,0,0,0
110,私立,一般大學,1015,世新大學,學士班(日間),美國,北美洲,1,1,0,1,1,0,0,0,0,0,0,0,0,0,0
110,私立,一般大學,1015,世新大學,學士班(日間),智利,中南美洲,1,1,0,1,1,0,0,0,0,0,0,0,0,0,0
110,私立,一般大學,1015,世新大學,學士班(日間),新加坡共和國,東協,8,1,7,8,1,7,0,0,0,0,0,0,0,0,0
110,私立,一般大學,1015,世新大學,學士班(日間),葡萄牙共和國,歐洲,1,1,0,1,1,0,0,0,0,0,0,0,0,0,0
110,私立,一般大學,1015,世新大學,學士班(日間),蒙古國,其他亞洲地區,1,0,1,1,0,1,0,0,0,0,0,0,0,0,0
110,私立,一般大學,1015,世新大學,碩士班(日間),奈及利亞聯邦共和國,非洲,1,1,0,1,1,0,0,0,0,0,0,0,0,0,0
110,私立,一般大學,1015,世新大學,碩士班(日間),俄羅斯聯邦,其他亞洲地區,3,0,3,3,0,3,0,0,0,0,0,0,0,0,0
110,私立,一般大學,1015,世新大學,碩士班(日間),土耳其共和國,其他亞洲地區,1,1,0,1,1,0,0,0,0,0,0,0,0,0,0
110,私立,一般大學,1015,世新大學,碩士班(日間),大陸地區,大陸地區,49,16,33,0,0,0,0,0,0,0,0,0,49,16,33
110,私立,一般大學,1015,世新大學,碩士班(日間),大韓民國(南韓),其他亞洲地區,1,1,0,1,1,0,0,0,0,0,0,0,0,0,0
110,私立,一般大學,1015,世新大學,碩士班(日間),印度尼西亞共和國,東協,1,0,1,1,0,1,0,0,0,0,0,0,0,0,0
110,私立,一般大學,1015,世新大學,碩士班(日間),香港,港澳,19,6,13,0,0,0,0,0,0,19,6,13,0,0,0
110,私立,一般大學,1015,世新大學,碩士班(日間),馬來西亞,東協,8,2,6,5,1,4,3,1,2,0,0,0,0,0,0
110,私立,一般大學,1015,世新大學,碩士班(日間),越南社會主義共和國,東協,2,0,2,2,0,2,0,0,0,0,0,0,0,0,0
110,私立,一般大學,1015,世新大學,碩士班(日間),澳門,港澳,5,3,2,0,0,0,0,0,0,5,3,2,0,0,0
110,私立,一般大學,1015,世新大學,博士班,大陸地區,大陸地區,25,11,14,0,0,0,0,0,0,0,0,0,25,11,14
110,私立,一般大學,1016,銘傳大學,學士班(日間),大陸地區,大陸地區,100,36,64,0,0,0,0,0,0,0,0,0,100,36,64
110,私立,一般大學,1016,銘傳大學,學士班(日間),大韓民國(南韓),其他亞洲地區,11,6,5,11,6,5,0,0,0,0,0,0,0,0,0
110,私立,一般大學,1016,銘傳大學,學士班(日間),厄瓜多共和國,中南美洲,2,0,2,2,0,2,0,0,0,0,0,0,0,0,0
110,私立,一般大學,1016,銘傳大學,學士班(日間),巴布亞紐幾內亞獨立國,其他亞洲地區,9,4,5,9,4,5,0,0,0,0,0,0,0,0,0
110,私立,一般大學,1016,銘傳大學,學士班(日間),巴西聯邦共和國,中南美洲,5,3,2,5,3,2,0,0,0,0,0,0,0,0,0
110,私立,一般大學,1016,銘傳大學,學士班(日間),尼泊爾聯邦民主共和國,南亞,2,2,0,2,2,0,0,0,0,0,0,0,0,0,0
110,私立,一般大學,1016,銘傳大學,學士班(日間),瓜地馬拉共和國,中南美洲,12,6,6,12,6,6,0,0,0,0,0,0,0,0,0
110,私立,一般大學,1016,銘傳大學,學士班(日間),印度,南亞,7,2,5,7,2,5,0,0,0,0,0,0,0,0,0
110,私立,一般大學,1016,銘傳大學,學士班(日間),印度尼西亞共和國,東協,185,72,113,133,53,80,52,19,33,0,0,0,0,0,0
110,私立,一般大學,1016,銘傳大學,學士班(日間),宏都拉斯共和國,中南美洲,26,9,17,26,9,17,0,0,0,0,0,0,0,0,0
110,私立,一般大學,1016,銘傳大學,學士班(日間),帛琉共和國,其他亞洲地區,20,10,10,20,10,10,0,0,0,0,0,0,0,0,0
110,私立,一般大學,1016,銘傳大學,學士班(日間),拉脫維亞共和國,歐洲,1,0,1,1,0,1,0,0,0,0,0,0,0,0,0
110,私立,一般大學,1016,銘傳大學,學士班(日間),南非共和國,非洲,4,2,2,4,2,2,0,0,0,0,0,0,0,0,0
110,私立,一般大學,1016,銘傳大學,學士班(日間),英國,歐洲,2,1,1,2,1,1,0,0,0,0,0,0,0,0,0
110,私立,一般大學,1016,銘傳大學,學士班(日間),香港,港澳,360,165,195,0,0,0,0,0,0,360,165,195,0,0,0
110,私立,一般大學,1016,銘傳大學,學士班(日間),秘魯共和國,中南美洲,5,1,4,5,1,4,0,0,0,0,0,0,0,0,0
110,私立,一般大學,1016,銘傳大學,學士班(日間),馬來西亞,東協,466,178,288,255,107,148,211,71,140,0,0,0,0,0,0
110,私立,一般大學,1016,銘傳大學,學士班(日間),馬紹爾群島共和國,其他亞洲地區,11,5,6,11,5,6,0,0,0,0,0,0,0,0,0
110,私立,一般大學,1016,銘傳大學,學士班(日間),馬達加斯加共和國,非洲,1,1,0,0,0,0,1,1,0,0,0,0,0,0,0
110,私立,一般大學,1016,銘傳大學,學士班(日間),菲律賓共和國,東協,10,2,8,8,1,7,2,1,1,0,0,0,0,0,0
110,私立,一般大學,1016,銘傳大學,學士班(日間),義大利共和國,歐洲,2,2,0,2,2,0,0,0,0,0,0,0,0,0,0
110,私立,一般大學,1016,銘傳大學,學士班(日間),聖文森(及格瑞那丁),中南美洲,7,1,6,7,1,6,0,0,0,0,0,0,0,0,0
110,私立,一般大學,1016,銘傳大學,學士班(日間),聖克里斯多福及尼維斯,中南美洲,12,7,5,12,7,5,0,0,0,0,0,0,0,0,0
110,私立,一般大學,1016,銘傳大學,學士班(日間),聖露西亞,中南美洲,5,0,5,5,0,5,0,0,0,0,0,0,0,0,0
110,私立,一般大學,1016,銘傳大學,學士班(日間),葡萄牙共和國,歐洲,5,4,1,0,0,0,5,4,1,0,0,0,0,0,0
110,私立,一般大學,1016,銘傳大學,學士班(日間),蒙古國,其他亞洲地區,13,7,6,13,7,6,0,0,0,0,0,0,0,0,0
110,私立,一般大學,1016,銘傳大學,學士班(日間),澳大利亞,其他亞洲地區,2,2,0,1,1,0,1,1,0,0,0,0,0,0,0
110,私立,一般大學,1016,銘傳大學,學士班(日間),澳門,港澳,81,38,43,0,0,0,0,0,0,81,38,43,0,0,0
110,私立,一般大學,1016,銘傳大學,學士班(日間),諾魯共和國,其他亞洲地區,7,3,4,7,3,4,0,0,0,0,0,0,0,0,0
110,私立,一般大學,1016,銘傳大學,學士班(日間),薩爾瓦多,中南美洲,1,1,0,1,1,0,0,0,0,0,0,0,0,0,0
110,私立,一般大學,1016,銘傳大學,學士班(日間),巴拉圭,中南美洲,4,4,0,4,4,0,0,0,0,0,0,0,0,0,0
110,私立,一般大學,1016,銘傳大學,學士班(日間),巴勒斯坦,其他亞洲地區,1,1,0,1,1,0,0,0,0,0,0,0,0,0,0
110,私立,一般大學,1016,銘傳大學,學士班(日間),日本,其他亞洲地區,88,20,68,84,20,64,4,0,4,0,0,0,0,0,0
110,私立,一般大學,1016,銘傳大學,學士班(日間),史瓦帝尼王國,非洲,12,5,7,12,5,7,0,0,0,0,0,0,0,0,0
110,私立,一般大學,1016,銘傳大學,學士班(日間),尼加拉瓜,中南美洲,9,5,4,9,5,4,0,0,0,0,0,0,0,0,0
110,私立,一般大學,1016,銘傳大學,學士班(日間),吐瓦魯,其他亞洲地區,6,2,4,6,2,4,0,0,0,0,0,0,0,0,0
110,私立,一般大學,1016,銘傳大學,學士班(日間),貝里斯,中南美洲,12,4,8,12,4,8,0,0,0,0,0,0,0,0,0
110,私立,一般大學,1016,銘傳大學,學士班(日間),奈及利亞聯邦共和國,非洲,2,0,2,2,0,2,0,0,0,0,0,0,0,0,0
110,私立,一般大學,1016,銘傳大學,學士班(日間),委內瑞拉共和國,中南美洲,1,0,1,0,0,0,1,0,1,0,0,0,0,0,0
110,私立,一般大學,1016,銘傳大學,學士班(日間),法國,歐洲,4,2,2,4,2,2,0,0,0,0,0,0,0,0,0
110,私立,一般大學,1016,銘傳大學,學士班(日間),俄羅斯聯邦,其他亞洲地區,3,2,1,3,2,1,0,0,0,0,0,0,0,0,0
110,私立,一般大學,1016,銘傳大學,學士班(日間),美國,北美洲,21,17,4,19,16,3,2,1,1,0,0,0,0,0,0
110,私立,一般大學,1016,銘傳大學,學士班(日間),埃及阿拉伯共和國,非洲,2,1,1,2,1,1,0,0,0,0,0,0,0,0,0
110,私立,一般大學,1016,銘傳大學,學士班(日間),泰國,東協,75,30,45,67,25,42,8,5,3,0,0,0,0,0,0
110,私立,一般大學,1016,銘傳大學,學士班(日間),海地共和國,中南美洲,3,1,2,3,1,2,0,0,0,0,0,0,0,0,0
110,私立,一般大學,1016,銘傳大學,學士班(日間),斯洛伐克共和國,歐洲,1,1,0,1,1,0,0,0,0,0,0,0,0,0,0
110,私立,一般大學,1016,銘傳大學,學士班(日間),越南社會主義共和國,東協,237,69,168,226,66,160,11,3,8,0,0,0,0,0,0
110,私立,一般大學,1016,銘傳大學,學士班(日間),塔吉克共和國,其他亞洲地區,1,1,0,1,1,0,0,0,0,0,0,0,0,0,0
110,私立,一般大學,1016,銘傳大學,學士班(日間),瑞士聯邦,歐洲,2,2,0,2,2,0,0,0,0,0,0,0,0,0,0
110,私立,一般大學,1016,銘傳大學,學士班(日間),德意志聯邦共和國,歐洲,2,2,0,2,2,0,0,0,0,0,0,0,0,0,0
110,私立,一般大學,1016,銘傳大學,學士班(日間),緬甸,東協,1,0,1,1,0,1,0,0,0,0,0,0,0,0,0
110,私立,一般大學,1016,銘傳大學,學士班(日間),墨西哥合眾國,中南美洲,1,0,1,1,0,1,0,0,0,0,0,0,0,0,0
110,私立,一般大學,1016,銘傳大學,碩士班(日間),巴拉圭,中南美洲,1,0,1,1,0,1,0,0,0,0,0,0,0,0,0
110,私立,一般大學,1016,銘傳大學,碩士班(日間),日本,其他亞洲地區,2,1,1,1,0,1,1,1,0,0,0,0,0,0,0
110,私立,一般大學,1016,銘傳大學,碩士班(日間),史瓦帝尼王國,非洲,1,1,0,1,1,0,0,0,0,0,0,0,0,0,0
110,私立,一般大學,1016,銘傳大學,碩士班(日間),匈牙利共和國,歐洲,1,1,0,1,1,0,0,0,0,0,0,0,0,0,0
110,私立,一般大學,1016,銘傳大學,碩士班(日間),印度尼西亞共和國,東協,3,1,2,3,1,2,0,0,0,0,0,0,0,0,0
110,私立,一般大學,1016,銘傳大學,碩士班(日間),波蘭共和國,歐洲,1,1,0,1,1,0,0,0,0,0,0,0,0,0,0
110,私立,一般大學,1016,銘傳大學,碩士班(日間),科威特,其他亞洲地區,1,0,1,1,0,1,0,0,0,0,0,0,0,0,0
110,私立,一般大學,1016,銘傳大學,碩士班(日間),美國,北美洲,4,4,0,4,4,0,0,0,0,0,0,0,0,0,0
110,私立,一般大學,1016,銘傳大學,碩士班(日間),泰國,東協,6,0,6,6,0,6,0,0,0,0,0,0,0,0,0
110,私立,一般大學,1016,銘傳大學,碩士班(日間),海地共和國,中南美洲,2,2,0,2,2,0,0,0,0,0,0,0,0,0,0
110,私立,一般大學,1016,銘傳大學,碩士班(日間),越南社會主義共和國,東協,25,8,17,24,8,16,1,0,1,0,0,0,0,0,0
110,私立,一般大學,1016,銘傳大學,碩士班(日間),墨西哥合眾國,中南美洲,2,0,2,2,0,2,0,0,0,0,0,0,0,0,0
110,私立,一般大學,1016,銘傳大學,碩士班(日間),澳門,港澳,2,1,1,0,0,0,0,0,0,2,1,1,0,0,0
110,私立,一般大學,1016,銘傳大學,碩士班(日間),大陸地區,大陸地區,27,15,12,0,0,0,0,0,0,0,0,0,27,15,12
110,私立,一般大學,1016,銘傳大學,碩士班(日間),尼加拉瓜,中南美洲,1,1,0,1,1,0,0,0,0,0,0,0,0,0,0
110,私立,一般大學,1016,銘傳大學,碩士班(日間),瓜地馬拉共和國,中南美洲,5,2,3,5,2,3,0,0,0,0,0,0,0,0,0
110,私立,一般大學,1016,銘傳大學,碩士班(日間),西班牙王國,歐洲,1,0,1,1,0,1,0,0,0,0,0,0,0,0,0
110,私立,一般大學,1016,銘傳大學,碩士班(日間),宏都拉斯共和國,中南美洲,2,1,1,2,1,1,0,0,0,0,0,0,0,0,0
110,私立,一般大學,1016,銘傳大學,碩士班(日間),貝里斯,中南美洲,5,3,2,5,3,2,0,0,0,0,0,0,0,0,0
110,私立,一般大學,1016,銘傳大學,碩士班(日間),奈及利亞聯邦共和國,非洲,2,2,0,2,2,0,0,0,0,0,0,0,0,0,0
110,私立,一般大學,1016,銘傳大學,碩士班(日間),帛琉共和國,其他亞洲地區,2,0,2,2,0,2,0,0,0,0,0,0,0,0,0
110,私立,一般大學,1016,銘傳大學,碩士班(日間),南非共和國,非洲,2,0,2,2,0,2,0,0,0,0,0,0,0,0,0
110,私立,一般大學,1016,銘傳大學,碩士班(日間),香港,港澳,22,9,13,0,0,0,0,0,0,22,9,13,0,0,0
110,私立,一般大學,1016,銘傳大學,碩士班(日間),秘魯共和國,中南美洲,1,0,1,1,0,1,0,0,0,0,0,0,0,0,0
110,私立,一般大學,1016,銘傳大學,碩士班(日間),馬來西亞,東協,19,7,12,10,3,7,9,4,5,0,0,0,0,0,0
110,私立,一般大學,1016,銘傳大學,碩士班(日間),菲律賓共和國,東協,3,2,1,3,2,1,0,0,0,0,0,0,0,0,0
110,私立,一般大學,1016,銘傳大學,碩士班(日間),義大利共和國,歐洲,1,1,0,1,1,0,0,0,0,0,0,0,0,0,0
110,私立,一般大學,1016,銘傳大學,碩士班(日間),聖克里斯多福及尼維斯,中南美洲,1,1,0,1,1,0,0,0,0,0,0,0,0,0,0
110,私立,一般大學,1016,銘傳大學,碩士班(日間),聖露西亞,中南美洲,1,0,1,1,0,1,0,0,0,0,0,0,0,0,0
110,私立,一般大學,1016,銘傳大學,碩士班(日間),蒙古國,其他亞洲地區,1,0,1,1,0,1,0,0,0,0,0,0,0,0,0
110,私立,一般大學,1016,銘傳大學,碩士班(日間),澳大利亞,其他亞洲地區,1,1,0,1,1,0,0,0,0,0,0,0,0,0,0
110,私立,一般大學,1016,銘傳大學,碩士班(日間),諾魯共和國,其他亞洲地區,1,1,0,1,1,0,0,0,0,0,0,0,0,0,0
110,私立,一般大學,1016,銘傳大學,博士班,大陸地區,大陸地區,22,11,11,0,0,0,0,0,0,0,0,0,22,11,11
110,私立,一般大學,1016,銘傳大學,博士班,越南社會主義共和國,東協,1,0,1,1,0,1,0,0,0,0,0,0,0,0,0
110,私立,一般大學,1017,實踐大學,學士班(日間),大陸地區,大陸地區,57,16,41,0,0,0,0,0,0,0,0,0,57,16,41
110,私立,一般大學,1017,實踐大學,學士班(日間),日本,其他亞洲地區,99,40,59,99,40,59,0,0,0,0,0,0,0,0,0
110,私立,一般大學,1017,實踐大學,學士班(日間),史瓦帝尼王國,非洲,2,1,1,2,1,1,0,0,0,0,0,0,0,0,0
110,私立,一般大學,1017,實踐大學,學士班(日間),印度尼西亞共和國,東協,70,17,53,32,12,20,38,5,33,0,0,0,0,0,0
110,私立,一般大學,1017,實踐大學,學士班(日間),美國,北美洲,2,1,1,2,1,1,0,0,0,0,0,0,0,0,0
110,私立,一般大學,1017,實踐大學,學士班(日間),香港,港澳,196,80,116,0,0,0,0,0,0,196,80,116,0,0,0
110,私立,一般大學,1017,實踐大學,學士班(日間),荷蘭王國,歐洲,1,1,0,1,1,0,0,0,0,0,0,0,0,0,0
110,私立,一般大學,1017,實踐大學,學士班(日間),義大利共和國,歐洲,4,4,0,4,4,0,0,0,0,0,0,0,0,0,0
110,私立,一般大學,1017,實踐大學,學士班(日間),德意志聯邦共和國,歐洲,5,3,2,5,3,2,0,0,0,0,0,0,0,0,0
110,私立,一般大學,1017,實踐大學,學士班(日間),緬甸,東協,6,0,6,1,0,1,5,0,5,0,0,0,0,0,0
110,私立,一般大學,1017,實踐大學,學士班(日間),澳門,港澳,61,30,31,0,0,0,0,0,0,61,30,31,0,0,0
110,私立,一般大學,1017,實踐大學,學士班(日間),大韓民國(南韓),其他亞洲地區,7,5,2,4,2,2,3,3,0,0,0,0,0,0,0
110,私立,一般大學,1017,實踐大學,學士班(日間),巴拉圭,中南美洲,2,0,2,2,0,2,0,0,0,0,0,0,0,0,0
110,私立,一般大學,1017,實踐大學,學士班(日間),尼加拉瓜,中南美洲,1,0,1,1,0,1,0,0,0,0,0,0,0,0,0
110,私立,一般大學,1017,實踐大學,學士班(日間),尼泊爾聯邦民主共和國,南亞,1,0,1,1,0,1,0,0,0,0,0,0,0,0,0
110,私立,一般大學,1017,實踐大學,學士班(日間),阿根廷,中南美洲,1,0,1,1,0,1,0,0,0,0,0,0,0,0,0
110,私立,一般大學,1017,實踐大學,學士班(日間),俄羅斯聯邦,其他亞洲地區,2,1,1,2,1,1,0,0,0,0,0,0,0,0,0
110,私立,一般大學,1017,實踐大學,學士班(日間),英國,歐洲,1,1,0,1,1,0,0,0,0,0,0,0,0,0,0
110,私立,一般大學,1017,實踐大學,學士班(日間),哥倫比亞共和國,中南美洲,1,0,1,1,0,1,0,0,0,0,0,0,0,0,0
110,私立,一般大學,1017,實踐大學,學士班(日間),泰國,東協,5,1,4,5,1,4,0,0,0,0,0,0,0,0,0
110,私立,一般大學,1017,實踐大學,學士班(日間),馬來西亞,東協,83,26,57,24,8,16,59,18,41,0,0,0,0,0,0
110,私立,一般大學,1017,實踐大學,學士班(日間),斯洛伐克共和國,歐洲,1,0,1,1,0,1,0,0,0,0,0,0,0,0,0
110,私立,一般大學,1017,實踐大學,學士班(日間),菲律賓共和國,東協,1,0,1,1,0,1,0,0,0,0,0,0,0,0,0
110,私立,一般大學,1017,實踐大學,學士班(日間),越南社會主義共和國,東協,31,7,24,27,6,21,4,1,3,0,0,0,0,0,0
110,私立,一般大學,1017,實踐大學,學士班(日間),澳大利亞,其他亞洲地區,2,1,1,2,1,1,0,0,0,0,0,0,0,0,0
110,私立,一般大學,1017,實踐大學,碩士班(日間),大韓民國(南韓),其他亞洲地區,1,1,0,1,1,0,0,0,0,0,0,0,0,0,0
110,私立,一般大學,1017,實踐大學,碩士班(日間),泰國,東協,2,0,2,2,0,2,0,0,0,0,0,0,0,0,0
110,私立,一般大學,1017,實踐大學,碩士班(日間),馬來西亞,東協,4,2,2,2,1,1,2,1,1,0,0,0,0,0,0
110,私立,一般大學,1017,實踐大學,碩士班(日間),越南社會主義共和國,東協,1,0,1,1,0,1,0,0,0,0,0,0,0,0,0
110,私立,一般大學,1017,實踐大學,碩士班(日間),澳門,港澳,4,2,2,0,0,0,0,0,0,4,2,2,0,0,0
110,私立,一般大學,1017,實踐大學,碩士班(日間),大陸地區,大陸地區,15,6,9,0,0,0,0,0,0,0,0,0,15,6,9
110,私立,一般大學,1017,實踐大學,碩士班(日間),印度,南亞,1,0,1,1,0,1,0,0,0,0,0,0,0,0,0
110,私立,一般大學,1017,實踐大學,碩士班(日間),印度尼西亞共和國,東協,2,1,1,2,1,1,0,0,0,0,0,0,0,0,0
110,私立,一般大學,1017,實踐大學,碩士班(日間),西班牙王國,歐洲,1,0,1,1,0,1,0,0,0,0,0,0,0,0,0
110,私立,一般大學,1017,實踐大學,碩士班(日間),美國,北美洲,1,1,0,1,1,0,0,0,0,0,0,0,0,0,0
110,私立,一般大學,1017,實踐大學,碩士班(日間),香港,港澳,11,5,6,0,0,0,0,0,0,11,5,6,0,0,0
110,私立,一般大學,1017,實踐大學,碩士班(日間),德意志聯邦共和國,歐洲,1,0,1,1,0,1,0,0,0,0,0,0,0,0,0
110,私立,一般大學,1017,實踐大學,碩士班(日間),緬甸,東協,1,1,0,1,1,0,0,0,0,0,0,0,0,0,0
110,私立,一般大學,1017,實踐大學,博士班,大陸地區,大陸地區,15,5,10,0,0,0,0,0,0,0,0,0,15,5,10
110,私立,一般大學,1017,實踐大學,博士班,美國,北美洲,1,1,0,1,1,0,0,0,0,0,0,0,0,0,0
110,私立,技專校院,1018,朝陽科技大學,學士班(日間),日本,其他亞洲地區,2,1,1,1,1,0,1,0,1,0,0,0,0,0,0
110,私立,技專校院,1018,朝陽科技大學,學士班(日間),泰國,東協,1,0,1,1,0,1,0,0,0,0,0,0,0,0,0
110,私立,技專校院,1018,朝陽科技大學,學士班(日間),越南社會主義共和國,東協,405,159,246,404,158,246,1,1,0,0,0,0,0,0,0
110,私立,技專校院,1018,朝陽科技大學,學士班(日間),緬甸,東協,2,1,1,1,0,1,1,1,0,0,0,0,0,0,0
110,私立,技專校院,1018,朝陽科技大學,學士班(日間),澳門,港澳,18,16,2,0,0,0,0,0,0,18,16,2,0,0,0
110,私立,技專校院,1018,朝陽科技大學,學士班(日間),大陸地區,大陸地區,34,15,19,0,0,0,0,0,0,0,0,0,34,15,19
110,私立,技專校院,1018,朝陽科技大學,學士班(日間),加拿大,北美洲,1,1,0,0,0,0,1,1,0,0,0,0,0,0,0
110,私立,技專校院,1018,朝陽科技大學,學士班(日間),印度尼西亞共和國,東協,32,12,20,28,12,16,4,0,4,0,0,0,0,0,0
110,私立,技專校院,1018,朝陽科技大學,學士班(日間),俄羅斯聯邦,其他亞洲地區,2,0,2,2,0,2,0,0,0,0,0,0,0,0,0
110,私立,技專校院,1018,朝陽科技大學,學士班(日間),香港,港澳,85,40,45,0,0,0,0,0,0,85,40,45,0,0,0
110,私立,技專校院,1018,朝陽科技大學,學士班(日間),馬來西亞,東協,71,37,34,45,23,22,26,14,12,0,0,0,0,0,0
110,私立,技專校院,1018,朝陽科技大學,學士班(日間),菲律賓共和國,東協,2,1,1,2,1,1,0,0,0,0,0,0,0,0,0
110,私立,技專校院,1018,朝陽科技大學,學士班(日間),蒙古國,其他亞洲地區,20,12,8,20,12,8,0,0,0,0,0,0,0,0,0
110,私立,技專校院,1018,朝陽科技大學,學士班(日間),寮人民民主共和國(寮國),東協,1,1,0,0,0,0,1,1,0,0,0,0,0,0,0
110,私立,技專校院,1018,朝陽科技大學,碩士班(日間),大陸地區,大陸地區,4,2,2,0,0,0,0,0,0,0,0,0,4,2,2
110,私立,技專校院,1018,朝陽科技大學,碩士班(日間),大韓民國(南韓),其他亞洲地區,1,0,1,1,0,1,0,0,0,0,0,0,0,0,0
110,私立,技專校院,1018,朝陽科技大學,碩士班(日間),印度,南亞,2,1,1,2,1,1,0,0,0,0,0,0,0,0,0
110,私立,技專校院,1018,朝陽科技大學,碩士班(日間),印度尼西亞共和國,東協,5,2,3,5,2,3,0,0,0,0,0,0,0,0,0
110,私立,技專校院,1018,朝陽科技大學,碩士班(日間),吉爾吉斯,其他亞洲地區,1,1,0,1,1,0,0,0,0,0,0,0,0,0,0
110,私立,技專校院,1018,朝陽科技大學,碩士班(日間),香港,港澳,8,3,5,0,0,0,0,0,0,8,3,5,0,0,0
110,私立,技專校院,1018,朝陽科技大學,碩士班(日間),馬來西亞,東協,5,2,3,5,2,3,0,0,0,0,0,0,0,0,0
110,私立,技專校院,1018,朝陽科技大學,碩士班(日間),菲律賓共和國,東協,1,0,1,1,0,1,0,0,0,0,0,0,0,0,0
110,私立,技專校院,1018,朝陽科技大學,碩士班(日間),越南社會主義共和國,東協,12,4,8,12,4,8,0,0,0,0,0,0,0,0,0
110,私立,技專校院,1018,朝陽科技大學,碩士班(日間),蒙古國,其他亞洲地區,4,2,2,4,2,2,0,0,0,0,0,0,0,0,0
110,私立,技專校院,1018,朝陽科技大學,碩士班(日間),寮人民民主共和國(寮國),東協,2,1,1,2,1,1,0,0,0,0,0,0,0,0,0
110,私立,技專校院,1018,朝陽科技大學,碩士班(日間),泰國,東協,1,0,1,1,0,1,0,0,0,0,0,0,0,0,0
110,私立,技專校院,1018,朝陽科技大學,碩士班(日間),緬甸,東協,3,1,2,3,1,2,0,0,0,0,0,0,0,0,0
110,私立,技專校院,1018,朝陽科技大學,博士班,印度尼西亞共和國,東協,15,9,6,15,9,6,0,0,0,0,0,0,0,0,0
110,私立,技專校院,1018,朝陽科技大學,博士班,馬來西亞,東協,1,0,1,1,0,1,0,0,0,0,0,0,0,0,0
110,私立,技專校院,1018,朝陽科技大學,博士班,菲律賓共和國,東協,2,2,0,2,2,0,0,0,0,0,0,0,0,0,0
110,私立,技專校院,1018,朝陽科技大學,博士班,越南社會主義共和國,東協,6,1,5,6,1,5,0,0,0,0,0,0,0,0,0
110,私立,技專校院,1018,朝陽科技大學,博士班,墨西哥合眾國,中南美洲,1,0,1,1,0,1,0,0,0,0,0,0,0,0,0
110,私立,技專校院,1018,朝陽科技大學,博士班,大陸地區,大陸地區,6,2,4,0,0,0,0,0,0,0,0,0,6,2,4
110,私立,技專校院,1018,朝陽科技大學,博士班,尼泊爾聯邦民主共和國,南亞,3,2,1,3,2,1,0,0,0,0,0,0,0,0,0
110,私立,技專校院,1018,朝陽科技大學,博士班,印度,南亞,8,3,5,8,3,5,0,0,0,0,0,0,0,0,0
110,私立,技專校院,1018,朝陽科技大學,博士班,緬甸,東協,1,1,0,1,1,0,0,0,0,0,0,0,0,0,0
110,私立,一般大學,1019,高雄醫學大學,學士班(日間),大陸地區,大陸地區,10,4,6,0,0,0,0,0,0,0,0,0,10,4,6
110,私立,一般大學,1019,高雄醫學大學,學士班(日間),大韓民國(南韓),其他亞洲地區,9,3,6,3,0,3,6,3,3,0,0,0,0,0,0
110,私立,一般大學,1019,高雄醫學大學,學士班(日間),加拿大,北美洲,9,5,4,0,0,0,9,5,4,0,0,0,0,0,0
110,私立,一般大學,1019,高雄醫學大學,學士班(日間),印度尼西亞共和國,東協,8,2,6,3,1,2,5,1,4,0,0,0,0,0,0
110,私立,一般大學,1019,高雄醫學大學,學士班(日間),阿根廷,中南美洲,1,0,1,0,0,0,1,0,1,0,0,0,0,0,0
110,私立,一般大學,1019,高雄醫學大學,學士班(日間),南非共和國,非洲,1,0,1,0,0,0,1,0,1,0,0,0,0,0,0
110,私立,一般大學,1019,高雄醫學大學,學士班(日間),約旦哈什米王國,其他亞洲地區,1,1,0,1,1,0,0,0,0,0,0,0,0,0,0
110,私立,一般大學,1019,高雄醫學大學,學士班(日間),香港,港澳,55,21,34,0,0,0,0,0,0,55,21,34,0,0,0
110,私立,一般大學,1019,高雄醫學大學,學士班(日間),馬來西亞,東協,96,30,66,12,4,8,84,26,58,0,0,0,0,0,0
110,私立,一般大學,1019,高雄醫學大學,學士班(日間),新加坡共和國,東協,7,4,3,0,0,0,7,4,3,0,0,0,0,0,0
110,私立,一般大學,1019,高雄醫學大學,學士班(日間),聖文森(及格瑞那丁),中南美洲,1,0,1,1,0,1,0,0,0,0,0,0,0,0,0
110,私立,一般大學,1019,高雄醫學大學,學士班(日間),蒙古國,其他亞洲地區,1,1,0,1,1,0,0,0,0,0,0,0,0,0,0
110,私立,一般大學,1019,高雄醫學大學,學士班(日間),貝里斯,中南美洲,2,0,2,2,0,2,0,0,0,0,0,0,0,0,0
110,私立,一般大學,1019,高雄醫學大學,學士班(日間),法國,歐洲,1,1,0,1,1,0,0,0,0,0,0,0,0,0,0
110,私立,一般大學,1019,高雄醫學大學,學士班(日間),美國,北美洲,9,3,6,5,1,4,4,2,2,0,0,0,0,0,0
110,私立,一般大學,1019,高雄醫學大學,學士班(日間),泰國,東協,1,1,0,0,0,0,1,1,0,0,0,0,0,0,0
110,私立,一般大學,1019,高雄醫學大學,學士班(日間),越南社會主義共和國,東協,1,0,1,1,0,1,0,0,0,0,0,0,0,0,0
110,私立,一般大學,1019,高雄醫學大學,學士班(日間),緬甸,東協,5,0,5,1,0,1,4,0,4,0,0,0,0,0,0
110,私立,一般大學,1019,高雄醫學大學,學士班(日間),澳門,港澳,32,15,17,0,0,0,0,0,0,32,15,17,0,0,0
110,私立,一般大學,1019,高雄醫學大學,碩士班(日間),巴拉圭,中南美洲,1,0,1,1,0,1,0,0,0,0,0,0,0,0,0
110,私立,一般大學,1019,高雄醫學大學,碩士班(日間),史瓦帝尼王國,非洲,1,0,1,1,0,1,0,0,0,0,0,0,0,0,0
110,私立,一般大學,1019,高雄醫學大學,碩士班(日間),貝里斯,中南美洲,1,0,1,1,0,1,0,0,0,0,0,0,0,0,0
110,私立,一般大學,1019,高雄醫學大學,碩士班(日間),哥倫比亞共和國,中南美洲,1,0,1,1,0,1,0,0,0,0,0,0,0,0,0
110,私立,一般大學,1019,高雄醫學大學,碩士班(日間),海地共和國,中南美洲,1,0,1,1,0,1,0,0,0,0,0,0,0,0,0
110,私立,一般大學,1019,高雄醫學大學,碩士班(日間),索羅門群島,其他亞洲地區,1,0,1,1,0,1,0,0,0,0,0,0,0,0,0
110,私立,一般大學,1019,高雄醫學大學,碩士班(日間),越南社會主義共和國,東協,6,1,5,6,1,5,0,0,0,0,0,0,0,0,0
110,私立,一般大學,1019,高雄醫學大學,碩士班(日間),澳門,港澳,5,2,3,0,0,0,0,0,0,5,2,3,0,0,0
110,私立,一般大學,1019,高雄醫學大學,碩士班(日間),印度,南亞,1,1,0,1,1,0,0,0,0,0,0,0,0,0,0
110,私立,一般大學,1019,高雄醫學大學,碩士班(日間),印度尼西亞共和國,東協,1,0,1,1,0,1,0,0,0,0,0,0,0,0,0
110,私立,一般大學,1019,高雄醫學大學,碩士班(日間),俄羅斯聯邦,其他亞洲地區,1,1,0,1,1,0,0,0,0,0,0,0,0,0,0
110,私立,一般大學,1019,高雄醫學大學,碩士班(日間),南非共和國,非洲,2,1,1,0,0,0,2,1,1,0,0,0,0,0,0
110,私立,一般大學,1019,高雄醫學大學,碩士班(日間),香港,港澳,5,3,2,0,0,0,0,0,0,5,3,2,0,0,0
110,私立,一般大學,1019,高雄醫學大學,碩士班(日間),馬來西亞,東協,7,2,5,1,0,1,6,2,4,0,0,0,0,0,0
110,私立,一般大學,1019,高雄醫學大學,碩士班(日間),聖文森(及格瑞那丁),中南美洲,1,0,1,1,0,1,0,0,0,0,0,0,0,0,0
110,私立,一般大學,1019,高雄醫學大學,碩士班(日間),聖露西亞,中南美洲,1,1,0,1,1,0,0,0,0,0,0,0,0,0,0
110,私立,一般大學,1019,高雄醫學大學,博士班,大陸地區,大陸地區,1,0,1,0,0,0,0,0,0,0,0,0,1,0,1
110,私立,一般大學,1019,高雄醫學大學,博士班,巴基斯坦,南亞,2,2,0,2,2,0,0,0,0,0,0,0,0,0,0
110,私立,一般大學,1019,高雄醫學大學,博士班,印度,南亞,35,17,18,35,17,18,0,0,0,0,0,0,0,0,0
110,私立,一般大學,1019,高雄醫學大學,博士班,印度尼西亞共和國,東協,15,6,9,15,6,9,0,0,0,0,0,0,0,0,0
110,私立,一般大學,1019,高雄醫學大學,博士班,貝里斯,中南美洲,1,0,1,1,0,1,0,0,0,0,0,0,0,0,0
110,私立,一般大學,1019,高雄醫學大學,博士班,緬甸,東協,2,1,1,2,1,1,0,0,0,0,0,0,0,0,0
110,私立,一般大學,1019,高雄醫學大學,博士班,史瓦帝尼王國,非洲,3,2,1,3,2,1,0,0,0,0,0,0,0,0,0
110,私立,一般大學,1019,高雄醫學大學,博士班,匈牙利共和國,歐洲,2,0,2,2,0,2,0,0,0,0,0,0,0,0,0
110,私立,一般大學,1019,高雄醫學大學,博士班,泰國,東協,1,0,1,1,0,1,0,0,0,0,0,0,0,0,0
110,私立,一般大學,1019,高雄醫學大學,博士班,馬來西亞,東協,4,1,3,1,0,1,3,1,2,0,0,0,0,0,0
110,私立,一般大學,1019,高雄醫學大學,博士班,菲律賓共和國,東協,3,0,3,3,0,3,0,0,0,0,0,0,0,0,0
110,私立,一般大學,1019,高雄醫學大學,博士班,越南社會主義共和國,東協,2,0,2,2,0,2,0,0,0,0,0,0,0,0,0
110,私立,一般大學,1019,高雄醫學大學,博士班,蒙古國,其他亞洲地區,1,0,1,1,0,1,0,0,0,0,0,0,0,0,0
110,私立,一般大學,1020,南華大學,學士班(日間),日本,其他亞洲地區,6,5,1,6,5,1,0,0,0,0,0,0,0,0,0
110,私立,一般大學,1020,南華大學,學士班(日間),史瓦帝尼王國,非洲,7,3,4,7,3,4,0,0,0,0,0,0,0,0,0
110,私立,一般大學,1020,南華大學,學士班(日間),尼泊爾聯邦民主共和國,南亞,6,3,3,6,3,3,0,0,0,0,0,0,0,0,0
110,私立,一般大學,1020,南華大學,學士班(日間),印度,南亞,7,5,2,7,5,2,0,0,0,0,0,0,0,0,0
110,私立,一般大學,1020,南華大學,學士班(日間),吉爾吉斯,其他亞洲地區,3,3,0,3,3,0,0,0,0,0,0,0,0,0,0
110,私立,一般大學,1020,南華大學,學士班(日間),奈及利亞聯邦共和國,非洲,1,1,0,1,1,0,0,0,0,0,0,0,0,0,0
110,私立,一般大學,1020,南華大學,學士班(日間),斯里蘭卡民主社會主義共和國,南亞,2,1,1,2,1,1,0,0,0,0,0,0,0,0,0
110,私立,一般大學,1020,南華大學,學士班(日間),蒙古國,其他亞洲地區,54,30,24,54,30,24,0,0,0,0,0,0,0,0,0
110,私立,一般大學,1020,南華大學,學士班(日間),巴西聯邦共和國,中南美洲,19,19,0,19,19,0,0,0,0,0,0,0,0,0,0
110,私立,一般大學,1020,南華大學,學士班(日間),印度尼西亞共和國,東協,10,7,3,9,7,2,1,0,1,0,0,0,0,0,0
110,私立,一般大學,1020,南華大學,學士班(日間),南非共和國,非洲,1,1,0,1,1,0,0,0,0,0,0,0,0,0,0
110,私立,一般大學,1020,南華大學,學士班(日間),柬埔寨王國,東協,16,7,9,16,7,9,0,0,0,0,0,0,0,0,0
110,私立,一般大學,1020,南華大學,學士班(日間),英國,歐洲,1,1,0,1,1,0,0,0,0,0,0,0,0,0,0
110,私立,一般大學,1020,南華大學,學士班(日間),香港,港澳,14,4,10,0,0,0,0,0,0,14,4,10,0,0,0
110,私立,一般大學,1020,南華大學,學士班(日間),馬來西亞,東協,44,25,19,28,15,13,16,10,6,0,0,0,0,0,0
110,私立,一般大學,1020,南華大學,學士班(日間),越南社會主義共和國,東協,12,7,5,12,7,5,0,0,0,0,0,0,0,0,0
110,私立,一般大學,1020,南華大學,學士班(日間),緬甸,東協,1,1,0,1,1,0,0,0,0,0,0,0,0,0,0
110,私立,一般大學,1020,南華大學,學士班(日間),澳門,港澳,1,0,1,0,0,0,0,0,0,1,0,1,0,0,0
110,私立,一般大學,1020,南華大學,碩士班(日間),印度,南亞,9,7,2,9,7,2,0,0,0,0,0,0,0,0,0
110,私立,一般大學,1020,南華大學,碩士班(日間),印度尼西亞共和國,東協,2,2,0,2,2,0,0,0,0,0,0,0,0,0,0
110,私立,一般大學,1020,南華大學,碩士班(日間),柬埔寨王國,東協,7,5,2,7,5,2,0,0,0,0,0,0,0,0,0
110,私立,一般大學,1020,南華大學,碩士班(日間),香港,港澳,2,1,1,0,0,0,0,0,0,2,1,1,0,0,0
110,私立,一般大學,1020,南華大學,碩士班(日間),馬來西亞,東協,10,5,5,8,3,5,2,2,0,0,0,0,0,0,0
110,私立,一般大學,1020,南華大學,碩士班(日間),菲律賓共和國,東協,9,1,8,9,1,8,0,0,0,0,0,0,0,0,0
110,私立,一般大學,1020,南華大學,碩士班(日間),越南社會主義共和國,東協,12,4,8,12,4,8,0,0,0,0,0,0,0,0,0
110,私立,一般大學,1020,南華大學,碩士班(日間),巴西聯邦共和國,中南美洲,2,2,0,2,2,0,0,0,0,0,0,0,0,0,0
110,私立,一般大學,1020,南華大學,碩士班(日間),史瓦帝尼王國,非洲,1,1,0,1,1,0,0,0,0,0,0,0,0,0,0
110,私立,一般大學,1020,南華大學,碩士班(日間),泰國,東協,2,0,2,2,0,2,0,0,0,0,0,0,0,0,0
110,私立,一般大學,1020,南華大學,碩士班(日間),新加坡共和國,東協,1,0,1,1,0,1,0,0,0,0,0,0,0,0,0
110,私立,一般大學,1020,南華大學,碩士班(日間),蒙古國,其他亞洲地區,6,1,5,6,1,5,0,0,0,0,0,0,0,0,0
110,私立,一般大學,1020,南華大學,博士班,大陸地區,大陸地區,1,0,1,0,0,0,0,0,0,0,0,0,1,0,1
110,私立,一般大學,1020,南華大學,博士班,印度,南亞,3,3,0,3,3,0,0,0,0,0,0,0,0,0,0
110,私立,一般大學,1020,南華大學,博士班,孟加拉人民共和國,南亞,1,1,0,1,1,0,0,0,0,0,0,0,0,0,0
110,私立,一般大學,1020,南華大學,博士班,越南社會主義共和國,東協,15,9,6,15,9,6,0,0,0,0,0,0,0,0,0
110,私立,一般大學,1020,南華大學,博士班,蒙古國,其他亞洲地區,1,0,1,1,0,1,0,0,0,0,0,0,0,0,0
110,私立,一般大學,1021,真理大學,學士班(日間),日本,其他亞洲地區,22,5,17,21,5,16,1,0,1,0,0,0,0,0,0
110,私立,一般大學,1021,真理大學,學士班(日間),泰國,東協,3,0,3,3,0,3,0,0,0,0,0,0,0,0,0
110,私立,一般大學,1021,真理大學,學士班(日間),越南社會主義共和國,東協,49,13,36,46,11,35,3,2,1,0,0,0,0,0,0
110,私立,一般大學,1021,真理大學,學士班(日間),大韓民國(南韓),其他亞洲地區,1,1,0,1,1,0,0,0,0,0,0,0,0,0,0
110,私立,一般大學,1021,真理大學,學士班(日間),香港,港澳,21,10,11,0,0,0,0,0,0,21,10,11,0,0,0
110,私立,一般大學,1021,真理大學,學士班(日間),馬來西亞,東協,72,41,31,6,2,4,66,39,27,0,0,0,0,0,0
110,私立,一般大學,1021,真理大學,碩士班(日間),香港,港澳,1,1,0,0,0,0,0,0,0,1,1,0,0,0,0
110,私立,一般大學,1021,真理大學,碩士班(日間),馬來西亞,東協,1,1,0,0,0,0,1,1,0,0,0,0,0,0,0
110,私立,一般大學,1021,真理大學,碩士班(日間),菲律賓共和國,東協,2,0,2,2,0,2,0,0,0,0,0,0,0,0,0
110,私立,一般大學,1021,真理大學,碩士班(日間),印度尼西亞共和國,東協,1,1,0,1,1,0,0,0,0,0,0,0,0,0,0
110,私立,一般大學,1021,真理大學,碩士班(日間),泰國,東協,1,0,1,1,0,1,0,0,0,0,0,0,0,0,0
110,私立,一般大學,1021,真理大學,碩士班(日間),越南社會主義共和國,東協,18,5,13,17,5,12,1,0,1,0,0,0,0,0,0
110,私立,一般大學,1022,大同大學,學士班(日間),大陸地區,大陸地區,17,12,5,0,0,0,0,0,0,0,0,0,17,12,5
110,私立,一般大學,1022,大同大學,學士班(日間),加拿大,北美洲,1,0,1,0,0,0,1,0,1,0,0,0,0,0,0
110,私立,一般大學,1022,大同大學,學士班(日間),印度尼西亞共和國,東協,3,1,2,2,0,2,1,1,0,0,0,0,0,0,0
110,私立,一般大學,1022,大同大學,學士班(日間),香港,港澳,40,25,15,0,0,0,0,0,0,40,25,15,0,0,0
110,私立,一般大學,1022,大同大學,學士班(日間),海地共和國,中南美洲,1,1,0,1,1,0,0,0,0,0,0,0,0,0,0
110,私立,一般大學,1022,大同大學,學士班(日間),聖文森(及格瑞那丁),中南美洲,1,1,0,1,1,0,0,0,0,0,0,0,0,0,0
110,私立,一般大學,1022,大同大學,學士班(日間),緬甸,東協,1,1,0,0,0,0,1,1,0,0,0,0,0,0,0
110,私立,一般大學,1022,大同大學,學士班(日間),澳門,港澳,4,4,0,0,0,0,0,0,0,4,4,0,0,0,0
110,私立,一般大學,1022,大同大學,學士班(日間),日本,其他亞洲地區,4,2,2,4,2,2,0,0,0,0,0,0,0,0,0
110,私立,一般大學,1022,大同大學,學士班(日間),俄羅斯聯邦,其他亞洲地區,1,0,1,1,0,1,0,0,0,0,0,0,0,0,0
110,私立,一般大學,1022,大同大學,學士班(日間),馬來西亞,東協,2,2,0,0,0,0,2,2,0,0,0,0,0,0,0
110,私立,一般大學,1022,大同大學,學士班(日間),菲律賓共和國,東協,1,1,0,0,0,0,1,1,0,0,0,0,0,0,0
110,私立,一般大學,1022,大同大學,學士班(日間),新加坡共和國,東協,1,1,0,0,0,0,1,1,0,0,0,0,0,0,0
110,私立,一般大學,1022,大同大學,碩士班(日間),俄羅斯聯邦,其他亞洲地區,1,0,1,1,0,1,0,0,0,0,0,0,0,0,0
110,私立,一般大學,1022,大同大學,碩士班(日間),大陸地區,大陸地區,2,0,2,0,0,0,0,0,0,0,0,0,2,0,2
110,私立,一般大學,1022,大同大學,碩士班(日間),印度尼西亞共和國,東協,1,0,1,1,0,1,0,0,0,0,0,0,0,0,0
110,私立,一般大學,1022,大同大學,碩士班(日間),香港,港澳,3,1,2,0,0,0,0,0,0,3,1,2,0,0,0
110,私立,一般大學,1022,大同大學,碩士班(日間),越南社會主義共和國,東協,1,0,1,1,0,1,0,0,0,0,0,0,0,0,0
110,私立,一般大學,1022,大同大學,碩士班(日間),德意志聯邦共和國,歐洲,3,1,2,3,1,2,0,0,0,0,0,0,0,0,0
110,私立,一般大學,1022,大同大學,碩士班(日間),澳門,港澳,1,0,1,0,0,0,0,0,0,1,0,1,0,0,0
110,私立,一般大學,1022,大同大學,博士班,大陸地區,大陸地區,19,12,7,0,0,0,0,0,0,0,0,0,19,12,7
110,私立,一般大學,1022,大同大學,博士班,印度,南亞,1,0,1,1,0,1,0,0,0,0,0,0,0,0,0
110,私立,技專校院,1023,南臺學校財團法人南臺科技大學,五專,香港,港澳,1,1,0,0,0,0,0,0,0,1,1,0,0,0,0
110,私立,技專校院,1023,南臺學校財團法人南臺科技大學,五專,加拿大,北美洲,1,1,0,0,0,0,1,1,0,0,0,0,0,0,0
110,私立,技專校院,1023,南臺學校財團法人南臺科技大學,學士班(日間),大陸地區,大陸地區,13,7,6,0,0,0,0,0,0,0,0,0,13,7,6
110,私立,技專校院,1023,南臺學校財團法人南臺科技大學,學士班(日間),大韓民國(南韓),其他亞洲地區,1,0,1,1,0,1,0,0,0,0,0,0,0,0,0
110,私立,技專校院,1023,南臺學校財團法人南臺科技大學,學士班(日間),日本,其他亞洲地區,1,1,0,1,1,0,0,0,0,0,0,0,0,0,0
110,私立,技專校院,1023,南臺學校財團法人南臺科技大學,學士班(日間),印度,南亞,2,2,0,2,2,0,0,0,0,0,0,0,0,0,0
110,私立,技專校院,1023,南臺學校財團法人南臺科技大學,學士班(日間),印度尼西亞共和國,東協,16,6,10,10,4,6,6,2,4,0,0,0,0,0,0
110,私立,技專校院,1023,南臺學校財團法人南臺科技大學,學士班(日間),宏都拉斯共和國,中南美洲,2,1,1,2,1,1,0,0,0,0,0,0,0,0,0
110,私立,技專校院,1023,南臺學校財團法人南臺科技大學,學士班(日間),香港,港澳,64,41,23,0,0,0,0,0,0,64,41,23,0,0,0
110,私立,技專校院,1023,南臺學校財團法人南臺科技大學,學士班(日間),秘魯共和國,中南美洲,1,0,1,1,0,1,0,0,0,0,0,0,0,0,0
110,私立,技專校院,1023,南臺學校財團法人南臺科技大學,學士班(日間),馬來西亞,東協,84,52,32,60,38,22,24,14,10,0,0,0,0,0,0
110,私立,技專校院,1023,南臺學校財團法人南臺科技大學,學士班(日間),菲律賓共和國,東協,11,1,10,11,1,10,0,0,0,0,0,0,0,0,0
110,私立,技專校院,1023,南臺學校財團法人南臺科技大學,學士班(日間),聖露西亞,中南美洲,1,1,0,1,1,0,0,0,0,0,0,0,0,0,0
110,私立,技專校院,1023,南臺學校財團法人南臺科技大學,學士班(日間),葡萄牙共和國,歐洲,1,1,0,0,0,0,1,1,0,0,0,0,0,0,0
110,私立,技專校院,1023,南臺學校財團法人南臺科技大學,學士班(日間),蒙古國,其他亞洲地區,11,6,5,11,6,5,0,0,0,0,0,0,0,0,0
110,私立,技專校院,1023,南臺學校財團法人南臺科技大學,學士班(日間),澳門,港澳,3,2,1,0,0,0,0,0,0,3,2,1,0,0,0
110,私立,技專校院,1023,南臺學校財團法人南臺科技大學,學士班(日間),巴西聯邦共和國,中南美洲,1,1,0,0,0,0,1,1,0,0,0,0,0,0,0
110,私立,技專校院,1023,南臺學校財團法人南臺科技大學,學士班(日間),史瓦帝尼王國,非洲,5,1,4,5,1,4,0,0,0,0,0,0,0,0,0
110,私立,技專校院,1023,南臺學校財團法人南臺科技大學,學士班(日間),匈牙利共和國,歐洲,1,1,0,1,1,0,0,0,0,0,0,0,0,0,0
110,私立,技專校院,1023,南臺學校財團法人南臺科技大學,學士班(日間),坦尚尼亞聯合共和國,非洲,1,0,1,1,0,1,0,0,0,0,0,0,0,0,0
110,私立,技專校院,1023,南臺學校財團法人南臺科技大學,學士班(日間),美國,北美洲,2,2,0,1,1,0,1,1,0,0,0,0,0,0,0
110,私立,技專校院,1023,南臺學校財團法人南臺科技大學,學士班(日間),泰國,東協,6,1,5,5,1,4,1,0,1,0,0,0,0,0,0
110,私立,技專校院,1023,南臺學校財團法人南臺科技大學,學士班(日間),越南社會主義共和國,東協,33,3,30,29,3,26,4,0,4,0,0,0,0,0,0
110,私立,技專校院,1023,南臺學校財團法人南臺科技大學,學士班(日間),摩洛哥王國,非洲,1,1,0,1,1,0,0,0,0,0,0,0,0,0,0
110,私立,技專校院,1023,南臺學校財團法人南臺科技大學,碩士班(日間),巴拉圭,中南美洲,1,0,1,1,0,1,0,0,0,0,0,0,0,0,0
110,私立,技專校院,1023,南臺學校財團法人南臺科技大學,碩士班(日間),史瓦帝尼王國,非洲,2,2,0,2,2,0,0,0,0,0,0,0,0,0,0
110,私立,技專校院,1023,南臺學校財團法人南臺科技大學,碩士班(日間),甘比亞共和國,非洲,1,1,0,1,1,0,0,0,0,0,0,0,0,0,0
110,私立,技專校院,1023,南臺學校財團法人南臺科技大學,碩士班(日間),印度尼西亞共和國,東協,4,3,1,4,3,1,0,0,0,0,0,0,0,0,0
110,私立,技專校院,1023,南臺學校財團法人南臺科技大學,碩士班(日間),克羅埃西亞共和國,歐洲,1,1,0,1,1,0,0,0,0,0,0,0,0,0,0
110,私立,技專校院,1023,南臺學校財團法人南臺科技大學,碩士班(日間),泰國,東協,2,1,1,2,1,1,0,0,0,0,0,0,0,0,0
110,私立,技專校院,1023,南臺學校財團法人南臺科技大學,碩士班(日間),荷蘭王國,歐洲,1,1,0,1,1,0,0,0,0,0,0,0,0,0,0
110,私立,技專校院,1023,南臺學校財團法人南臺科技大學,碩士班(日間),越南社會主義共和國,東協,12,8,4,12,8,4,0,0,0,0,0,0,0,0,0
110,私立,技專校院,1023,南臺學校財團法人南臺科技大學,碩士班(日間),德意志聯邦共和國,歐洲,4,3,1,4,3,1,0,0,0,0,0,0,0,0,0
110,私立,技專校院,1023,南臺學校財團法人南臺科技大學,碩士班(日間),摩洛哥王國,非洲,1,1,0,1,1,0,0,0,0,0,0,0,0,0,0
110,私立,技專校院,1023,南臺學校財團法人南臺科技大學,碩士班(日間),大陸地區,大陸地區,8,6,2,0,0,0,0,0,0,0,0,0,8,6,2
110,私立,技專校院,1023,南臺學校財團法人南臺科技大學,碩士班(日間),大韓民國(南韓),其他亞洲地區,1,0,1,1,0,1,0,0,0,0,0,0,0,0,0
110,私立,技專校院,1023,南臺學校財團法人南臺科技大學,碩士班(日間),巴拿馬共和國,中南美洲,3,2,1,3,2,1,0,0,0,0,0,0,0,0,0
110,私立,技專校院,1023,南臺學校財團法人南臺科技大學,碩士班(日間),日本,其他亞洲地區,1,1,0,1,1,0,0,0,0,0,0,0,0,0,0
110,私立,技專校院,1023,南臺學校財團法人南臺科技大學,碩士班(日間),印度,南亞,5,3,2,5,3,2,0,0,0,0,0,0,0,0,0
110,私立,技專校院,1023,南臺學校財團法人南臺科技大學,碩士班(日間),宏都拉斯共和國,中南美洲,1,1,0,1,1,0,0,0,0,0,0,0,0,0,0
110,私立,技專校院,1023,南臺學校財團法人南臺科技大學,碩士班(日間),貝里斯,中南美洲,2,0,2,2,0,2,0,0,0,0,0,0,0,0,0
110,私立,技專校院,1023,南臺學校財團法人南臺科技大學,碩士班(日間),香港,港澳,8,4,4,0,0,0,0,0,0,8,4,4,0,0,0
110,私立,技專校院,1023,南臺學校財團法人南臺科技大學,碩士班(日間),海地共和國,中南美洲,2,2,0,2,2,0,0,0,0,0,0,0,0,0,0
110,私立,技專校院,1023,南臺學校財團法人南臺科技大學,碩士班(日間),秘魯共和國,中南美洲,1,1,0,1,1,0,0,0,0,0,0,0,0,0,0
110,私立,技專校院,1023,南臺學校財團法人南臺科技大學,碩士班(日間),馬來西亞,東協,13,9,4,12,9,3,1,0,1,0,0,0,0,0,0
110,私立,技專校院,1023,南臺學校財團法人南臺科技大學,碩士班(日間),斯洛伐克共和國,歐洲,1,1,0,1,1,0,0,0,0,0,0,0,0,0,0
110,私立,技專校院,1023,南臺學校財團法人南臺科技大學,碩士班(日間),菲律賓共和國,東協,9,7,2,9,7,2,0,0,0,0,0,0,0,0,0
110,私立,技專校院,1023,南臺學校財團法人南臺科技大學,碩士班(日間),聖露西亞,中南美洲,1,1,0,1,1,0,0,0,0,0,0,0,0,0,0
110,私立,技專校院,1023,南臺學校財團法人南臺科技大學,碩士班(日間),蒙古國,其他亞洲地區,7,3,4,7,3,4,0,0,0,0,0,0,0,0,0
110,私立,技專校院,1023,南臺學校財團法人南臺科技大學,碩士班(日間),薩爾瓦多,中南美洲,5,4,1,5,4,1,0,0,0,0,0,0,0,0,0
110,私立,技專校院,1023,南臺學校財團法人南臺科技大學,博士班,丹麥王國,歐洲,1,1,0,1,1,0,0,0,0,0,0,0,0,0,0
110,私立,技專校院,1023,南臺學校財團法人南臺科技大學,博士班,印度,南亞,8,7,1,8,7,1,0,0,0,0,0,0,0,0,0
110,私立,技專校院,1023,南臺學校財團法人南臺科技大學,博士班,印度尼西亞共和國,東協,16,10,6,16,10,6,0,0,0,0,0,0,0,0,0
110,私立,技專校院,1023,南臺學校財團法人南臺科技大學,博士班,克羅埃西亞共和國,歐洲,1,1,0,1,1,0,0,0,0,0,0,0,0,0,0
110,私立,技專校院,1023,南臺學校財團法人南臺科技大學,博士班,墨西哥合眾國,中南美洲,1,1,0,1,1,0,0,0,0,0,0,0,0,0,0
110,私立,技專校院,1023,南臺學校財團法人南臺科技大學,博士班,大陸地區,大陸地區,1,1,0,0,0,0,0,0,0,0,0,0,1,1,0
110,私立,技專校院,1023,南臺學校財團法人南臺科技大學,博士班,貝里斯,中南美洲,1,1,0,1,1,0,0,0,0,0,0,0,0,0,0
110,私立,技專校院,1023,南臺學校財團法人南臺科技大學,博士班,法國,歐洲,2,0,2,2,0,2,0,0,0,0,0,0,0,0,0
110,私立,技專校院,1023,南臺學校財團法人南臺科技大學,博士班,秘魯共和國,中南美洲,1,1,0,1,1,0,0,0,0,0,0,0,0,0,0
110,私立,技專校院,1023,南臺學校財團法人南臺科技大學,博士班,捷克共和國,歐洲,1,1,0,1,1,0,0,0,0,0,0,0,0,0,0
110,私立,技專校院,1023,南臺學校財團法人南臺科技大學,博士班,菲律賓共和國,東協,4,1,3,4,1,3,0,0,0,0,0,0,0,0,0
110,私立,技專校院,1023,南臺學校財團法人南臺科技大學,博士班,越南社會主義共和國,東協,19,6,13,19,6,13,0,0,0,0,0,0,0,0,0
110,私立,技專校院,1024,崑山科技大學,學士班(日間),日本,其他亞洲地區,19,6,13,19,6,13,0,0,0,0,0,0,0,0,0
110,私立,技專校院,1024,崑山科技大學,學士班(日間),史瓦帝尼王國,非洲,25,16,9,25,16,9,0,0,0,0,0,0,0,0,0
110,私立,技專校院,1024,崑山科技大學,學士班(日間),印度尼西亞共和國,東協,96,54,42,54,31,23,42,23,19,0,0,0,0,0,0
110,私立,技專校院,1024,崑山科技大學,學士班(日間),宏都拉斯共和國,中南美洲,10,9,1,10,9,1,0,0,0,0,0,0,0,0,0
110,私立,技專校院,1024,崑山科技大學,學士班(日間),南非共和國,非洲,1,0,1,1,0,1,0,0,0,0,0,0,0,0,0
110,私立,技專校院,1024,崑山科技大學,學士班(日間),馬來西亞,東協,32,15,17,13,3,10,19,12,7,0,0,0,0,0,0
110,私立,技專校院,1024,崑山科技大學,學士班(日間),諾魯共和國,其他亞洲地區,2,2,0,2,2,0,0,0,0,0,0,0,0,0,0
110,私立,技專校院,1024,崑山科技大學,學士班(日間),大陸地區,大陸地區,7,5,2,0,0,0,0,0,0,0,0,0,7,5,2
110,私立,技專校院,1024,崑山科技大學,學士班(日間),大韓民國(南韓),其他亞洲地區,14,6,8,13,5,8,1,1,0,0,0,0,0,0,0
110,私立,技專校院,1024,崑山科技大學,學士班(日間),巴拉圭,中南美洲,1,1,0,1,1,0,0,0,0,0,0,0,0,0,0
110,私立,技專校院,1024,崑山科技大學,學士班(日間),巴基斯坦,南亞,1,1,0,1,1,0,0,0,0,0,0,0,0,0,0
110,私立,技專校院,1024,崑山科技大學,學士班(日間),尼加拉瓜,中南美洲,4,0,4,4,0,4,0,0,0,0,0,0,0,0,0
110,私立,技專校院,1024,崑山科技大學,學士班(日間),瓜地馬拉共和國,中南美洲,2,2,0,2,2,0,0,0,0,0,0,0,0,0,0
110,私立,技專校院,1024,崑山科技大學,學士班(日間),貝里斯,中南美洲,22,14,8,22,14,8,0,0,0,0,0,0,0,0,0
110,私立,技專校院,1024,崑山科技大學,學士班(日間),孟加拉人民共和國,南亞,1,1,0,1,1,0,0,0,0,0,0,0,0,0,0
110,私立,技專校院,1024,崑山科技大學,學士班(日間),帛琉共和國,其他亞洲地區,2,2,0,2,2,0,0,0,0,0,0,0,0,0,0
110,私立,技專校院,1024,崑山科技大學,學士班(日間),香港,港澳,24,12,12,0,0,0,0,0,0,24,12,12,0,0,0
110,私立,技專校院,1024,崑山科技大學,學士班(日間),哥斯大黎加共和國,中南美洲,1,1,0,1,1,0,0,0,0,0,0,0,0,0,0
110,私立,技專校院,1024,崑山科技大學,學士班(日間),泰國,東協,1,1,0,0,0,0,1,1,0,0,0,0,0,0,0
110,私立,技專校院,1024,崑山科技大學,學士班(日間),海地共和國,中南美洲,4,4,0,4,4,0,0,0,0,0,0,0,0,0,0
110,私立,技專校院,1024,崑山科技大學,學士班(日間),秘魯共和國,中南美洲,2,2,0,2,2,0,0,0,0,0,0,0,0,0,0
110,私立,技專校院,1024,崑山科技大學,學士班(日間),菲律賓共和國,東協,146,63,83,146,63,83,0,0,0,0,0,0,0,0,0
110,私立,技專校院,1024,崑山科技大學,學士班(日間),越南社會主義共和國,東協,241,109,132,172,69,103,69,40,29,0,0,0,0,0,0
110,私立,技專校院,1024,崑山科技大學,學士班(日間),聖文森(及格瑞那丁),中南美洲,3,3,0,3,3,0,0,0,0,0,0,0,0,0,0
110,私立,技專校院,1024,崑山科技大學,學士班(日間),聖克里斯多福及尼維斯,中南美洲,5,5,0,5,5,0,0,0,0,0,0,0,0,0,0
110,私立,技專校院,1024,崑山科技大學,學士班(日間),聖露西亞,中南美洲,6,5,1,6,5,1,0,0,0,0,0,0,0,0,0
110,私立,技專校院,1024,崑山科技大學,學士班(日間),蒙古國,其他亞洲地區,1,0,1,1,0,1,0,0,0,0,0,0,0,0,0
110,私立,技專校院,1024,崑山科技大學,學士班(日間),澳門,港澳,2,1,1,0,0,0,0,0,0,2,1,1,0,0,0
110,私立,技專校院,1024,崑山科技大學,學士班(日間),薩爾瓦多,中南美洲,1,1,0,1,1,0,0,0,0,0,0,0,0,0,0
110,私立,技專校院,1024,崑山科技大學,碩士班(日間),大陸地區,大陸地區,1,0,1,0,0,0,0,0,0,0,0,0,1,0,1
110,私立,技專校院,1024,崑山科技大學,碩士班(日間),史瓦帝尼王國,非洲,1,0,1,1,0,1,0,0,0,0,0,0,0,0,0
110,私立,技專校院,1024,崑山科技大學,碩士班(日間),宏都拉斯共和國,中南美洲,2,2,0,2,2,0,0,0,0,0,0,0,0,0,0
110,私立,技專校院,1024,崑山科技大學,碩士班(日間),貝里斯,中南美洲,1,1,0,1,1,0,0,0,0,0,0,0,0,0,0
110,私立,技專校院,1024,崑山科技大學,碩士班(日間),美國,北美洲,1,1,0,1,1,0,0,0,0,0,0,0,0,0,0
110,私立,技專校院,1024,崑山科技大學,碩士班(日間),香港,港澳,2,1,1,0,0,0,0,0,0,2,1,1,0,0,0
110,私立,技專校院,1024,崑山科技大學,碩士班(日間),智利,中南美洲,1,0,1,1,0,1,0,0,0,0,0,0,0,0,0
110,私立,技專校院,1024,崑山科技大學,碩士班(日間),聖露西亞,中南美洲,1,1,0,1,1,0,0,0,0,0,0,0,0,0,0
110,私立,技專校院,1024,崑山科技大學,碩士班(日間),澳門,港澳,1,0,1,0,0,0,0,0,0,1,0,1,0,0,0
110,私立,技專校院,1024,崑山科技大學,碩士班(日間),印度尼西亞共和國,東協,3,2,1,2,1,1,1,1,0,0,0,0,0,0,0
110,私立,技專校院,1024,崑山科技大學,碩士班(日間),馬來西亞,東協,2,1,1,2,1,1,0,0,0,0,0,0,0,0,0
110,私立,技專校院,1024,崑山科技大學,博士班,大陸地區,大陸地區,1,0,1,0,0,0,0,0,0,0,0,0,1,0,1
110,私立,技專校院,1024,崑山科技大學,博士班,印度尼西亞共和國,東協,1,1,0,1,1,0,0,0,0,0,0,0,0,0,0
110,私立,技專校院,1024,崑山科技大學,博士班,貝里斯,中南美洲,2,1,1,2,1,1,0,0,0,0,0,0,0,0,0
110,私立,技專校院,1024,崑山科技大學,博士班,葉門共和國,其他亞洲地區,1,1,0,1,1,0,0,0,0,0,0,0,0,0,0
110,私立,技專校院,1025,嘉藥學校財團法人嘉南藥理大學,學士班(日間),大韓民國(南韓),其他亞洲地區,1,1,0,0,0,0,1,1,0,0,0,0,0,0,0
110,私立,技專校院,1025,嘉藥學校財團法人嘉南藥理大學,學士班(日間),印度尼西亞共和國,東協,4,2,2,4,2,2,0,0,0,0,0,0,0,0,0
110,私立,技專校院,1025,嘉藥學校財團法人嘉南藥理大學,學士班(日間),香港,港澳,46,29,17,0,0,0,0,0,0,46,29,17,0,0,0
110,私立,技專校院,1025,嘉藥學校財團法人嘉南藥理大學,學士班(日間),馬來西亞,東協,8,5,3,0,0,0,8,5,3,0,0,0,0,0,0
110,私立,技專校院,1025,嘉藥學校財團法人嘉南藥理大學,學士班(日間),越南社會主義共和國,東協,76,43,33,76,43,33,0,0,0,0,0,0,0,0,0
110,私立,技專校院,1025,嘉藥學校財團法人嘉南藥理大學,學士班(日間),澳門,港澳,2,2,0,0,0,0,0,0,0,2,2,0,0,0,0
110,私立,技專校院,1025,嘉藥學校財團法人嘉南藥理大學,學士班(日間),巴西聯邦共和國,中南美洲,3,2,1,0,0,0,3,2,1,0,0,0,0,0,0
110,私立,技專校院,1025,嘉藥學校財團法人嘉南藥理大學,學士班(日間),日本,其他亞洲地區,5,1,4,5,1,4,0,0,0,0,0,0,0,0,0
110,私立,技專校院,1025,嘉藥學校財團法人嘉南藥理大學,學士班(日間),美國,北美洲,2,2,0,0,0,0,2,2,0,0,0,0,0,0,0
110,私立,技專校院,1025,嘉藥學校財團法人嘉南藥理大學,碩士班(日間),泰國,東協,6,3,3,6,3,3,0,0,0,0,0,0,0,0,0
110,私立,技專校院,1025,嘉藥學校財團法人嘉南藥理大學,碩士班(日間),馬來西亞,東協,1,1,0,0,0,0,1,1,0,0,0,0,0,0,0
110,私立,技專校院,1025,嘉藥學校財團法人嘉南藥理大學,碩士班(日間),越南社會主義共和國,東協,1,0,1,1,0,1,0,0,0,0,0,0,0,0,0
110,私立,技專校院,1026,樹德科技大學,學士班(日間),大韓民國(南韓),其他亞洲地區,1,0,1,1,0,1,0,0,0,0,0,0,0,0,0
110,私立,技專校院,1026,樹德科技大學,學士班(日間),日本,其他亞洲地區,87,45,42,85,44,41,2,1,1,0,0,0,0,0,0
110,私立,技專校院,1026,樹德科技大學,學士班(日間),馬來西亞,東協,135,65,70,36,20,16,99,45,54,0,0,0,0,0,0
110,私立,技專校院,1026,樹德科技大學,學士班(日間),大陸地區,大陸地區,27,11,16,0,0,0,0,0,0,0,0,0,27,11,16
110,私立,技專校院,1026,樹德科技大學,學士班(日間),印度尼西亞共和國,東協,127,54,73,85,41,44,42,13,29,0,0,0,0,0,0
110,私立,技專校院,1026,樹德科技大學,學士班(日間),香港,港澳,124,53,71,0,0,0,0,0,0,124,53,71,0,0,0
110,私立,技專校院,1026,樹德科技大學,學士班(日間),菲律賓共和國,東協,3,1,2,3,1,2,0,0,0,0,0,0,0,0,0
110,私立,技專校院,1026,樹德科技大學,學士班(日間),越南社會主義共和國,東協,50,12,38,17,4,13,33,8,25,0,0,0,0,0,0
110,私立,技專校院,1026,樹德科技大學,學士班(日間),緬甸,東協,22,6,16,0,0,0,22,6,16,0,0,0,0,0,0
110,私立,技專校院,1026,樹德科技大學,學士班(日間),澳門,港澳,7,2,5,0,0,0,0,0,0,7,2,5,0,0,0
110,私立,技專校院,1026,樹德科技大學,碩士班(日間),大陸地區,大陸地區,5,3,2,0,0,0,0,0,0,0,0,0,5,3,2
110,私立,技專校院,1026,樹德科技大學,碩士班(日間),印度尼西亞共和國,東協,1,0,1,1,0,1,0,0,0,0,0,0,0,0,0
110,私立,技專校院,1026,樹德科技大學,碩士班(日間),香港,港澳,4,4,0,0,0,0,0,0,0,4,4,0,0,0,0
110,私立,技專校院,1026,樹德科技大學,碩士班(日間),越南社會主義共和國,東協,3,1,2,3,1,2,0,0,0,0,0,0,0,0,0
110,私立,技專校院,1026,樹德科技大學,碩士班(日間),澳門,港澳,1,0,1,0,0,0,0,0,0,1,0,1,0,0,0
110,私立,技專校院,1026,樹德科技大學,碩士班(日間),馬來西亞,東協,5,3,2,4,2,2,1,1,0,0,0,0,0,0,0
110,私立,技專校院,1026,樹德科技大學,碩士班(日間),菲律賓共和國,東協,1,1,0,1,1,0,0,0,0,0,0,0,0,0,0
110,私立,技專校院,1026,樹德科技大學,博士班,馬來西亞,東協,1,1,0,1,1,0,0,0,0,0,0,0,0,0,0
110,私立,技專校院,1026,樹德科技大學,博士班,越南社會主義共和國,東協,1,1,0,1,1,0,0,0,0,0,0,0,0,0,0
110,私立,技專校院,1026,樹德科技大學,博士班,墨西哥合眾國,中南美洲,1,0,1,1,0,1,0,0,0,0,0,0,0,0,0
110,私立,一般大學,1027,慈濟學校財團法人慈濟大學,學士班(日間),大陸地區,大陸地區,4,0,4,0,0,0,0,0,0,0,0,0,4,0,4
110,私立,一般大學,1027,慈濟學校財團法人慈濟大學,學士班(日間),大韓民國(南韓),其他亞洲地區,9,6,3,9,6,3,0,0,0,0,0,0,0,0,0
110,私立,一般大學,1027,慈濟學校財團法人慈濟大學,學士班(日間),吉爾吉斯,其他亞洲地區,1,1,0,1,1,0,0,0,0,0,0,0,0,0,0
110,私立,一般大學,1027,慈濟學校財團法人慈濟大學,學士班(日間),法國,歐洲,1,1,0,1,1,0,0,0,0,0,0,0,0,0,0
110,私立,一般大學,1027,慈濟學校財團法人慈濟大學,學士班(日間),香港,港澳,6,3,3,0,0,0,0,0,0,6,3,3,0,0,0
110,私立,一般大學,1027,慈濟學校財團法人慈濟大學,學士班(日間),泰國,東協,3,0,3,3,0,3,0,0,0,0,0,0,0,0,0
110,私立,一般大學,1027,慈濟學校財團法人慈濟大學,學士班(日間),越南社會主義共和國,東協,8,2,6,7,1,6,1,1,0,0,0,0,0,0,0
110,私立,一般大學,1027,慈濟學校財團法人慈濟大學,學士班(日間),澳大利亞,其他亞洲地區,1,1,0,0,0,0,1,1,0,0,0,0,0,0,0
110,私立,一般大學,1027,慈濟學校財團法人慈濟大學,學士班(日間),澳門,港澳,5,4,1,0,0,0,0,0,0,5,4,1,0,0,0
110,私立,一般大學,1027,慈濟學校財團法人慈濟大學,學士班(日間),加拿大,北美洲,1,0,1,0,0,0,1,0,1,0,0,0,0,0,0
110,私立,一般大學,1027,慈濟學校財團法人慈濟大學,學士班(日間),史瓦帝尼王國,非洲,1,1,0,1,1,0,0,0,0,0,0,0,0,0,0
110,私立,一般大學,1027,慈濟學校財團法人慈濟大學,學士班(日間),印度尼西亞共和國,東協,33,10,23,27,10,17,6,0,6,0,0,0,0,0,0
110,私立,一般大學,1027,慈濟學校財團法人慈濟大學,學士班(日間),南非共和國,非洲,2,0,2,2,0,2,0,0,0,0,0,0,0,0,0
110,私立,一般大學,1027,慈濟學校財團法人慈濟大學,學士班(日間),柬埔寨王國,東協,1,1,0,1,1,0,0,0,0,0,0,0,0,0,0
110,私立,一般大學,1027,慈濟學校財團法人慈濟大學,學士班(日間),美國,北美洲,3,2,1,2,1,1,1,1,0,0,0,0,0,0,0
110,私立,一般大學,1027,慈濟學校財團法人慈濟大學,學士班(日間),馬來西亞,東協,100,29,71,76,23,53,24,6,18,0,0,0,0,0,0
110,私立,一般大學,1027,慈濟學校財團法人慈濟大學,學士班(日間),莫三比克共和國,非洲,1,0,1,1,0,1,0,0,0,0,0,0,0,0,0
110,私立,一般大學,1027,慈濟學校財團法人慈濟大學,學士班(日間),菲律賓共和國,東協,3,0,3,3,0,3,0,0,0,0,0,0,0,0,0
110,私立,一般大學,1027,慈濟學校財團法人慈濟大學,學士班(日間),新加坡共和國,東協,2,0,2,1,0,1,1,0,1,0,0,0,0,0,0
110,私立,一般大學,1027,慈濟學校財團法人慈濟大學,學士班(日間),瑞典王國,歐洲,1,1,0,1,1,0,0,0,0,0,0,0,0,0,0
110,私立,一般大學,1027,慈濟學校財團法人慈濟大學,碩士班(日間),大韓民國(南韓),其他亞洲地區,1,1,0,1,1,0,0,0,0,0,0,0,0,0,0
110,私立,一般大學,1027,慈濟學校財團法人慈濟大學,碩士班(日間),日本,其他亞洲地區,1,1,0,1,1,0,0,0,0,0,0,0,0,0,0
110,私立,一般大學,1027,慈濟學校財團法人慈濟大學,碩士班(日間),印度尼西亞共和國,東協,6,2,4,6,2,4,0,0,0,0,0,0,0,0,0
110,私立,一般大學,1027,慈濟學校財團法人慈濟大學,碩士班(日間),南非共和國,非洲,1,0,1,1,0,1,0,0,0,0,0,0,0,0,0
110,私立,一般大學,1027,慈濟學校財團法人慈濟大學,碩士班(日間),美國,北美洲,1,1,0,0,0,0,1,1,0,0,0,0,0,0,0
110,私立,一般大學,1027,慈濟學校財團法人慈濟大學,碩士班(日間),泰國,東協,3,1,2,3,1,2,0,0,0,0,0,0,0,0,0
110,私立,一般大學,1027,慈濟學校財團法人慈濟大學,碩士班(日間),馬來西亞,東協,16,3,13,15,3,12,1,0,1,0,0,0,0,0,0
110,私立,一般大學,1027,慈濟學校財團法人慈濟大學,碩士班(日間),菲律賓共和國,東協,1,0,1,1,0,1,0,0,0,0,0,0,0,0,0
110,私立,一般大學,1027,慈濟學校財團法人慈濟大學,碩士班(日間),大陸地區,大陸地區,2,0,2,0,0,0,0,0,0,0,0,0,2,0,2
110,私立,一般大學,1027,慈濟學校財團法人慈濟大學,碩士班(日間),巴基斯坦,南亞,2,2,0,2,2,0,0,0,0,0,0,0,0,0,0
110,私立,一般大學,1027,慈濟學校財團法人慈濟大學,碩士班(日間),尼泊爾聯邦民主共和國,南亞,1,1,0,1,1,0,0,0,0,0,0,0,0,0,0
110,私立,一般大學,1027,慈濟學校財團法人慈濟大學,碩士班(日間),印度,南亞,7,3,4,7,3,4,0,0,0,0,0,0,0,0,0
110,私立,一般大學,1027,慈濟學校財團法人慈濟大學,碩士班(日間),奈及利亞聯邦共和國,非洲,1,1,0,1,1,0,0,0,0,0,0,0,0,0,0
110,私立,一般大學,1027,慈濟學校財團法人慈濟大學,碩士班(日間),孟加拉人民共和國,南亞,3,0,3,3,0,3,0,0,0,0,0,0,0,0,0
110,私立,一般大學,1027,慈濟學校財團法人慈濟大學,碩士班(日間),迦納共和國,非洲,2,1,1,2,1,1,0,0,0,0,0,0,0,0,0
110,私立,一般大學,1027,慈濟學校財團法人慈濟大學,碩士班(日間),香港,港澳,1,0,1,0,0,0,0,0,0,1,0,1,0,0,0
110,私立,一般大學,1027,慈濟學校財團法人慈濟大學,碩士班(日間),馬拉威共和國,非洲,3,0,3,3,0,3,0,0,0,0,0,0,0,0,0
110,私立,一般大學,1027,慈濟學校財團法人慈濟大學,碩士班(日間),越南社會主義共和國,東協,3,1,2,3,1,2,0,0,0,0,0,0,0,0,0
110,私立,一般大學,1027,慈濟學校財團法人慈濟大學,碩士班(日間),澳門,港澳,2,1,1,0,0,0,0,0,0,2,1,1,0,0,0
110,私立,一般大學,1027,慈濟學校財團法人慈濟大學,博士班,奈及利亞聯邦共和國,非洲,1,1,0,1,1,0,0,0,0,0,0,0,0,0,0
110,私立,一般大學,1027,慈濟學校財團法人慈濟大學,博士班,孟加拉人民共和國,南亞,2,1,1,2,1,1,0,0,0,0,0,0,0,0,0
110,私立,一般大學,1027,慈濟學校財團法人慈濟大學,博士班,泰國,東協,1,0,1,1,0,1,0,0,0,0,0,0,0,0,0
110,私立,一般大學,1027,慈濟學校財團法人慈濟大學,博士班,蒙古國,其他亞洲地區,1,0,1,1,0,1,0,0,0,0,0,0,0,0,0
110,私立,一般大學,1027,慈濟學校財團法人慈濟大學,博士班,印度,南亞,9,2,7,9,2,7,0,0,0,0,0,0,0,0,0
110,私立,一般大學,1027,慈濟學校財團法人慈濟大學,博士班,印度尼西亞共和國,東協,2,0,2,2,0,2,0,0,0,0,0,0,0,0,0
110,私立,一般大學,1027,慈濟學校財團法人慈濟大學,博士班,香港,港澳,1,1,0,0,0,0,0,0,0,1,1,0,0,0,0
110,私立,一般大學,1027,慈濟學校財團法人慈濟大學,博士班,馬來西亞,東協,4,3,1,2,1,1,2,2,0,0,0,0,0,0,0
110,私立,一般大學,1027,慈濟學校財團法人慈濟大學,博士班,馬拉威共和國,非洲,1,1,0,1,1,0,0,0,0,0,0,0,0,0,0
110,私立,一般大學,1027,慈濟學校財團法人慈濟大學,博士班,越南社會主義共和國,東協,1,1,0,1,1,0,0,0,0,0,0,0,0,0,0
110,私立,一般大學,1028,臺北醫學大學,學士班(日間),日本,其他亞洲地區,2,1,1,2,1,1,0,0,0,0,0,0,0,0,0
110,私立,一般大學,1028,臺北醫學大學,學士班(日間),美國,北美洲,6,4,2,2,0,2,4,4,0,0,0,0,0,0,0
110,私立,一般大學,1028,臺北醫學大學,學士班(日間),泰國,東協,2,1,1,0,0,0,2,1,1,0,0,0,0,0,0
110,私立,一般大學,1028,臺北醫學大學,學士班(日間),新加坡共和國,東協,6,1,5,0,0,0,6,1,5,0,0,0,0,0,0
110,私立,一般大學,1028,臺北醫學大學,學士班(日間),葡萄牙共和國,歐洲,1,0,1,1,0,1,0,0,0,0,0,0,0,0,0
110,私立,一般大學,1028,臺北醫學大學,學士班(日間),大陸地區,大陸地區,14,5,9,0,0,0,0,0,0,0,0,0,14,5,9
110,私立,一般大學,1028,臺北醫學大學,學士班(日間),大韓民國(南韓),其他亞洲地區,11,5,6,2,0,2,9,5,4,0,0,0,0,0,0
110,私立,一般大學,1028,臺北醫學大學,學士班(日間),加拿大,北美洲,10,6,4,0,0,0,10,6,4,0,0,0,0,0,0
110,私立,一般大學,1028,臺北醫學大學,學士班(日間),伊朗伊斯蘭共和國,其他亞洲地區,1,0,1,0,0,0,1,0,1,0,0,0,0,0,0
110,私立,一般大學,1028,臺北醫學大學,學士班(日間),印度尼西亞共和國,東協,14,2,12,0,0,0,14,2,12,0,0,0,0,0,0
110,私立,一般大學,1028,臺北醫學大學,學士班(日間),香港,港澳,58,25,33,0,0,0,0,0,0,58,25,33,0,0,0
110,私立,一般大學,1028,臺北醫學大學,學士班(日間),馬來西亞,東協,100,27,73,4,1,3,96,26,70,0,0,0,0,0,0
110,私立,一般大學,1028,臺北醫學大學,學士班(日間),越南社會主義共和國,東協,6,3,3,0,0,0,6,3,3,0,0,0,0,0,0
110,私立,一般大學,1028,臺北醫學大學,學士班(日間),緬甸,東協,2,1,1,0,0,0,2,1,1,0,0,0,0,0,0
110,私立,一般大學,1028,臺北醫學大學,學士班(日間),澳門,港澳,17,9,8,0,0,0,0,0,0,17,9,8,0,0,0
110,私立,一般大學,1028,臺北醫學大學,碩士班(日間),大陸地區,大陸地區,2,2,0,0,0,0,0,0,0,0,0,0,2,2,0
110,私立,一般大學,1028,臺北醫學大學,碩士班(日間),大韓民國(南韓),其他亞洲地區,1,0,1,1,0,1,0,0,0,0,0,0,0,0,0
110,私立,一般大學,1028,臺北醫學大學,碩士班(日間),厄瓜多共和國,中南美洲,2,1,1,2,1,1,0,0,0,0,0,0,0,0,0
110,私立,一般大學,1028,臺北醫學大學,碩士班(日間),巴拉圭,中南美洲,1,0,1,1,0,1,0,0,0,0,0,0,0,0,0
110,私立,一般大學,1028,臺北醫學大學,碩士班(日間),加拿大,北美洲,1,0,1,1,0,1,0,0,0,0,0,0,0,0,0
110,私立,一般大學,1028,臺北醫學大學,碩士班(日間),印度,南亞,6,3,3,6,3,3,0,0,0,0,0,0,0,0,0
110,私立,一般大學,1028,臺北醫學大學,碩士班(日間),印度尼西亞共和國,東協,27,5,22,27,5,22,0,0,0,0,0,0,0,0,0
110,私立,一般大學,1028,臺北醫學大學,碩士班(日間),宏都拉斯共和國,中南美洲,2,2,0,2,2,0,0,0,0,0,0,0,0,0,0
110,私立,一般大學,1028,臺北醫學大學,碩士班(日間),貝里斯,中南美洲,3,1,2,3,1,2,0,0,0,0,0,0,0,0,0
110,私立,一般大學,1028,臺北醫學大學,碩士班(日間),英國,歐洲,2,0,2,2,0,2,0,0,0,0,0,0,0,0,0
110,私立,一般大學,1028,臺北醫學大學,碩士班(日間),香港,港澳,7,2,5,0,0,0,0,0,0,7,2,5,0,0,0
110,私立,一般大學,1028,臺北醫學大學,碩士班(日間),挪威王國,歐洲,1,0,1,1,0,1,0,0,0,0,0,0,0,0,0
110,私立,一般大學,1028,臺北醫學大學,碩士班(日間),馬來西亞,東協,9,1,8,4,0,4,5,1,4,0,0,0,0,0,0
110,私立,一般大學,1028,臺北醫學大學,碩士班(日間),馬拉威共和國,非洲,4,1,3,4,1,3,0,0,0,0,0,0,0,0,0
110,私立,一般大學,1028,臺北醫學大學,碩士班(日間),馬紹爾群島共和國,其他亞洲地區,2,0,2,2,0,2,0,0,0,0,0,0,0,0,0
110,私立,一般大學,1028,臺北醫學大學,碩士班(日間),斯洛維尼亞共和國,歐洲,1,0,1,1,0,1,0,0,0,0,0,0,0,0,0
110,私立,一般大學,1028,臺北醫學大學,碩士班(日間),智利,中南美洲,1,0,1,1,0,1,0,0,0,0,0,0,0,0,0
110,私立,一般大學,1028,臺北醫學大學,碩士班(日間),越南社會主義共和國,東協,29,7,22,29,7,22,0,0,0,0,0,0,0,0,0
110,私立,一般大學,1028,臺北醫學大學,碩士班(日間),愛沙尼亞共和國,歐洲,1,0,1,1,0,1,0,0,0,0,0,0,0,0,0
110,私立,一般大學,1028,臺北醫學大學,碩士班(日間),新加坡共和國,東協,2,2,0,1,1,0,1,1,0,0,0,0,0,0,0
110,私立,一般大學,1028,臺北醫學大學,碩士班(日間),聖文森(及格瑞那丁),中南美洲,3,0,3,3,0,3,0,0,0,0,0,0,0,0,0
110,私立,一般大學,1028,臺北醫學大學,碩士班(日間),聖克里斯多福及尼維斯,中南美洲,1,0,1,1,0,1,0,0,0,0,0,0,0,0,0
110,私立,一般大學,1028,臺北醫學大學,碩士班(日間),蒙古國,其他亞洲地區,1,0,1,1,0,1,0,0,0,0,0,0,0,0,0
110,私立,一般大學,1028,臺北醫學大學,碩士班(日間),緬甸,東協,3,3,0,3,3,0,0,0,0,0,0,0,0,0,0
110,私立,一般大學,1028,臺北醫學大學,碩士班(日間),澳大利亞,其他亞洲地區,1,0,1,1,0,1,0,0,0,0,0,0,0,0,0
110,私立,一般大學,1028,臺北醫學大學,碩士班(日間),澳門,港澳,1,1,0,0,0,0,0,0,0,1,1,0,0,0,0
110,私立,一般大學,1028,臺北醫學大學,碩士班(日間),史瓦帝尼王國,非洲,3,0,3,3,0,3,0,0,0,0,0,0,0,0,0
110,私立,一般大學,1028,臺北醫學大學,碩士班(日間),甘比亞共和國,非洲,2,2,0,2,2,0,0,0,0,0,0,0,0,0,0
110,私立,一般大學,1028,臺北醫學大學,碩士班(日間),奈及利亞聯邦共和國,非洲,2,2,0,2,2,0,0,0,0,0,0,0,0,0,0
110,私立,一般大學,1028,臺北醫學大學,碩士班(日間),法國,歐洲,1,0,1,1,0,1,0,0,0,0,0,0,0,0,0
110,私立,一般大學,1028,臺北醫學大學,碩士班(日間),俄羅斯聯邦,其他亞洲地區,2,1,1,2,1,1,0,0,0,0,0,0,0,0,0
110,私立,一般大學,1028,臺北醫學大學,碩士班(日間),美國,北美洲,7,3,4,6,3,3,1,0,1,0,0,0,0,0,0
110,私立,一般大學,1028,臺北醫學大學,碩士班(日間),泰國,東協,8,2,6,8,2,6,0,0,0,0,0,0,0,0,0
110,私立,一般大學,1028,臺北醫學大學,碩士班(日間),菲律賓共和國,東協,3,3,0,3,3,0,0,0,0,0,0,0,0,0,0
110,私立,一般大學,1028,臺北醫學大學,碩士班(日間),聖露西亞,中南美洲,1,0,1,1,0,1,0,0,0,0,0,0,0,0,0
110,私立,一般大學,1028,臺北醫學大學,碩士班(日間),德意志聯邦共和國,歐洲,2,1,1,2,1,1,0,0,0,0,0,0,0,0,0
110,私立,一般大學,1028,臺北醫學大學,碩士班(日間),墨西哥合眾國,中南美洲,2,2,0,2,2,0,0,0,0,0,0,0,0,0,0
110,私立,一般大學,1028,臺北醫學大學,博士班,大陸地區,大陸地區,2,2,0,0,0,0,0,0,0,0,0,0,2,2,0
110,私立,一般大學,1028,臺北醫學大學,博士班,大韓民國(南韓),其他亞洲地區,1,0,1,1,0,1,0,0,0,0,0,0,0,0,0
110,私立,一般大學,1028,臺北醫學大學,博士班,巴基斯坦,南亞,2,1,1,2,1,1,0,0,0,0,0,0,0,0,0
110,私立,一般大學,1028,臺北醫學大學,博士班,加拿大,北美洲,1,1,0,1,1,0,0,0,0,0,0,0,0,0,0
110,私立,一般大學,1028,臺北醫學大學,博士班,布吉納法索,非洲,2,1,1,2,1,1,0,0,0,0,0,0,0,0,0
110,私立,一般大學,1028,臺北醫學大學,博士班,伊朗伊斯蘭共和國,其他亞洲地區,1,1,0,1,1,0,0,0,0,0,0,0,0,0,0
110,私立,一般大學,1028,臺北醫學大學,博士班,印度,南亞,29,13,16,29,13,16,0,0,0,0,0,0,0,0,0
110,私立,一般大學,1028,臺北醫學大學,博士班,印度尼西亞共和國,東協,93,43,50,93,43,50,0,0,0,0,0,0,0,0,0
110,私立,一般大學,1028,臺北醫學大學,博士班,宏都拉斯共和國,中南美洲,1,1,0,1,1,0,0,0,0,0,0,0,0,0,0
110,私立,一般大學,1028,臺北醫學大學,博士班,俄羅斯聯邦,其他亞洲地區,2,1,1,2,1,1,0,0,0,0,0,0,0,0,0
110,私立,一般大學,1028,臺北醫學大學,博士班,南非共和國,非洲,1,1,0,1,1,0,0,0,0,0,0,0,0,0,0
110,私立,一般大學,1028,臺北醫學大學,博士班,香港,港澳,1,1,0,0,0,0,0,0,0,1,1,0,0,0,0
110,私立,一般大學,1028,臺北醫學大學,博士班,索馬利蘭共和國,非洲,1,1,0,1,1,0,0,0,0,0,0,0,0,0,0
110,私立,一般大學,1028,臺北醫學大學,博士班,馬來西亞,東協,4,3,1,1,1,0,3,2,1,0,0,0,0,0,0
110,私立,一般大學,1028,臺北醫學大學,博士班,馬拉威共和國,非洲,5,3,2,5,3,2,0,0,0,0,0,0,0,0,0
110,私立,一般大學,1028,臺北醫學大學,博士班,喀麥隆共和國,非洲,1,0,1,1,0,1,0,0,0,0,0,0,0,0,0
110,私立,一般大學,1028,臺北醫學大學,博士班,菲律賓共和國,東協,2,2,0,2,2,0,0,0,0,0,0,0,0,0,0
110,私立,一般大學,1028,臺北醫學大學,博士班,新加坡共和國,東協,2,0,2,2,0,2,0,0,0,0,0,0,0,0,0
110,私立,一般大學,1028,臺北醫學大學,博士班,聖文森(及格瑞那丁),中南美洲,1,0,1,1,0,1,0,0,0,0,0,0,0,0,0
110,私立,一般大學,1028,臺北醫學大學,博士班,聖克里斯多福及尼維斯,中南美洲,2,1,1,2,1,1,0,0,0,0,0,0,0,0,0
110,私立,一般大學,1028,臺北醫學大學,博士班,蒙古國,其他亞洲地區,5,0,5,5,0,5,0,0,0,0,0,0,0,0,0
110,私立,一般大學,1028,臺北醫學大學,博士班,史瓦帝尼王國,非洲,4,2,2,4,2,2,0,0,0,0,0,0,0,0,0
110,私立,一般大學,1028,臺北醫學大學,博士班,瓜地馬拉共和國,中南美洲,1,1,0,1,1,0,0,0,0,0,0,0,0,0,0
110,私立,一般大學,1028,臺北醫學大學,博士班,甘比亞共和國,非洲,1,1,0,1,1,0,0,0,0,0,0,0,0,0,0
110,私立,一般大學,1028,臺北醫學大學,博士班,西班牙王國,歐洲,1,1,0,1,1,0,0,0,0,0,0,0,0,0,0
110,私立,一般大學,1028,臺北醫學大學,博士班,貝里斯,中南美洲,1,0,1,1,0,1,0,0,0,0,0,0,0,0,0
110,私立,一般大學,1028,臺北醫學大學,博士班,奈及利亞聯邦共和國,非洲,2,1,1,2,1,1,0,0,0,0,0,0,0,0,0
110,私立,一般大學,1028,臺北醫學大學,博士班,孟加拉人民共和國,南亞,2,1,1,2,1,1,0,0,0,0,0,0,0,0,0
110,私立,一般大學,1028,臺北醫學大學,博士班,美國,北美洲,3,2,1,3,2,1,0,0,0,0,0,0,0,0,0
110,私立,一般大學,1028,臺北醫學大學,博士班,泰國,東協,10,2,8,10,2,8,0,0,0,0,0,0,0,0,0
110,私立,一般大學,1028,臺北醫學大學,博士班,海地共和國,中南美洲,2,1,1,2,1,1,0,0,0,0,0,0,0,0,0
110,私立,一般大學,1028,臺北醫學大學,博士班,烏干達共和國,非洲,1,1,0,1,1,0,0,0,0,0,0,0,0,0,0
110,私立,一般大學,1028,臺北醫學大學,博士班,越南社會主義共和國,東協,74,43,31,74,43,31,0,0,0,0,0,0,0,0,0
110,私立,一般大學,1028,臺北醫學大學,博士班,獅子山共和國,非洲,2,1,1,2,1,1,0,0,0,0,0,0,0,0,0
110,私立,一般大學,1028,臺北醫學大學,博士班,瑞典王國,歐洲,1,0,1,1,0,1,0,0,0,0,0,0,0,0,0
110,私立,一般大學,1028,臺北醫學大學,博士班,德意志聯邦共和國,歐洲,1,1,0,1,1,0,0,0,0,0,0,0,0,0,0
110,私立,一般大學,1028,臺北醫學大學,博士班,緬甸,東協,1,1,0,1,1,0,0,0,0,0,0,0,0,0,0
110,私立,一般大學,1028,臺北醫學大學,博士班,澳門,港澳,1,1,0,0,0,0,0,0,0,1,1,0,0,0,0
110,私立,一般大學,1029,中山醫學大學,學士班(日間),大陸地區,大陸地區,14,8,6,0,0,0,0,0,0,0,0,0,14,8,6
110,私立,一般大學,1029,中山醫學大學,學士班(日間),大韓民國(南韓),其他亞洲地區,2,1,1,0,0,0,2,1,1,0,0,0,0,0,0
110,私立,一般大學,1029,中山醫學大學,學士班(日間),日本,其他亞洲地區,2,1,1,0,0,0,2,1,1,0,0,0,0,0,0
110,私立,一般大學,1029,中山醫學大學,學士班(日間),加拿大,北美洲,10,5,5,0,0,0,10,5,5,0,0,0,0,0,0
110,私立,一般大學,1029,中山醫學大學,學士班(日間),印度尼西亞共和國,東協,7,1,6,1,0,1,6,1,5,0,0,0,0,0,0
110,私立,一般大學,1029,中山醫學大學,學士班(日間),貝里斯,中南美洲,1,0,1,1,0,1,0,0,0,0,0,0,0,0,0
110,私立,一般大學,1029,中山醫學大學,學士班(日間),香港,港澳,53,27,26,0,0,0,0,0,0,53,27,26,0,0,0
110,私立,一般大學,1029,中山醫學大學,學士班(日間),新加坡共和國,東協,3,0,3,0,0,0,3,0,3,0,0,0,0,0,0
110,私立,一般大學,1029,中山醫學大學,學士班(日間),葡萄牙共和國,歐洲,2,1,1,0,0,0,2,1,1,0,0,0,0,0,0
110,私立,一般大學,1029,中山醫學大學,學士班(日間),緬甸,東協,4,1,3,0,0,0,4,1,3,0,0,0,0,0,0
110,私立,一般大學,1029,中山醫學大學,學士班(日間),澳門,港澳,61,25,36,0,0,0,0,0,0,61,25,36,0,0,0
110,私立,一般大學,1029,中山醫學大學,學士班(日間),巴拉圭,中南美洲,1,0,1,0,0,0,1,0,1,0,0,0,0,0,0
110,私立,一般大學,1029,中山醫學大學,學士班(日間),史瓦帝尼王國,非洲,1,0,1,0,0,0,1,0,1,0,0,0,0,0,0
110,私立,一般大學,1029,中山醫學大學,學士班(日間),美國,北美洲,5,2,3,0,0,0,5,2,3,0,0,0,0,0,0
110,私立,一般大學,1029,中山醫學大學,學士班(日間),英國,歐洲,1,1,0,0,0,0,1,1,0,0,0,0,0,0,0
110,私立,一般大學,1029,中山醫學大學,學士班(日間),泰國,東協,2,0,2,0,0,0,2,0,2,0,0,0,0,0,0
110,私立,一般大學,1029,中山醫學大學,學士班(日間),馬來西亞,東協,58,21,37,3,2,1,55,19,36,0,0,0,0,0,0
110,私立,一般大學,1029,中山醫學大學,學士班(日間),越南社會主義共和國,東協,2,0,2,0,0,0,2,0,2,0,0,0,0,0,0
110,私立,一般大學,1029,中山醫學大學,碩士班(日間),美國,北美洲,1,0,1,0,0,0,1,0,1,0,0,0,0,0,0
110,私立,一般大學,1029,中山醫學大學,碩士班(日間),馬來西亞,東協,5,1,4,2,0,2,3,1,2,0,0,0,0,0,0
110,私立,一般大學,1029,中山醫學大學,碩士班(日間),大陸地區,大陸地區,2,2,0,0,0,0,0,0,0,0,0,0,2,2,0
110,私立,一般大學,1029,中山醫學大學,碩士班(日間),印度尼西亞共和國,東協,2,2,0,2,2,0,0,0,0,0,0,0,0,0,0
110,私立,一般大學,1029,中山醫學大學,碩士班(日間),香港,港澳,3,2,1,0,0,0,0,0,0,3,2,1,0,0,0
110,私立,一般大學,1029,中山醫學大學,碩士班(日間),澳門,港澳,6,1,5,0,0,0,0,0,0,6,1,5,0,0,0
110,私立,一般大學,1029,中山醫學大學,博士班,越南社會主義共和國,東協,1,1,0,1,1,0,0,0,0,0,0,0,0,0,0
110,私立,一般大學,1029,中山醫學大學,博士班,馬來西亞,東協,2,1,1,0,0,0,2,1,1,0,0,0,0,0,0
110,私立,技專校院,1030,龍華科技大學,五專,白俄羅斯共和國,其他亞洲地區,1,1,0,1,1,0,0,0,0,0,0,0,0,0,0
110,私立,技專校院,1030,龍華科技大學,學士班(日間),大陸地區,大陸地區,1,0,1,0,0,0,0,0,0,0,0,0,1,0,1
110,私立,技專校院,1030,龍華科技大學,學士班(日間),印度尼西亞共和國,東協,146,113,33,86,72,14,60,41,19,0,0,0,0,0,0
110,私立,技專校院,1030,龍華科技大學,學士班(日間),香港,港澳,53,41,12,0,0,0,0,0,0,53,41,12,0,0,0
110,私立,技專校院,1030,龍華科技大學,學士班(日間),緬甸,東協,11,7,4,0,0,0,11,7,4,0,0,0,0,0,0
110,私立,技專校院,1030,龍華科技大學,學士班(日間),泰國,東協,3,0,3,1,0,1,2,0,2,0,0,0,0,0,0
110,私立,技專校院,1030,龍華科技大學,學士班(日間),烏克蘭,其他亞洲地區,1,1,0,1,1,0,0,0,0,0,0,0,0,0,0
110,私立,技專校院,1030,龍華科技大學,學士班(日間),馬來西亞,東協,55,50,5,40,37,3,15,13,2,0,0,0,0,0,0
110,私立,技專校院,1030,龍華科技大學,學士班(日間),菲律賓共和國,東協,1,0,1,0,0,0,1,0,1,0,0,0,0,0,0
110,私立,技專校院,1030,龍華科技大學,學士班(日間),越南社會主義共和國,東協,908,470,438,625,288,337,283,182,101,0,0,0,0,0,0
110,私立,技專校院,1030,龍華科技大學,學士班(日間),瑞士聯邦,歐洲,1,1,0,1,1,0,0,0,0,0,0,0,0,0,0
110,私立,技專校院,1030,龍華科技大學,學士班(日間),澳門,港澳,1,1,0,0,0,0,0,0,0,1,1,0,0,0,0
110,私立,技專校院,1030,龍華科技大學,碩士班(日間),美國,北美洲,1,1,0,1,1,0,0,0,0,0,0,0,0,0,0
110,私立,技專校院,1030,龍華科技大學,碩士班(日間),馬來西亞,東協,6,3,3,6,3,3,0,0,0,0,0,0,0,0,0
110,私立,技專校院,1030,龍華科技大學,碩士班(日間),越南社會主義共和國,東協,50,14,36,48,14,34,2,0,2,0,0,0,0,0,0
110,私立,技專校院,1030,龍華科技大學,碩士班(日間),香港,港澳,7,6,1,0,0,0,0,0,0,7,6,1,0,0,0
110,私立,技專校院,1031,輔英科技大學,五專,馬來西亞,東協,1,0,1,0,0,0,1,0,1,0,0,0,0,0,0
110,私立,技專校院,1031,輔英科技大學,學士班(日間),印度尼西亞共和國,東協,12,6,6,0,0,0,12,6,6,0,0,0,0,0,0
110,私立,技專校院,1031,輔英科技大學,學士班(日間),西班牙王國,歐洲,2,1,1,2,1,1,0,0,0,0,0,0,0,0,0
110,私立,技專校院,1031,輔英科技大學,學士班(日間),香港,港澳,44,24,20,0,0,0,0,0,0,44,24,20,0,0,0
110,私立,技專校院,1031,輔英科技大學,學士班(日間),馬來西亞,東協,22,9,13,1,0,1,21,9,12,0,0,0,0,0,0
110,私立,技專校院,1031,輔英科技大學,學士班(日間),越南社會主義共和國,東協,128,30,98,87,21,66,41,9,32,0,0,0,0,0,0
110,私立,技專校院,1031,輔英科技大學,學士班(日間),蒙古國,其他亞洲地區,1,0,1,1,0,1,0,0,0,0,0,0,0,0,0
110,私立,技專校院,1031,輔英科技大學,學士班(日間),澳門,港澳,15,8,7,0,0,0,0,0,0,15,8,7,0,0,0
110,私立,技專校院,1031,輔英科技大學,學士班(日間),美國,北美洲,1,1,0,0,0,0,1,1,0,0,0,0,0,0,0
110,私立,技專校院,1031,輔英科技大學,碩士班(日間),越南社會主義共和國,東協,10,2,8,10,2,8,0,0,0,0,0,0,0,0,0
110,私立,技專校院,1031,輔英科技大學,碩士班(日間),香港,港澳,2,2,0,0,0,0,0,0,0,2,2,0,0,0,0
110,私立,技專校院,1032,明新學校財團法人明新科技大學,學士班(日間),日本,其他亞洲地區,29,20,9,29,20,9,0,0,0,0,0,0,0,0,0
110,私立,技專校院,1032,明新學校財團法人明新科技大學,學士班(日間),柬埔寨王國,東協,8,5,3,0,0,0,8,5,3,0,0,0,0,0,0
110,私立,技專校院,1032,明新學校財團法人明新科技大學,學士班(日間),香港,港澳,13,8,5,0,0,0,0,0,0,13,8,5,0,0,0
110,私立,技專校院,1032,明新學校財團法人明新科技大學,學士班(日間),泰國,東協,1,0,1,1,0,1,0,0,0,0,0,0,0,0,0
110,私立,技專校院,1032,明新學校財團法人明新科技大學,學士班(日間),緬甸,東協,33,12,21,30,11,19,3,1,2,0,0,0,0,0,0
110,私立,技專校院,1032,明新學校財團法人明新科技大學,學士班(日間),大韓民國(南韓),其他亞洲地區,7,3,4,7,3,4,0,0,0,0,0,0,0,0,0
110,私立,技專校院,1032,明新學校財團法人明新科技大學,學士班(日間),印度尼西亞共和國,東協,64,35,29,61,34,27,3,1,2,0,0,0,0,0,0
110,私立,技專校院,1032,明新學校財團法人明新科技大學,學士班(日間),俄羅斯聯邦,其他亞洲地區,1,1,0,1,1,0,0,0,0,0,0,0,0,0,0
110,私立,技專校院,1032,明新學校財團法人明新科技大學,學士班(日間),馬來西亞,東協,10,7,3,4,4,0,6,3,3,0,0,0,0,0,0
110,私立,技專校院,1032,明新學校財團法人明新科技大學,學士班(日間),菲律賓共和國,東協,113,38,75,113,38,75,0,0,0,0,0,0,0,0,0
110,私立,技專校院,1032,明新學校財團法人明新科技大學,學士班(日間),越南社會主義共和國,東協,909,489,420,907,488,419,2,1,1,0,0,0,0,0,0
110,私立,技專校院,1032,明新學校財團法人明新科技大學,學士班(日間),蒙古國,其他亞洲地區,7,6,1,7,6,1,0,0,0,0,0,0,0,0,0
110,私立,技專校院,1032,明新學校財團法人明新科技大學,碩士班(日間),大韓民國(南韓),其他亞洲地區,3,1,2,3,1,2,0,0,0,0,0,0,0,0,0
110,私立,技專校院,1032,明新學校財團法人明新科技大學,碩士班(日間),尼加拉瓜,中南美洲,1,1,0,1,1,0,0,0,0,0,0,0,0,0,0
110,私立,技專校院,1032,明新學校財團法人明新科技大學,碩士班(日間),印度,南亞,2,1,1,2,1,1,0,0,0,0,0,0,0,0,0
110,私立,技專校院,1032,明新學校財團法人明新科技大學,碩士班(日間),菲律賓共和國,東協,27,19,8,27,19,8,0,0,0,0,0,0,0,0,0
110,私立,技專校院,1032,明新學校財團法人明新科技大學,碩士班(日間),越南社會主義共和國,東協,45,13,32,45,13,32,0,0,0,0,0,0,0,0,0
110,私立,技專校院,1032,明新學校財團法人明新科技大學,碩士班(日間),蒙古國,其他亞洲地區,3,1,2,3,1,2,0,0,0,0,0,0,0,0,0
110,私立,技專校院,1032,明新學校財團法人明新科技大學,碩士班(日間),印度尼西亞共和國,東協,1,0,1,1,0,1,0,0,0,0,0,0,0,0,0
110,私立,技專校院,1032,明新學校財團法人明新科技大學,碩士班(日間),哈薩克共和國,其他亞洲地區,1,1,0,1,1,0,0,0,0,0,0,0,0,0,0
110,私立,技專校院,1032,明新學校財團法人明新科技大學,碩士班(日間),柬埔寨王國,東協,1,1,0,1,1,0,0,0,0,0,0,0,0,0,0
110,私立,一般大學,1033,長榮大學,學士班(日間),日本,其他亞洲地區,53,17,36,52,17,35,1,0,1,0,0,0,0,0,0
110,私立,一般大學,1033,長榮大學,學士班(日間),史瓦帝尼王國,非洲,6,3,3,6,3,3,0,0,0,0,0,0,0,0,0
110,私立,一般大學,1033,長榮大學,學士班(日間),西班牙王國,歐洲,1,1,0,1,1,0,0,0,0,0,0,0,0,0,0
110,私立,一般大學,1033,長榮大學,學士班(日間),貝里斯,中南美洲,1,0,1,1,0,1,0,0,0,0,0,0,0,0,0
110,私立,一般大學,1033,長榮大學,學士班(日間),坦尚尼亞聯合共和國,非洲,37,19,18,37,19,18,0,0,0,0,0,0,0,0,0
110,私立,一般大學,1033,長榮大學,學士班(日間),孟加拉人民共和國,南亞,1,0,1,1,0,1,0,0,0,0,0,0,0,0,0
110,私立,一般大學,1033,長榮大學,學士班(日間),蒲隆地共和國,非洲,21,16,5,21,16,5,0,0,0,0,0,0,0,0,0
110,私立,一般大學,1033,長榮大學,學士班(日間),德意志聯邦共和國,歐洲,1,1,0,1,1,0,0,0,0,0,0,0,0,0,0
110,私立,一般大學,1033,長榮大學,學士班(日間),澳門,港澳,7,2,5,0,0,0,0,0,0,7,2,5,0,0,0
110,私立,一般大學,1033,長榮大學,學士班(日間),大陸地區,大陸地區,1,1,0,0,0,0,0,0,0,0,0,0,1,1,0
110,私立,一般大學,1033,長榮大學,學士班(日間),大韓民國(南韓),其他亞洲地區,5,4,1,4,4,0,1,0,1,0,0,0,0,0,0
110,私立,一般大學,1033,長榮大學,學士班(日間),印度尼西亞共和國,東協,24,14,10,6,4,2,18,10,8,0,0,0,0,0,0
110,私立,一般大學,1033,長榮大學,學士班(日間),香港,港澳,47,26,21,0,0,0,0,0,0,47,26,21,0,0,0
110,私立,一般大學,1033,長榮大學,學士班(日間),馬來西亞,東協,110,60,50,13,10,3,97,50,47,0,0,0,0,0,0
110,私立,一般大學,1033,長榮大學,學士班(日間),越南社會主義共和國,東協,2,1,1,2,1,1,0,0,0,0,0,0,0,0,0
110,私立,一般大學,1033,長榮大學,學士班(日間),蒙古國,其他亞洲地區,4,3,1,4,3,1,0,0,0,0,0,0,0,0,0
110,私立,一般大學,1033,長榮大學,學士班(日間),澳大利亞,其他亞洲地區,1,0,1,1,0,1,0,0,0,0,0,0,0,0,0
110,私立,一般大學,1033,長榮大學,碩士班(日間),大韓民國(南韓),其他亞洲地區,1,1,0,1,1,0,0,0,0,0,0,0,0,0,0
110,私立,一般大學,1033,長榮大學,碩士班(日間),印度,南亞,2,2,0,2,2,0,0,0,0,0,0,0,0,0,0
110,私立,一般大學,1033,長榮大學,碩士班(日間),印度尼西亞共和國,東協,3,1,2,2,0,2,1,1,0,0,0,0,0,0,0
110,私立,一般大學,1033,長榮大學,碩士班(日間),香港,港澳,3,0,3,0,0,0,0,0,0,3,0,3,0,0,0
110,私立,一般大學,1033,長榮大學,碩士班(日間),馬來西亞,東協,2,2,0,1,1,0,1,1,0,0,0,0,0,0,0
110,私立,一般大學,1033,長榮大學,碩士班(日間),越南社會主義共和國,東協,2,0,2,2,0,2,0,0,0,0,0,0,0,0,0
110,私立,一般大學,1033,長榮大學,碩士班(日間),聖克里斯多福及尼維斯,中南美洲,1,0,1,1,0,1,0,0,0,0,0,0,0,0,0
110,私立,一般大學,1033,長榮大學,碩士班(日間),日本,其他亞洲地區,1,1,0,1,1,0,0,0,0,0,0,0,0,0,0
110,私立,一般大學,1033,長榮大學,碩士班(日間),甘比亞共和國,非洲,1,0,1,1,0,1,0,0,0,0,0,0,0,0,0
110,私立,一般大學,1033,長榮大學,碩士班(日間),坦尚尼亞聯合共和國,非洲,2,2,0,2,2,0,0,0,0,0,0,0,0,0,0
110,私立,一般大學,1033,長榮大學,碩士班(日間),美國,北美洲,1,1,0,1,1,0,0,0,0,0,0,0,0,0,0
110,私立,一般大學,1033,長榮大學,碩士班(日間),瑞典王國,歐洲,1,1,0,1,1,0,0,0,0,0,0,0,0,0,0
110,私立,一般大學,1033,長榮大學,博士班,越南社會主義共和國,東協,8,4,4,8,4,4,0,0,0,0,0,0,0,0,0
110,私立,技專校院,1034,弘光科技大學,學士班(日間),大陸地區,大陸地區,2,2,0,0,0,0,0,0,0,0,0,0,2,2,0
110,私立,技專校院,1034,弘光科技大學,學士班(日間),日本,其他亞洲地區,12,6,6,12,6,6,0,0,0,0,0,0,0,0,0
110,私立,技專校院,1034,弘光科技大學,學士班(日間),加拿大,北美洲,1,1,0,1,1,0,0,0,0,0,0,0,0,0,0
110,私立,技專校院,1034,弘光科技大學,學士班(日間),印度尼西亞共和國,東協,10,0,10,3,0,3,7,0,7,0,0,0,0,0,0
110,私立,技專校院,1034,弘光科技大學,學士班(日間),汶萊和平之國,東協,3,2,1,0,0,0,3,2,1,0,0,0,0,0,0
110,私立,技專校院,1034,弘光科技大學,學士班(日間),香港,港澳,89,37,52,0,0,0,0,0,0,89,37,52,0,0,0
110,私立,技專校院,1034,弘光科技大學,學士班(日間),緬甸,東協,1,0,1,0,0,0,1,0,1,0,0,0,0,0,0
110,私立,技專校院,1034,弘光科技大學,學士班(日間),馬來西亞,東協,254,125,129,80,37,43,174,88,86,0,0,0,0,0,0
110,私立,技專校院,1034,弘光科技大學,學士班(日間),越南社會主義共和國,東協,6,0,6,6,0,6,0,0,0,0,0,0,0,0,0
110,私立,技專校院,1034,弘光科技大學,學士班(日間),澳門,港澳,36,22,14,0,0,0,0,0,0,36,22,14,0,0,0
110,私立,技專校院,1034,弘光科技大學,碩士班(日間),馬來西亞,東協,5,2,3,5,2,3,0,0,0,0,0,0,0,0,0
110,私立,技專校院,1034,弘光科技大學,碩士班(日間),越南社會主義共和國,東協,3,0,3,3,0,3,0,0,0,0,0,0,0,0,0
110,私立,技專校院,1034,弘光科技大學,碩士班(日間),澳門,港澳,1,1,0,0,0,0,0,0,0,1,1,0,0,0,0
110,私立,技專校院,1034,弘光科技大學,碩士班(日間),香港,港澳,1,1,0,0,0,0,0,0,0,1,1,0,0,0,0
110,私立,技專校院,1034,弘光科技大學,博士班,越南社會主義共和國,東協,2,1,1,2,1,1,0,0,0,0,0,0,0,0,0
110,私立,一般大學,1035,中國醫藥大學,學士班(日間),大陸地區,大陸地區,10,2,8,0,0,0,0,0,0,0,0,0,10,2,8
110,私立,一般大學,1035,中國醫藥大學,學士班(日間),大韓民國(南韓),其他亞洲地區,21,10,11,10,6,4,11,4,7,0,0,0,0,0,0
110,私立,一般大學,1035,中國醫藥大學,學士班(日間),加拿大,北美洲,15,6,9,1,0,1,14,6,8,0,0,0,0,0,0
110,私立,一般大學,1035,中國醫藥大學,學士班(日間),印度尼西亞共和國,東協,15,5,10,4,1,3,11,4,7,0,0,0,0,0,0
110,私立,一般大學,1035,中國醫藥大學,學士班(日間),香港,港澳,67,33,34,0,0,0,0,0,0,67,33,34,0,0,0
110,私立,一般大學,1035,中國醫藥大學,學士班(日間),馬來西亞,東協,126,39,87,29,10,19,97,29,68,0,0,0,0,0,0
110,私立,一般大學,1035,中國醫藥大學,學士班(日間),菲律賓共和國,東協,1,0,1,0,0,0,1,0,1,0,0,0,0,0,0
110,私立,一般大學,1035,中國醫藥大學,學士班(日間),新加坡共和國,東協,12,4,8,0,0,0,12,4,8,0,0,0,0,0,0
110,私立,一般大學,1035,中國醫藥大學,學士班(日間),聖文森(及格瑞那丁),中南美洲,2,1,1,2,1,1,0,0,0,0,0,0,0,0,0
110,私立,一般大學,1035,中國醫藥大學,學士班(日間),聖克里斯多福及尼維斯,中南美洲,1,1,0,1,1,0,0,0,0,0,0,0,0,0,0
110,私立,一般大學,1035,中國醫藥大學,學士班(日間),聖露西亞,中南美洲,2,2,0,2,2,0,0,0,0,0,0,0,0,0,0
110,私立,一般大學,1035,中國醫藥大學,學士班(日間),葡萄牙共和國,歐洲,1,0,1,1,0,1,0,0,0,0,0,0,0,0,0
110,私立,一般大學,1035,中國醫藥大學,學士班(日間),緬甸,東協,8,3,5,1,1,0,7,2,5,0,0,0,0,0,0
110,私立,一般大學,1035,中國醫藥大學,學士班(日間),澳門,港澳,57,32,25,0,0,0,0,0,0,57,32,25,0,0,0
110,私立,一般大學,1035,中國醫藥大學,學士班(日間),巴西聯邦共和國,中南美洲,1,0,1,0,0,0,1,0,1,0,0,0,0,0,0
110,私立,一般大學,1035,中國醫藥大學,學士班(日間),巴拉圭,中南美洲,1,1,0,0,0,0,1,1,0,0,0,0,0,0,0
110,私立,一般大學,1035,中國醫藥大學,學士班(日間),日本,其他亞洲地區,11,3,8,10,3,7,1,0,1,0,0,0,0,0,0
110,私立,一般大學,1035,中國醫藥大學,學士班(日間),史瓦帝尼王國,非洲,1,0,1,1,0,1,0,0,0,0,0,0,0,0,0
110,私立,一般大學,1035,中國醫藥大學,學士班(日間),美國,北美洲,26,17,9,6,6,0,20,11,9,0,0,0,0,0,0
110,私立,一般大學,1035,中國醫藥大學,學士班(日間),泰國,東協,3,1,2,2,0,2,1,1,0,0,0,0,0,0,0
110,私立,一般大學,1035,中國醫藥大學,學士班(日間),紐西蘭,其他亞洲地區,2,0,2,0,0,0,2,0,2,0,0,0,0,0,0
110,私立,一般大學,1035,中國醫藥大學,學士班(日間),智利,中南美洲,1,1,0,0,0,0,1,1,0,0,0,0,0,0,0
110,私立,一般大學,1035,中國醫藥大學,學士班(日間),越南社會主義共和國,東協,5,3,2,2,2,0,3,1,2,0,0,0,0,0,0
110,私立,一般大學,1035,中國醫藥大學,碩士班(日間),甘比亞共和國,非洲,1,1,0,1,1,0,0,0,0,0,0,0,0,0,0
110,私立,一般大學,1035,中國醫藥大學,碩士班(日間),奈及利亞聯邦共和國,非洲,1,1,0,1,1,0,0,0,0,0,0,0,0,0,0
110,私立,一般大學,1035,中國醫藥大學,碩士班(日間),泰國,東協,2,1,1,2,1,1,0,0,0,0,0,0,0,0,0
110,私立,一般大學,1035,中國醫藥大學,碩士班(日間),索馬利蘭共和國,非洲,1,0,1,1,0,1,0,0,0,0,0,0,0,0,0
110,私立,一般大學,1035,中國醫藥大學,碩士班(日間),越南社會主義共和國,東協,9,4,5,9,4,5,0,0,0,0,0,0,0,0,0
110,私立,一般大學,1035,中國醫藥大學,碩士班(日間),葉門共和國,其他亞洲地區,1,0,1,1,0,1,0,0,0,0,0,0,0,0,0
110,私立,一般大學,1035,中國醫藥大學,碩士班(日間),大陸地區,大陸地區,3,1,2,0,0,0,0,0,0,0,0,0,3,1,2
110,私立,一般大學,1035,中國醫藥大學,碩士班(日間),巴基斯坦,南亞,2,1,1,2,1,1,0,0,0,0,0,0,0,0,0
110,私立,一般大學,1035,中國醫藥大學,碩士班(日間),印度,南亞,2,2,0,2,2,0,0,0,0,0,0,0,0,0,0
110,私立,一般大學,1035,中國醫藥大學,碩士班(日間),印度尼西亞共和國,東協,2,0,2,2,0,2,0,0,0,0,0,0,0,0,0
110,私立,一般大學,1035,中國醫藥大學,碩士班(日間),尚比亞共和國,非洲,2,0,2,2,0,2,0,0,0,0,0,0,0,0,0
110,私立,一般大學,1035,中國醫藥大學,碩士班(日間),英國,歐洲,1,1,0,1,1,0,0,0,0,0,0,0,0,0,0
110,私立,一般大學,1035,中國醫藥大學,碩士班(日間),香港,港澳,3,1,2,0,0,0,0,0,0,3,1,2,0,0,0
110,私立,一般大學,1035,中國醫藥大學,碩士班(日間),烏克蘭,其他亞洲地區,1,1,0,1,1,0,0,0,0,0,0,0,0,0,0
110,私立,一般大學,1035,中國醫藥大學,碩士班(日間),馬來西亞,東協,6,1,5,3,0,3,3,1,2,0,0,0,0,0,0
110,私立,一般大學,1035,中國醫藥大學,碩士班(日間),馬拉威共和國,非洲,2,2,0,2,2,0,0,0,0,0,0,0,0,0,0
110,私立,一般大學,1035,中國醫藥大學,碩士班(日間),菲律賓共和國,東協,1,0,1,1,0,1,0,0,0,0,0,0,0,0,0
110,私立,一般大學,1035,中國醫藥大學,碩士班(日間),聖文森(及格瑞那丁),中南美洲,1,0,1,1,0,1,0,0,0,0,0,0,0,0,0
110,私立,一般大學,1035,中國醫藥大學,碩士班(日間),蒙古國,其他亞洲地區,2,0,2,2,0,2,0,0,0,0,0,0,0,0,0
110,私立,一般大學,1035,中國醫藥大學,碩士班(日間),澳門,港澳,1,0,1,0,0,0,0,0,0,1,0,1,0,0,0
110,私立,一般大學,1035,中國醫藥大學,博士班,印度,南亞,5,3,2,5,3,2,0,0,0,0,0,0,0,0,0
110,私立,一般大學,1035,中國醫藥大學,博士班,印度尼西亞共和國,東協,16,13,3,15,12,3,1,1,0,0,0,0,0,0,0
110,私立,一般大學,1035,中國醫藥大學,博士班,馬拉威共和國,非洲,3,3,0,3,3,0,0,0,0,0,0,0,0,0,0
110,私立,一般大學,1035,中國醫藥大學,博士班,智利,中南美洲,1,0,1,1,0,1,0,0,0,0,0,0,0,0,0
110,私立,一般大學,1035,中國醫藥大學,博士班,新加坡共和國,東協,1,0,1,1,0,1,0,0,0,0,0,0,0,0,0
110,私立,一般大學,1035,中國醫藥大學,博士班,大韓民國(南韓),其他亞洲地區,1,0,1,1,0,1,0,0,0,0,0,0,0,0,0
110,私立,一般大學,1035,中國醫藥大學,博士班,巴基斯坦,南亞,2,1,1,2,1,1,0,0,0,0,0,0,0,0,0
110,私立,一般大學,1035,中國醫藥大學,博士班,衣索比亞聯邦民主共和國,非洲,3,3,0,3,3,0,0,0,0,0,0,0,0,0,0
110,私立,一般大學,1035,中國醫藥大學,博士班,奈及利亞聯邦共和國,非洲,1,1,0,1,1,0,0,0,0,0,0,0,0,0,0
110,私立,一般大學,1035,中國醫藥大學,博士班,美國,北美洲,1,1,0,1,1,0,0,0,0,0,0,0,0,0,0
110,私立,一般大學,1035,中國醫藥大學,博士班,泰國,東協,4,1,3,4,1,3,0,0,0,0,0,0,0,0,0
110,私立,一般大學,1035,中國醫藥大學,博士班,秘魯共和國,中南美洲,1,0,1,1,0,1,0,0,0,0,0,0,0,0,0
110,私立,一般大學,1035,中國醫藥大學,博士班,馬來西亞,東協,2,1,1,0,0,0,2,1,1,0,0,0,0,0,0
110,私立,一般大學,1035,中國醫藥大學,博士班,菲律賓共和國,東協,1,0,1,1,0,1,0,0,0,0,0,0,0,0,0
110,私立,一般大學,1035,中國醫藥大學,博士班,越南社會主義共和國,東協,14,6,8,14,6,8,0,0,0,0,0,0,0,0,0
110,私立,一般大學,1035,中國醫藥大學,博士班,蒙古國,其他亞洲地區,2,0,2,2,0,2,0,0,0,0,0,0,0,0,0
110,私立,一般大學,1035,中國醫藥大學,博士班,墨西哥合眾國,中南美洲,2,1,1,2,1,1,0,0,0,0,0,0,0,0,0
110,私立,技專校院,1036,健行學校財團法人健行科技大學,學士班(日間),泰國,東協,4,0,4,4,0,4,0,0,0,0,0,0,0,0,0
110,私立,技專校院,1036,健行學校財團法人健行科技大學,學士班(日間),越南社會主義共和國,東協,252,88,164,215,71,144,37,17,20,0,0,0,0,0,0
110,私立,技專校院,1036,健行學校財團法人健行科技大學,學士班(日間),巴基斯坦,南亞,1,1,0,1,1,0,0,0,0,0,0,0,0,0,0
110,私立,技專校院,1036,健行學校財團法人健行科技大學,學士班(日間),日本,其他亞洲地區,2,1,1,2,1,1,0,0,0,0,0,0,0,0,0
110,私立,技專校院,1036,健行學校財團法人健行科技大學,學士班(日間),印度尼西亞共和國,東協,474,325,149,463,319,144,11,6,5,0,0,0,0,0,0
110,私立,技專校院,1036,健行學校財團法人健行科技大學,學士班(日間),香港,港澳,6,3,3,0,0,0,0,0,0,6,3,3,0,0,0
110,私立,技專校院,1036,健行學校財團法人健行科技大學,學士班(日間),馬來西亞,東協,21,12,9,16,8,8,5,4,1,0,0,0,0,0,0
110,私立,技專校院,1036,健行學校財團法人健行科技大學,學士班(日間),新加坡共和國,東協,1,1,0,1,1,0,0,0,0,0,0,0,0,0,0
110,私立,技專校院,1036,健行學校財團法人健行科技大學,學士班(日間),聖文森(及格瑞那丁),中南美洲,1,1,0,1,1,0,0,0,0,0,0,0,0,0,0
110,私立,技專校院,1036,健行學校財團法人健行科技大學,學士班(日間),緬甸,東協,1,1,0,0,0,0,1,1,0,0,0,0,0,0,0
110,私立,技專校院,1036,健行學校財團法人健行科技大學,碩士班(日間),馬來西亞,東協,1,1,0,1,1,0,0,0,0,0,0,0,0,0,0
110,私立,技專校院,1036,健行學校財團法人健行科技大學,碩士班(日間),甘比亞共和國,非洲,1,1,0,1,1,0,0,0,0,0,0,0,0,0,0
110,私立,技專校院,1036,健行學校財團法人健行科技大學,碩士班(日間),泰國,東協,9,3,6,9,3,6,0,0,0,0,0,0,0,0,0
110,私立,技專校院,1036,健行學校財團法人健行科技大學,碩士班(日間),越南社會主義共和國,東協,47,12,35,47,12,35,0,0,0,0,0,0,0,0,0
110,私立,技專校院,1037,正修學校財團法人正修科技大學,學士班(日間),日本,其他亞洲地區,1,1,0,1,1,0,0,0,0,0,0,0,0,0,0
110,私立,技專校院,1037,正修學校財團法人正修科技大學,學士班(日間),印度,南亞,1,1,0,1,1,0,0,0,0,0,0,0,0,0,0
110,私立,技專校院,1037,正修學校財團法人正修科技大學,學士班(日間),印度尼西亞共和國,東協,427,272,155,198,123,75,229,149,80,0,0,0,0,0,0
110,私立,技專校院,1037,正修學校財團法人正修科技大學,學士班(日間),柬埔寨王國,東協,7,5,2,0,0,0,7,5,2,0,0,0,0,0,0
110,私立,技專校院,1037,正修學校財團法人正修科技大學,學士班(日間),挪威王國,歐洲,1,0,1,1,0,1,0,0,0,0,0,0,0,0,0
110,私立,技專校院,1037,正修學校財團法人正修科技大學,學士班(日間),馬來西亞,東協,51,44,7,2,1,1,49,43,6,0,0,0,0,0,0
110,私立,技專校院,1037,正修學校財團法人正修科技大學,學士班(日間),新加坡共和國,東協,2,1,1,1,0,1,1,1,0,0,0,0,0,0,0
110,私立,技專校院,1037,正修學校財團法人正修科技大學,學士班(日間),大陸地區,大陸地區,1,1,0,0,0,0,0,0,0,0,0,0,1,1,0
110,私立,技專校院,1037,正修學校財團法人正修科技大學,學士班(日間),香港,港澳,9,5,4,0,0,0,0,0,0,9,5,4,0,0,0
110,私立,技專校院,1037,正修學校財團法人正修科技大學,學士班(日間),泰國,東協,16,8,8,3,3,0,13,5,8,0,0,0,0,0,0
110,私立,技專校院,1037,正修學校財團法人正修科技大學,學士班(日間),越南社會主義共和國,東協,516,264,252,28,10,18,488,254,234,0,0,0,0,0,0
110,私立,技專校院,1037,正修學校財團法人正修科技大學,學士班(日間),瑞士聯邦,歐洲,1,0,1,1,0,1,0,0,0,0,0,0,0,0,0
110,私立,技專校院,1037,正修學校財團法人正修科技大學,學士班(日間),緬甸,東協,15,10,5,0,0,0,15,10,5,0,0,0,0,0,0
110,私立,技專校院,1037,正修學校財團法人正修科技大學,碩士班(日間),印度,南亞,3,3,0,3,3,0,0,0,0,0,0,0,0,0,0
110,私立,技專校院,1037,正修學校財團法人正修科技大學,碩士班(日間),奈及利亞聯邦共和國,非洲,1,1,0,1,1,0,0,0,0,0,0,0,0,0,0
110,私立,技專校院,1037,正修學校財團法人正修科技大學,碩士班(日間),美國,北美洲,1,1,0,1,1,0,0,0,0,0,0,0,0,0,0
110,私立,技專校院,1037,正修學校財團法人正修科技大學,碩士班(日間),香港,港澳,1,0,1,0,0,0,0,0,0,1,0,1,0,0,0
110,私立,技專校院,1037,正修學校財團法人正修科技大學,碩士班(日間),越南社會主義共和國,東協,2,0,2,2,0,2,0,0,0,0,0,0,0,0,0
110,私立,技專校院,1037,正修學校財團法人正修科技大學,碩士班(日間),蒙古國,其他亞洲地區,1,1,0,1,1,0,0,0,0,0,0,0,0,0,0
110,私立,技專校院,1037,正修學校財團法人正修科技大學,碩士班(日間),印度尼西亞共和國,東協,5,4,1,5,4,1,0,0,0,0,0,0,0,0,0
110,私立,技專校院,1037,正修學校財團法人正修科技大學,碩士班(日間),泰國,東協,3,2,1,3,2,1,0,0,0,0,0,0,0,0,0
110,私立,技專校院,1037,正修學校財團法人正修科技大學,碩士班(日間),菲律賓共和國,東協,1,0,1,1,0,1,0,0,0,0,0,0,0,0,0
110,私立,技專校院,1037,正修學校財團法人正修科技大學,博士班,印度尼西亞共和國,東協,1,1,0,1,1,0,0,0,0,0,0,0,0,0,0
110,私立,技專校院,1038,萬能學校財團法人萬能科技大學,學士班(日間),印度尼西亞共和國,東協,63,21,42,42,12,30,21,9,12,0,0,0,0,0,0
110,私立,技專校院,1038,萬能學校財團法人萬能科技大學,學士班(日間),法國,歐洲,1,1,0,1,1,0,0,0,0,0,0,0,0,0,0
110,私立,技專校院,1038,萬能學校財團法人萬能科技大學,學士班(日間),泰國,東協,38,15,23,38,15,23,0,0,0,0,0,0,0,0,0
110,私立,技專校院,1038,萬能學校財團法人萬能科技大學,學士班(日間),馬來西亞,東協,139,101,38,124,90,34,15,11,4,0,0,0,0,0,0
110,私立,技專校院,1038,萬能學校財團法人萬能科技大學,學士班(日間),大陸地區,大陸地區,1,1,0,0,0,0,0,0,0,0,0,0,1,1,0
110,私立,技專校院,1038,萬能學校財團法人萬能科技大學,學士班(日間),巴拉圭,中南美洲,1,0,1,0,0,0,1,0,1,0,0,0,0,0,0
110,私立,技專校院,1038,萬能學校財團法人萬能科技大學,學士班(日間),日本,其他亞洲地區,3,2,1,3,2,1,0,0,0,0,0,0,0,0,0
110,私立,技專校院,1038,萬能學校財團法人萬能科技大學,學士班(日間),奈及利亞聯邦共和國,非洲,1,1,0,1,1,0,0,0,0,0,0,0,0,0,0
110,私立,技專校院,1038,萬能學校財團法人萬能科技大學,學士班(日間),美國,北美洲,1,1,0,1,1,0,0,0,0,0,0,0,0,0,0
110,私立,技專校院,1038,萬能學校財團法人萬能科技大學,學士班(日間),香港,港澳,63,30,33,0,0,0,0,0,0,63,30,33,0,0,0
110,私立,技專校院,1038,萬能學校財團法人萬能科技大學,學士班(日間),越南社會主義共和國,東協,285,105,180,196,68,128,89,37,52,0,0,0,0,0,0
110,私立,技專校院,1038,萬能學校財團法人萬能科技大學,學士班(日間),緬甸,東協,2,2,0,0,0,0,2,2,0,0,0,0,0,0,0
110,私立,技專校院,1038,萬能學校財團法人萬能科技大學,碩士班(日間),馬來西亞,東協,6,3,3,6,3,3,0,0,0,0,0,0,0,0,0
110,私立,技專校院,1038,萬能學校財團法人萬能科技大學,碩士班(日間),越南社會主義共和國,東協,1,0,1,1,0,1,0,0,0,0,0,0,0,0,0
110,私立,一般大學,1039,玄奘大學,學士班(日間),大陸地區,大陸地區,2,0,2,0,0,0,0,0,0,0,0,0,2,0,2
110,私立,一般大學,1039,玄奘大學,學士班(日間),印度尼西亞共和國,東協,1,1,0,1,1,0,0,0,0,0,0,0,0,0,0
110,私立,一般大學,1039,玄奘大學,學士班(日間),南非共和國,非洲,1,1,0,1,1,0,0,0,0,0,0,0,0,0,0
110,私立,一般大學,1039,玄奘大學,學士班(日間),香港,港澳,84,39,45,0,0,0,0,0,0,84,39,45,0,0,0
110,私立,一般大學,1039,玄奘大學,學士班(日間),泰國,東協,1,0,1,1,0,1,0,0,0,0,0,0,0,0,0
110,私立,一般大學,1039,玄奘大學,學士班(日間),馬來西亞,東協,47,22,25,18,6,12,29,16,13,0,0,0,0,0,0
110,私立,一般大學,1039,玄奘大學,學士班(日間),墨西哥合眾國,中南美洲,1,1,0,1,1,0,0,0,0,0,0,0,0,0,0
110,私立,一般大學,1039,玄奘大學,學士班(日間),印度,南亞,7,5,2,7,5,2,0,0,0,0,0,0,0,0,0
110,私立,一般大學,1039,玄奘大學,學士班(日間),越南社會主義共和國,東協,16,4,12,16,4,12,0,0,0,0,0,0,0,0,0
110,私立,一般大學,1039,玄奘大學,碩士班(日間),越南社會主義共和國,東協,6,0,6,6,0,6,0,0,0,0,0,0,0,0,0
110,私立,一般大學,1039,玄奘大學,碩士班(日間),澳門,港澳,1,0,1,0,0,0,0,0,0,1,0,1,0,0,0
110,私立,一般大學,1039,玄奘大學,碩士班(日間),大陸地區,大陸地區,2,2,0,0,0,0,0,0,0,0,0,0,2,2,0
110,私立,一般大學,1039,玄奘大學,碩士班(日間),印度,南亞,9,5,4,9,5,4,0,0,0,0,0,0,0,0,0
110,私立,一般大學,1039,玄奘大學,碩士班(日間),香港,港澳,7,5,2,0,0,0,0,0,0,7,5,2,0,0,0
110,私立,一般大學,1039,玄奘大學,碩士班(日間),馬來西亞,東協,7,2,5,6,2,4,1,0,1,0,0,0,0,0,0
110,私立,技專校院,1040,建國科技大學,學士班(日間),印度尼西亞共和國,東協,90,74,16,88,72,16,2,2,0,0,0,0,0,0,0
110,私立,技專校院,1040,建國科技大學,學士班(日間),馬來西亞,東協,10,7,3,6,5,1,4,2,2,0,0,0,0,0,0
110,私立,技專校院,1040,建國科技大學,學士班(日間),蒙古國,其他亞洲地區,12,7,5,12,7,5,0,0,0,0,0,0,0,0,0
110,私立,技專校院,1040,建國科技大學,學士班(日間),日本,其他亞洲地區,4,3,1,4,3,1,0,0,0,0,0,0,0,0,0
110,私立,技專校院,1040,建國科技大學,學士班(日間),香港,港澳,2,0,2,0,0,0,0,0,0,2,0,2,0,0,0
110,私立,技專校院,1040,建國科技大學,學士班(日間),越南社會主義共和國,東協,78,54,24,76,53,23,2,1,1,0,0,0,0,0,0
110,私立,技專校院,1040,建國科技大學,學士班(日間),緬甸,東協,3,2,1,3,2,1,0,0,0,0,0,0,0,0,0
110,私立,技專校院,1040,建國科技大學,碩士班(日間),馬來西亞,東協,1,1,0,1,1,0,0,0,0,0,0,0,0,0,0
110,私立,技專校院,1040,建國科技大學,碩士班(日間),越南社會主義共和國,東協,2,0,2,2,0,2,0,0,0,0,0,0,0,0,0
110,私立,技專校院,1040,建國科技大學,碩士班(日間),蒙古國,其他亞洲地區,4,2,2,4,2,2,0,0,0,0,0,0,0,0,0
110,私立,技專校院,1041,明志科技大學,學士班(日間),香港,港澳,3,3,0,0,0,0,0,0,0,3,3,0,0,0,0
110,私立,技專校院,1041,明志科技大學,學士班(日間),越南社會主義共和國,東協,1,1,0,0,0,0,1,1,0,0,0,0,0,0,0
110,私立,技專校院,1041,明志科技大學,學士班(日間),印度尼西亞共和國,東協,1,0,1,0,0,0,1,0,1,0,0,0,0,0,0
110,私立,技專校院,1041,明志科技大學,學士班(日間),馬來西亞,東協,6,5,1,0,0,0,6,5,1,0,0,0,0,0,0
110,私立,技專校院,1041,明志科技大學,碩士班(日間),大陸地區,大陸地區,4,3,1,0,0,0,0,0,0,0,0,0,4,3,1
110,私立,技專校院,1041,明志科技大學,碩士班(日間),巴西聯邦共和國,中南美洲,1,1,0,1,1,0,0,0,0,0,0,0,0,0,0
110,私立,技專校院,1041,明志科技大學,碩士班(日間),加拿大,北美洲,1,0,1,0,0,0,1,0,1,0,0,0,0,0,0
110,私立,技專校院,1041,明志科技大學,碩士班(日間),布吉納法索,非洲,1,1,0,1,1,0,0,0,0,0,0,0,0,0,0
110,私立,技專校院,1041,明志科技大學,碩士班(日間),印度尼西亞共和國,東協,18,15,3,17,15,2,1,0,1,0,0,0,0,0,0
110,私立,技專校院,1041,明志科技大學,碩士班(日間),巴基斯坦,南亞,3,2,1,3,2,1,0,0,0,0,0,0,0,0,0
110,私立,技專校院,1041,明志科技大學,碩士班(日間),印度,南亞,6,5,1,6,5,1,0,0,0,0,0,0,0,0,0
110,私立,技專校院,1041,明志科技大學,碩士班(日間),美國,北美洲,2,0,2,2,0,2,0,0,0,0,0,0,0,0,0
110,私立,技專校院,1041,明志科技大學,碩士班(日間),香港,港澳,1,1,0,0,0,0,0,0,0,1,1,0,0,0,0
110,私立,技專校院,1041,明志科技大學,碩士班(日間),泰國,東協,9,2,7,9,2,7,0,0,0,0,0,0,0,0,0
110,私立,技專校院,1041,明志科技大學,碩士班(日間),越南社會主義共和國,東協,25,9,16,25,9,16,0,0,0,0,0,0,0,0,0
110,私立,技專校院,1041,明志科技大學,碩士班(日間),新加坡共和國,東協,1,1,0,1,1,0,0,0,0,0,0,0,0,0,0
110,私立,技專校院,1041,明志科技大學,博士班,巴基斯坦,南亞,4,2,2,4,2,2,0,0,0,0,0,0,0,0,0
110,私立,技專校院,1041,明志科技大學,博士班,埃及阿拉伯共和國,非洲,1,1,0,1,1,0,0,0,0,0,0,0,0,0,0
110,私立,技專校院,1041,明志科技大學,博士班,泰國,東協,1,1,0,1,1,0,0,0,0,0,0,0,0,0,0
110,私立,技專校院,1041,明志科技大學,博士班,菲律賓共和國,東協,1,0,1,1,0,1,0,0,0,0,0,0,0,0,0
110,私立,技專校院,1041,明志科技大學,博士班,印度,南亞,9,7,2,9,7,2,0,0,0,0,0,0,0,0,0
110,私立,技專校院,1041,明志科技大學,博士班,印度尼西亞共和國,東協,2,0,2,2,0,2,0,0,0,0,0,0,0,0,0
110,私立,技專校院,1041,明志科技大學,博士班,衣索比亞聯邦民主共和國,非洲,9,9,0,9,9,0,0,0,0,0,0,0,0,0,0
110,私立,技專校院,1041,明志科技大學,博士班,越南社會主義共和國,東協,2,1,1,2,1,1,0,0,0,0,0,0,0,0,0
110,私立,技專校院,1042,高苑科技大學,學士班(日間),日本,其他亞洲地區,1,1,0,1,1,0,0,0,0,0,0,0,0,0,0
110,私立,技專校院,1042,高苑科技大學,學士班(日間),印度尼西亞共和國,東協,345,220,125,258,175,83,87,45,42,0,0,0,0,0,0
110,私立,技專校院,1042,高苑科技大學,學士班(日間),柬埔寨王國,東協,15,10,5,15,10,5,0,0,0,0,0,0,0,0,0
110,私立,技專校院,1042,高苑科技大學,學士班(日間),香港,港澳,2,2,0,0,0,0,0,0,0,2,2,0,0,0,0
110,私立,技專校院,1042,高苑科技大學,學士班(日間),斯里蘭卡民主社會主義共和國,南亞,2,1,1,2,1,1,0,0,0,0,0,0,0,0,0
110,私立,技專校院,1042,高苑科技大學,學士班(日間),緬甸,東協,5,2,3,5,2,3,0,0,0,0,0,0,0,0,0
110,私立,技專校院,1042,高苑科技大學,學士班(日間),馬來西亞,東協,8,2,6,6,1,5,2,1,1,0,0,0,0,0,0
110,私立,技專校院,1042,高苑科技大學,學士班(日間),菲律賓共和國,東協,165,80,85,165,80,85,0,0,0,0,0,0,0,0,0
110,私立,技專校院,1042,高苑科技大學,學士班(日間),越南社會主義共和國,東協,418,191,227,405,187,218,13,4,9,0,0,0,0,0,0
110,私立,技專校院,1042,高苑科技大學,學士班(日間),澳門,港澳,1,0,1,0,0,0,0,0,0,1,0,1,0,0,0
110,私立,技專校院,1042,高苑科技大學,碩士班(日間),菲律賓共和國,東協,1,1,0,1,1,0,0,0,0,0,0,0,0,0,0
110,私立,技專校院,1042,高苑科技大學,碩士班(日間),越南社會主義共和國,東協,11,3,8,9,2,7,2,1,1,0,0,0,0,0,0
110,私立,技專校院,1042,高苑科技大學,碩士班(日間),緬甸,東協,1,0,1,1,0,1,0,0,0,0,0,0,0,0,0
110,私立,技專校院,1042,高苑科技大學,碩士班(日間),印度尼西亞共和國,東協,4,1,3,1,0,1,3,1,2,0,0,0,0,0,0
110,私立,技專校院,1042,高苑科技大學,碩士班(日間),南蘇丹共和國,非洲,1,1,0,1,1,0,0,0,0,0,0,0,0,0,0
110,私立,技專校院,1042,高苑科技大學,碩士班(日間),柬埔寨王國,東協,1,1,0,1,1,0,0,0,0,0,0,0,0,0,0
110,私立,技專校院,1042,高苑科技大學,碩士班(日間),馬來西亞,東協,1,1,0,1,1,0,0,0,0,0,0,0,0,0,0
110,私立,技專校院,1043,大仁科技大學,學士班(日間),大韓民國(南韓),其他亞洲地區,1,0,1,1,0,1,0,0,0,0,0,0,0,0,0
110,私立,技專校院,1043,大仁科技大學,學士班(日間),日本,其他亞洲地區,2,1,1,1,1,0,1,0,1,0,0,0,0,0,0
110,私立,技專校院,1043,大仁科技大學,學士班(日間),印度尼西亞共和國,東協,7,3,4,0,0,0,7,3,4,0,0,0,0,0,0
110,私立,技專校院,1043,大仁科技大學,學士班(日間),香港,港澳,103,37,66,0,0,0,0,0,0,103,37,66,0,0,0
110,私立,技專校院,1043,大仁科技大學,學士班(日間),馬來西亞,東協,38,23,15,4,2,2,34,21,13,0,0,0,0,0,0
110,私立,技專校院,1043,大仁科技大學,學士班(日間),緬甸,東協,1,0,1,0,0,0,1,0,1,0,0,0,0,0,0
110,私立,技專校院,1043,大仁科技大學,學士班(日間),澳門,港澳,5,2,3,0,0,0,0,0,0,5,2,3,0,0,0
110,私立,技專校院,1043,大仁科技大學,學士班(日間),美國,北美洲,1,1,0,0,0,0,1,1,0,0,0,0,0,0,0
110,私立,技專校院,1043,大仁科技大學,學士班(日間),泰國,東協,2,2,0,0,0,0,2,2,0,0,0,0,0,0,0
110,私立,技專校院,1043,大仁科技大學,學士班(日間),越南社會主義共和國,東協,57,24,33,2,1,1,55,23,32,0,0,0,0,0,0
110,私立,技專校院,1043,大仁科技大學,碩士班(日間),香港,港澳,1,1,0,0,0,0,0,0,0,1,1,0,0,0,0
110,私立,技專校院,1044,聖約翰科技大學,五專,印度尼西亞共和國,東協,1,0,1,1,0,1,0,0,0,0,0,0,0,0,0
110,私立,技專校院,1044,聖約翰科技大學,學士班(日間),越南社會主義共和國,東協,72,43,29,72,43,29,0,0,0,0,0,0,0,0,0
110,私立,技專校院,1044,聖約翰科技大學,學士班(日間),大陸地區,大陸地區,5,3,2,0,0,0,0,0,0,0,0,0,5,3,2
110,私立,技專校院,1044,聖約翰科技大學,學士班(日間),印度尼西亞共和國,東協,1,0,1,1,0,1,0,0,0,0,0,0,0,0,0
110,私立,技專校院,1044,聖約翰科技大學,學士班(日間),香港,港澳,25,18,7,0,0,0,0,0,0,25,18,7,0,0,0
110,私立,技專校院,1044,聖約翰科技大學,學士班(日間),泰國,東協,1,1,0,0,0,0,1,1,0,0,0,0,0,0,0
110,私立,技專校院,1044,聖約翰科技大學,學士班(日間),馬來西亞,東協,130,76,54,108,64,44,22,12,10,0,0,0,0,0,0
110,私立,技專校院,1044,聖約翰科技大學,碩士班(日間),香港,港澳,5,3,2,0,0,0,0,0,0,5,3,2,0,0,0
110,私立,技專校院,1044,聖約翰科技大學,碩士班(日間),馬來西亞,東協,18,14,4,18,14,4,0,0,0,0,0,0,0,0,0
110,私立,技專校院,1045,嶺東科技大學,學士班(日間),印度尼西亞共和國,東協,2,0,2,2,0,2,0,0,0,0,0,0,0,0,0
110,私立,技專校院,1045,嶺東科技大學,學士班(日間),馬來西亞,東協,41,21,20,32,16,16,9,5,4,0,0,0,0,0,0
110,私立,技專校院,1045,嶺東科技大學,學士班(日間),越南社會主義共和國,東協,7,2,5,7,2,5,0,0,0,0,0,0,0,0,0
110,私立,技專校院,1045,嶺東科技大學,學士班(日間),大陸地區,大陸地區,6,3,3,0,0,0,0,0,0,0,0,0,6,3,3
110,私立,技專校院,1045,嶺東科技大學,學士班(日間),香港,港澳,8,4,4,0,0,0,0,0,0,8,4,4,0,0,0
110,私立,技專校院,1045,嶺東科技大學,學士班(日間),泰國,東協,2,0,2,0,0,0,2,0,2,0,0,0,0,0,0
110,私立,技專校院,1045,嶺東科技大學,學士班(日間),澳門,港澳,2,2,0,0,0,0,0,0,0,2,2,0,0,0,0
110,私立,技專校院,1045,嶺東科技大學,碩士班(日間),大陸地區,大陸地區,5,3,2,0,0,0,0,0,0,0,0,0,5,3,2
110,私立,技專校院,1045,嶺東科技大學,碩士班(日間),伊朗伊斯蘭共和國,其他亞洲地區,2,0,2,2,0,2,0,0,0,0,0,0,0,0,0
110,私立,技專校院,1045,嶺東科技大學,碩士班(日間),美國,北美洲,1,0,1,1,0,1,0,0,0,0,0,0,0,0,0
110,私立,技專校院,1045,嶺東科技大學,碩士班(日間),香港,港澳,1,1,0,0,0,0,0,0,0,1,1,0,0,0,0
110,私立,技專校院,1045,嶺東科技大學,碩士班(日間),大韓民國(南韓),其他亞洲地區,1,1,0,1,1,0,0,0,0,0,0,0,0,0,0
110,私立,技專校院,1045,嶺東科技大學,碩士班(日間),馬來西亞,東協,4,3,1,4,3,1,0,0,0,0,0,0,0,0,0
110,私立,技專校院,1046,中國科技大學,學士班(日間),大韓民國(南韓),其他亞洲地區,1,1,0,1,1,0,0,0,0,0,0,0,0,0,0
110,私立,技專校院,1046,中國科技大學,學士班(日間),巴拿馬共和國,中南美洲,1,0,1,1,0,1,0,0,0,0,0,0,0,0,0
110,私立,技專校院,1046,中國科技大學,學士班(日間),日本,其他亞洲地區,16,7,9,16,7,9,0,0,0,0,0,0,0,0,0
110,私立,技專校院,1046,中國科技大學,學士班(日間),印度尼西亞共和國,東協,7,5,2,3,3,0,4,2,2,0,0,0,0,0,0
110,私立,技專校院,1046,中國科技大學,學士班(日間),委內瑞拉共和國,中南美洲,1,0,1,1,0,1,0,0,0,0,0,0,0,0,0
110,私立,技專校院,1046,中國科技大學,學士班(日間),泰國,東協,1,0,1,1,0,1,0,0,0,0,0,0,0,0,0
110,私立,技專校院,1046,中國科技大學,學士班(日間),馬來西亞,東協,84,44,40,62,29,33,22,15,7,0,0,0,0,0,0
110,私立,技專校院,1046,中國科技大學,學士班(日間),菲律賓共和國,東協,1,1,0,0,0,0,1,1,0,0,0,0,0,0,0
110,私立,技專校院,1046,中國科技大學,學士班(日間),寮人民民主共和國(寮國),東協,1,0,1,1,0,1,0,0,0,0,0,0,0,0,0
110,私立,技專校院,1046,中國科技大學,學士班(日間),大陸地區,大陸地區,14,5,9,0,0,0,0,0,0,0,0,0,14,5,9
110,私立,技專校院,1046,中國科技大學,學士班(日間),美國,北美洲,1,1,0,1,1,0,0,0,0,0,0,0,0,0,0
110,私立,技專校院,1046,中國科技大學,學士班(日間),香港,港澳,16,8,8,0,0,0,0,0,0,16,8,8,0,0,0
110,私立,技專校院,1046,中國科技大學,學士班(日間),越南社會主義共和國,東協,86,13,73,82,13,69,4,0,4,0,0,0,0,0,0
110,私立,技專校院,1046,中國科技大學,學士班(日間),緬甸,東協,2,2,0,0,0,0,2,2,0,0,0,0,0,0,0
110,私立,技專校院,1046,中國科技大學,學士班(日間),澳門,港澳,4,2,2,0,0,0,0,0,0,4,2,2,0,0,0
110,私立,技專校院,1046,中國科技大學,碩士班(日間),大陸地區,大陸地區,3,1,2,0,0,0,0,0,0,0,0,0,3,1,2
110,私立,技專校院,1046,中國科技大學,碩士班(日間),美國,北美洲,1,1,0,1,1,0,0,0,0,0,0,0,0,0,0
110,私立,技專校院,1046,中國科技大學,碩士班(日間),香港,港澳,1,1,0,0,0,0,0,0,0,1,1,0,0,0,0
110,私立,技專校院,1046,中國科技大學,碩士班(日間),越南社會主義共和國,東協,18,7,11,18,7,11,0,0,0,0,0,0,0,0,0
110,私立,技專校院,1046,中國科技大學,碩士班(日間),馬來西亞,東協,8,3,5,8,3,5,0,0,0,0,0,0,0,0,0
110,私立,技專校院,1047,中臺科技大學,二專(日間),越南社會主義共和國,東協,16,6,10,16,6,10,0,0,0,0,0,0,0,0,0
110,私立,技專校院,1047,中臺科技大學,學士班(日間),大陸地區,大陸地區,1,0,1,0,0,0,0,0,0,0,0,0,1,0,1
110,私立,技專校院,1047,中臺科技大學,學士班(日間),印度尼西亞共和國,東協,2,0,2,0,0,0,2,0,2,0,0,0,0,0,0
110,私立,技專校院,1047,中臺科技大學,學士班(日間),香港,港澳,6,4,2,0,0,0,0,0,0,6,4,2,0,0,0
110,私立,技專校院,1047,中臺科技大學,學士班(日間),馬來西亞,東協,13,6,7,7,4,3,6,2,4,0,0,0,0,0,0
110,私立,技專校院,1047,中臺科技大學,學士班(日間),越南社會主義共和國,東協,1,0,1,1,0,1,0,0,0,0,0,0,0,0,0
110,私立,技專校院,1047,中臺科技大學,學士班(日間),澳門,港澳,1,1,0,0,0,0,0,0,0,1,1,0,0,0,0
110,私立,技專校院,1047,中臺科技大學,碩士班(日間),阿根廷,中南美洲,1,0,1,1,0,1,0,0,0,0,0,0,0,0,0
110,私立,技專校院,1047,中臺科技大學,碩士班(日間),印度,南亞,1,0,1,1,0,1,0,0,0,0,0,0,0,0,0
110,私立,一般大學,1048,亞洲大學,學士班(日間),土耳其共和國,其他亞洲地區,1,1,0,1,1,0,0,0,0,0,0,0,0,0,0
110,私立,一般大學,1048,亞洲大學,學士班(日間),大韓民國(南韓),其他亞洲地區,1,1,0,1,1,0,0,0,0,0,0,0,0,0,0
110,私立,一般大學,1048,亞洲大學,學士班(日間),尼泊爾聯邦民主共和國,南亞,1,1,0,1,1,0,0,0,0,0,0,0,0,0,0
110,私立,一般大學,1048,亞洲大學,學士班(日間),俄羅斯聯邦,其他亞洲地區,1,0,1,1,0,1,0,0,0,0,0,0,0,0,0
110,私立,一般大學,1048,亞洲大學,學士班(日間),南非共和國,非洲,1,1,0,1,1,0,0,0,0,0,0,0,0,0,0
110,私立,一般大學,1048,亞洲大學,學士班(日間),英國,歐洲,1,1,0,1,1,0,0,0,0,0,0,0,0,0,0
110,私立,一般大學,1048,亞洲大學,學士班(日間),紐西蘭,其他亞洲地區,1,1,0,0,0,0,1,1,0,0,0,0,0,0,0
110,私立,一般大學,1048,亞洲大學,學士班(日間),馬來西亞,東協,15,8,7,5,3,2,10,5,5,0,0,0,0,0,0
110,私立,一般大學,1048,亞洲大學,學士班(日間),越南社會主義共和國,東協,21,12,9,21,12,9,0,0,0,0,0,0,0,0,0
110,私立,一般大學,1048,亞洲大學,學士班(日間),蒙古國,其他亞洲地區,34,14,20,34,14,20,0,0,0,0,0,0,0,0,0
110,私立,一般大學,1048,亞洲大學,學士班(日間),澳門,港澳,12,6,6,0,0,0,0,0,0,12,6,6,0,0,0
110,私立,一般大學,1048,亞洲大學,學士班(日間),賴索托王國,非洲,1,0,1,1,0,1,0,0,0,0,0,0,0,0,0
110,私立,一般大學,1048,亞洲大學,學士班(日間),大陸地區,大陸地區,25,13,12,0,0,0,0,0,0,0,0,0,25,13,12
110,私立,一般大學,1048,亞洲大學,學士班(日間),日本,其他亞洲地區,22,8,14,20,7,13,2,1,1,0,0,0,0,0,0
110,私立,一般大學,1048,亞洲大學,學士班(日間),史瓦帝尼王國,非洲,2,2,0,2,2,0,0,0,0,0,0,0,0,0,0
110,私立,一般大學,1048,亞洲大學,學士班(日間),印度尼西亞共和國,東協,50,28,22,42,26,16,8,2,6,0,0,0,0,0,0
110,私立,一般大學,1048,亞洲大學,學士班(日間),美國,北美洲,1,0,1,1,0,1,0,0,0,0,0,0,0,0,0
110,私立,一般大學,1048,亞洲大學,學士班(日間),香港,港澳,75,32,43,0,0,0,0,0,0,75,32,43,0,0,0
110,私立,一般大學,1048,亞洲大學,碩士班(日間),大陸地區,大陸地區,7,6,1,0,0,0,0,0,0,0,0,0,7,6,1
110,私立,一般大學,1048,亞洲大學,碩士班(日間),日本,其他亞洲地區,2,1,1,2,1,1,0,0,0,0,0,0,0,0,0
110,私立,一般大學,1048,亞洲大學,碩士班(日間),甘比亞共和國,非洲,1,1,0,1,1,0,0,0,0,0,0,0,0,0,0
110,私立,一般大學,1048,亞洲大學,碩士班(日間),印度,南亞,10,5,5,10,5,5,0,0,0,0,0,0,0,0,0
110,私立,一般大學,1048,亞洲大學,碩士班(日間),印度尼西亞共和國,東協,17,9,8,17,9,8,0,0,0,0,0,0,0,0,0
110,私立,一般大學,1048,亞洲大學,碩士班(日間),香港,港澳,4,2,2,0,0,0,0,0,0,4,2,2,0,0,0
110,私立,一般大學,1048,亞洲大學,碩士班(日間),泰國,東協,2,0,2,2,0,2,0,0,0,0,0,0,0,0,0
110,私立,一般大學,1048,亞洲大學,碩士班(日間),巴基斯坦,南亞,1,1,0,1,1,0,0,0,0,0,0,0,0,0,0
110,私立,一般大學,1048,亞洲大學,碩士班(日間),坦尚尼亞聯合共和國,非洲,1,1,0,1,1,0,0,0,0,0,0,0,0,0,0
110,私立,一般大學,1048,亞洲大學,碩士班(日間),美國,北美洲,1,0,1,1,0,1,0,0,0,0,0,0,0,0,0
110,私立,一般大學,1048,亞洲大學,碩士班(日間),英國,歐洲,1,1,0,1,1,0,0,0,0,0,0,0,0,0,0
110,私立,一般大學,1048,亞洲大學,碩士班(日間),哥倫比亞共和國,中南美洲,2,0,2,2,0,2,0,0,0,0,0,0,0,0,0
110,私立,一般大學,1048,亞洲大學,碩士班(日間),馬來西亞,東協,5,3,2,2,2,0,3,1,2,0,0,0,0,0,0
110,私立,一般大學,1048,亞洲大學,碩士班(日間),菲律賓共和國,東協,1,0,1,1,0,1,0,0,0,0,0,0,0,0,0
110,私立,一般大學,1048,亞洲大學,碩士班(日間),越南社會主義共和國,東協,2,0,2,2,0,2,0,0,0,0,0,0,0,0,0
110,私立,一般大學,1048,亞洲大學,碩士班(日間),蒙古國,其他亞洲地區,7,1,6,7,1,6,0,0,0,0,0,0,0,0,0
110,私立,一般大學,1048,亞洲大學,碩士班(日間),摩洛哥王國,非洲,1,1,0,1,1,0,0,0,0,0,0,0,0,0,0
110,私立,一般大學,1048,亞洲大學,碩士班(日間),澳門,港澳,6,3,3,0,0,0,0,0,0,6,3,3,0,0,0
110,私立,一般大學,1048,亞洲大學,博士班,日本,其他亞洲地區,1,1,0,1,1,0,0,0,0,0,0,0,0,0,0
110,私立,一般大學,1048,亞洲大學,博士班,印度,南亞,6,5,1,6,5,1,0,0,0,0,0,0,0,0,0
110,私立,一般大學,1048,亞洲大學,博士班,美國,北美洲,1,1,0,1,1,0,0,0,0,0,0,0,0,0,0
110,私立,一般大學,1048,亞洲大學,博士班,索馬利蘭共和國,非洲,1,1,0,1,1,0,0,0,0,0,0,0,0,0,0
110,私立,一般大學,1048,亞洲大學,博士班,蒙古國,其他亞洲地區,1,1,0,1,1,0,0,0,0,0,0,0,0,0,0
110,私立,一般大學,1048,亞洲大學,博士班,大陸地區,大陸地區,6,2,4,0,0,0,0,0,0,0,0,0,6,2,4
110,私立,一般大學,1048,亞洲大學,博士班,印度尼西亞共和國,東協,37,23,14,37,23,14,0,0,0,0,0,0,0,0,0
110,私立,一般大學,1048,亞洲大學,博士班,泰國,東協,4,2,2,4,2,2,0,0,0,0,0,0,0,0,0
110,私立,一般大學,1048,亞洲大學,博士班,越南社會主義共和國,東協,9,4,5,9,4,5,0,0,0,0,0,0,0,0,0
110,私立,一般大學,1049,開南大學,學士班(日間),大韓民國(南韓),其他亞洲地區,2,1,1,2,1,1,0,0,0,0,0,0,0,0,0
110,私立,一般大學,1049,開南大學,學士班(日間),帛琉共和國,其他亞洲地區,2,1,1,2,1,1,0,0,0,0,0,0,0,0,0
110,私立,一般大學,1049,開南大學,學士班(日間),香港,港澳,15,10,5,0,0,0,0,0,0,15,10,5,0,0,0
110,私立,一般大學,1049,開南大學,學士班(日間),海地共和國,中南美洲,5,4,1,5,4,1,0,0,0,0,0,0,0,0,0
110,私立,一般大學,1049,開南大學,學士班(日間),菲律賓共和國,東協,1,1,0,1,1,0,0,0,0,0,0,0,0,0,0
110,私立,一般大學,1049,開南大學,學士班(日間),越南社會主義共和國,東協,319,87,232,285,82,203,34,5,29,0,0,0,0,0,0
110,私立,一般大學,1049,開南大學,學士班(日間),蒙古國,其他亞洲地區,7,3,4,7,3,4,0,0,0,0,0,0,0,0,0
110,私立,一般大學,1049,開南大學,學士班(日間),澳門,港澳,2,2,0,0,0,0,0,0,0,2,2,0,0,0,0
110,私立,一般大學,1049,開南大學,學士班(日間),日本,其他亞洲地區,128,51,77,128,51,77,0,0,0,0,0,0,0,0,0
110,私立,一般大學,1049,開南大學,學士班(日間),印度尼西亞共和國,東協,5,0,5,4,0,4,1,0,1,0,0,0,0,0,0
110,私立,一般大學,1049,開南大學,學士班(日間),南非共和國,非洲,1,1,0,1,1,0,0,0,0,0,0,0,0,0,0
110,私立,一般大學,1049,開南大學,學士班(日間),泰國,東協,10,0,10,9,0,9,1,0,1,0,0,0,0,0,0
110,私立,一般大學,1049,開南大學,學士班(日間),馬來西亞,東協,5,4,1,2,2,0,3,2,1,0,0,0,0,0,0
110,私立,一般大學,1049,開南大學,學士班(日間),寮人民民主共和國(寮國),東協,13,6,7,13,6,7,0,0,0,0,0,0,0,0,0
110,私立,一般大學,1049,開南大學,碩士班(日間),柬埔寨王國,東協,1,1,0,1,1,0,0,0,0,0,0,0,0,0,0
110,私立,一般大學,1049,開南大學,碩士班(日間),泰國,東協,1,0,1,1,0,1,0,0,0,0,0,0,0,0,0
110,私立,一般大學,1049,開南大學,碩士班(日間),馬來西亞,東協,1,0,1,1,0,1,0,0,0,0,0,0,0,0,0
110,私立,一般大學,1049,開南大學,碩士班(日間),菲律賓共和國,東協,12,0,12,12,0,12,0,0,0,0,0,0,0,0,0
110,私立,一般大學,1049,開南大學,碩士班(日間),美國,北美洲,2,2,0,2,2,0,0,0,0,0,0,0,0,0,0
110,私立,一般大學,1049,開南大學,碩士班(日間),香港,港澳,2,1,1,0,0,0,0,0,0,2,1,1,0,0,0
110,私立,一般大學,1049,開南大學,碩士班(日間),越南社會主義共和國,東協,27,8,19,26,8,18,1,0,1,0,0,0,0,0,0
110,私立,一般大學,1049,開南大學,碩士班(日間),蒙古國,其他亞洲地區,1,1,0,1,1,0,0,0,0,0,0,0,0,0,0
110,私立,一般大學,1050,佛光大學,學士班(日間),大韓民國(南韓),其他亞洲地區,1,1,0,1,1,0,0,0,0,0,0,0,0,0,0
110,私立,一般大學,1050,佛光大學,學士班(日間),日本,其他亞洲地區,3,2,1,1,1,0,2,1,1,0,0,0,0,0,0
110,私立,一般大學,1050,佛光大學,學士班(日間),印度尼西亞共和國,東協,4,3,1,0,0,0,4,3,1,0,0,0,0,0,0
110,私立,一般大學,1050,佛光大學,學士班(日間),美國,北美洲,1,1,0,0,0,0,1,1,0,0,0,0,0,0,0
110,私立,一般大學,1050,佛光大學,學士班(日間),馬來西亞,東協,58,30,28,3,0,3,55,30,25,0,0,0,0,0,0
110,私立,一般大學,1050,佛光大學,學士班(日間),義大利共和國,歐洲,1,0,1,1,0,1,0,0,0,0,0,0,0,0,0
110,私立,一般大學,1050,佛光大學,學士班(日間),印度,南亞,3,3,0,3,3,0,0,0,0,0,0,0,0,0,0
110,私立,一般大學,1050,佛光大學,學士班(日間),阿根廷,中南美洲,2,1,1,0,0,0,2,1,1,0,0,0,0,0,0
110,私立,一般大學,1050,佛光大學,學士班(日間),香港,港澳,13,9,4,0,0,0,0,0,0,13,9,4,0,0,0
110,私立,一般大學,1050,佛光大學,學士班(日間),越南社會主義共和國,東協,26,11,15,26,11,15,0,0,0,0,0,0,0,0,0
110,私立,一般大學,1050,佛光大學,學士班(日間),新加坡共和國,東協,1,0,1,1,0,1,0,0,0,0,0,0,0,0,0
110,私立,一般大學,1050,佛光大學,學士班(日間),緬甸,東協,6,5,1,3,3,0,3,2,1,0,0,0,0,0,0
110,私立,一般大學,1050,佛光大學,碩士班(日間),大陸地區,大陸地區,1,1,0,0,0,0,0,0,0,0,0,0,1,1,0
110,私立,一般大學,1050,佛光大學,碩士班(日間),印度,南亞,1,0,1,1,0,1,0,0,0,0,0,0,0,0,0
110,私立,一般大學,1050,佛光大學,碩士班(日間),阿根廷,中南美洲,1,0,1,0,0,0,1,0,1,0,0,0,0,0,0
110,私立,一般大學,1050,佛光大學,碩士班(日間),香港,港澳,6,3,3,0,0,0,0,0,0,6,3,3,0,0,0
110,私立,一般大學,1050,佛光大學,碩士班(日間),越南社會主義共和國,東協,12,7,5,12,7,5,0,0,0,0,0,0,0,0,0
110,私立,一般大學,1050,佛光大學,碩士班(日間),新加坡共和國,東協,1,0,1,1,0,1,0,0,0,0,0,0,0,0,0
110,私立,一般大學,1050,佛光大學,碩士班(日間),緬甸,東協,1,0,1,1,0,1,0,0,0,0,0,0,0,0,0
110,私立,一般大學,1050,佛光大學,碩士班(日間),大韓民國(南韓),其他亞洲地區,1,0,1,1,0,1,0,0,0,0,0,0,0,0,0
110,私立,一般大學,1050,佛光大學,碩士班(日間),日本,其他亞洲地區,2,0,2,0,0,0,2,0,2,0,0,0,0,0,0
110,私立,一般大學,1050,佛光大學,碩士班(日間),印度尼西亞共和國,東協,2,0,2,0,0,0,2,0,2,0,0,0,0,0,0
110,私立,一般大學,1050,佛光大學,碩士班(日間),法國,歐洲,1,0,1,1,0,1,0,0,0,0,0,0,0,0,0
110,私立,一般大學,1050,佛光大學,碩士班(日間),美國,北美洲,1,0,1,1,0,1,0,0,0,0,0,0,0,0,0
110,私立,一般大學,1050,佛光大學,碩士班(日間),泰國,東協,1,1,0,1,1,0,0,0,0,0,0,0,0,0,0
110,私立,一般大學,1050,佛光大學,碩士班(日間),馬來西亞,東協,10,1,9,4,0,4,6,1,5,0,0,0,0,0,0
110,私立,一般大學,1050,佛光大學,碩士班(日間),荷蘭王國,歐洲,1,1,0,1,1,0,0,0,0,0,0,0,0,0,0
110,私立,一般大學,1050,佛光大學,碩士班(日間),菲律賓共和國,東協,3,1,2,3,1,2,0,0,0,0,0,0,0,0,0
110,私立,一般大學,1050,佛光大學,博士班,大陸地區,大陸地區,3,0,3,0,0,0,0,0,0,0,0,0,3,0,3
110,私立,一般大學,1050,佛光大學,博士班,馬來西亞,東協,4,0,4,4,0,4,0,0,0,0,0,0,0,0,0
110,私立,一般大學,1050,佛光大學,博士班,越南社會主義共和國,東協,3,0,3,3,0,3,0,0,0,0,0,0,0,0,0
110,私立,技專校院,1051,台南家專學校財團法人台南應用科技大學,五專,日本,其他亞洲地區,1,1,0,0,0,0,1,1,0,0,0,0,0,0,0
110,私立,技專校院,1051,台南家專學校財團法人台南應用科技大學,五專,美國,北美洲,2,2,0,2,2,0,0,0,0,0,0,0,0,0,0
110,私立,技專校院,1051,台南家專學校財團法人台南應用科技大學,學士班(日間),日本,其他亞洲地區,17,7,10,16,7,9,1,0,1,0,0,0,0,0,0
110,私立,技專校院,1051,台南家專學校財團法人台南應用科技大學,學士班(日間),印度尼西亞共和國,東協,1,1,0,0,0,0,1,1,0,0,0,0,0,0,0
110,私立,技專校院,1051,台南家專學校財團法人台南應用科技大學,學士班(日間),大陸地區,大陸地區,5,4,1,0,0,0,0,0,0,0,0,0,5,4,1
110,私立,技專校院,1051,台南家專學校財團法人台南應用科技大學,學士班(日間),大韓民國(南韓),其他亞洲地區,1,0,1,1,0,1,0,0,0,0,0,0,0,0,0
110,私立,技專校院,1051,台南家專學校財團法人台南應用科技大學,學士班(日間),尼加拉瓜,中南美洲,1,0,1,1,0,1,0,0,0,0,0,0,0,0,0
110,私立,技專校院,1051,台南家專學校財團法人台南應用科技大學,學士班(日間),貝里斯,中南美洲,1,0,1,0,0,0,1,0,1,0,0,0,0,0,0
110,私立,技專校院,1051,台南家專學校財團法人台南應用科技大學,學士班(日間),香港,港澳,36,14,22,0,0,0,0,0,0,36,14,22,0,0,0
110,私立,技專校院,1051,台南家專學校財團法人台南應用科技大學,學士班(日間),馬來西亞,東協,31,17,14,15,8,7,16,9,7,0,0,0,0,0,0
110,私立,技專校院,1051,台南家專學校財團法人台南應用科技大學,學士班(日間),越南社會主義共和國,東協,1,1,0,1,1,0,0,0,0,0,0,0,0,0,0
110,私立,技專校院,1051,台南家專學校財團法人台南應用科技大學,學士班(日間),澳門,港澳,3,0,3,0,0,0,0,0,0,3,0,3,0,0,0
110,私立,技專校院,1051,台南家專學校財團法人台南應用科技大學,碩士班(日間),越南社會主義共和國,東協,1,1,0,1,1,0,0,0,0,0,0,0,0,0,0
110,私立,技專校院,1051,台南家專學校財團法人台南應用科技大學,碩士班(日間),香港,港澳,1,1,0,0,0,0,0,0,0,1,1,0,0,0,0
110,私立,技專校院,1052,遠東科技大學,學士班(日間),大韓民國(南韓),其他亞洲地區,2,2,0,2,2,0,0,0,0,0,0,0,0,0,0
110,私立,技專校院,1052,遠東科技大學,學士班(日間),印度尼西亞共和國,東協,3,3,0,0,0,0,3,3,0,0,0,0,0,0,0
110,私立,技專校院,1052,遠東科技大學,學士班(日間),柬埔寨王國,東協,1,1,0,0,0,0,1,1,0,0,0,0,0,0,0
110,私立,技專校院,1052,遠東科技大學,學士班(日間),美國,北美洲,1,1,0,1,1,0,0,0,0,0,0,0,0,0,0
110,私立,技專校院,1052,遠東科技大學,學士班(日間),泰國,東協,1,0,1,1,0,1,0,0,0,0,0,0,0,0,0
110,私立,技專校院,1052,遠東科技大學,學士班(日間),馬來西亞,東協,12,7,5,12,7,5,0,0,0,0,0,0,0,0,0
110,私立,技專校院,1052,遠東科技大學,學士班(日間),菲律賓共和國,東協,13,13,0,13,13,0,0,0,0,0,0,0,0,0,0
110,私立,技專校院,1052,遠東科技大學,學士班(日間),印度,南亞,1,1,0,1,1,0,0,0,0,0,0,0,0,0,0
110,私立,技專校院,1052,遠東科技大學,學士班(日間),香港,港澳,9,7,2,0,0,0,0,0,0,9,7,2,0,0,0
110,私立,技專校院,1052,遠東科技大學,學士班(日間),越南社會主義共和國,東協,23,10,13,18,8,10,5,2,3,0,0,0,0,0,0
110,私立,技專校院,1052,遠東科技大學,學士班(日間),澳門,港澳,1,1,0,0,0,0,0,0,0,1,1,0,0,0,0
110,私立,技專校院,1052,遠東科技大學,碩士班(日間),香港,港澳,2,2,0,0,0,0,0,0,0,2,2,0,0,0,0
110,私立,技專校院,1052,遠東科技大學,碩士班(日間),越南社會主義共和國,東協,8,3,5,7,2,5,1,1,0,0,0,0,0,0,0
110,私立,技專校院,1052,遠東科技大學,碩士班(日間),大韓民國(南韓),其他亞洲地區,2,1,1,2,1,1,0,0,0,0,0,0,0,0,0
110,私立,技專校院,1052,遠東科技大學,碩士班(日間),印度尼西亞共和國,東協,2,1,1,2,1,1,0,0,0,0,0,0,0,0,0
110,私立,技專校院,1052,遠東科技大學,碩士班(日間),馬來西亞,東協,2,1,1,1,0,1,1,1,0,0,0,0,0,0,0
110,私立,技專校院,1053,光宇學校財團法人元培醫事科技大學,學士班(日間),史瓦帝尼王國,非洲,1,1,0,1,1,0,0,0,0,0,0,0,0,0,0
110,私立,技專校院,1053,光宇學校財團法人元培醫事科技大學,學士班(日間),印度尼西亞共和國,東協,43,23,20,43,23,20,0,0,0,0,0,0,0,0,0
110,私立,技專校院,1053,光宇學校財團法人元培醫事科技大學,學士班(日間),泰國,東協,1,0,1,1,0,1,0,0,0,0,0,0,0,0,0
110,私立,技專校院,1053,光宇學校財團法人元培醫事科技大學,學士班(日間),馬來西亞,東協,40,19,21,35,16,19,5,3,2,0,0,0,0,0,0
110,私立,技專校院,1053,光宇學校財團法人元培醫事科技大學,學士班(日間),越南社會主義共和國,東協,221,107,114,221,107,114,0,0,0,0,0,0,0,0,0
110,私立,技專校院,1053,光宇學校財團法人元培醫事科技大學,學士班(日間),澳門,港澳,2,1,1,0,0,0,0,0,0,2,1,1,0,0,0
110,私立,技專校院,1053,光宇學校財團法人元培醫事科技大學,學士班(日間),宏都拉斯共和國,中南美洲,1,1,0,1,1,0,0,0,0,0,0,0,0,0,0
110,私立,技專校院,1053,光宇學校財團法人元培醫事科技大學,學士班(日間),香港,港澳,9,1,8,0,0,0,0,0,0,9,1,8,0,0,0
110,私立,技專校院,1053,光宇學校財團法人元培醫事科技大學,碩士班(日間),日本,其他亞洲地區,1,1,0,1,1,0,0,0,0,0,0,0,0,0,0
110,私立,技專校院,1053,光宇學校財團法人元培醫事科技大學,碩士班(日間),加拿大,北美洲,1,0,1,1,0,1,0,0,0,0,0,0,0,0,0
110,私立,技專校院,1053,光宇學校財團法人元培醫事科技大學,碩士班(日間),馬來西亞,東協,1,0,1,1,0,1,0,0,0,0,0,0,0,0,0
110,私立,技專校院,1054,景文科技大學,學士班(日間),日本,其他亞洲地區,35,18,17,35,18,17,0,0,0,0,0,0,0,0,0
110,私立,技專校院,1054,景文科技大學,學士班(日間),泰國,東協,2,0,2,2,0,2,0,0,0,0,0,0,0,0,0
110,私立,技專校院,1054,景文科技大學,學士班(日間),智利,中南美洲,1,0,1,1,0,1,0,0,0,0,0,0,0,0,0
110,私立,技專校院,1054,景文科技大學,學士班(日間),越南社會主義共和國,東協,385,142,243,384,142,242,1,0,1,0,0,0,0,0,0
110,私立,技專校院,1054,景文科技大學,學士班(日間),大陸地區,大陸地區,7,6,1,0,0,0,0,0,0,0,0,0,7,6,1
110,私立,技專校院,1054,景文科技大學,學士班(日間),大韓民國(南韓),其他亞洲地區,3,2,1,2,1,1,1,1,0,0,0,0,0,0,0
110,私立,技專校院,1054,景文科技大學,學士班(日間),印度尼西亞共和國,東協,9,3,6,1,0,1,8,3,5,0,0,0,0,0,0
110,私立,技專校院,1054,景文科技大學,學士班(日間),香港,港澳,94,41,53,0,0,0,0,0,0,94,41,53,0,0,0
110,私立,技專校院,1054,景文科技大學,學士班(日間),馬來西亞,東協,47,17,30,8,4,4,39,13,26,0,0,0,0,0,0
110,私立,技專校院,1054,景文科技大學,學士班(日間),緬甸,東協,1,0,1,0,0,0,1,0,1,0,0,0,0,0,0
110,私立,技專校院,1054,景文科技大學,學士班(日間),澳門,港澳,13,9,4,0,0,0,0,0,0,13,9,4,0,0,0
110,私立,技專校院,1054,景文科技大學,碩士班(日間),約旦哈什米王國,其他亞洲地區,1,1,0,0,0,0,1,1,0,0,0,0,0,0,0
110,私立,技專校院,1055,中華醫事科技大學,學士班(日間),印度尼西亞共和國,東協,165,110,55,165,110,55,0,0,0,0,0,0,0,0,0
110,私立,技專校院,1055,中華醫事科技大學,學士班(日間),香港,港澳,7,0,7,0,0,0,0,0,0,7,0,7,0,0,0
110,私立,技專校院,1055,中華醫事科技大學,學士班(日間),馬來西亞,東協,10,1,9,8,1,7,2,0,2,0,0,0,0,0,0
110,私立,技專校院,1055,中華醫事科技大學,學士班(日間),越南社會主義共和國,東協,153,41,112,152,40,112,1,1,0,0,0,0,0,0,0
110,私立,技專校院,1055,中華醫事科技大學,學士班(日間),澳門,港澳,2,0,2,0,0,0,0,0,0,2,0,2,0,0,0
110,私立,技專校院,1055,中華醫事科技大學,學士班(日間),泰國,東協,1,0,1,1,0,1,0,0,0,0,0,0,0,0,0
110,私立,技專校院,1056,東南科技大學,學士班(日間),大陸地區,大陸地區,1,1,0,0,0,0,0,0,0,0,0,0,1,1,0
110,私立,技專校院,1056,東南科技大學,學士班(日間),印度尼西亞共和國,東協,29,11,18,0,0,0,29,11,18,0,0,0,0,0,0
110,私立,技專校院,1056,東南科技大學,學士班(日間),香港,港澳,11,4,7,0,0,0,0,0,0,11,4,7,0,0,0
110,私立,技專校院,1056,東南科技大學,學士班(日間),馬來西亞,東協,91,58,33,12,8,4,79,50,29,0,0,0,0,0,0
110,私立,技專校院,1056,東南科技大學,學士班(日間),菲律賓共和國,東協,1,1,0,0,0,0,1,1,0,0,0,0,0,0,0
110,私立,技專校院,1056,東南科技大學,學士班(日間),越南社會主義共和國,東協,558,256,302,419,202,217,139,54,85,0,0,0,0,0,0
110,私立,技專校院,1056,東南科技大學,學士班(日間),緬甸,東協,35,16,19,0,0,0,35,16,19,0,0,0,0,0,0
110,私立,技專校院,1056,東南科技大學,學士班(日間),澳門,港澳,1,0,1,0,0,0,0,0,0,1,0,1,0,0,0
110,私立,技專校院,1056,東南科技大學,學士班(日間),日本,其他亞洲地區,4,2,2,2,0,2,2,2,0,0,0,0,0,0,0
110,私立,技專校院,1056,東南科技大學,學士班(日間),西班牙王國,歐洲,1,0,1,1,0,1,0,0,0,0,0,0,0,0,0
110,私立,技專校院,1056,東南科技大學,碩士班(日間),馬來西亞,東協,3,1,2,1,0,1,2,1,1,0,0,0,0,0,0
110,私立,技專校院,1056,東南科技大學,碩士班(日間),越南社會主義共和國,東協,3,0,3,2,0,2,1,0,1,0,0,0,0,0,0
110,私立,技專校院,1057,德明財經科技大學,學士班(日間),大韓民國(南韓),其他亞洲地區,3,2,1,3,2,1,0,0,0,0,0,0,0,0,0
110,私立,技專校院,1057,德明財經科技大學,學士班(日間),日本,其他亞洲地區,9,5,4,9,5,4,0,0,0,0,0,0,0,0,0
110,私立,技專校院,1057,德明財經科技大學,學士班(日間),印度尼西亞共和國,東協,34,14,20,30,12,18,4,2,2,0,0,0,0,0,0
110,私立,技專校院,1057,德明財經科技大學,學士班(日間),柬埔寨王國,東協,1,0,1,1,0,1,0,0,0,0,0,0,0,0,0
110,私立,技專校院,1057,德明財經科技大學,學士班(日間),馬來西亞,東協,1,1,0,0,0,0,1,1,0,0,0,0,0,0,0
110,私立,技專校院,1057,德明財經科技大學,學士班(日間),孟加拉人民共和國,南亞,1,1,0,1,1,0,0,0,0,0,0,0,0,0,0
110,私立,技專校院,1057,德明財經科技大學,學士班(日間),香港,港澳,6,3,3,0,0,0,0,0,0,6,3,3,0,0,0
110,私立,技專校院,1057,德明財經科技大學,學士班(日間),越南社會主義共和國,東協,493,193,300,486,190,296,7,3,4,0,0,0,0,0,0
110,私立,技專校院,1057,德明財經科技大學,學士班(日間),緬甸,東協,1,1,0,0,0,0,1,1,0,0,0,0,0,0,0
110,私立,技專校院,1057,德明財經科技大學,碩士班(日間),香港,港澳,1,1,0,0,0,0,0,0,0,1,1,0,0,0,0
110,私立,技專校院,1057,德明財經科技大學,碩士班(日間),越南社會主義共和國,東協,15,5,10,15,5,10,0,0,0,0,0,0,0,0,0
110,私立,一般大學,1058,明道學校財團法人明道大學,學士班(日間),大陸地區,大陸地區,1,1,0,0,0,0,0,0,0,0,0,0,1,1,0
110,私立,一般大學,1058,明道學校財團法人明道大學,學士班(日間),大韓民國(南韓),其他亞洲地區,3,3,0,3,3,0,0,0,0,0,0,0,0,0,0
110,私立,一般大學,1058,明道學校財團法人明道大學,學士班(日間),日本,其他亞洲地區,6,0,6,6,0,6,0,0,0,0,0,0,0,0,0
110,私立,一般大學,1058,明道學校財團法人明道大學,學士班(日間),奈及利亞聯邦共和國,非洲,2,2,0,2,2,0,0,0,0,0,0,0,0,0,0
110,私立,一般大學,1058,明道學校財團法人明道大學,學士班(日間),香港,港澳,40,22,18,0,0,0,0,0,0,40,22,18,0,0,0
110,私立,一般大學,1058,明道學校財團法人明道大學,學士班(日間),哥斯大黎加共和國,中南美洲,1,0,1,0,0,0,1,0,1,0,0,0,0,0,0
110,私立,一般大學,1058,明道學校財團法人明道大學,學士班(日間),馬來西亞,東協,31,17,14,12,5,7,19,12,7,0,0,0,0,0,0
110,私立,一般大學,1058,明道學校財團法人明道大學,學士班(日間),蒙古國,其他亞洲地區,9,4,5,9,4,5,0,0,0,0,0,0,0,0,0
110,私立,一般大學,1058,明道學校財團法人明道大學,學士班(日間),史瓦帝尼王國,非洲,45,23,22,45,23,22,0,0,0,0,0,0,0,0,0
110,私立,一般大學,1058,明道學校財團法人明道大學,學士班(日間),印度尼西亞共和國,東協,137,81,56,94,60,34,43,21,22,0,0,0,0,0,0
110,私立,一般大學,1058,明道學校財團法人明道大學,學士班(日間),俄羅斯聯邦,其他亞洲地區,1,1,0,1,1,0,0,0,0,0,0,0,0,0,0
110,私立,一般大學,1058,明道學校財團法人明道大學,學士班(日間),泰國,東協,35,22,13,35,22,13,0,0,0,0,0,0,0,0,0
110,私立,一般大學,1058,明道學校財團法人明道大學,學士班(日間),莫三比克共和國,非洲,1,1,0,1,1,0,0,0,0,0,0,0,0,0,0
110,私立,一般大學,1058,明道學校財團法人明道大學,學士班(日間),越南社會主義共和國,東協,20,5,15,17,5,12,3,0,3,0,0,0,0,0,0
110,私立,一般大學,1058,明道學校財團法人明道大學,學士班(日間),澳門,港澳,1,1,0,0,0,0,0,0,0,1,1,0,0,0,0
110,私立,一般大學,1058,明道學校財團法人明道大學,碩士班(日間),印度尼西亞共和國,東協,1,1,0,1,1,0,0,0,0,0,0,0,0,0,0
110,私立,一般大學,1058,明道學校財團法人明道大學,碩士班(日間),越南社會主義共和國,東協,21,11,10,20,11,9,1,0,1,0,0,0,0,0,0
110,私立,一般大學,1058,明道學校財團法人明道大學,碩士班(日間),大韓民國(南韓),其他亞洲地區,1,1,0,1,1,0,0,0,0,0,0,0,0,0,0
110,私立,一般大學,1058,明道學校財團法人明道大學,碩士班(日間),香港,港澳,3,2,1,0,0,0,0,0,0,3,2,1,0,0,0
110,私立,一般大學,1058,明道學校財團法人明道大學,碩士班(日間),馬來西亞,東協,7,5,2,4,3,1,3,2,1,0,0,0,0,0,0
110,私立,一般大學,1058,明道學校財團法人明道大學,碩士班(日間),蒙古國,其他亞洲地區,1,0,1,1,0,1,0,0,0,0,0,0,0,0,0
110,私立,一般大學,1058,明道學校財團法人明道大學,博士班,大陸地區,大陸地區,4,4,0,0,0,0,0,0,0,0,0,0,4,4,0
110,私立,技專校院,1060,南開科技大學,學士班(日間),香港,港澳,3,2,1,0,0,0,0,0,0,3,2,1,0,0,0
110,私立,技專校院,1060,南開科技大學,學士班(日間),馬來西亞,東協,78,64,14,25,18,7,53,46,7,0,0,0,0,0,0
110,私立,技專校院,1060,南開科技大學,學士班(日間),印度尼西亞共和國,東協,69,37,32,67,35,32,2,2,0,0,0,0,0,0,0
110,私立,技專校院,1060,南開科技大學,學士班(日間),越南社會主義共和國,東協,112,50,62,112,50,62,0,0,0,0,0,0,0,0,0
110,私立,技專校院,1060,南開科技大學,碩士班(日間),越南社會主義共和國,東協,1,1,0,0,0,0,1,1,0,0,0,0,0,0,0
110,私立,技專校院,1060,南開科技大學,碩士班(日間),馬來西亞,東協,1,1,0,0,0,0,1,1,0,0,0,0,0,0,0
110,私立,技專校院,1061,中華學校財團法人中華科技大學,學士班(日間),香港,港澳,1,0,1,0,0,0,0,0,0,1,0,1,0,0,0
110,私立,技專校院,1061,中華學校財團法人中華科技大學,學士班(日間),馬來西亞,東協,11,4,7,9,2,7,2,2,0,0,0,0,0,0,0
110,私立,技專校院,1061,中華學校財團法人中華科技大學,學士班(日間),越南社會主義共和國,東協,52,16,36,48,14,34,4,2,2,0,0,0,0,0,0
110,私立,技專校院,1061,中華學校財團法人中華科技大學,學士班(日間),緬甸,東協,50,16,34,50,16,34,0,0,0,0,0,0,0,0,0
110,私立,技專校院,1061,中華學校財團法人中華科技大學,學士班(日間),美國,北美洲,1,1,0,0,0,0,1,1,0,0,0,0,0,0,0
110,私立,技專校院,1061,中華學校財團法人中華科技大學,碩士班(日間),印度,南亞,1,1,0,0,0,0,1,1,0,0,0,0,0,0,0
110,私立,技專校院,1061,中華學校財團法人中華科技大學,碩士班(日間),香港,港澳,2,2,0,0,0,0,0,0,0,2,2,0,0,0,0
110,私立,技專校院,1061,中華學校財團法人中華科技大學,碩士班(日間),馬來西亞,東協,1,1,0,0,0,0,1,1,0,0,0,0,0,0,0
110,私立,技專校院,1061,中華學校財團法人中華科技大學,碩士班(日間),越南社會主義共和國,東協,1,0,1,1,0,1,0,0,0,0,0,0,0,0,0
110,私立,技專校院,1062,僑光科技大學,學士班(日間),日本,其他亞洲地區,1,0,1,1,0,1,0,0,0,0,0,0,0,0,0
110,私立,技專校院,1062,僑光科技大學,學士班(日間),比利時王國,歐洲,1,0,1,0,0,0,1,0,1,0,0,0,0,0,0
110,私立,技專校院,1062,僑光科技大學,學士班(日間),美國,北美洲,1,1,0,1,1,0,0,0,0,0,0,0,0,0,0
110,私立,技專校院,1062,僑光科技大學,學士班(日間),泰國,東協,2,1,1,2,1,1,0,0,0,0,0,0,0,0,0
110,私立,技專校院,1062,僑光科技大學,學士班(日間),印度尼西亞共和國,東協,38,37,1,37,37,0,1,0,1,0,0,0,0,0,0
110,私立,技專校院,1062,僑光科技大學,學士班(日間),香港,港澳,7,7,0,0,0,0,0,0,0,7,7,0,0,0,0
110,私立,技專校院,1062,僑光科技大學,學士班(日間),馬來西亞,東協,65,47,18,58,44,14,7,3,4,0,0,0,0,0,0
110,私立,技專校院,1062,僑光科技大學,學士班(日間),越南社會主義共和國,東協,12,2,10,12,2,10,0,0,0,0,0,0,0,0,0
110,私立,技專校院,1062,僑光科技大學,碩士班(日間),香港,港澳,1,1,0,0,0,0,0,0,0,1,1,0,0,0,0
110,私立,技專校院,1062,僑光科技大學,碩士班(日間),蒙古國,其他亞洲地區,1,0,1,1,0,1,0,0,0,0,0,0,0,0,0
110,私立,技專校院,1063,廣亞學校財團法人育達科技大學,學士班(日間),日本,其他亞洲地區,1,1,0,1,1,0,0,0,0,0,0,0,0,0,0
110,私立,技專校院,1063,廣亞學校財團法人育達科技大學,學士班(日間),印度尼西亞共和國,東協,21,8,13,21,8,13,0,0,0,0,0,0,0,0,0
110,私立,技專校院,1063,廣亞學校財團法人育達科技大學,學士班(日間),馬來西亞,東協,3,3,0,3,3,0,0,0,0,0,0,0,0,0,0
110,私立,技專校院,1063,廣亞學校財團法人育達科技大學,學士班(日間),菲律賓共和國,東協,1,1,0,1,1,0,0,0,0,0,0,0,0,0,0
110,私立,技專校院,1063,廣亞學校財團法人育達科技大學,學士班(日間),越南社會主義共和國,東協,164,61,103,164,61,103,0,0,0,0,0,0,0,0,0
110,私立,技專校院,1063,廣亞學校財團法人育達科技大學,碩士班(日間),馬來西亞,東協,2,2,0,1,1,0,1,1,0,0,0,0,0,0,0
110,私立,技專校院,1063,廣亞學校財團法人育達科技大學,碩士班(日間),菲律賓共和國,東協,29,6,23,29,6,23,0,0,0,0,0,0,0,0,0
110,私立,技專校院,1063,廣亞學校財團法人育達科技大學,碩士班(日間),緬甸,東協,2,0,2,0,0,0,2,0,2,0,0,0,0,0,0
110,私立,技專校院,1064,美和學校財團法人美和科技大學,學士班(日間),香港,港澳,2,1,1,0,0,0,0,0,0,2,1,1,0,0,0
110,私立,技專校院,1064,美和學校財團法人美和科技大學,學士班(日間),義大利共和國,歐洲,1,1,0,1,1,0,0,0,0,0,0,0,0,0,0
110,私立,技專校院,1064,美和學校財團法人美和科技大學,學士班(日間),德意志聯邦共和國,歐洲,1,0,1,1,0,1,0,0,0,0,0,0,0,0,0
110,私立,技專校院,1064,美和學校財團法人美和科技大學,碩士班(日間),香港,港澳,1,1,0,0,0,0,0,0,0,1,1,0,0,0,0
110,私立,技專校院,1064,美和學校財團法人美和科技大學,碩士班(日間),越南社會主義共和國,東協,9,7,2,9,7,2,0,0,0,0,0,0,0,0,0
110,私立,技專校院,1065,吳鳳科技大學,學士班(日間),泰國,東協,1,0,1,1,0,1,0,0,0,0,0,0,0,0,0
110,私立,技專校院,1065,吳鳳科技大學,學士班(日間),越南社會主義共和國,東協,346,176,170,154,73,81,192,103,89,0,0,0,0,0,0
110,私立,技專校院,1065,吳鳳科技大學,學士班(日間),大韓民國(南韓),其他亞洲地區,3,3,0,3,3,0,0,0,0,0,0,0,0,0,0
110,私立,技專校院,1065,吳鳳科技大學,學士班(日間),日本,其他亞洲地區,1,1,0,1,1,0,0,0,0,0,0,0,0,0,0
110,私立,技專校院,1065,吳鳳科技大學,學士班(日間),印度,南亞,1,1,0,1,1,0,0,0,0,0,0,0,0,0,0
110,私立,技專校院,1065,吳鳳科技大學,學士班(日間),印度尼西亞共和國,東協,14,8,6,9,5,4,5,3,2,0,0,0,0,0,0
110,私立,技專校院,1065,吳鳳科技大學,學士班(日間),馬來西亞,東協,17,14,3,1,0,1,16,14,2,0,0,0,0,0,0
110,私立,技專校院,1065,吳鳳科技大學,學士班(日間),蒙古國,其他亞洲地區,1,1,0,1,1,0,0,0,0,0,0,0,0,0,0
110,私立,技專校院,1065,吳鳳科技大學,學士班(日間),緬甸,東協,1,0,1,1,0,1,0,0,0,0,0,0,0,0,0
110,私立,技專校院,1065,吳鳳科技大學,碩士班(日間),越南社會主義共和國,東協,1,1,0,1,1,0,0,0,0,0,0,0,0,0,0
110,私立,技專校院,1066,環球學校財團法人環球科技大學,學士班(日間),日本,其他亞洲地區,8,4,4,8,4,4,0,0,0,0,0,0,0,0,0
110,私立,技專校院,1066,環球學校財團法人環球科技大學,學士班(日間),越南社會主義共和國,東協,38,15,23,26,7,19,12,8,4,0,0,0,0,0,0
110,私立,技專校院,1066,環球學校財團法人環球科技大學,學士班(日間),印度尼西亞共和國,東協,25,15,10,18,11,7,7,4,3,0,0,0,0,0,0
110,私立,技專校院,1066,環球學校財團法人環球科技大學,學士班(日間),香港,港澳,7,2,5,0,0,0,0,0,0,7,2,5,0,0,0
110,私立,技專校院,1066,環球學校財團法人環球科技大學,學士班(日間),馬來西亞,東協,165,78,87,149,69,80,16,9,7,0,0,0,0,0,0
110,私立,技專校院,1066,環球學校財團法人環球科技大學,學士班(日間),澳門,港澳,1,1,0,0,0,0,0,0,0,1,1,0,0,0,0
110,私立,技專校院,1066,環球學校財團法人環球科技大學,碩士班(日間),香港,港澳,2,1,1,0,0,0,0,0,0,2,1,1,0,0,0
110,私立,技專校院,1066,環球學校財團法人環球科技大學,碩士班(日間),馬來西亞,東協,11,9,2,11,9,2,0,0,0,0,0,0,0,0,0
110,私立,技專校院,1066,環球學校財團法人環球科技大學,碩士班(日間),日本,其他亞洲地區,1,1,0,1,1,0,0,0,0,0,0,0,0,0,0
110,私立,一般大學,1067,台灣首府學校財團法人台灣首府大學,學士班(日間),印度尼西亞共和國,東協,154,85,69,119,65,54,35,20,15,0,0,0,0,0,0
110,私立,一般大學,1067,台灣首府學校財團法人台灣首府大學,學士班(日間),柬埔寨王國,東協,1,1,0,0,0,0,1,1,0,0,0,0,0,0,0
110,私立,一般大學,1067,台灣首府學校財團法人台灣首府大學,學士班(日間),香港,港澳,4,0,4,0,0,0,0,0,0,4,0,4,0,0,0
110,私立,一般大學,1067,台灣首府學校財團法人台灣首府大學,學士班(日間),馬來西亞,東協,5,1,4,1,0,1,4,1,3,0,0,0,0,0,0
110,私立,一般大學,1067,台灣首府學校財團法人台灣首府大學,學士班(日間),越南社會主義共和國,東協,3,0,3,0,0,0,3,0,3,0,0,0,0,0,0
110,私立,一般大學,1067,台灣首府學校財團法人台灣首府大學,學士班(日間),緬甸,東協,2,0,2,2,0,2,0,0,0,0,0,0,0,0,0
110,私立,一般大學,1067,台灣首府學校財團法人台灣首府大學,學士班(日間),澳門,港澳,1,0,1,0,0,0,0,0,0,1,0,1,0,0,0
110,私立,一般大學,1067,台灣首府學校財團法人台灣首府大學,碩士班(日間),柬埔寨王國,東協,1,1,0,1,1,0,0,0,0,0,0,0,0,0,0
110,私立,一般大學,1067,台灣首府學校財團法人台灣首府大學,碩士班(日間),印度尼西亞共和國,東協,2,0,2,2,0,2,0,0,0,0,0,0,0,0,0
110,私立,一般大學,1067,台灣首府學校財團法人台灣首府大學,碩士班(日間),馬來西亞,東協,6,3,3,3,1,2,3,2,1,0,0,0,0,0,0
110,私立,技專校院,1068,中州學校財團法人中州科技大學,學士班(日間),馬來西亞,東協,10,9,1,9,8,1,1,1,0,0,0,0,0,0,0
110,私立,技專校院,1068,中州學校財團法人中州科技大學,學士班(日間),塞內加爾共和國,非洲,1,1,0,1,1,0,0,0,0,0,0,0,0,0,0
110,私立,技專校院,1068,中州學校財團法人中州科技大學,學士班(日間),史瓦帝尼王國,非洲,38,20,18,38,20,18,0,0,0,0,0,0,0,0,0
110,私立,技專校院,1068,中州學校財團法人中州科技大學,學士班(日間),烏干達共和國,非洲,14,7,7,14,7,7,0,0,0,0,0,0,0,0,0
110,私立,技專校院,1068,中州學校財團法人中州科技大學,學士班(日間),越南社會主義共和國,東協,1,0,1,1,0,1,0,0,0,0,0,0,0,0,0
110,私立,技專校院,1068,中州學校財團法人中州科技大學,學士班(日間),緬甸,東協,3,1,2,3,1,2,0,0,0,0,0,0,0,0,0
110,私立,技專校院,1069,修平學校財團法人修平科技大學,學士班(日間),印度尼西亞共和國,東協,88,52,36,88,52,36,0,0,0,0,0,0,0,0,0
110,私立,技專校院,1069,修平學校財團法人修平科技大學,學士班(日間),香港,港澳,5,2,3,0,0,0,0,0,0,5,2,3,0,0,0
110,私立,技專校院,1069,修平學校財團法人修平科技大學,學士班(日間),越南社會主義共和國,東協,12,5,7,12,5,7,0,0,0,0,0,0,0,0,0
110,私立,技專校院,1069,修平學校財團法人修平科技大學,學士班(日間),日本,其他亞洲地區,5,4,1,5,4,1,0,0,0,0,0,0,0,0,0
110,私立,技專校院,1069,修平學校財團法人修平科技大學,學士班(日間),馬來西亞,東協,21,16,5,21,16,5,0,0,0,0,0,0,0,0,0
110,私立,技專校院,1069,修平學校財團法人修平科技大學,學士班(日間),蒙古國,其他亞洲地區,5,4,1,5,4,1,0,0,0,0,0,0,0,0,0
110,私立,技專校院,1069,修平學校財團法人修平科技大學,碩士班(日間),蒙古國,其他亞洲地區,1,0,1,1,0,1,0,0,0,0,0,0,0,0,0
110,私立,技專校院,1069,修平學校財團法人修平科技大學,碩士班(日間),越南社會主義共和國,東協,2,2,0,2,2,0,0,0,0,0,0,0,0,0,0
110,私立,技專校院,1070,長庚學校財團法人長庚科技大學,學士班(日間),印度尼西亞共和國,東協,1,0,1,0,0,0,1,0,1,0,0,0,0,0,0
110,私立,技專校院,1070,長庚學校財團法人長庚科技大學,學士班(日間),澳門,港澳,1,1,0,0,0,0,0,0,0,1,1,0,0,0,0
110,私立,技專校院,1070,長庚學校財團法人長庚科技大學,學士班(日間),香港,港澳,34,7,27,0,0,0,0,0,0,34,7,27,0,0,0
110,私立,技專校院,1070,長庚學校財團法人長庚科技大學,學士班(日間),馬來西亞,東協,2,0,2,0,0,0,2,0,2,0,0,0,0,0,0
110,私立,技專校院,1071,城市學校財團法人臺北城市科技大學,學士班(日間),巴西聯邦共和國,中南美洲,1,0,1,0,0,0,1,0,1,0,0,0,0,0,0
110,私立,技專校院,1071,城市學校財團法人臺北城市科技大學,學士班(日間),泰國,東協,3,1,2,1,0,1,2,1,1,0,0,0,0,0,0
110,私立,技專校院,1071,城市學校財團法人臺北城市科技大學,學士班(日間),馬來西亞,東協,37,22,15,15,9,6,22,13,9,0,0,0,0,0,0
110,私立,技專校院,1071,城市學校財團法人臺北城市科技大學,學士班(日間),越南社會主義共和國,東協,205,75,130,169,71,98,36,4,32,0,0,0,0,0,0
110,私立,技專校院,1071,城市學校財團法人臺北城市科技大學,學士班(日間),大韓民國(南韓),其他亞洲地區,2,0,2,2,0,2,0,0,0,0,0,0,0,0,0
110,私立,技專校院,1071,城市學校財團法人臺北城市科技大學,學士班(日間),日本,其他亞洲地區,2,0,2,2,0,2,0,0,0,0,0,0,0,0,0
110,私立,技專校院,1071,城市學校財團法人臺北城市科技大學,學士班(日間),印度尼西亞共和國,東協,6,2,4,3,0,3,3,2,1,0,0,0,0,0,0
110,私立,技專校院,1071,城市學校財團法人臺北城市科技大學,學士班(日間),香港,港澳,37,18,19,0,0,0,0,0,0,37,18,19,0,0,0
110,私立,技專校院,1071,城市學校財團法人臺北城市科技大學,學士班(日間),海地共和國,中南美洲,1,1,0,1,1,0,0,0,0,0,0,0,0,0,0
110,私立,技專校院,1071,城市學校財團法人臺北城市科技大學,學士班(日間),馬拉威共和國,非洲,1,1,0,1,1,0,0,0,0,0,0,0,0,0,0
110,私立,技專校院,1071,城市學校財團法人臺北城市科技大學,學士班(日間),義大利共和國,歐洲,1,1,0,1,1,0,0,0,0,0,0,0,0,0,0
110,私立,技專校院,1071,城市學校財團法人臺北城市科技大學,學士班(日間),緬甸,東協,4,1,3,0,0,0,4,1,3,0,0,0,0,0,0
110,私立,技專校院,1071,城市學校財團法人臺北城市科技大學,學士班(日間),澳門,港澳,3,2,1,0,0,0,0,0,0,3,2,1,0,0,0
110,私立,技專校院,1071,城市學校財團法人臺北城市科技大學,碩士班(日間),香港,港澳,1,1,0,0,0,0,0,0,0,1,1,0,0,0,0
110,私立,技專校院,1071,城市學校財團法人臺北城市科技大學,碩士班(日間),印度尼西亞共和國,東協,1,0,1,0,0,0,1,0,1,0,0,0,0,0,0
110,私立,技專校院,1071,城市學校財團法人臺北城市科技大學,碩士班(日間),馬來西亞,東協,1,1,0,0,0,0,1,1,0,0,0,0,0,0,0
110,私立,技專校院,1071,城市學校財團法人臺北城市科技大學,碩士班(日間),越南社會主義共和國,東協,3,1,2,3,1,2,0,0,0,0,0,0,0,0,0
110,私立,技專校院,1072,大華學校財團法人敏實科技大學,學士班(日間),馬來西亞,東協,11,4,7,9,3,6,2,1,1,0,0,0,0,0,0
110,私立,技專校院,1073,醒吾學校財團法人醒吾科技大學,五專,尼加拉瓜,中南美洲,1,0,1,0,0,0,1,0,1,0,0,0,0,0,0
110,私立,技專校院,1073,醒吾學校財團法人醒吾科技大學,學士班(日間),日本,其他亞洲地區,12,6,6,12,6,6,0,0,0,0,0,0,0,0,0
110,私立,技專校院,1073,醒吾學校財團法人醒吾科技大學,學士班(日間),印度尼西亞共和國,東協,304,132,172,200,93,107,104,39,65,0,0,0,0,0,0
110,私立,技專校院,1073,醒吾學校財團法人醒吾科技大學,學士班(日間),香港,港澳,26,13,13,0,0,0,0,0,0,26,13,13,0,0,0
110,私立,技專校院,1073,醒吾學校財團法人醒吾科技大學,學士班(日間),馬來西亞,東協,26,14,12,5,1,4,21,13,8,0,0,0,0,0,0
110,私立,技專校院,1073,醒吾學校財團法人醒吾科技大學,學士班(日間),塞內加爾共和國,非洲,1,1,0,1,1,0,0,0,0,0,0,0,0,0,0
110,私立,技專校院,1073,醒吾學校財團法人醒吾科技大學,學士班(日間),美國,北美洲,1,1,0,1,1,0,0,0,0,0,0,0,0,0,0
110,私立,技專校院,1073,醒吾學校財團法人醒吾科技大學,學士班(日間),泰國,東協,2,1,1,2,1,1,0,0,0,0,0,0,0,0,0
110,私立,技專校院,1073,醒吾學校財團法人醒吾科技大學,學士班(日間),烏茲別克共和國,其他亞洲地區,1,0,1,1,0,1,0,0,0,0,0,0,0,0,0
110,私立,技專校院,1073,醒吾學校財團法人醒吾科技大學,學士班(日間),越南社會主義共和國,東協,519,175,344,513,174,339,6,1,5,0,0,0,0,0,0
110,私立,技專校院,1073,醒吾學校財團法人醒吾科技大學,學士班(日間),緬甸,東協,6,4,2,0,0,0,6,4,2,0,0,0,0,0,0
110,私立,技專校院,1073,醒吾學校財團法人醒吾科技大學,學士班(日間),澳門,港澳,5,2,3,0,0,0,0,0,0,5,2,3,0,0,0
110,私立,技專校院,1073,醒吾學校財團法人醒吾科技大學,碩士班(日間),越南社會主義共和國,東協,4,2,2,4,2,2,0,0,0,0,0,0,0,0,0
110,私立,技專校院,1073,醒吾學校財團法人醒吾科技大學,碩士班(日間),澳門,港澳,1,0,1,0,0,0,0,0,0,1,0,1,0,0,0
110,私立,技專校院,1073,醒吾學校財團法人醒吾科技大學,碩士班(日間),香港,港澳,3,2,1,0,0,0,0,0,0,3,2,1,0,0,0
110,私立,技專校院,1073,醒吾學校財團法人醒吾科技大學,碩士班(日間),馬來西亞,東協,1,0,1,0,0,0,1,0,1,0,0,0,0,0,0
110,私立,技專校院,1075,文藻學校財團法人文藻外語大學,五專,大韓民國(南韓),其他亞洲地區,1,0,1,1,0,1,0,0,0,0,0,0,0,0,0
110,私立,技專校院,1075,文藻學校財團法人文藻外語大學,五專,日本,其他亞洲地區,1,0,1,1,0,1,0,0,0,0,0,0,0,0,0
110,私立,技專校院,1075,文藻學校財團法人文藻外語大學,五專,印度尼西亞共和國,東協,1,0,1,0,0,0,1,0,1,0,0,0,0,0,0
110,私立,技專校院,1075,文藻學校財團法人文藻外語大學,五專,阿根廷,中南美洲,1,1,0,0,0,0,1,1,0,0,0,0,0,0,0
110,私立,技專校院,1075,文藻學校財團法人文藻外語大學,五專,泰國,東協,1,1,0,0,0,0,1,1,0,0,0,0,0,0,0
110,私立,技專校院,1075,文藻學校財團法人文藻外語大學,五專,馬紹爾群島共和國,其他亞洲地區,1,0,1,0,0,0,1,0,1,0,0,0,0,0,0
110,私立,技專校院,1075,文藻學校財團法人文藻外語大學,學士班(日間),大陸地區,大陸地區,22,9,13,0,0,0,0,0,0,0,0,0,22,9,13
110,私立,技專校院,1075,文藻學校財團法人文藻外語大學,學士班(日間),尼加拉瓜,中南美洲,2,2,0,2,2,0,0,0,0,0,0,0,0,0,0
110,私立,技專校院,1075,文藻學校財團法人文藻外語大學,學士班(日間),印度,南亞,3,0,3,3,0,3,0,0,0,0,0,0,0,0,0
110,私立,技專校院,1075,文藻學校財團法人文藻外語大學,學士班(日間),希臘共和國,歐洲,1,1,0,1,1,0,0,0,0,0,0,0,0,0,0
110,私立,技專校院,1075,文藻學校財團法人文藻外語大學,學士班(日間),奈及利亞聯邦共和國,非洲,2,1,1,2,1,1,0,0,0,0,0,0,0,0,0
110,私立,技專校院,1075,文藻學校財團法人文藻外語大學,學士班(日間),阿根廷,中南美洲,1,0,1,0,0,0,1,0,1,0,0,0,0,0,0
110,私立,技專校院,1075,文藻學校財團法人文藻外語大學,學士班(日間),美國,北美洲,7,4,3,7,4,3,0,0,0,0,0,0,0,0,0
110,私立,技專校院,1075,文藻學校財團法人文藻外語大學,學士班(日間),香港,港澳,53,22,31,0,0,0,0,0,0,53,22,31,0,0,0
110,私立,技專校院,1075,文藻學校財團法人文藻外語大學,學士班(日間),哥倫比亞共和國,中南美洲,1,0,1,1,0,1,0,0,0,0,0,0,0,0,0
110,私立,技專校院,1075,文藻學校財團法人文藻外語大學,學士班(日間),越南社會主義共和國,東協,62,8,54,60,8,52,2,0,2,0,0,0,0,0,0
110,私立,技專校院,1075,文藻學校財團法人文藻外語大學,學士班(日間),德意志聯邦共和國,歐洲,1,1,0,1,1,0,0,0,0,0,0,0,0,0,0
110,私立,技專校院,1075,文藻學校財團法人文藻外語大學,學士班(日間),緬甸,東協,2,2,0,0,0,0,2,2,0,0,0,0,0,0,0
110,私立,技專校院,1075,文藻學校財團法人文藻外語大學,學士班(日間),澳門,港澳,3,1,2,0,0,0,0,0,0,3,1,2,0,0,0
110,私立,技專校院,1075,文藻學校財團法人文藻外語大學,學士班(日間),大韓民國(南韓),其他亞洲地區,5,1,4,5,1,4,0,0,0,0,0,0,0,0,0
110,私立,技專校院,1075,文藻學校財團法人文藻外語大學,學士班(日間),巴西聯邦共和國,中南美洲,1,0,1,1,0,1,0,0,0,0,0,0,0,0,0
110,私立,技專校院,1075,文藻學校財團法人文藻外語大學,學士班(日間),日本,其他亞洲地區,49,18,31,47,18,29,2,0,2,0,0,0,0,0,0
110,私立,技專校院,1075,文藻學校財團法人文藻外語大學,學士班(日間),加拿大,北美洲,1,1,0,1,1,0,0,0,0,0,0,0,0,0,0
110,私立,技專校院,1075,文藻學校財團法人文藻外語大學,學士班(日間),印度尼西亞共和國,東協,47,6,41,42,6,36,5,0,5,0,0,0,0,0,0
110,私立,技專校院,1075,文藻學校財團法人文藻外語大學,學士班(日間),西班牙王國,歐洲,2,2,0,2,2,0,0,0,0,0,0,0,0,0,0
110,私立,技專校院,1075,文藻學校財團法人文藻外語大學,學士班(日間),波蘭共和國,歐洲,1,1,0,1,1,0,0,0,0,0,0,0,0,0,0
110,私立,技專校院,1075,文藻學校財團法人文藻外語大學,學士班(日間),法國,歐洲,1,1,0,1,1,0,0,0,0,0,0,0,0,0,0
110,私立,技專校院,1075,文藻學校財團法人文藻外語大學,學士班(日間),肯亞共和國,非洲,1,1,0,1,1,0,0,0,0,0,0,0,0,0,0
110,私立,技專校院,1075,文藻學校財團法人文藻外語大學,學士班(日間),俄羅斯聯邦,其他亞洲地區,7,5,2,7,5,2,0,0,0,0,0,0,0,0,0
110,私立,技專校院,1075,文藻學校財團法人文藻外語大學,學士班(日間),南非共和國,非洲,2,2,0,2,2,0,0,0,0,0,0,0,0,0,0
110,私立,技專校院,1075,文藻學校財團法人文藻外語大學,學士班(日間),約旦哈什米王國,其他亞洲地區,1,1,0,1,1,0,0,0,0,0,0,0,0,0,0
110,私立,技專校院,1075,文藻學校財團法人文藻外語大學,學士班(日間),泰國,東協,4,0,4,3,0,3,1,0,1,0,0,0,0,0,0
110,私立,技專校院,1075,文藻學校財團法人文藻外語大學,學士班(日間),秘魯共和國,中南美洲,5,1,4,4,1,3,1,0,1,0,0,0,0,0,0
110,私立,技專校院,1075,文藻學校財團法人文藻外語大學,學士班(日間),馬來西亞,東協,16,4,12,9,2,7,7,2,5,0,0,0,0,0,0
110,私立,技專校院,1075,文藻學校財團法人文藻外語大學,學士班(日間),荷蘭王國,歐洲,2,1,1,2,1,1,0,0,0,0,0,0,0,0,0
110,私立,技專校院,1075,文藻學校財團法人文藻外語大學,學士班(日間),菲律賓共和國,東協,2,0,2,1,0,1,1,0,1,0,0,0,0,0,0
110,私立,技專校院,1075,文藻學校財團法人文藻外語大學,學士班(日間),義大利共和國,歐洲,2,1,1,2,1,1,0,0,0,0,0,0,0,0,0
110,私立,技專校院,1075,文藻學校財團法人文藻外語大學,學士班(日間),聖文森(及格瑞那丁),中南美洲,2,1,1,2,1,1,0,0,0,0,0,0,0,0,0
110,私立,技專校院,1075,文藻學校財團法人文藻外語大學,學士班(日間),蒙古國,其他亞洲地區,1,0,1,1,0,1,0,0,0,0,0,0,0,0,0
110,私立,技專校院,1075,文藻學校財團法人文藻外語大學,學士班(日間),澳大利亞,其他亞洲地區,1,1,0,1,1,0,0,0,0,0,0,0,0,0,0
110,私立,技專校院,1075,文藻學校財團法人文藻外語大學,碩士班(日間),匈牙利共和國,歐洲,1,0,1,1,0,1,0,0,0,0,0,0,0,0,0
110,私立,技專校院,1075,文藻學校財團法人文藻外語大學,碩士班(日間),印度尼西亞共和國,東協,9,2,7,7,2,5,2,0,2,0,0,0,0,0,0
110,私立,技專校院,1075,文藻學校財團法人文藻外語大學,碩士班(日間),吉布地共和國,非洲,1,0,1,1,0,1,0,0,0,0,0,0,0,0,0
110,私立,技專校院,1075,文藻學校財團法人文藻外語大學,碩士班(日間),法國,歐洲,4,2,2,4,2,2,0,0,0,0,0,0,0,0,0
110,私立,技專校院,1075,文藻學校財團法人文藻外語大學,碩士班(日間),英國,歐洲,1,1,0,1,1,0,0,0,0,0,0,0,0,0,0
110,私立,技專校院,1075,文藻學校財團法人文藻外語大學,碩士班(日間),泰國,東協,2,0,2,2,0,2,0,0,0,0,0,0,0,0,0
110,私立,技專校院,1075,文藻學校財團法人文藻外語大學,碩士班(日間),秘魯共和國,中南美洲,1,1,0,1,1,0,0,0,0,0,0,0,0,0,0
110,私立,技專校院,1075,文藻學校財團法人文藻外語大學,碩士班(日間),馬來西亞,東協,1,0,1,1,0,1,0,0,0,0,0,0,0,0,0
110,私立,技專校院,1075,文藻學校財團法人文藻外語大學,碩士班(日間),菲律賓共和國,東協,3,0,3,3,0,3,0,0,0,0,0,0,0,0,0
110,私立,技專校院,1075,文藻學校財團法人文藻外語大學,碩士班(日間),越南社會主義共和國,東協,20,5,15,20,5,15,0,0,0,0,0,0,0,0,0
110,私立,技專校院,1075,文藻學校財團法人文藻外語大學,碩士班(日間),義大利共和國,歐洲,1,0,1,1,0,1,0,0,0,0,0,0,0,0,0
110,私立,技專校院,1075,文藻學校財團法人文藻外語大學,碩士班(日間),蒙古國,其他亞洲地區,1,1,0,1,1,0,0,0,0,0,0,0,0,0,0
110,私立,技專校院,1075,文藻學校財團法人文藻外語大學,碩士班(日間),澳大利亞,其他亞洲地區,1,1,0,1,1,0,0,0,0,0,0,0,0,0,0
110,私立,技專校院,1075,文藻學校財團法人文藻外語大學,碩士班(日間),大陸地區,大陸地區,3,1,2,0,0,0,0,0,0,0,0,0,3,1,2
110,私立,技專校院,1075,文藻學校財團法人文藻外語大學,碩士班(日間),日本,其他亞洲地區,4,0,4,4,0,4,0,0,0,0,0,0,0,0,0
110,私立,技專校院,1075,文藻學校財團法人文藻外語大學,碩士班(日間),尼加拉瓜,中南美洲,2,0,2,2,0,2,0,0,0,0,0,0,0,0,0
110,私立,技專校院,1075,文藻學校財團法人文藻外語大學,碩士班(日間),印度,南亞,1,1,0,1,1,0,0,0,0,0,0,0,0,0,0
110,私立,技專校院,1075,文藻學校財團法人文藻外語大學,碩士班(日間),西班牙王國,歐洲,3,0,3,3,0,3,0,0,0,0,0,0,0,0,0
110,私立,技專校院,1075,文藻學校財團法人文藻外語大學,碩士班(日間),波蘭共和國,歐洲,1,0,1,1,0,1,0,0,0,0,0,0,0,0,0
110,私立,技專校院,1075,文藻學校財團法人文藻外語大學,碩士班(日間),美國,北美洲,2,2,0,2,2,0,0,0,0,0,0,0,0,0,0
110,私立,技專校院,1075,文藻學校財團法人文藻外語大學,碩士班(日間),香港,港澳,3,0,3,0,0,0,0,0,0,3,0,3,0,0,0
110,私立,技專校院,1075,文藻學校財團法人文藻外語大學,碩士班(日間),葡萄牙共和國,歐洲,1,1,0,1,1,0,0,0,0,0,0,0,0,0,0
110,私立,技專校院,1076,華夏學校財團法人華夏科技大學,學士班(日間),大韓民國(南韓),其他亞洲地區,1,0,1,1,0,1,0,0,0,0,0,0,0,0,0
110,私立,技專校院,1076,華夏學校財團法人華夏科技大學,學士班(日間),日本,其他亞洲地區,1,1,0,1,1,0,0,0,0,0,0,0,0,0,0
110,私立,技專校院,1076,華夏學校財團法人華夏科技大學,學士班(日間),香港,港澳,6,2,4,0,0,0,0,0,0,6,2,4,0,0,0
110,私立,技專校院,1076,華夏學校財團法人華夏科技大學,學士班(日間),緬甸,東協,19,11,8,15,7,8,4,4,0,0,0,0,0,0,0
110,私立,技專校院,1076,華夏學校財團法人華夏科技大學,學士班(日間),澳門,港澳,1,1,0,0,0,0,0,0,0,1,1,0,0,0,0
110,私立,技專校院,1076,華夏學校財團法人華夏科技大學,學士班(日間),印度尼西亞共和國,東協,1,0,1,1,0,1,0,0,0,0,0,0,0,0,0
110,私立,技專校院,1076,華夏學校財團法人華夏科技大學,學士班(日間),馬來西亞,東協,2,0,2,1,0,1,1,0,1,0,0,0,0,0,0
110,私立,技專校院,1076,華夏學校財團法人華夏科技大學,學士班(日間),越南社會主義共和國,東協,113,51,62,111,49,62,2,2,0,0,0,0,0,0,0
110,私立,技專校院,1076,華夏學校財團法人華夏科技大學,碩士班(日間),香港,港澳,1,1,0,0,0,0,0,0,0,1,1,0,0,0,0
110,私立,技專校院,1076,華夏學校財團法人華夏科技大學,碩士班(日間),緬甸,東協,1,0,1,0,0,0,1,0,1,0,0,0,0,0,0
110,私立,技專校院,1077,慈濟學校財團法人慈濟科技大學,二專(日間),菲律賓共和國,東協,14,4,10,14,4,10,0,0,0,0,0,0,0,0,0
110,私立,技專校院,1077,慈濟學校財團法人慈濟科技大學,五專,泰國,東協,4,1,3,4,1,3,0,0,0,0,0,0,0,0,0
110,私立,技專校院,1077,慈濟學校財團法人慈濟科技大學,五專,馬來西亞,東協,7,4,3,7,4,3,0,0,0,0,0,0,0,0,0
110,私立,技專校院,1077,慈濟學校財團法人慈濟科技大學,學士班(日間),印度尼西亞共和國,東協,53,34,19,52,34,18,1,0,1,0,0,0,0,0,0
110,私立,技專校院,1077,慈濟學校財團法人慈濟科技大學,學士班(日間),泰國,東協,8,1,7,3,0,3,5,1,4,0,0,0,0,0,0
110,私立,技專校院,1077,慈濟學校財團法人慈濟科技大學,學士班(日間),越南社會主義共和國,東協,4,3,1,4,3,1,0,0,0,0,0,0,0,0,0
110,私立,技專校院,1077,慈濟學校財團法人慈濟科技大學,學士班(日間),尼泊爾聯邦民主共和國,南亞,1,0,1,1,0,1,0,0,0,0,0,0,0,0,0
110,私立,技專校院,1077,慈濟學校財團法人慈濟科技大學,學士班(日間),香港,港澳,2,1,1,0,0,0,0,0,0,2,1,1,0,0,0
110,私立,技專校院,1077,慈濟學校財團法人慈濟科技大學,學士班(日間),馬來西亞,東協,78,35,43,56,24,32,22,11,11,0,0,0,0,0,0
110,私立,技專校院,1077,慈濟學校財團法人慈濟科技大學,學士班(日間),菲律賓共和國,東協,2,1,1,2,1,1,0,0,0,0,0,0,0,0,0
110,私立,技專校院,1077,慈濟學校財團法人慈濟科技大學,碩士班(日間),巴基斯坦,南亞,1,1,0,1,1,0,0,0,0,0,0,0,0,0,0
110,私立,技專校院,1077,慈濟學校財團法人慈濟科技大學,碩士班(日間),馬來西亞,東協,4,3,1,3,2,1,1,1,0,0,0,0,0,0,0
110,私立,技專校院,1078,致理學校財團法人致理科技大學,學士班(日間),大陸地區,大陸地區,2,2,0,0,0,0,0,0,0,0,0,0,2,2,0
110,私立,技專校院,1078,致理學校財團法人致理科技大學,學士班(日間),印度尼西亞共和國,東協,3,2,1,0,0,0,3,2,1,0,0,0,0,0,0
110,私立,技專校院,1078,致理學校財團法人致理科技大學,學士班(日間),汶萊和平之國,東協,1,1,0,1,1,0,0,0,0,0,0,0,0,0,0
110,私立,技專校院,1078,致理學校財團法人致理科技大學,學士班(日間),南非共和國,非洲,1,1,0,0,0,0,1,1,0,0,0,0,0,0,0
110,私立,技專校院,1078,致理學校財團法人致理科技大學,學士班(日間),香港,港澳,40,24,16,0,0,0,0,0,0,40,24,16,0,0,0
110,私立,技專校院,1078,致理學校財團法人致理科技大學,學士班(日間),馬來西亞,東協,9,6,3,6,3,3,3,3,0,0,0,0,0,0,0
110,私立,技專校院,1078,致理學校財團法人致理科技大學,學士班(日間),日本,其他亞洲地區,5,4,1,5,4,1,0,0,0,0,0,0,0,0,0
110,私立,技專校院,1078,致理學校財團法人致理科技大學,學士班(日間),泰國,東協,3,0,3,1,0,1,2,0,2,0,0,0,0,0,0
110,私立,技專校院,1078,致理學校財團法人致理科技大學,學士班(日間),越南社會主義共和國,東協,214,49,165,213,49,164,1,0,1,0,0,0,0,0,0
110,私立,技專校院,1078,致理學校財團法人致理科技大學,學士班(日間),澳門,港澳,1,0,1,0,0,0,0,0,0,1,0,1,0,0,0
110,私立,技專校院,1078,致理學校財團法人致理科技大學,碩士班(日間),香港,港澳,1,0,1,0,0,0,0,0,0,1,0,1,0,0,0
110,私立,技專校院,1078,致理學校財團法人致理科技大學,碩士班(日間),越南社會主義共和國,東協,6,2,4,6,2,4,0,0,0,0,0,0,0,0,0
110,私立,一般大學,1079,康寧學校財團法人康寧大學,五專,義大利共和國,歐洲,1,0,1,1,0,1,0,0,0,0,0,0,0,0,0
110,私立,一般大學,1079,康寧學校財團法人康寧大學,五專,泰國,東協,1,0,1,1,0,1,0,0,0,0,0,0,0,0,0
110,私立,一般大學,1079,康寧學校財團法人康寧大學,五專,馬來西亞,東協,1,0,1,0,0,0,1,0,1,0,0,0,0,0,0
110,私立,一般大學,1079,康寧學校財團法人康寧大學,五專,菲律賓共和國,東協,1,0,1,1,0,1,0,0,0,0,0,0,0,0,0
110,私立,一般大學,1079,康寧學校財團法人康寧大學,學士班(日間),斯里蘭卡民主社會主義共和國,南亞,18,16,2,18,16,2,0,0,0,0,0,0,0,0,0
110,私立,一般大學,1079,康寧學校財團法人康寧大學,學士班(日間),馬來西亞,東協,1,0,1,0,0,0,1,0,1,0,0,0,0,0,0
110,私立,技專校院,1080,宏國學校財團法人宏國德霖科技大學,學士班(日間),大韓民國(南韓),其他亞洲地區,1,1,0,1,1,0,0,0,0,0,0,0,0,0,0
110,私立,技專校院,1080,宏國學校財團法人宏國德霖科技大學,學士班(日間),印度尼西亞共和國,東協,3,1,2,0,0,0,3,1,2,0,0,0,0,0,0
110,私立,技專校院,1080,宏國學校財團法人宏國德霖科技大學,學士班(日間),美國,北美洲,1,1,0,1,1,0,0,0,0,0,0,0,0,0,0
110,私立,技專校院,1080,宏國學校財團法人宏國德霖科技大學,學士班(日間),馬來西亞,東協,8,4,4,0,0,0,8,4,4,0,0,0,0,0,0
110,私立,技專校院,1080,宏國學校財團法人宏國德霖科技大學,學士班(日間),蒙古國,其他亞洲地區,3,3,0,3,3,0,0,0,0,0,0,0,0,0,0
110,私立,技專校院,1080,宏國學校財團法人宏國德霖科技大學,學士班(日間),香港,港澳,3,1,2,0,0,0,0,0,0,3,1,2,0,0,0
110,私立,技專校院,1080,宏國學校財團法人宏國德霖科技大學,學士班(日間),越南社會主義共和國,東協,88,36,52,88,36,52,0,0,0,0,0,0,0,0,0
110,私立,技專校院,1081,東方學校財團法人東方設計大學,五專,馬來西亞,東協,1,0,1,0,0,0,1,0,1,0,0,0,0,0,0
110,私立,技專校院,1081,東方學校財團法人東方設計大學,學士班(日間),緬甸,東協,34,19,15,34,19,15,0,0,0,0,0,0,0,0,0
110,私立,技專校院,1081,東方學校財團法人東方設計大學,學士班(日間),印度尼西亞共和國,東協,90,56,34,90,56,34,0,0,0,0,0,0,0,0,0
110,私立,技專校院,1081,東方學校財團法人東方設計大學,學士班(日間),香港,港澳,1,0,1,0,0,0,0,0,0,1,0,1,0,0,0
110,私立,技專校院,1081,東方學校財團法人東方設計大學,學士班(日間),馬來西亞,東協,2,2,0,0,0,0,2,2,0,0,0,0,0,0,0
110,私立,技專校院,1081,東方學校財團法人東方設計大學,學士班(日間),越南社會主義共和國,東協,9,4,5,9,4,5,0,0,0,0,0,0,0,0,0
110,私立,技專校院,1081,東方學校財團法人東方設計大學,碩士班(日間),肯亞共和國,非洲,1,1,0,1,1,0,0,0,0,0,0,0,0,0,0
110,私立,技專校院,1081,東方學校財團法人東方設計大學,碩士班(日間),越南社會主義共和國,東協,4,3,1,4,3,1,0,0,0,0,0,0,0,0,0
110,私立,技專校院,1081,東方學校財團法人東方設計大學,碩士班(日間),日本,其他亞洲地區,1,0,1,1,0,1,0,0,0,0,0,0,0,0,0
110,私立,技專校院,1081,東方學校財團法人東方設計大學,博士班,大陸地區,大陸地區,1,0,1,0,0,0,0,0,0,0,0,0,1,0,1
110,私立,技專校院,1082,崇右學校財團法人崇右影藝科技大學,學士班(日間),印度尼西亞共和國,東協,80,43,37,80,43,37,0,0,0,0,0,0,0,0,0
110,私立,技專校院,1082,崇右學校財團法人崇右影藝科技大學,學士班(日間),香港,港澳,6,3,3,0,0,0,0,0,0,6,3,3,0,0,0
110,私立,技專校院,1082,崇右學校財團法人崇右影藝科技大學,學士班(日間),越南社會主義共和國,東協,70,25,45,69,25,44,1,0,1,0,0,0,0,0,0
110,私立,技專校院,1082,崇右學校財團法人崇右影藝科技大學,學士班(日間),緬甸,東協,8,3,5,8,3,5,0,0,0,0,0,0,0,0,0
110,私立,技專校院,1082,崇右學校財團法人崇右影藝科技大學,學士班(日間),馬來西亞,東協,4,0,4,2,0,2,2,0,2,0,0,0,0,0,0
110,私立,技專校院,1082,崇右學校財團法人崇右影藝科技大學,碩士班(日間),越南社會主義共和國,東協,1,0,1,1,0,1,0,0,0,0,0,0,0,0,0
110,私立,技專校院,1083,台北海洋學校財團法人台北海洋科技大學,五專,越南社會主義共和國,東協,1,1,0,1,1,0,0,0,0,0,0,0,0,0,0
110,私立,技專校院,1083,台北海洋學校財團法人台北海洋科技大學,學士班(日間),印度尼西亞共和國,東協,35,22,13,33,20,13,2,2,0,0,0,0,0,0,0
110,私立,技專校院,1083,台北海洋學校財團法人台北海洋科技大學,學士班(日間),泰國,東協,1,0,1,0,0,0,1,0,1,0,0,0,0,0,0
110,私立,技專校院,1083,台北海洋學校財團法人台北海洋科技大學,學士班(日間),馬來西亞,東協,14,6,8,4,3,1,10,3,7,0,0,0,0,0,0
110,私立,技專校院,1083,台北海洋學校財團法人台北海洋科技大學,學士班(日間),菲律賓共和國,東協,95,34,61,95,34,61,0,0,0,0,0,0,0,0,0
110,私立,技專校院,1083,台北海洋學校財團法人台北海洋科技大學,學士班(日間),日本,其他亞洲地區,1,0,1,1,0,1,0,0,0,0,0,0,0,0,0
110,私立,技專校院,1083,台北海洋學校財團法人台北海洋科技大學,學士班(日間),香港,港澳,12,6,6,0,0,0,0,0,0,12,6,6,0,0,0
110,私立,技專校院,1083,台北海洋學校財團法人台北海洋科技大學,學士班(日間),緬甸,東協,1,0,1,0,0,0,1,0,1,0,0,0,0,0,0
110,私立,技專校院,1083,台北海洋學校財團法人台北海洋科技大學,碩士班(日間),菲律賓共和國,東協,5,0,5,5,0,5,0,0,0,0,0,0,0,0,0
110,私立,技專校院,1084,亞東學校財團法人亞東科技大學,學士班(日間),越南社會主義共和國,東協,2,2,0,1,1,0,1,1,0,0,0,0,0,0,0
110,私立,技專校院,1084,亞東學校財團法人亞東科技大學,學士班(日間),約旦哈什米王國,其他亞洲地區,1,0,1,1,0,1,0,0,0,0,0,0,0,0,0
110,私立,技專校院,1084,亞東學校財團法人亞東科技大學,碩士班(日間),伊拉克共和國,其他亞洲地區,1,1,0,1,1,0,0,0,0,0,0,0,0,0,0
110,私立,技專校院,1084,亞東學校財團法人亞東科技大學,碩士班(日間),約旦哈什米王國,其他亞洲地區,1,1,0,1,1,0,0,0,0,0,0,0,0,0,0
110,私立,一般大學,1125,中信學校財團法人中信金融管理學院,學士班(日間),日本,其他亞洲地區,2,2,0,2,2,0,0,0,0,0,0,0,0,0,0
110,私立,一般大學,1125,中信學校財團法人中信金融管理學院,學士班(日間),俄羅斯聯邦,其他亞洲地區,1,1,0,1,1,0,0,0,0,0,0,0,0,0,0
110,私立,一般大學,1125,中信學校財團法人中信金融管理學院,學士班(日間),泰國,東協,1,0,1,1,0,1,0,0,0,0,0,0,0,0,0
110,私立,一般大學,1125,中信學校財團法人中信金融管理學院,學士班(日間),馬來西亞,東協,1,1,0,1,1,0,0,0,0,0,0,0,0,0,0
110,私立,一般大學,1125,中信學校財團法人中信金融管理學院,學士班(日間),加拿大,北美洲,1,1,0,1,1,0,0,0,0,0,0,0,0,0,0
110,私立,一般大學,1125,中信學校財團法人中信金融管理學院,學士班(日間),格瑞那達,中南美洲,1,0,1,1,0,1,0,0,0,0,0,0,0,0,0
110,私立,一般大學,1125,中信學校財團法人中信金融管理學院,學士班(日間),蒙古國,其他亞洲地區,3,3,0,3,3,0,0,0,0,0,0,0,0,0,0
110,私立,一般大學,1125,中信學校財團法人中信金融管理學院,碩士班(日間),大陸地區,大陸地區,1,1,0,0,0,0,0,0,0,0,0,0,1,1,0
110,私立,一般大學,1125,中信學校財團法人中信金融管理學院,碩士班(日間),日本,其他亞洲地區,1,0,1,1,0,1,0,0,0,0,0,0,0,0,0
110,私立,一般大學,1125,中信學校財團法人中信金融管理學院,碩士班(日間),印度,南亞,1,1,0,1,1,0,0,0,0,0,0,0,0,0,0
110,私立,一般大學,1125,中信學校財團法人中信金融管理學院,碩士班(日間),俄羅斯聯邦,其他亞洲地區,1,1,0,1,1,0,0,0,0,0,0,0,0,0,0
110,私立,一般大學,1125,中信學校財團法人中信金融管理學院,碩士班(日間),泰國,東協,3,2,1,3,2,1,0,0,0,0,0,0,0,0,0
110,私立,一般大學,1125,中信學校財團法人中信金融管理學院,碩士班(日間),菲律賓共和國,東協,3,0,3,3,0,3,0,0,0,0,0,0,0,0,0
110,私立,技專校院,1159,和春技術學院,五專,越南社會主義共和國,東協,5,0,5,5,0,5,0,0,0,0,0,0,0,0,0
110,私立,技專校院,1159,和春技術學院,學士班(日間),越南社會主義共和國,東協,7,5,2,7,5,2,0,0,0,0,0,0,0,0,0
110,私立,技專校院,1168,南亞科技學校財團法人南亞技術學院,學士班(日間),越南社會主義共和國,東協,4,0,4,4,0,4,0,0,0,0,0,0,0,0,0
110,私立,技專校院,1183,黎明技術學院,學士班(日間),泰國,東協,8,5,3,1,0,1,7,5,2,0,0,0,0,0,0
110,私立,技專校院,1183,黎明技術學院,學士班(日間),印度尼西亞共和國,東協,3,1,2,1,1,0,2,0,2,0,0,0,0,0,0
110,私立,技專校院,1183,黎明技術學院,學士班(日間),香港,港澳,8,5,3,0,0,0,0,0,0,8,5,3,0,0,0
110,私立,技專校院,1183,黎明技術學院,學士班(日間),馬來西亞,東協,50,21,29,23,11,12,27,10,17,0,0,0,0,0,0
110,私立,技專校院,1183,黎明技術學院,學士班(日間),越南社會主義共和國,東協,566,328,238,483,312,171,83,16,67,0,0,0,0,0,0
110,私立,技專校院,1183,黎明技術學院,學士班(日間),緬甸,東協,17,3,14,0,0,0,17,3,14,0,0,0,0,0,0
110,私立,技專校院,1185,經國管理暨健康學院,學士班(日間),香港,港澳,2,2,0,0,0,0,0,0,0,2,2,0,0,0,0
110,私立,技專校院,1185,經國管理暨健康學院,學士班(日間),馬來西亞,東協,21,19,2,5,5,0,16,14,2,0,0,0,0,0,0
110,私立,技專校院,1185,經國管理暨健康學院,學士班(日間),越南社會主義共和國,東協,232,98,134,200,84,116,32,14,18,0,0,0,0,0,0
110,私立,技專校院,1185,經國管理暨健康學院,學士班(日間),緬甸,東協,1,0,1,1,0,1,0,0,0,0,0,0,0,0,0
110,私立,技專校院,1185,經國管理暨健康學院,學士班(日間),澳門,港澳,1,0,1,0,0,0,0,0,0,1,0,1,0,0,0
110,私立,技專校院,1185,經國管理暨健康學院,學士班(日間),泰國,東協,1,0,1,1,0,1,0,0,0,0,0,0,0,0,0
110,私立,技專校院,1188,大同技術學院,學士班(日間),巴西聯邦共和國,中南美洲,1,0,1,0,0,0,1,0,1,0,0,0,0,0,0
110,私立,技專校院,1188,大同技術學院,學士班(日間),印度尼西亞共和國,東協,17,12,5,17,12,5,0,0,0,0,0,0,0,0,0
110,私立,技專校院,1188,大同技術學院,學士班(日間),越南社會主義共和國,東協,2,0,2,2,0,2,0,0,0,0,0,0,0,0,0
110,私立,一般大學,1195,馬偕學校財團法人馬偕醫學院,學士班(日間),大韓民國(南韓),其他亞洲地區,2,1,1,0,0,0,2,1,1,0,0,0,0,0,0
110,私立,一般大學,1195,馬偕學校財團法人馬偕醫學院,學士班(日間),加拿大,北美洲,1,0,1,0,0,0,1,0,1,0,0,0,0,0,0
110,私立,一般大學,1195,馬偕學校財團法人馬偕醫學院,學士班(日間),香港,港澳,9,6,3,0,0,0,0,0,0,9,6,3,0,0,0
110,私立,一般大學,1195,馬偕學校財團法人馬偕醫學院,學士班(日間),澳門,港澳,2,0,2,0,0,0,0,0,0,2,0,2,0,0,0
110,私立,一般大學,1196,法鼓學校財團法人法鼓文理學院,學士班(日間),香港,港澳,2,0,2,0,0,0,0,0,0,2,0,2,0,0,0
110,私立,一般大學,1196,法鼓學校財團法人法鼓文理學院,學士班(日間),越南社會主義共和國,東協,13,6,7,13,6,7,0,0,0,0,0,0,0,0,0
110,私立,一般大學,1196,法鼓學校財團法人法鼓文理學院,學士班(日間),加拿大,北美洲,1,1,0,1,1,0,0,0,0,0,0,0,0,0,0
110,私立,一般大學,1196,法鼓學校財團法人法鼓文理學院,學士班(日間),印度尼西亞共和國,東協,1,0,1,1,0,1,0,0,0,0,0,0,0,0,0
110,私立,一般大學,1196,法鼓學校財團法人法鼓文理學院,學士班(日間),挪威王國,歐洲,1,1,0,1,1,0,0,0,0,0,0,0,0,0,0
110,私立,一般大學,1196,法鼓學校財團法人法鼓文理學院,學士班(日間),泰國,東協,2,2,0,2,2,0,0,0,0,0,0,0,0,0,0
110,私立,一般大學,1196,法鼓學校財團法人法鼓文理學院,碩士班(日間),大韓民國(南韓),其他亞洲地區,2,2,0,2,2,0,0,0,0,0,0,0,0,0,0
110,私立,一般大學,1196,法鼓學校財團法人法鼓文理學院,碩士班(日間),英國,歐洲,2,1,1,2,1,1,0,0,0,0,0,0,0,0,0
110,私立,一般大學,1196,法鼓學校財團法人法鼓文理學院,碩士班(日間),泰國,東協,2,1,1,2,1,1,0,0,0,0,0,0,0,0,0
110,私立,一般大學,1196,法鼓學校財團法人法鼓文理學院,碩士班(日間),馬來西亞,東協,7,2,5,6,2,4,1,0,1,0,0,0,0,0,0
110,私立,一般大學,1196,法鼓學校財團法人法鼓文理學院,碩士班(日間),荷蘭王國,歐洲,1,0,1,1,0,1,0,0,0,0,0,0,0,0,0
110,私立,一般大學,1196,法鼓學校財團法人法鼓文理學院,碩士班(日間),瑞士聯邦,歐洲,1,0,1,1,0,1,0,0,0,0,0,0,0,0,0
110,私立,一般大學,1196,法鼓學校財團法人法鼓文理學院,碩士班(日間),香港,港澳,3,2,1,0,0,0,0,0,0,3,2,1,0,0,0
110,私立,一般大學,1196,法鼓學校財團法人法鼓文理學院,碩士班(日間),越南社會主義共和國,東協,10,2,8,10,2,8,0,0,0,0,0,0,0,0,0
110,私立,一般大學,1196,法鼓學校財團法人法鼓文理學院,碩士班(日間),新加坡共和國,東協,1,1,0,1,1,0,0,0,0,0,0,0,0,0,0
110,私立,一般大學,1196,法鼓學校財團法人法鼓文理學院,碩士班(日間),德意志聯邦共和國,歐洲,1,1,0,1,1,0,0,0,0,0,0,0,0,0,0
110,私立,一般大學,1196,法鼓學校財團法人法鼓文理學院,碩士班(日間),澳門,港澳,1,0,1,0,0,0,0,0,0,1,0,1,0,0,0
110,私立,一般大學,1196,法鼓學校財團法人法鼓文理學院,博士班,大陸地區,大陸地區,1,1,0,0,0,0,0,0,0,0,0,0,1,1,0
110,私立,一般大學,1196,法鼓學校財團法人法鼓文理學院,博士班,波蘭共和國,歐洲,1,1,0,1,1,0,0,0,0,0,0,0,0,0,0
110,私立,一般大學,1196,法鼓學校財團法人法鼓文理學院,博士班,香港,港澳,1,1,0,0,0,0,0,0,0,1,1,0,0,0,0
110,私立,一般大學,1196,法鼓學校財團法人法鼓文理學院,博士班,馬來西亞,東協,1,1,0,1,1,0,0,0,0,0,0,0,0,0,0
110,私立,技專校院,1284,樹人醫護管理專科學校,五專,尼加拉瓜,中南美洲,2,1,1,2,1,1,0,0,0,0,0,0,0,0,0
110,私立,技專校院,1285,慈惠醫護管理專科學校,五專,緬甸,東協,2,1,1,0,0,0,2,1,1,0,0,0,0,0,0
110,私立,技專校院,1286,耕莘健康管理專科學校,五專,馬來西亞,東協,1,0,1,1,0,1,0,0,0,0,0,0,0,0,0
110,私立,技專校院,1287,敏惠醫護管理專科學校,五專,菲律賓共和國,東協,1,0,1,1,0,1,0,0,0,0,0,0,0,0,0
110,私立,技專校院,1289,育英醫護管理專科學校,五專,日本,其他亞洲地區,1,0,1,0,0,0,1,0,1,0,0,0,0,0,0
110,私立,宗教研修學院,1R02,學校財團法人中華浸信會基督教台灣浸會神學院,碩士班(日間),香港,港澳,1,0,1,0,0,0,0,0,0,1,0,1,0,0,0
110,私立,宗教研修學院,1R03,臺北基督學院,學士班(日間),日本,其他亞洲地區,1,0,1,1,0,1,0,0,0,0,0,0,0,0,0
110,私立,宗教研修學院,1R03,臺北基督學院,學士班(日間),香港,港澳,1,1,0,0,0,0,0,0,0,1,1,0,0,0,0
110,私立,宗教研修學院,1R03,臺北基督學院,學士班(日間),馬來西亞,東協,1,0,1,0,0,0,1,0,1,0,0,0,0,0,0
110,私立,宗教研修學院,1R04,財團法人一貫道天皇基金會一貫道天皇學院,學士班(日間),馬來西亞,東協,2,1,1,2,1,1,0,0,0,0,0,0,0,0,0
110,私立,宗教研修學院,1R04,財團法人一貫道天皇基金會一貫道天皇學院,碩士班(日間),馬來西亞,東協,1,1,0,1,1,0,0,0,0,0,0,0,0,0,0
110,私立,宗教研修學院,1R05,台神學校財團法人台灣神學研究學院,碩士班(日間),香港,港澳,2,1,1,0,0,0,0,0,0,2,1,1,0,0,0
110,私立,宗教研修學院,1R05,台神學校財團法人台灣神學研究學院,碩士班(日間),馬來西亞,東協,6,1,5,6,1,5,0,0,0,0,0,0,0,0,0
110,私立,宗教研修學院,1R06,一貫道崇德學院,碩士班(日間),美國,北美洲,1,0,1,0,0,0,1,0,1,0,0,0,0,0,0
110,私立,宗教研修學院,1R06,一貫道崇德學院,碩士班(日間),泰國,東協,1,0,1,1,0,1,0,0,0,0,0,0,0,0,0
110,私立,宗教研修學院,1R06,一貫道崇德學院,碩士班(日間),馬來西亞,東協,1,0,1,1,0,1,0,0,0,0,0,0,0,0,0
110,私立,宗教研修學院,1R06,一貫道崇德學院,碩士班(日間),加拿大,北美洲,1,1,0,0,0,0,1,1,0,0,0,0,0,0,0
110,私立,宗教研修學院,1R06,一貫道崇德學院,碩士班(日間),印度尼西亞共和國,東協,2,0,2,1,0,1,1,0,1,0,0,0,0,0,0
110,私立,宗教研修學院,1R06,一貫道崇德學院,碩士班(日間),越南社會主義共和國,東協,2,0,2,2,0,2,0,0,0,0,0,0,0,0,0
110,公立,一般大學,3002,臺北市立大學,學士班(日間),土耳其共和國,其他亞洲地區,1,0,1,1,0,1,0,0,0,0,0,0,0,0,0
110,公立,一般大學,3002,臺北市立大學,學士班(日間),大陸地區,大陸地區,2,1,1,0,0,0,0,0,0,0,0,0,2,1,1
110,公立,一般大學,3002,臺北市立大學,學士班(日間),大韓民國(南韓),其他亞洲地區,4,0,4,4,0,4,0,0,0,0,0,0,0,0,0
110,公立,一般大學,3002,臺北市立大學,學士班(日間),厄瓜多共和國,中南美洲,1,0,1,0,0,0,1,0,1,0,0,0,0,0,0
110,公立,一般大學,3002,臺北市立大學,學士班(日間),日本,其他亞洲地區,6,2,4,4,1,3,2,1,1,0,0,0,0,0,0
110,公立,一般大學,3002,臺北市立大學,學士班(日間),印度尼西亞共和國,東協,3,1,2,0,0,0,3,1,2,0,0,0,0,0,0
110,公立,一般大學,3002,臺北市立大學,學士班(日間),法國,歐洲,1,1,0,1,1,0,0,0,0,0,0,0,0,0,0
110,公立,一般大學,3002,臺北市立大學,學士班(日間),香港,港澳,40,21,19,0,0,0,0,0,0,40,21,19,0,0,0
110,公立,一般大學,3002,臺北市立大學,學士班(日間),馬來西亞,東協,42,16,26,6,2,4,36,14,22,0,0,0,0,0,0
110,公立,一般大學,3002,臺北市立大學,學士班(日間),越南社會主義共和國,東協,11,6,5,3,1,2,8,5,3,0,0,0,0,0,0
110,公立,一般大學,3002,臺北市立大學,學士班(日間),緬甸,東協,10,3,7,0,0,0,10,3,7,0,0,0,0,0,0
110,公立,一般大學,3002,臺北市立大學,學士班(日間),澳門,港澳,11,7,4,0,0,0,0,0,0,11,7,4,0,0,0
110,公立,一般大學,3002,臺北市立大學,學士班(日間),美國,北美洲,1,1,0,0,0,0,1,1,0,0,0,0,0,0,0
110,公立,一般大學,3002,臺北市立大學,學士班(日間),泰國,東協,1,1,0,0,0,0,1,1,0,0,0,0,0,0,0
110,公立,一般大學,3002,臺北市立大學,學士班(日間),模里西斯共和國,非洲,1,1,0,0,0,0,1,1,0,0,0,0,0,0,0
110,公立,一般大學,3002,臺北市立大學,碩士班(日間),泰國,東協,1,0,1,1,0,1,0,0,0,0,0,0,0,0,0
110,公立,一般大學,3002,臺北市立大學,碩士班(日間),義大利共和國,歐洲,1,0,1,0,0,0,1,0,1,0,0,0,0,0,0
110,公立,一般大學,3002,臺北市立大學,碩士班(日間),大陸地區,大陸地區,6,2,4,0,0,0,0,0,0,0,0,0,6,2,4
110,公立,一般大學,3002,臺北市立大學,碩士班(日間),大韓民國(南韓),其他亞洲地區,1,0,1,1,0,1,0,0,0,0,0,0,0,0,0
110,公立,一般大學,3002,臺北市立大學,碩士班(日間),日本,其他亞洲地區,1,0,1,1,0,1,0,0,0,0,0,0,0,0,0
110,公立,一般大學,3002,臺北市立大學,碩士班(日間),貝里斯,中南美洲,1,1,0,1,1,0,0,0,0,0,0,0,0,0,0
110,公立,一般大學,3002,臺北市立大學,碩士班(日間),南非共和國,非洲,1,0,1,0,0,0,1,0,1,0,0,0,0,0,0
110,公立,一般大學,3002,臺北市立大學,碩士班(日間),英國,歐洲,1,1,0,1,1,0,0,0,0,0,0,0,0,0,0
110,公立,一般大學,3002,臺北市立大學,碩士班(日間),香港,港澳,16,7,9,0,0,0,0,0,0,16,7,9,0,0,0
110,公立,一般大學,3002,臺北市立大學,碩士班(日間),馬來西亞,東協,17,9,8,0,0,0,17,9,8,0,0,0,0,0,0
110,公立,一般大學,3002,臺北市立大學,碩士班(日間),越南社會主義共和國,東協,3,1,2,3,1,2,0,0,0,0,0,0,0,0,0
110,公立,一般大學,3002,臺北市立大學,碩士班(日間),澳門,港澳,2,1,1,0,0,0,0,0,0,2,1,1,0,0,0
110,公立,一般大學,3002,臺北市立大學,博士班,大陸地區,大陸地區,11,3,8,0,0,0,0,0,0,0,0,0,11,3,8
110,公立,一般大學,3002,臺北市立大學,博士班,香港,港澳,1,0,1,0,0,0,0,0,0,1,0,1,0,0,0
110,公立,一般大學,3002,臺北市立大學,博士班,印度尼西亞共和國,東協,1,0,1,1,0,1,0,0,0,0,0,0,0,0,0
110,公立,一般大學,3002,臺北市立大學,博士班,泰國,東協,3,1,2,3,1,2,0,0,0,0,0,0,0,0,0
110,公立,一般大學,3002,臺北市立大學,博士班,馬來西亞,東協,1,1,0,0,0,0,1,1,0,0,0,0,0,0,0
110,公立,一般大學,3002,臺北市立大學,博士班,捷克共和國,歐洲,1,1,0,1,1,0,0,0,0,0,0,0,0,0,0
