學年度,設立別,學校類別,學校統計處代碼,學校名稱,專任教師數-教師總數,專任教師數-教師總數男,專任教師數-教師總數女,專任教師數-教授男,專任教師數-教授女,專任教師數-副教授男,專任教師數-副教授女,專任教師數-助理教授男,專任教師數-助理教授女,專任教師數-講師男,專任教師數-講師女,專任教師數-其他教師男,專任教師數-其他教師女,專任助理教授以上總人數,專任助理教授以上總人數男,專任助理教授以上總人數女,專任講師以上總人數,專任講師以上總人數男,專任講師以上總人數女
106,公立,一般大學,0001,國立政治大學,722,429,293,202,110,137,94,76,48,12,18,2,23,667,415,252,697,427,270
106,公立,一般大學,0002,國立清華大學,824,574,250,361,83,142,106,66,51,2,8,3,2,809,569,240,819,571,248
106,公立,一般大學,0003,國立臺灣大學,2045,1437,608,880,266,315,164,225,151,15,14,2,13,2001,1420,581,2030,1435,595
106,公立,一般大學,0004,國立臺灣師範大學,826,473,353,274,145,124,120,59,58,14,18,2,12,780,457,323,812,471,341
106,公立,一般大學,0005,國立成功大學,1326,993,333,541,110,267,109,161,91,13,12,11,11,1279,969,310,1304,982,322
106,公立,一般大學,0006,國立中興大學,769,600,169,333,66,151,42,96,39,11,10,9,12,727,580,147,748,591,157
106,公立,一般大學,0007,國立陽明交通大學,722,592,130,349,48,137,37,96,35,6,8,4,2,702,582,120,716,588,128
106,公立,一般大學,0008,國立中央大學,653,517,136,280,51,147,39,81,22,7,15,2,9,620,508,112,642,515,127
106,公立,一般大學,0009,國立中山大學,509,381,128,198,50,87,29,90,44,3,0,3,5,498,375,123,501,378,123
106,公立,一般大學,0012,國立臺灣海洋大學,414,347,67,158,20,95,22,84,14,6,1,4,10,393,337,56,400,343,57
106,公立,一般大學,0013,國立中正大學,542,393,149,205,62,125,53,57,26,4,7,2,1,528,387,141,539,391,148
106,公立,一般大學,0014,國立高雄師範大學,290,175,115,88,40,64,44,21,25,0,1,2,5,282,173,109,283,173,110
106,公立,一般大學,0015,國立彰化師範大學,373,253,120,137,50,75,41,38,24,3,4,0,1,365,250,115,372,253,119
106,公立,一般大學,0016,國立陽明大學,398,241,157,125,71,66,47,39,31,6,2,5,6,379,230,149,387,236,151
106,公立,一般大學,0017,國立臺北大學,380,231,149,98,37,65,46,59,50,6,6,3,10,355,222,133,367,228,139
106,公立,一般大學,0018,國立嘉義大學,515,358,157,148,46,110,54,82,38,12,11,6,8,478,340,138,501,352,149
106,公立,一般大學,0019,國立高雄大學,235,179,56,86,17,52,24,37,14,3,0,1,1,230,175,55,233,178,55
106,公立,一般大學,0020,國立東華大學,492,315,177,132,50,123,85,43,32,17,10,0,0,465,298,167,492,315,177
106,公立,一般大學,0021,國立暨南國際大學,268,175,93,82,21,65,50,21,16,6,5,1,1,255,168,87,266,174,92
106,公立,技專校院,0022,國立臺灣科技大學,458,373,85,201,28,108,30,55,19,6,5,3,3,441,364,77,452,370,82
106,公立,技專校院,0023,國立雲林科技大學,365,292,73,122,15,112,26,44,19,12,4,2,9,338,278,60,354,290,64
106,公立,技專校院,0024,國立屏東科技大學,398,280,118,119,30,93,46,53,26,12,13,3,3,367,265,102,392,277,115
106,公立,技專校院,0025,國立臺北科技大學,470,384,86,168,17,129,29,66,26,12,6,9,8,435,363,72,453,375,78
106,公立,技專校院,0026,國立高雄第一科技大學,269,198,71,81,17,67,26,44,18,5,8,1,2,253,192,61,266,197,69
106,公立,技專校院,0027,國立高雄應用科技大學,351,275,76,112,12,100,31,50,18,6,4,7,11,323,262,61,333,268,65
106,公立,一般大學,0028,國立臺北藝術大學,160,81,79,21,18,26,31,22,14,10,4,2,12,132,69,63,146,79,67
106,公立,一般大學,0029,國立臺灣藝術大學,162,98,64,41,21,31,27,20,10,6,3,0,3,150,92,58,159,98,61
106,公立,一般大學,0030,國立臺東大學,192,129,63,29,10,50,24,37,18,9,9,4,2,168,116,52,186,125,61
106,公立,一般大學,0031,國立宜蘭大學,233,180,53,81,10,57,16,26,13,13,12,3,2,203,164,39,228,177,51
106,公立,一般大學,0032,國立聯合大學,288,217,71,64,12,102,29,34,20,15,9,2,1,261,200,61,285,215,70
106,公立,技專校院,0033,國立虎尾科技大學,329,268,61,90,4,100,30,68,19,8,6,2,2,311,258,53,325,266,59
106,公立,技專校院,0034,國立高雄海洋科技大學,230,173,57,49,7,79,27,31,13,9,9,5,1,206,159,47,224,168,56
106,公立,一般大學,0035,國立臺南藝術大學,105,55,50,17,10,15,17,20,21,3,2,0,0,100,52,48,105,55,50
106,公立,一般大學,0036,國立臺南大學,237,137,100,66,36,53,41,15,20,1,0,2,3,231,134,97,232,135,97
106,公立,一般大學,0037,國立臺北教育大學,223,118,105,64,39,25,35,23,26,6,2,0,3,212,112,100,220,118,102
106,公立,一般大學,0039,國立臺中教育大學,199,115,84,48,25,37,33,27,17,1,6,2,3,187,112,75,194,113,81
106,公立,技專校院,0042,國立澎湖科技大學,123,83,40,22,4,27,17,28,15,5,4,1,0,113,77,36,122,82,40
106,公立,技專校院,0043,國立勤益科技大學,281,215,66,75,17,87,29,36,13,12,5,5,2,257,198,59,274,210,64
106,公立,一般大學,0044,國立體育大學,101,71,30,24,4,23,15,13,5,3,5,8,1,84,60,24,92,63,29
106,公立,技專校院,0046,國立臺北護理健康大學,174,46,128,13,23,18,34,13,35,1,11,1,25,136,44,92,148,45,103
106,公立,技專校院,0047,國立高雄餐旅大學,149,98,51,20,11,40,23,30,10,5,6,3,1,134,90,44,145,95,50
106,公立,一般大學,0048,國立金門大學,149,108,41,17,0,51,26,36,15,2,0,2,0,145,104,41,147,106,41
106,公立,一般大學,0049,國立臺灣體育運動大學,108,74,34,15,6,21,13,23,7,6,5,9,3,85,59,26,96,65,31
106,公立,技專校院,0050,國立臺中科技大學,405,173,232,47,32,74,72,40,71,9,25,3,32,336,161,175,370,170,200
106,公立,技專校院,0051,國立臺北商業大學,208,112,96,25,10,48,42,19,15,11,21,9,8,159,92,67,191,103,88
106,公立,一般大學,0052,國立屏東大學,339,204,135,50,24,86,62,53,34,13,8,2,7,309,189,120,330,202,128
106,公立,技專校院,0144,國立臺灣戲曲學院,34,17,17,2,1,5,6,5,6,4,3,1,1,25,12,13,32,16,16
106,公立,技專校院,0221,國立臺南護理專科學校,85,18,67,3,1,7,8,8,15,0,15,0,28,42,18,24,57,18,39
106,公立,技專校院,0222,國立臺東專科學校,64,45,19,7,1,8,2,22,7,7,9,1,0,47,37,10,63,44,19
106,私立,一般大學,1001,東海大學,533,365,168,127,22,121,55,83,65,19,18,15,8,473,331,142,510,350,160
106,私立,一般大學,1002,輔仁大學,698,389,309,101,62,158,115,109,101,11,23,10,8,646,368,278,680,379,301
106,私立,一般大學,1003,東吳大學,435,251,184,106,43,78,82,43,35,18,22,6,2,387,227,160,427,245,182
106,私立,一般大學,1004,中原大學,482,345,137,125,19,103,56,93,51,9,9,15,2,447,321,126,465,330,135
106,私立,一般大學,1005,淡江大學學校財團法人淡江大學,759,479,280,167,45,198,127,73,83,19,14,22,11,693,438,255,726,457,269
106,私立,一般大學,1006,中國文化大學,746,474,272,141,44,183,114,119,88,24,17,7,9,689,443,246,730,467,263
106,私立,一般大學,1007,逢甲大學,649,506,143,166,28,194,48,111,49,23,12,12,6,596,471,125,631,494,137
106,私立,一般大學,1008,靜宜大學,368,223,145,61,24,76,57,62,44,21,18,3,2,324,199,125,363,220,143
106,私立,一般大學,1009,長庚大學,596,418,178,142,46,134,41,124,79,15,11,3,1,566,400,166,592,415,177
106,私立,一般大學,1010,元智大學,309,220,89,79,13,70,34,60,38,8,3,3,1,294,209,85,305,217,88
106,私立,一般大學,1011,中華大學學校財團法人中華大學,255,165,90,55,14,61,29,41,22,6,23,2,2,222,157,65,251,163,88
106,私立,一般大學,1012,大葉大學,336,226,110,44,8,82,37,83,49,10,14,7,2,303,209,94,327,219,108
106,私立,一般大學,1013,華梵大學,109,82,27,16,2,33,12,25,10,7,2,1,1,98,74,24,107,81,26
106,私立,一般大學,1014,義守大學,488,332,156,88,23,137,41,91,76,11,13,5,3,456,316,140,480,327,153
106,私立,一般大學,1015,世新大學,326,194,132,51,26,68,60,49,33,23,10,3,3,287,168,119,320,191,129
106,私立,一般大學,1016,銘傳大學,591,353,238,82,26,137,104,109,91,22,15,3,2,549,328,221,586,350,236
106,私立,一般大學,1017,實踐大學,399,223,176,36,13,77,44,90,87,14,29,6,3,347,203,144,390,217,173
106,私立,技專校院,1018,朝陽科技大學,400,265,135,49,15,100,52,96,48,14,16,6,4,360,245,115,390,259,131
106,私立,一般大學,1019,高雄醫學大學,557,360,197,136,47,108,55,105,84,11,9,0,2,535,349,186,555,360,195
106,私立,一般大學,1020,南華大學,217,142,75,31,5,55,27,55,42,1,0,0,1,215,141,74,216,142,74
106,私立,一般大學,1021,真理大學,280,179,101,33,2,73,41,59,38,13,17,1,3,246,165,81,276,178,98
106,私立,一般大學,1022,大同大學,165,125,40,55,7,36,12,19,13,14,8,1,0,142,110,32,164,124,40
106,私立,技專校院,1023,南臺學校財團法人南臺科技大學,578,410,168,85,11,170,49,110,68,34,38,11,2,493,365,128,565,399,166
106,私立,技專校院,1024,崑山科技大學,359,262,97,60,3,101,45,72,35,26,13,3,1,316,233,83,355,259,96
106,私立,技專校院,1025,嘉藥學校財團法人嘉南藥理大學,478,284,194,50,20,109,70,101,86,19,15,5,3,436,260,176,470,279,191
106,私立,技專校院,1026,樹德科技大學,281,184,97,25,3,54,15,94,70,10,8,1,1,261,173,88,279,183,96
106,私立,一般大學,1027,慈濟學校財團法人慈濟大學,251,127,124,30,19,53,47,36,48,8,9,0,1,233,119,114,250,127,123
106,私立,一般大學,1028,臺北醫學大學,620,410,210,129,48,122,70,142,86,17,4,0,2,597,393,204,618,410,208
106,私立,一般大學,1029,中山醫學大學,399,243,156,101,41,67,54,58,51,14,9,3,1,372,226,146,395,240,155
106,私立,技專校院,1030,龍華科技大學,242,189,53,35,4,72,16,58,20,20,12,4,1,205,165,40,237,185,52
106,私立,技專校院,1031,輔英科技大學,331,102,229,14,3,42,43,33,73,8,42,5,68,208,89,119,258,97,161
106,私立,技專校院,1032,明新學校財團法人明新科技大學,372,245,127,34,4,100,38,64,43,42,36,5,6,283,198,85,361,240,121
106,私立,一般大學,1033,長榮大學,350,201,149,37,11,61,47,93,77,9,11,1,3,326,191,135,346,200,146
106,私立,技專校院,1034,弘光科技大學,322,123,199,34,16,44,54,36,53,4,30,5,46,237,114,123,271,118,153
106,私立,一般大學,1035,中國醫藥大學,484,332,152,134,39,108,68,87,42,3,2,0,1,478,329,149,483,332,151
106,私立,技專校院,1036,健行學校財團法人健行科技大學,299,210,89,29,1,91,23,56,43,27,21,7,1,243,176,67,291,203,88
106,私立,技專校院,1037,正修學校財團法人正修科技大學,437,313,124,63,7,125,46,76,40,41,27,8,4,357,264,93,425,305,120
106,私立,技專校院,1038,萬能學校財團法人萬能科技大學,248,170,78,20,3,56,22,60,26,34,24,0,3,187,136,51,245,170,75
106,私立,一般大學,1039,玄奘大學,143,87,56,6,3,20,10,50,32,11,11,0,0,121,76,45,143,87,56
106,私立,技專校院,1040,建國科技大學,263,185,78,20,2,82,21,54,36,26,17,3,2,215,156,59,258,182,76
106,私立,技專校院,1041,明志科技大學,196,166,30,31,4,61,10,53,11,18,4,3,1,170,145,25,192,163,29
106,私立,技專校院,1042,高苑科技大學,264,204,60,29,1,86,19,65,16,21,24,3,0,216,180,36,261,201,60
106,私立,技專校院,1043,大仁科技大學,250,149,101,24,3,66,29,33,30,25,38,1,1,185,123,62,248,148,100
106,私立,技專校院,1044,聖約翰科技大學,187,144,43,24,0,62,12,37,19,19,11,2,1,154,123,31,184,142,42
106,私立,技專校院,1045,嶺東科技大學,264,152,112,16,6,61,49,54,33,18,21,3,3,219,131,88,258,149,109
106,私立,技專校院,1046,中國科技大學,305,207,98,15,2,49,28,95,33,45,31,3,4,222,159,63,298,204,94
106,私立,技專校院,1047,中臺科技大學,275,129,146,22,14,54,41,37,44,13,24,3,23,212,113,99,249,126,123
106,私立,一般大學,1048,亞洲大學,400,256,144,76,22,87,40,71,68,19,12,3,2,364,234,130,395,253,142
106,私立,一般大學,1049,開南大學,258,166,92,22,10,70,25,66,51,7,6,1,0,244,158,86,257,165,92
106,私立,一般大學,1050,佛光大學,176,117,59,25,7,48,19,41,28,2,5,1,0,168,114,54,175,116,59
106,私立,技專校院,1051,台南家專學校財團法人台南應用科技大學,333,160,173,19,8,50,55,67,68,20,42,4,0,267,136,131,329,156,173
106,私立,技專校院,1052,遠東科技大學,232,172,60,28,0,57,16,69,26,17,16,1,2,196,154,42,229,171,58
106,私立,技專校院,1053,光宇學校財團法人元培醫事科技大學,220,125,95,18,7,40,22,46,41,19,21,2,4,174,104,70,214,123,91
106,私立,技專校院,1054,景文科技大學,201,115,86,8,5,43,28,38,24,21,27,5,2,146,89,57,194,110,84
106,私立,技專校院,1055,中華醫事科技大學,299,121,178,21,6,38,53,43,50,16,37,3,32,211,102,109,264,118,146
106,私立,技專校院,1056,東南科技大學,210,155,55,16,1,59,16,53,21,27,16,0,1,166,128,38,209,155,54
106,私立,技專校院,1057,德明財經科技大學,236,117,119,10,4,50,31,42,46,15,38,0,0,183,102,81,236,117,119
106,私立,一般大學,1058,明道學校財團法人明道大學,130,88,42,8,2,22,7,52,31,4,2,2,0,122,82,40,128,86,42
106,私立,技專校院,1060,南開科技大學,195,157,38,29,1,60,16,41,16,24,4,3,1,163,130,33,191,154,37
106,私立,技專校院,1061,中華學校財團法人中華科技大學,231,175,56,15,0,55,11,55,24,47,20,3,1,160,125,35,227,172,55
106,私立,技專校院,1062,僑光科技大學,227,139,88,9,2,52,28,50,22,26,32,2,4,163,111,52,221,137,84
106,私立,技專校院,1063,廣亞學校財團法人育達科技大學,129,70,59,8,0,16,12,31,32,13,13,2,2,99,55,44,125,68,57
106,私立,技專校院,1064,美和學校財團法人美和科技大學,231,88,143,8,0,33,23,32,48,13,27,2,45,144,73,71,184,86,98
106,私立,技專校院,1065,吳鳳科技大學,163,114,49,9,0,53,6,30,20,20,21,2,2,118,92,26,159,112,47
106,私立,技專校院,1066,環球學校財團法人環球科技大學,181,112,69,10,2,26,11,51,35,22,19,3,2,135,87,48,176,109,67
106,私立,一般大學,1067,台灣首府學校財團法人台灣首府大學,105,75,30,3,1,22,0,45,22,2,6,3,1,93,70,23,101,72,29
106,私立,技專校院,1068,中州學校財團法人中州科技大學,123,76,47,6,0,30,7,34,20,6,20,0,0,97,70,27,123,76,47
106,私立,技專校院,1069,修平學校財團法人修平科技大學,203,156,47,22,0,56,10,54,21,22,13,2,3,163,132,31,198,154,44
106,私立,技專校院,1070,長庚學校財團法人長庚科技大學,348,59,289,12,13,22,57,13,67,9,62,3,90,184,47,137,255,56,199
106,私立,技專校院,1071,城市學校財團法人臺北城市科技大學,248,165,83,8,0,68,21,52,21,32,34,5,7,170,128,42,236,160,76
106,私立,技專校院,1072,大華學校財團法人敏實科技大學,110,69,41,6,1,23,17,14,11,24,12,2,0,72,43,29,108,67,41
106,私立,技專校院,1073,醒吾學校財團法人醒吾科技大學,243,124,119,16,2,37,37,46,29,22,51,3,0,167,99,68,240,121,119
106,私立,技專校院,1074,南榮學校財團法人南榮科技大學,103,68,35,4,0,25,9,18,13,20,12,1,1,69,47,22,101,67,34
106,私立,技專校院,1075,文藻學校財團法人文藻外語大學,270,113,157,16,9,35,44,50,68,11,34,1,2,222,101,121,267,112,155
106,私立,技專校院,1076,華夏學校財團法人華夏科技大學,161,116,45,12,0,51,11,24,16,27,14,2,4,114,87,27,155,114,41
106,私立,技專校院,1077,慈濟學校財團法人慈濟科技大學,155,48,107,6,1,16,23,22,35,4,38,0,10,103,44,59,145,48,97
106,私立,技專校院,1078,致理學校財團法人致理科技大學,275,130,145,15,4,48,62,47,50,19,25,1,4,226,110,116,270,129,141
106,私立,一般大學,1079,康寧學校財團法人康寧大學,162,78,84,9,3,13,12,28,32,26,36,2,1,97,50,47,159,76,83
106,私立,技專校院,1080,宏國學校財團法人宏國德霖科技大學,201,143,58,10,1,45,11,48,23,38,23,2,0,138,103,35,199,141,58
106,私立,技專校院,1081,東方學校財團法人東方設計大學,156,105,51,13,0,37,8,39,21,10,19,6,3,118,89,29,147,99,48
106,私立,技專校院,1082,崇右學校財團法人崇右影藝科技大學,99,59,40,8,0,16,14,24,12,10,14,1,0,74,48,26,98,58,40
106,私立,技專校院,1083,台北海洋學校財團法人台北海洋科技大學,162,86,76,2,0,18,17,49,40,13,16,4,3,126,69,57,155,82,73
106,私立,一般大學,1125,中信學校財團法人中信金融管理學院,38,28,10,7,2,3,2,14,5,4,1,0,0,33,24,9,38,28,10
106,私立,技專校院,1148,大漢技術學院,57,39,18,3,0,14,7,15,2,7,9,0,0,41,32,9,57,39,18
106,私立,技專校院,1159,和春技術學院,108,73,35,4,0,12,3,45,22,9,9,3,1,86,61,25,104,70,34
106,私立,技專校院,1166,亞東技術學院,162,117,45,16,1,48,13,37,18,15,9,1,4,133,101,32,157,116,41
106,私立,技專校院,1168,南亞科技學校財團法人南亞技術學院,142,89,53,12,1,24,13,24,13,25,26,4,0,87,60,27,138,85,53
106,私立,一般大學,1176,稻江科技暨管理學院,60,35,25,0,1,7,5,21,15,6,4,1,0,49,28,21,59,34,25
106,私立,技專校院,1182,蘭陽技術學院,84,56,28,0,1,12,3,21,1,22,23,1,0,38,33,5,83,55,28
106,私立,技專校院,1183,黎明技術學院,154,107,47,7,0,36,7,26,12,36,27,2,1,88,69,19,151,105,46
106,私立,技專校院,1185,經國管理暨健康學院,141,51,90,1,0,18,18,21,25,8,28,3,19,83,40,43,119,48,71
106,私立,技專校院,1188,大同技術學院,66,34,32,2,1,9,12,17,14,4,3,2,2,55,28,27,62,32,30
106,私立,技專校院,1189,亞太學校財團法人亞太創意技術學院,57,31,26,1,0,12,2,8,7,10,16,0,1,30,21,9,56,31,25
106,私立,技專校院,1192,臺灣觀光學院,44,28,16,1,0,4,3,17,6,5,6,1,1,31,22,9,42,27,15
106,私立,一般大學,1195,馬偕學校財團法人馬偕醫學院,103,68,35,12,3,20,7,35,22,1,3,0,0,99,67,32,103,68,35
106,私立,一般大學,1196,法鼓學校財團法人法鼓文理學院,20,15,5,3,0,5,3,7,2,0,0,0,0,20,15,5,20,15,5
106,私立,技專校院,1282,馬偕學校財團法人馬偕醫護管理專科學校,141,47,94,4,0,10,4,21,19,7,49,5,22,58,35,23,114,42,72
106,私立,技專校院,1283,仁德醫護管理專科學校,203,73,130,2,0,3,1,18,22,43,63,7,44,46,23,23,152,66,86
106,私立,技專校院,1284,樹人醫護管理專科學校,210,60,150,3,0,2,1,22,25,26,85,7,39,53,27,26,164,53,111
106,私立,技專校院,1285,慈惠醫護管理專科學校,170,48,122,1,0,2,0,14,16,23,63,8,43,33,17,16,119,40,79
106,私立,技專校院,1286,耕莘健康管理專科學校,181,38,143,0,0,7,5,14,20,12,89,5,29,46,21,25,147,33,114
106,私立,技專校院,1287,敏惠醫護管理專科學校,124,28,96,1,0,4,0,8,9,10,65,5,22,22,13,9,97,23,74
106,私立,技專校院,1288,高美醫護管理專科學校,27,13,14,0,0,0,0,5,1,6,8,2,5,6,5,1,20,11,9
106,私立,技專校院,1289,育英醫護管理專科學校,71,13,58,0,0,1,1,4,4,5,30,3,23,10,5,5,45,10,35
106,私立,技專校院,1290,崇仁醫護管理專科學校,130,28,102,1,1,4,1,5,10,15,59,3,31,22,10,12,96,25,71
106,私立,技專校院,1291,聖母醫護管理專科學校,111,35,76,1,0,5,2,12,10,12,51,5,13,30,18,12,93,30,63
106,私立,技專校院,1292,新生醫護管理專科學校,213,47,166,2,0,3,3,19,32,16,95,7,36,59,24,35,170,40,130
106,私立,宗教研修學院,1R02,學校財團法人中華浸信會基督教台灣浸會神學院,10,6,4,2,0,1,0,3,4,0,0,0,0,10,6,4,10,6,4
106,私立,宗教研修學院,1R03,臺北基督學院,12,5,7,0,1,0,0,4,4,1,2,0,0,9,4,5,12,5,7
106,私立,宗教研修學院,1R04,財團法人一貫道天皇基金會一貫道天皇學院,9,6,3,2,0,1,2,3,0,0,1,0,0,8,6,2,9,6,3
106,私立,宗教研修學院,1R05,台神學校財團法人台灣神學研究學院,14,8,6,1,2,0,2,7,2,0,0,0,0,14,8,6,14,8,6
106,私立,宗教研修學院,1R06,一貫道崇德學院,5,3,2,1,0,2,1,0,1,0,0,0,0,5,3,2,5,3,2
106,公立,一般大學,3002,臺北市立大學,331,180,151,54,45,79,48,28,43,9,8,10,7,297,161,136,314,170,144
107,公立,一般大學,0001,國立政治大學,714,417,297,197,113,143,92,64,52,11,18,2,22,661,404,257,690,415,275
107,公立,一般大學,0002,國立清華大學,823,570,253,359,86,146,107,61,50,1,8,3,2,809,566,243,818,567,251
107,公立,一般大學,0003,國立臺灣大學,2043,1423,620,880,273,311,175,215,147,16,13,1,12,2001,1406,595,2030,1422,608
107,公立,一般大學,0004,國立臺灣師範大學,839,485,354,282,156,123,117,62,51,16,19,2,11,791,467,324,826,483,343
107,公立,一般大學,0005,國立成功大學,1325,998,327,545,113,274,115,153,76,18,12,8,11,1276,972,304,1306,990,316
107,公立,一般大學,0006,國立中興大學,775,601,174,330,67,150,42,104,43,9,11,8,11,736,584,152,756,593,163
107,公立,一般大學,0007,國立陽明交通大學,735,604,131,351,50,136,35,107,36,6,7,4,3,715,594,121,728,600,128
107,公立,一般大學,0008,國立中央大學,645,510,135,282,52,142,39,77,22,7,15,2,7,614,501,113,636,508,128
107,公立,一般大學,0009,國立中山大學,522,390,132,193,53,90,35,102,39,3,0,2,5,512,385,127,515,388,127
107,公立,一般大學,0012,國立臺灣海洋大學,416,345,71,160,21,94,22,81,18,6,0,4,10,396,335,61,402,341,61
107,公立,一般大學,0013,國立中正大學,548,397,151,217,61,115,58,59,24,4,6,2,2,534,391,143,544,395,149
107,公立,一般大學,0014,國立高雄師範大學,289,176,113,94,41,60,46,20,20,0,1,2,5,281,174,107,282,174,108
107,公立,一般大學,0015,國立彰化師範大學,369,248,121,138,53,71,40,36,23,3,4,0,1,361,245,116,368,248,120
107,公立,一般大學,0016,國立陽明大學,408,252,156,127,74,68,42,44,32,8,3,5,5,387,239,148,398,247,151
107,公立,一般大學,0017,國立臺北大學,380,232,148,96,45,69,41,58,46,6,6,3,10,355,223,132,367,229,138
107,公立,一般大學,0018,國立嘉義大學,517,354,163,153,48,99,56,85,38,12,12,5,9,479,337,142,503,349,154
107,公立,一般大學,0019,國立高雄大學,237,178,59,84,18,52,23,38,17,3,0,1,1,232,174,58,235,177,58
107,公立,一般大學,0020,國立東華大學,477,309,168,140,54,118,78,34,26,17,10,0,0,450,292,158,477,309,168
107,公立,一般大學,0021,國立暨南國際大學,269,178,91,87,25,61,46,24,13,5,6,1,1,256,172,84,267,177,90
107,公立,技專校院,0022,國立臺灣科技大學,499,406,93,217,32,104,29,69,23,13,6,3,3,474,390,84,493,403,90
107,公立,技專校院,0023,國立雲林科技大學,411,320,91,127,16,111,28,66,32,14,6,2,9,380,304,76,400,318,82
107,公立,技專校院,0024,國立屏東科技大學,411,291,120,128,34,87,39,57,33,16,11,3,3,378,272,106,405,288,117
107,公立,技專校院,0025,國立臺北科技大學,469,383,86,169,19,128,28,67,26,10,8,9,5,437,364,73,455,374,81
107,公立,一般大學,0028,國立臺北藝術大學,163,84,79,23,14,26,33,27,18,6,4,2,10,141,76,65,151,82,69
107,公立,一般大學,0029,國立臺灣藝術大學,167,100,67,42,26,33,23,20,12,5,3,0,3,156,95,61,164,100,64
107,公立,一般大學,0030,國立臺東大學,194,133,61,33,10,52,26,39,17,7,6,2,2,177,124,53,190,131,59
107,公立,一般大學,0031,國立宜蘭大學,232,177,55,77,10,56,15,29,15,12,13,3,2,202,162,40,227,174,53
107,公立,一般大學,0032,國立聯合大學,284,212,72,62,11,103,31,32,20,13,9,2,1,259,197,62,281,210,71
107,公立,技專校院,0033,國立虎尾科技大學,335,277,58,110,11,98,25,59,16,8,4,2,2,319,267,52,331,275,56
107,公立,一般大學,0035,國立臺南藝術大學,108,60,48,21,11,18,17,18,19,3,1,0,0,104,57,47,108,60,48
107,公立,一般大學,0036,國立臺南大學,235,133,102,74,37,41,41,16,21,1,0,1,3,230,131,99,231,132,99
107,公立,一般大學,0037,國立臺北教育大學,235,126,109,64,38,22,39,34,27,6,2,0,3,224,120,104,232,126,106
107,公立,一般大學,0039,國立臺中教育大學,203,119,84,48,27,39,31,29,17,1,6,2,3,191,116,75,198,117,81
107,公立,技專校院,0042,國立澎湖科技大學,120,82,38,28,4,24,15,22,16,7,3,1,0,109,74,35,119,81,38
107,公立,技專校院,0043,國立勤益科技大學,288,217,71,82,20,79,27,40,17,11,5,5,2,265,201,64,281,212,69
107,公立,一般大學,0044,國立體育大學,99,68,31,22,5,26,16,9,5,3,4,8,1,83,57,26,90,60,30
107,公立,技專校院,0046,國立臺北護理健康大學,188,49,139,13,23,19,35,15,46,1,10,1,25,151,47,104,162,48,114
107,公立,技專校院,0047,國立高雄餐旅大學,161,103,58,22,11,37,25,37,14,4,7,3,1,146,96,50,157,100,57
107,公立,一般大學,0048,國立金門大學,145,105,40,22,1,47,25,33,14,2,0,1,0,142,102,40,144,104,40
107,公立,一般大學,0049,國立臺灣體育運動大學,114,80,34,18,6,27,13,20,7,6,5,9,3,91,65,26,102,71,31
107,公立,技專校院,0050,國立臺中科技大學,419,178,241,55,38,69,71,43,69,8,24,3,39,345,167,178,377,175,202
107,公立,技專校院,0051,國立臺北商業大學,213,118,95,29,13,44,42,26,17,10,17,9,6,171,99,72,198,109,89
107,公立,一般大學,0052,國立屏東大學,342,208,134,59,24,81,60,55,38,11,7,2,5,317,195,122,335,206,129
107,公立,技專校院,0053,國立高雄科技大學,871,664,207,255,39,243,81,135,54,19,20,12,13,807,633,174,846,652,194
107,公立,技專校院,0144,國立臺灣戲曲學院,35,17,18,2,1,5,6,5,6,4,4,1,1,25,12,13,33,16,17
107,公立,技專校院,0221,國立臺南護理專科學校,88,19,69,5,2,7,10,7,19,0,12,0,26,50,19,31,62,19,43
107,公立,技專校院,0222,國立臺東專科學校,66,45,21,7,1,8,2,23,9,7,9,0,0,50,38,12,66,45,21
107,私立,一般大學,1001,東海大學,544,367,177,123,26,120,54,89,71,20,16,15,10,483,332,151,519,352,167
107,私立,一般大學,1002,輔仁大學,734,410,324,100,61,165,123,112,108,22,24,11,8,669,377,292,715,399,316
107,私立,一般大學,1003,東吳大學,443,255,188,98,42,75,81,60,41,16,22,6,2,397,233,164,435,249,186
107,私立,一般大學,1004,中原大學,497,351,146,125,20,107,58,96,56,10,9,13,3,462,328,134,481,338,143
107,私立,一般大學,1005,淡江大學學校財團法人淡江大學,738,474,264,170,48,192,130,76,63,15,12,21,11,679,438,241,706,453,253
107,私立,一般大學,1006,中國文化大學,727,454,273,133,46,187,126,107,80,21,14,6,7,679,427,252,714,448,266
107,私立,一般大學,1007,逢甲大學,653,503,150,170,33,195,53,109,49,18,9,11,6,609,474,135,636,492,144
107,私立,一般大學,1008,靜宜大學,374,224,150,56,25,77,57,67,52,21,14,3,2,334,200,134,369,221,148
107,私立,一般大學,1009,長庚大學,586,405,181,142,50,129,44,117,75,14,11,3,1,557,388,169,582,402,180
107,私立,一般大學,1010,元智大學,312,222,90,75,13,67,35,68,39,8,2,4,1,297,210,87,307,218,89
107,私立,一般大學,1011,中華大學學校財團法人中華大學,234,148,86,47,14,55,28,37,22,6,20,3,2,203,139,64,229,145,84
107,私立,一般大學,1012,大葉大學,315,207,108,48,8,72,42,71,43,9,14,7,1,284,191,93,307,200,107
107,私立,一般大學,1013,華梵大學,95,66,29,18,2,23,12,19,11,5,3,1,1,85,60,25,93,65,28
107,私立,一般大學,1014,義守大學,502,347,155,96,27,136,40,94,75,16,11,5,2,468,326,142,495,342,153
107,私立,一般大學,1015,世新大學,336,199,137,53,24,69,59,49,40,25,10,3,4,294,171,123,329,196,133
107,私立,一般大學,1016,銘傳大學,576,340,236,80,30,130,104,109,87,18,13,3,2,540,319,221,571,337,234
107,私立,一般大學,1017,實踐大學,372,208,164,33,14,76,46,81,75,13,27,5,2,325,190,135,365,203,162
107,私立,技專校院,1018,朝陽科技大學,402,266,136,48,18,97,49,98,49,16,15,7,5,359,243,116,390,259,131
107,私立,一般大學,1019,高雄醫學大學,558,356,202,138,54,107,56,100,81,11,9,0,2,536,345,191,556,356,200
107,私立,一般大學,1020,南華大學,203,132,71,30,4,50,26,51,41,1,0,0,0,202,131,71,203,132,71
107,私立,一般大學,1021,真理大學,267,169,98,32,3,68,44,57,32,11,16,1,3,236,157,79,263,168,95
107,私立,一般大學,1022,大同大學,158,119,39,49,7,37,12,19,12,13,8,1,0,136,105,31,157,118,39
107,私立,技專校院,1023,南臺學校財團法人南臺科技大學,572,399,173,84,11,164,51,107,71,34,38,10,2,488,355,133,560,389,171
107,私立,技專校院,1024,崑山科技大學,343,250,93,57,2,101,46,65,35,24,9,3,1,306,223,83,339,247,92
107,私立,技專校院,1025,嘉藥學校財團法人嘉南藥理大學,465,273,192,55,19,96,70,99,84,18,15,5,4,423,250,173,456,268,188
107,私立,技專校院,1026,樹德科技大學,281,184,97,23,3,61,13,91,72,8,8,1,1,263,175,88,279,183,96
107,私立,一般大學,1027,慈濟學校財團法人慈濟大學,240,116,124,27,16,49,49,34,45,6,13,0,1,220,110,110,239,116,123
107,私立,一般大學,1028,臺北醫學大學,616,411,205,134,54,129,73,136,74,12,2,0,2,600,399,201,614,411,203
107,私立,一般大學,1029,中山醫學大學,412,255,157,100,41,65,51,63,51,24,13,3,1,371,228,143,408,252,156
107,私立,技專校院,1030,龍華科技大學,251,190,61,31,5,71,18,70,27,14,10,4,1,222,172,50,246,186,60
107,私立,技專校院,1031,輔英科技大學,331,104,227,15,5,38,41,39,70,8,41,4,70,208,92,116,257,100,157
107,私立,技專校院,1032,明新學校財團法人明新科技大學,369,242,127,34,4,94,37,68,43,40,39,6,4,280,196,84,359,236,123
107,私立,一般大學,1033,長榮大學,334,195,139,39,10,57,51,92,67,6,8,1,3,316,188,128,330,194,136
107,私立,技專校院,1034,弘光科技大學,354,142,212,33,17,46,53,43,66,12,24,8,52,258,122,136,294,134,160
107,私立,一般大學,1035,中國醫藥大學,495,343,152,134,41,111,68,95,42,3,0,0,1,491,340,151,494,343,151
107,私立,技專校院,1036,健行學校財團法人健行科技大學,293,203,90,30,2,86,24,54,42,25,20,8,2,238,170,68,283,195,88
107,私立,技專校院,1037,正修學校財團法人正修科技大學,431,306,125,69,8,117,45,75,43,36,25,9,4,357,261,96,418,297,121
107,私立,技專校院,1038,萬能學校財團法人萬能科技大學,234,158,76,16,3,52,21,55,24,35,25,0,3,171,123,48,231,158,73
107,私立,一般大學,1039,玄奘大學,111,65,46,6,3,18,10,30,24,11,9,0,0,91,54,37,111,65,46
107,私立,技專校院,1040,建國科技大學,250,173,77,18,4,77,21,52,31,23,19,3,2,203,147,56,245,170,75
107,私立,技專校院,1041,明志科技大學,193,163,30,33,4,62,10,48,11,17,4,3,1,168,143,25,189,160,29
107,私立,技專校院,1042,高苑科技大學,242,189,53,25,0,79,21,61,13,21,19,3,0,199,165,34,239,186,53
107,私立,技專校院,1043,大仁科技大學,219,131,88,21,3,60,30,26,24,23,30,1,1,164,107,57,217,130,87
107,私立,技專校院,1044,聖約翰科技大學,175,133,42,20,0,59,12,34,20,19,9,1,1,145,113,32,173,132,41
107,私立,技專校院,1045,嶺東科技大學,264,152,112,16,5,58,49,60,35,16,20,2,3,223,134,89,259,150,109
107,私立,技專校院,1046,中國科技大學,290,200,90,11,1,48,29,96,35,42,22,3,3,220,155,65,284,197,87
107,私立,技專校院,1047,中臺科技大學,266,124,142,23,13,49,40,38,42,11,24,3,23,205,110,95,240,121,119
107,私立,一般大學,1048,亞洲大學,388,243,145,77,22,77,35,71,72,15,14,3,2,354,225,129,383,240,143
107,私立,一般大學,1049,開南大學,226,144,82,17,10,64,26,56,40,6,6,1,0,213,137,76,225,143,82
107,私立,一般大學,1050,佛光大學,173,113,60,23,9,48,20,38,25,3,6,1,0,163,109,54,172,112,60
107,私立,技專校院,1051,台南家專學校財團法人台南應用科技大學,331,161,170,20,9,51,56,66,66,20,39,4,0,268,137,131,327,157,170
107,私立,技專校院,1052,遠東科技大學,211,155,56,29,1,51,16,59,24,15,13,1,2,180,139,41,208,154,54
107,私立,技專校院,1053,光宇學校財團法人元培醫事科技大學,201,114,87,17,6,36,22,44,39,15,15,2,5,164,97,67,194,112,82
107,私立,技專校院,1054,景文科技大學,191,108,83,11,4,35,29,38,23,20,25,4,2,140,84,56,185,104,81
107,私立,技專校院,1055,中華醫事科技大學,288,110,178,17,6,34,55,42,51,14,35,3,31,205,93,112,254,107,147
107,私立,技專校院,1056,東南科技大學,192,144,48,16,1,53,14,49,17,26,15,0,1,150,118,32,191,144,47
107,私立,技專校院,1057,德明財經科技大學,227,115,112,7,5,48,29,43,47,17,31,0,0,179,98,81,227,115,112
107,私立,一般大學,1058,明道學校財團法人明道大學,127,85,42,12,0,15,7,53,32,3,3,2,0,119,80,39,125,83,42
107,私立,技專校院,1060,南開科技大學,181,143,38,24,1,57,16,39,16,20,4,3,1,153,120,33,177,140,37
107,私立,技專校院,1061,中華學校財團法人中華科技大學,211,156,55,14,0,50,11,45,23,45,20,2,1,143,109,34,208,154,54
107,私立,技專校院,1062,僑光科技大學,228,138,90,10,2,52,26,47,24,27,34,2,4,161,109,52,222,136,86
107,私立,技專校院,1063,廣亞學校財團法人育達科技大學,113,60,53,8,1,11,12,29,26,10,12,2,2,87,48,39,109,58,51
107,私立,技專校院,1064,美和學校財團法人美和科技大學,229,87,142,7,1,35,22,29,43,12,27,4,49,137,71,66,176,83,93
107,私立,技專校院,1065,吳鳳科技大學,154,104,50,9,0,48,6,26,22,19,20,2,2,111,83,28,150,102,48
107,私立,技專校院,1066,環球學校財團法人環球科技大學,167,101,66,10,4,22,11,49,32,18,17,2,2,128,81,47,163,99,64
107,私立,一般大學,1067,台灣首府學校財團法人台灣首府大學,90,66,24,1,0,20,0,40,19,2,4,3,1,80,61,19,86,63,23
107,私立,技專校院,1068,中州學校財團法人中州科技大學,112,68,44,5,0,28,8,29,17,6,19,0,0,87,62,25,112,68,44
107,私立,技專校院,1069,修平學校財團法人修平科技大學,188,142,46,20,0,52,9,46,24,22,10,2,3,151,118,33,183,140,43
107,私立,技專校院,1070,長庚學校財團法人長庚科技大學,338,57,281,12,14,24,60,10,66,9,50,2,91,186,46,140,245,55,190
107,私立,技專校院,1071,城市學校財團法人臺北城市科技大學,245,162,83,7,0,66,19,50,22,33,35,6,7,164,123,41,232,156,76
107,私立,技專校院,1072,大華學校財團法人敏實科技大學,79,45,34,4,1,18,13,11,9,10,11,2,0,56,33,23,77,43,34
107,私立,技專校院,1073,醒吾學校財團法人醒吾科技大學,223,115,108,12,4,36,30,41,26,25,48,1,0,149,89,60,222,114,108
107,私立,技專校院,1074,南榮學校財團法人南榮科技大學,88,53,35,2,0,23,9,15,10,13,15,0,1,59,40,19,87,53,34
107,私立,技專校院,1075,文藻學校財團法人文藻外語大學,266,110,156,13,10,36,44,49,69,11,31,1,2,221,98,123,263,109,154
107,私立,技專校院,1076,華夏學校財團法人華夏科技大學,149,107,42,12,0,45,11,26,16,22,12,2,3,110,83,27,144,105,39
107,私立,技專校院,1077,慈濟學校財團法人慈濟科技大學,159,49,110,5,0,17,23,23,37,3,22,1,28,105,45,60,130,48,82
107,私立,技專校院,1078,致理學校財團法人致理科技大學,277,134,143,14,4,47,62,51,54,20,20,2,3,232,112,120,272,132,140
107,私立,一般大學,1079,康寧學校財團法人康寧大學,122,55,67,1,2,10,11,19,27,23,26,2,1,70,30,40,119,53,66
107,私立,技專校院,1080,宏國學校財團法人宏國德霖科技大學,190,133,57,7,1,43,11,45,25,36,20,2,0,132,95,37,188,131,57
107,私立,技專校院,1081,東方學校財團法人東方設計大學,123,84,39,7,0,32,7,31,16,7,13,7,3,93,70,23,113,77,36
107,私立,技專校院,1082,崇右學校財團法人崇右影藝科技大學,98,57,41,8,0,18,14,21,13,9,14,1,0,74,47,27,97,56,41
107,私立,技專校院,1083,台北海洋學校財團法人台北海洋科技大學,144,73,71,2,0,15,20,40,34,12,14,4,3,111,57,54,137,69,68
107,私立,一般大學,1125,中信學校財團法人中信金融管理學院,48,34,14,10,3,4,2,13,4,7,4,0,1,36,27,9,47,34,13
107,私立,技專校院,1148,大漢技術學院,57,40,17,2,0,13,6,14,3,10,8,1,0,38,29,9,56,39,17
107,私立,技專校院,1159,和春技術學院,82,51,31,3,1,12,4,27,15,7,10,2,1,62,42,20,79,49,30
107,私立,技專校院,1166,亞東技術學院,157,112,45,18,2,47,14,32,18,13,7,2,4,131,97,34,151,110,41
107,私立,技專校院,1168,南亞科技學校財團法人南亞技術學院,114,72,42,10,0,18,7,20,14,20,21,4,0,69,48,21,110,68,42
107,私立,一般大學,1176,稻江科技暨管理學院,57,33,24,0,1,3,2,23,17,6,4,1,0,46,26,20,56,32,24
107,私立,技專校院,1182,蘭陽技術學院,78,52,26,0,1,11,2,19,1,21,22,1,0,34,30,4,77,51,26
107,私立,技專校院,1183,黎明技術學院,159,109,50,7,0,36,9,27,12,37,28,2,1,91,70,21,156,107,49
107,私立,技專校院,1185,經國管理暨健康學院,141,49,92,1,0,18,18,19,27,8,27,3,20,83,38,45,118,46,72
107,私立,技專校院,1188,大同技術學院,64,35,29,3,0,11,11,15,14,4,2,2,2,54,29,25,60,33,27
107,私立,技專校院,1192,臺灣觀光學院,24,14,10,1,0,1,1,5,5,6,4,1,0,13,7,6,23,13,10
107,私立,一般大學,1195,馬偕學校財團法人馬偕醫學院,125,84,41,14,2,28,10,41,23,1,6,0,0,118,83,35,125,84,41
107,私立,一般大學,1196,法鼓學校財團法人法鼓文理學院,23,16,7,3,0,6,3,7,4,0,0,0,0,23,16,7,23,16,7
107,私立,技專校院,1282,馬偕學校財團法人馬偕醫護管理專科學校,139,45,94,4,0,6,5,21,19,9,50,5,20,55,31,24,114,40,74
107,私立,技專校院,1283,仁德醫護管理專科學校,204,71,133,2,0,3,0,17,19,42,71,7,43,41,22,19,154,64,90
107,私立,技專校院,1284,樹人醫護管理專科學校,224,63,161,2,0,2,1,22,26,29,96,8,38,53,26,27,178,55,123
107,私立,技專校院,1285,慈惠醫護管理專科學校,154,41,113,1,0,2,0,12,14,18,58,8,41,29,15,14,105,33,72
107,私立,技專校院,1286,耕莘健康管理專科學校,172,36,136,0,0,6,5,14,19,11,89,5,23,44,20,24,144,31,113
107,私立,技專校院,1287,敏惠醫護管理專科學校,124,28,96,1,0,4,0,9,9,8,65,6,22,23,14,9,96,22,74
107,私立,技專校院,1289,育英醫護管理專科學校,70,14,56,0,0,1,1,5,4,5,29,3,22,11,6,5,45,11,34
107,私立,技專校院,1291,聖母醫護管理專科學校,94,27,67,1,0,6,1,6,9,11,48,3,9,23,13,10,82,24,58
107,私立,技專校院,1292,新生醫護管理專科學校,209,43,166,1,0,2,3,16,31,17,100,7,32,53,19,34,170,36,134
107,私立,技專校院,1293,崇仁醫護管理專科學校,129,28,101,2,0,4,1,5,10,15,62,2,28,22,11,11,99,26,73
107,私立,宗教研修學院,1R02,學校財團法人中華浸信會基督教台灣浸會神學院,12,6,6,1,0,2,1,3,5,0,0,0,0,12,6,6,12,6,6
107,私立,宗教研修學院,1R03,臺北基督學院,11,6,5,0,1,0,0,5,3,1,1,0,0,9,5,4,11,6,5
107,私立,宗教研修學院,1R04,財團法人一貫道天皇基金會一貫道天皇學院,9,5,4,2,0,1,2,2,1,0,1,0,0,8,5,3,9,5,4
107,私立,宗教研修學院,1R05,台神學校財團法人台灣神學研究學院,16,10,6,1,2,1,2,8,2,0,0,0,0,16,10,6,16,10,6
107,私立,宗教研修學院,1R06,一貫道崇德學院,6,3,3,1,0,2,1,0,2,0,0,0,0,6,3,3,6,3,3
107,私立,宗教研修學院,1R07,台灣基督長老教會南神神學院,10,6,4,1,0,1,1,4,3,0,0,0,0,10,6,4,10,6,4
107,公立,一般大學,3002,臺北市立大學,334,184,150,60,48,76,48,35,41,6,8,7,5,308,171,137,322,177,145
108,公立,一般大學,0001,國立政治大學,743,437,306,206,118,146,94,70,53,13,18,2,23,687,422,265,718,435,283
108,公立,一般大學,0002,國立清華大學,830,568,262,356,95,140,111,67,47,1,7,4,2,816,563,253,824,564,260
108,公立,一般大學,0003,國立臺灣大學,2021,1406,615,872,265,313,183,207,145,13,10,1,12,1985,1392,593,2008,1405,603
108,公立,一般大學,0004,國立臺灣師範大學,813,467,346,273,159,115,108,62,50,15,18,2,11,767,450,317,800,465,335
108,公立,一般大學,0005,國立成功大學,1340,1010,330,548,115,297,116,138,75,19,13,8,11,1289,983,306,1321,1002,319
108,公立,一般大學,0006,國立中興大學,781,606,175,341,67,150,47,100,41,8,9,7,11,746,591,155,763,599,164
108,公立,一般大學,0007,國立陽明交通大學,746,607,139,347,54,135,39,115,36,6,7,4,3,726,597,129,739,603,136
108,公立,一般大學,0008,國立中央大學,662,524,138,293,55,147,40,75,22,7,14,2,7,632,515,117,653,522,131
108,公立,一般大學,0009,國立中山大學,537,397,140,189,54,91,37,114,44,1,0,2,5,529,394,135,530,395,135
108,公立,一般大學,0012,國立臺灣海洋大學,430,352,78,165,21,94,21,84,26,5,0,4,10,411,343,68,416,348,68
108,公立,一般大學,0013,國立中正大學,532,389,143,221,65,101,54,61,17,4,5,2,2,519,383,136,528,387,141
108,公立,一般大學,0014,國立高雄師範大學,290,177,113,101,44,51,42,23,21,0,1,2,5,282,175,107,283,175,108
108,公立,一般大學,0015,國立彰化師範大學,363,242,121,136,53,75,38,28,25,3,4,0,1,355,239,116,362,242,120
108,公立,一般大學,0016,國立陽明大學,406,249,157,126,72,65,45,47,32,7,3,4,5,387,238,149,397,245,152
108,公立,一般大學,0017,國立臺北大學,381,233,148,97,49,70,44,56,40,6,6,4,9,356,223,133,368,229,139
108,公立,一般大學,0018,國立嘉義大學,520,354,166,158,51,96,56,84,38,11,11,5,10,483,338,145,505,349,156
108,公立,一般大學,0019,國立高雄大學,238,179,59,92,20,51,24,33,13,2,1,1,1,233,176,57,236,178,58
108,公立,一般大學,0020,國立東華大學,460,301,159,134,51,111,74,40,24,16,10,0,0,434,285,149,460,301,159
108,公立,一般大學,0021,國立暨南國際大學,275,181,94,93,30,62,42,17,14,6,8,3,0,258,172,86,272,178,94
108,公立,技專校院,0022,國立臺灣科技大學,532,432,100,230,33,102,29,82,28,15,8,3,2,504,414,90,527,429,98
108,公立,技專校院,0023,國立雲林科技大學,420,326,94,133,19,101,27,78,33,12,5,2,10,391,312,79,408,324,84
108,公立,技專校院,0024,國立屏東科技大學,404,284,120,129,38,81,38,51,30,20,12,3,2,367,261,106,399,281,118
108,公立,技專校院,0025,國立臺北科技大學,471,382,89,179,22,114,30,70,27,10,6,9,4,442,363,79,458,373,85
108,公立,一般大學,0028,國立臺北藝術大學,162,82,80,26,13,19,37,28,15,7,5,2,10,138,73,65,150,80,70
108,公立,一般大學,0029,國立臺灣藝術大學,156,96,60,39,26,32,19,21,9,4,3,0,3,146,92,54,153,96,57
108,公立,一般大學,0030,國立臺東大學,197,135,62,38,12,52,29,38,14,5,5,2,2,183,128,55,193,133,60
108,公立,一般大學,0031,國立宜蘭大學,231,178,53,82,10,58,16,27,14,9,12,2,1,207,167,40,228,176,52
108,公立,一般大學,0032,國立聯合大學,285,212,73,65,12,97,30,37,21,11,9,2,1,262,199,63,282,210,72
108,公立,技專校院,0033,國立虎尾科技大學,342,284,58,116,11,97,25,64,16,5,5,2,1,329,277,52,339,282,57
108,公立,一般大學,0035,國立臺南藝術大學,109,59,50,18,11,18,19,20,19,3,1,0,0,105,56,49,109,59,50
108,公立,一般大學,0036,國立臺南大學,232,133,99,74,37,41,39,17,20,0,0,1,3,228,132,96,228,132,96
108,公立,一般大學,0037,國立臺北教育大學,237,130,107,65,36,24,39,35,28,6,1,0,3,227,124,103,234,130,104
108,公立,一般大學,0039,國立臺中教育大學,202,120,82,52,28,40,29,25,18,1,5,2,2,192,117,75,198,118,80
108,公立,技專校院,0042,國立澎湖科技大學,121,82,39,28,4,25,15,22,18,6,2,1,0,112,75,37,120,81,39
108,公立,技專校院,0043,國立勤益科技大學,307,232,75,87,21,75,25,55,22,10,5,5,2,285,217,68,300,227,73
108,公立,一般大學,0044,國立體育大學,101,68,33,23,6,29,18,5,4,3,4,8,1,85,57,28,92,60,32
108,公立,技專校院,0046,國立臺北護理健康大學,195,51,144,15,22,19,36,15,51,1,9,1,26,158,49,109,168,50,118
108,公立,技專校院,0047,國立高雄餐旅大學,162,106,56,26,11,36,25,37,13,4,6,3,1,148,99,49,158,103,55
108,公立,一般大學,0048,國立金門大學,149,107,42,21,2,54,26,29,14,2,0,1,0,146,104,42,148,106,42
108,公立,一般大學,0049,國立臺灣體育運動大學,114,82,32,18,7,28,12,18,6,7,5,11,2,89,64,25,101,71,30
108,公立,技專校院,0050,國立臺中科技大學,427,180,247,57,38,69,78,46,76,5,21,3,34,364,172,192,390,177,213
108,公立,技專校院,0051,國立臺北商業大學,215,119,96,32,15,45,41,27,17,6,17,9,6,177,104,73,200,110,90
108,公立,一般大學,0052,國立屏東大學,347,210,137,60,26,84,58,54,42,9,7,3,4,324,198,126,340,207,133
108,公立,技專校院,0053,國立高雄科技大學,871,658,213,268,41,233,85,126,55,20,19,11,13,808,627,181,847,647,200
108,公立,技專校院,0144,國立臺灣戲曲學院,32,17,15,2,1,4,7,6,5,4,1,1,1,25,12,13,30,16,14
108,公立,技專校院,0221,國立臺南護理專科學校,90,20,70,5,5,7,9,8,19,0,11,0,26,53,20,33,64,20,44
108,公立,技專校院,0222,國立臺東專科學校,67,46,21,7,1,13,2,20,9,6,9,0,0,52,40,12,67,46,21
108,私立,一般大學,1001,東海大學,557,376,181,125,29,118,55,98,71,19,15,16,11,496,341,155,530,360,170
108,私立,一般大學,1002,輔仁大學,727,404,323,100,61,158,121,113,110,20,23,13,8,663,371,292,706,391,315
108,私立,一般大學,1003,東吳大學,442,254,188,97,49,74,73,64,43,15,21,4,2,400,235,165,436,250,186
108,私立,一般大學,1004,中原大學,495,352,143,130,22,109,61,93,50,8,8,12,2,465,332,133,481,340,141
108,私立,一般大學,1005,淡江大學學校財團法人淡江大學,719,459,260,163,45,188,130,72,66,12,9,24,10,664,423,241,685,435,250
108,私立,一般大學,1006,中國文化大學,724,445,279,143,48,183,126,95,84,17,14,7,7,679,421,258,710,438,272
108,私立,一般大學,1007,逢甲大學,633,486,147,170,36,184,54,107,44,13,7,12,6,595,461,134,615,474,141
108,私立,一般大學,1008,靜宜大學,387,229,158,64,27,77,62,66,52,19,15,3,2,348,207,141,382,226,156
108,私立,一般大學,1009,長庚大學,581,399,182,149,52,127,50,106,69,14,10,3,1,553,382,171,577,396,181
108,私立,一般大學,1010,元智大學,301,216,85,75,13,65,34,64,36,8,1,4,1,287,204,83,296,212,84
108,私立,一般大學,1011,中華大學學校財團法人中華大學,222,139,83,42,14,53,27,35,22,6,18,3,2,193,130,63,217,136,81
108,私立,一般大學,1012,大葉大學,298,195,103,44,10,67,37,66,40,11,15,7,1,264,177,87,290,188,102
108,私立,一般大學,1013,華梵大學,82,56,26,17,2,18,10,17,10,3,3,1,1,74,52,22,80,55,25
108,私立,一般大學,1014,義守大學,535,367,168,105,30,130,37,110,75,17,24,5,2,487,345,142,528,362,166
108,私立,一般大學,1015,世新大學,333,195,138,56,24,61,56,51,45,24,9,3,4,293,168,125,326,192,134
108,私立,一般大學,1016,銘傳大學,571,333,238,81,33,125,107,107,83,17,13,3,2,536,313,223,566,330,236
108,私立,一般大學,1017,實踐大學,355,200,155,37,12,66,46,78,74,14,21,5,2,313,181,132,348,195,153
108,私立,技專校院,1018,朝陽科技大學,395,265,130,46,18,93,48,101,49,17,12,8,3,355,240,115,384,257,127
108,私立,一般大學,1019,高雄醫學大學,558,353,205,134,59,109,58,99,78,11,8,0,2,537,342,195,556,353,203
108,私立,一般大學,1020,南華大學,206,135,71,34,5,51,26,49,40,1,0,0,0,205,134,71,206,135,71
108,私立,一般大學,1021,真理大學,255,161,94,32,4,65,46,52,26,10,16,2,2,225,149,76,251,159,92
108,私立,一般大學,1022,大同大學,150,113,37,47,7,34,12,19,11,12,7,1,0,130,100,30,149,112,37
108,私立,技專校院,1023,南臺學校財團法人南臺科技大學,556,380,176,85,11,154,55,104,73,28,35,9,2,482,343,139,545,371,174
108,私立,技專校院,1024,崑山科技大學,334,242,92,56,2,96,47,66,35,21,7,3,1,302,218,84,330,239,91
108,私立,技專校院,1025,嘉藥學校財團法人嘉南藥理大學,436,251,185,51,18,84,67,94,84,17,12,5,4,398,229,169,427,246,181
108,私立,技專校院,1026,樹德科技大學,272,177,95,23,3,65,15,79,68,9,8,1,1,253,167,86,270,176,94
108,私立,一般大學,1027,慈濟學校財團法人慈濟大學,235,111,124,30,19,46,54,31,38,4,12,0,1,218,107,111,234,111,123
108,私立,一般大學,1028,臺北醫學大學,651,442,209,136,58,140,74,152,72,14,3,0,2,632,428,204,649,442,207
108,私立,一般大學,1029,中山醫學大學,405,252,153,101,41,66,51,58,46,24,14,3,1,363,225,138,401,249,152
108,私立,技專校院,1030,龍華科技大學,249,186,63,32,5,69,22,70,26,11,9,4,1,224,171,53,244,182,62
108,私立,技專校院,1031,輔英科技大學,302,101,201,17,6,37,43,37,70,6,33,4,49,210,91,119,249,97,152
108,私立,技專校院,1032,明新學校財團法人明新科技大學,349,226,123,31,4,89,38,62,45,39,30,5,6,269,182,87,338,221,117
108,私立,一般大學,1033,長榮大學,322,181,141,35,13,50,50,91,67,4,8,1,3,306,176,130,318,180,138
108,私立,技專校院,1034,弘光科技大學,339,132,207,32,19,46,49,36,76,10,13,8,50,258,114,144,281,124,157
108,私立,一般大學,1035,中國醫藥大學,509,355,154,145,44,107,68,101,41,2,0,0,1,506,353,153,508,355,153
108,私立,技專校院,1036,健行學校財團法人健行科技大學,276,190,86,27,1,75,23,52,41,28,19,8,2,219,154,65,266,182,84
108,私立,技專校院,1037,正修學校財團法人正修科技大學,435,307,128,74,8,110,50,81,39,34,27,8,4,362,265,97,423,299,124
108,私立,技專校院,1038,萬能學校財團法人萬能科技大學,251,160,91,16,3,52,23,72,38,20,24,0,3,204,140,64,248,160,88
108,私立,一般大學,1039,玄奘大學,107,63,44,9,2,20,10,25,24,9,8,0,0,90,54,36,107,63,44
108,私立,技專校院,1040,建國科技大學,238,164,74,17,4,73,20,48,31,23,17,3,2,193,138,55,233,161,72
108,私立,技專校院,1041,明志科技大學,193,164,29,37,5,58,9,50,10,16,4,3,1,169,145,24,189,161,28
108,私立,技專校院,1042,高苑科技大學,198,153,45,22,0,59,18,51,11,18,16,3,0,161,132,29,195,150,45
108,私立,技專校院,1043,大仁科技大學,205,120,85,17,3,53,31,25,25,24,25,1,1,154,95,59,203,119,84
108,私立,技專校院,1044,聖約翰科技大學,167,127,40,20,0,58,13,29,17,19,9,1,1,137,107,30,165,126,39
108,私立,技專校院,1045,嶺東科技大學,275,158,117,16,5,61,49,63,40,16,21,2,2,234,140,94,271,156,115
108,私立,技專校院,1046,中國科技大學,265,188,77,17,1,45,24,87,33,36,16,3,3,207,149,58,259,185,74
108,私立,技專校院,1047,中臺科技大學,263,122,141,21,14,48,36,38,46,12,23,3,22,203,107,96,238,119,119
108,私立,一般大學,1048,亞洲大學,403,246,157,76,24,74,35,77,81,16,15,3,2,367,227,140,398,243,155
108,私立,一般大學,1049,開南大學,213,134,79,18,9,59,28,49,37,7,5,1,0,200,126,74,212,133,79
108,私立,一般大學,1050,佛光大學,166,107,59,21,11,46,20,34,21,5,7,1,0,153,101,52,165,106,59
108,私立,技專校院,1051,台南家專學校財團法人台南應用科技大學,329,158,171,19,9,52,58,64,64,19,40,4,0,266,135,131,325,154,171
108,私立,技專校院,1052,遠東科技大學,200,148,52,30,1,46,15,56,22,15,12,1,2,170,132,38,197,147,50
108,私立,技專校院,1053,光宇學校財團法人元培醫事科技大學,197,109,88,16,6,36,19,41,43,14,15,2,5,161,93,68,190,107,83
108,私立,技專校院,1054,景文科技大學,186,101,85,12,4,31,29,38,26,16,23,4,3,140,81,59,179,97,82
108,私立,技專校院,1055,中華醫事科技大學,286,110,176,18,7,32,56,43,46,14,34,3,33,202,93,109,250,107,143
108,私立,技專校院,1056,東南科技大學,181,135,46,14,1,47,14,49,16,25,14,0,1,141,110,31,180,135,45
108,私立,技專校院,1057,德明財經科技大學,229,115,114,7,5,46,31,46,47,16,31,0,0,182,99,83,229,115,114
108,私立,一般大學,1058,明道學校財團法人明道大學,119,79,40,13,1,12,5,49,32,3,2,2,0,112,74,38,117,77,40
108,私立,技專校院,1060,南開科技大學,152,119,33,23,1,51,13,27,14,15,4,3,1,129,101,28,148,116,32
108,私立,技專校院,1061,中華學校財團法人中華科技大學,170,122,48,9,0,38,9,39,21,34,17,2,1,116,86,30,167,120,47
108,私立,技專校院,1062,僑光科技大學,231,143,88,11,2,57,35,51,20,22,28,2,3,176,119,57,226,141,85
108,私立,技專校院,1063,廣亞學校財團法人育達科技大學,104,56,48,6,1,14,13,24,23,10,9,2,2,81,44,37,100,54,46
108,私立,技專校院,1064,美和學校財團法人美和科技大學,223,86,137,4,1,34,21,31,41,12,25,5,49,132,69,63,169,81,88
108,私立,技專校院,1065,吳鳳科技大學,147,100,47,8,0,49,8,23,18,18,19,2,2,106,80,26,143,98,45
108,私立,技專校院,1066,環球學校財團法人環球科技大學,152,91,61,8,2,25,12,42,27,15,17,1,3,116,75,41,148,90,58
108,私立,一般大學,1067,台灣首府學校財團法人台灣首府大學,74,51,23,2,0,13,0,31,19,2,3,3,1,65,46,19,70,48,22
108,私立,技專校院,1068,中州學校財團法人中州科技大學,99,65,34,5,1,34,9,22,14,4,10,0,0,85,61,24,99,65,34
108,私立,技專校院,1069,修平學校財團法人修平科技大學,183,138,45,21,0,48,9,46,23,21,10,2,3,147,115,32,178,136,42
108,私立,技專校院,1070,長庚學校財團法人長庚科技大學,277,56,221,14,16,23,65,10,67,7,41,2,32,195,47,148,243,54,189
108,私立,技專校院,1071,城市學校財團法人臺北城市科技大學,252,169,83,9,0,65,20,55,26,33,31,7,6,175,129,46,239,162,77
108,私立,技專校院,1072,大華學校財團法人敏實科技大學,47,33,14,2,1,15,2,6,5,8,6,2,0,31,23,8,45,31,14
108,私立,技專校院,1073,醒吾學校財團法人醒吾科技大學,231,118,113,11,4,37,34,42,27,27,48,1,0,155,90,65,230,117,113
108,私立,技專校院,1075,文藻學校財團法人文藻外語大學,266,115,151,13,10,39,46,52,65,10,28,1,2,225,104,121,263,114,149
108,私立,技專校院,1076,華夏學校財團法人華夏科技大學,142,102,40,11,0,42,11,26,14,21,12,2,3,104,79,25,137,100,37
108,私立,技專校院,1077,慈濟學校財團法人慈濟科技大學,161,47,114,5,1,16,21,21,35,4,25,1,32,99,42,57,128,46,82
108,私立,技專校院,1078,致理學校財團法人致理科技大學,278,138,140,15,4,47,60,56,56,18,17,2,3,238,118,120,273,136,137
108,私立,一般大學,1079,康寧學校財團法人康寧大學,124,48,76,2,3,6,14,16,26,22,32,2,1,67,24,43,121,46,75
108,私立,技專校院,1080,宏國學校財團法人宏國德霖科技大學,186,128,58,6,1,41,11,46,29,33,17,2,0,134,93,41,184,126,58
108,私立,技專校院,1081,東方學校財團法人東方設計大學,118,83,35,8,0,34,12,28,11,6,9,7,3,93,70,23,108,76,32
108,私立,技專校院,1082,崇右學校財團法人崇右影藝科技大學,85,49,36,6,0,19,16,15,8,8,12,1,0,64,40,24,84,48,36
108,私立,技專校院,1083,台北海洋學校財團法人台北海洋科技大學,138,72,66,4,1,16,19,34,32,14,11,4,3,106,54,52,131,68,63
108,私立,一般大學,1125,中信學校財團法人中信金融管理學院,51,36,15,9,2,4,2,17,5,6,5,0,1,39,30,9,50,36,14
108,私立,技專校院,1148,大漢技術學院,44,34,10,2,0,13,3,15,1,3,6,1,0,34,30,4,43,33,10
108,私立,技專校院,1159,和春技術學院,49,34,15,1,1,11,1,13,5,7,7,2,1,32,25,7,46,32,14
108,私立,技專校院,1166,亞東技術學院,154,109,45,18,1,46,14,32,20,11,6,2,4,131,96,35,148,107,41
108,私立,技專校院,1168,南亞科技學校財團法人南亞技術學院,101,64,37,8,0,16,8,20,13,17,16,3,0,65,44,21,98,61,37
108,私立,一般大學,1176,稻江科技暨管理學院,46,31,15,0,0,4,2,20,9,6,4,1,0,35,24,11,45,30,15
108,私立,技專校院,1182,蘭陽技術學院,51,33,18,0,0,7,2,11,1,14,15,1,0,21,18,3,50,32,18
108,私立,技專校院,1183,黎明技術學院,158,105,53,8,0,37,9,26,20,32,23,2,1,100,71,29,155,103,52
108,私立,技專校院,1185,經國管理暨健康學院,145,52,93,4,2,18,19,19,26,8,24,3,22,88,41,47,120,49,71
108,私立,技專校院,1188,大同技術學院,60,34,26,2,0,10,11,16,12,4,1,2,2,51,28,23,56,32,24
108,私立,技專校院,1192,臺灣觀光學院,18,11,7,0,0,0,1,4,5,6,1,1,0,10,4,6,17,10,7
108,私立,一般大學,1195,馬偕學校財團法人馬偕醫學院,127,85,42,14,1,28,11,41,24,2,6,0,0,119,83,36,127,85,42
108,私立,一般大學,1196,法鼓學校財團法人法鼓文理學院,26,17,9,3,1,8,4,6,4,0,0,0,0,26,17,9,26,17,9
108,私立,技專校院,1282,馬偕學校財團法人馬偕醫護管理專科學校,143,43,100,4,0,5,5,21,20,8,51,5,24,55,30,25,114,38,76
108,私立,技專校院,1283,仁德醫護管理專科學校,209,70,139,2,0,1,0,18,22,42,77,7,40,43,21,22,162,63,99
108,私立,技專校院,1284,樹人醫護管理專科學校,221,58,163,3,0,2,1,21,32,25,95,7,35,59,26,33,179,51,128
108,私立,技專校院,1285,慈惠醫護管理專科學校,152,44,108,1,0,2,0,11,17,21,49,9,42,31,14,17,101,35,66
108,私立,技專校院,1286,耕莘健康管理專科學校,169,35,134,0,0,7,5,11,21,11,84,6,24,44,18,26,139,29,110
108,私立,技專校院,1287,敏惠醫護管理專科學校,120,28,92,1,0,7,0,8,10,7,62,5,20,26,16,10,95,23,72
108,私立,技專校院,1289,育英醫護管理專科學校,69,14,55,0,0,1,1,6,3,4,29,3,22,11,7,4,44,11,33
108,私立,技專校院,1291,聖母醫護管理專科學校,93,26,67,1,0,7,1,3,11,11,45,4,10,23,11,12,79,22,57
108,私立,技專校院,1292,新生醫護管理專科學校,218,46,172,1,0,2,2,14,34,20,97,9,39,53,17,36,170,37,133
108,私立,技專校院,1293,崇仁醫護管理專科學校,126,29,97,2,0,4,1,5,13,15,58,3,25,25,11,14,98,26,72
108,私立,宗教研修學院,1R02,學校財團法人中華浸信會基督教台灣浸會神學院,12,6,6,1,0,3,1,2,5,0,0,0,0,12,6,6,12,6,6
108,私立,宗教研修學院,1R03,臺北基督學院,11,6,5,0,1,0,0,5,3,1,1,0,0,9,5,4,11,6,5
108,私立,宗教研修學院,1R04,財團法人一貫道天皇基金會一貫道天皇學院,11,7,4,2,0,1,2,4,1,0,1,0,0,10,7,3,11,7,4
108,私立,宗教研修學院,1R05,台神學校財團法人台灣神學研究學院,18,12,6,2,2,2,2,8,2,0,0,0,0,18,12,6,18,12,6
108,私立,宗教研修學院,1R06,一貫道崇德學院,6,3,3,1,0,2,1,0,2,0,0,0,0,6,3,3,6,3,3
108,私立,宗教研修學院,1R07,台灣基督長老教會南神神學院,10,6,4,1,0,1,1,4,3,0,0,0,0,10,6,4,10,6,4
108,公立,一般大學,3002,臺北市立大學,334,183,151,67,49,71,51,34,41,6,5,5,5,313,172,141,324,178,146
109,公立,一般大學,0001,國立政治大學,731,432,299,203,109,139,94,75,57,13,17,2,22,677,417,260,707,430,277
109,公立,一般大學,0002,國立清華大學,839,575,264,358,97,147,108,65,51,1,8,4,0,826,570,256,835,571,264
109,公立,一般大學,0003,國立臺灣大學,2053,1412,641,873,271,311,208,214,139,13,12,1,11,2016,1398,618,2041,1411,630
109,公立,一般大學,0004,國立臺灣師範大學,823,474,349,283,164,116,104,59,48,14,22,2,11,774,458,316,810,472,338
109,公立,一般大學,0005,國立成功大學,1336,1000,336,537,116,294,120,145,78,16,12,8,10,1290,976,314,1318,992,326
109,公立,一般大學,0006,國立中興大學,775,599,176,340,69,143,49,103,42,6,9,7,7,746,586,160,761,592,169
109,公立,一般大學,0007,國立陽明交通大學,755,617,138,350,52,133,43,122,34,8,7,4,2,734,605,129,749,613,136
109,公立,一般大學,0008,國立中央大學,669,530,139,304,57,139,37,81,26,5,14,1,5,644,524,120,663,529,134
109,公立,一般大學,0009,國立中山大學,558,418,140,196,54,94,33,126,49,1,0,1,4,552,416,136,553,417,136
109,公立,一般大學,0012,國立臺灣海洋大學,440,358,82,170,23,93,23,87,25,4,0,4,11,421,350,71,425,354,71
109,公立,一般大學,0013,國立中正大學,533,387,146,223,66,102,61,57,14,3,3,2,2,523,382,141,529,385,144
109,公立,一般大學,0014,國立高雄師範大學,286,173,113,103,45,47,41,21,21,0,1,2,5,278,171,107,279,171,108
109,公立,一般大學,0015,國立彰化師範大學,368,249,119,140,52,72,41,34,22,3,3,0,1,361,246,115,367,249,118
109,公立,一般大學,0016,國立陽明大學,405,248,157,129,76,66,46,43,27,6,3,4,5,387,238,149,396,244,152
109,公立,一般大學,0017,國立臺北大學,384,235,149,97,51,69,43,59,42,6,5,4,8,361,225,136,372,231,141
109,公立,一般大學,0018,國立嘉義大學,513,350,163,156,51,94,54,87,39,9,10,4,9,481,337,144,500,346,154
109,公立,一般大學,0019,國立高雄大學,238,180,58,93,21,51,22,33,13,2,1,1,1,233,177,56,236,179,57
109,公立,一般大學,0020,國立東華大學,457,300,157,139,54,109,69,38,24,14,10,0,0,433,286,147,457,300,157
109,公立,一般大學,0021,國立暨南國際大學,273,180,93,94,34,60,39,21,14,5,6,0,0,262,175,87,273,180,93
109,公立,技專校院,0022,國立臺灣科技大學,560,455,105,237,37,107,26,96,29,14,11,1,2,532,440,92,557,454,103
109,公立,技專校院,0023,國立雲林科技大學,425,327,98,136,22,100,26,77,37,12,4,2,9,398,313,85,414,325,89
109,公立,技專校院,0024,國立屏東科技大學,433,304,129,134,40,83,44,55,31,29,12,3,2,387,272,115,428,301,127
109,公立,技專校院,0025,國立臺北科技大學,459,374,85,184,23,114,32,60,21,8,5,8,4,434,358,76,447,366,81
109,公立,一般大學,0028,國立臺北藝術大學,165,85,80,26,13,23,36,26,17,8,4,2,10,141,75,66,153,83,70
109,公立,一般大學,0029,國立臺灣藝術大學,155,95,60,33,28,34,17,23,11,4,2,1,2,146,90,56,152,94,58
109,公立,一般大學,0030,國立臺東大學,202,139,63,41,13,54,30,35,14,7,4,2,2,187,130,57,198,137,61
109,公立,一般大學,0031,國立宜蘭大學,235,178,57,83,11,56,18,29,16,8,11,2,1,213,168,45,232,176,56
109,公立,一般大學,0032,國立聯合大學,284,215,69,64,13,96,27,43,19,9,9,3,1,262,203,59,280,212,68
109,公立,技專校院,0033,國立虎尾科技大學,347,285,62,120,13,93,23,64,20,6,5,2,1,333,277,56,344,283,61
109,公立,一般大學,0035,國立臺南藝術大學,109,60,49,18,12,17,19,23,17,2,1,0,0,106,58,48,109,60,49
109,公立,一般大學,0036,國立臺南大學,230,133,97,77,36,38,40,17,18,0,0,1,3,226,132,94,226,132,94
109,公立,一般大學,0037,國立臺北教育大學,238,129,109,64,37,19,38,41,29,5,2,0,3,228,124,104,235,129,106
109,公立,一般大學,0039,國立臺中教育大學,203,121,82,56,28,34,30,27,18,2,4,2,2,193,117,76,199,119,80
109,公立,技專校院,0042,國立澎湖科技大學,127,86,41,29,6,25,13,25,18,6,4,1,0,116,79,37,126,85,41
109,公立,技專校院,0043,國立勤益科技大學,315,238,77,90,22,74,25,59,24,10,5,5,1,294,223,71,309,233,76
109,公立,一般大學,0044,國立體育大學,102,67,35,25,8,29,16,3,7,3,2,7,2,88,57,31,93,60,33
109,公立,技專校院,0046,國立臺北護理健康大學,207,53,154,18,21,19,40,14,57,1,8,1,28,169,51,118,178,52,126
109,公立,技專校院,0047,國立高雄餐旅大學,164,109,55,27,10,35,25,40,12,4,7,3,1,149,102,47,160,106,54
109,公立,一般大學,0048,國立金門大學,147,106,41,23,3,55,22,24,16,3,0,1,0,143,102,41,146,105,41
109,公立,一般大學,0049,國立臺灣體育運動大學,124,89,35,17,7,32,13,17,6,5,5,18,4,92,66,26,102,71,31
109,公立,技專校院,0050,國立臺中科技大學,423,178,245,60,41,65,75,46,76,4,20,3,33,363,171,192,387,175,212
109,公立,技專校院,0051,國立臺北商業大學,221,123,98,36,17,43,42,29,20,6,14,9,5,187,108,79,207,114,93
109,公立,一般大學,0052,國立屏東大學,350,214,136,64,28,80,55,59,43,8,6,3,4,329,203,126,343,211,132
109,公立,技專校院,0053,國立高雄科技大學,864,657,207,281,43,230,80,117,53,18,18,11,13,804,628,176,840,646,194
109,公立,技專校院,0144,國立臺灣戲曲學院,32,17,15,2,0,7,6,6,6,2,3,0,0,27,15,12,32,17,15
109,公立,技專校院,0221,國立臺南護理專科學校,92,19,73,5,5,5,12,8,21,0,9,1,26,56,18,38,65,18,47
109,公立,技專校院,0222,國立臺東專科學校,67,46,21,7,1,12,2,22,10,5,8,0,0,54,41,13,67,46,21
109,私立,一般大學,1001,東海大學,561,378,183,128,31,114,55,105,74,15,12,16,11,507,347,160,534,362,172
109,私立,一般大學,1002,輔仁大學,728,403,325,96,64,158,121,118,110,19,23,12,7,667,372,295,709,391,318
109,私立,一般大學,1003,東吳大學,431,251,180,94,49,69,66,73,47,12,17,3,1,398,236,162,427,248,179
109,私立,一般大學,1004,中原大學,496,352,144,134,23,100,63,95,48,7,8,16,2,463,329,134,478,336,142
109,私立,一般大學,1005,淡江大學學校財團法人淡江大學,722,454,268,167,46,173,132,82,71,8,9,24,10,671,422,249,688,430,258
109,私立,一般大學,1006,中國文化大學,704,437,267,155,57,169,116,93,82,12,7,8,5,672,417,255,691,429,262
109,私立,一般大學,1007,逢甲大學,664,513,151,167,35,175,52,145,54,12,4,14,6,628,487,141,644,499,145
109,私立,一般大學,1008,靜宜大學,383,228,155,64,27,73,58,71,54,17,14,3,2,347,208,139,378,225,153
109,私立,一般大學,1009,長庚大學,571,390,181,155,53,122,51,97,67,13,9,3,1,545,374,171,567,387,180
109,私立,一般大學,1010,元智大學,301,215,86,80,15,66,38,58,31,7,1,4,1,288,204,84,296,211,85
109,私立,一般大學,1011,中華大學學校財團法人中華大學,216,135,81,45,14,48,28,35,20,5,17,2,2,190,128,62,212,133,79
109,私立,一般大學,1012,大葉大學,292,193,99,41,11,68,37,68,35,10,15,6,1,260,177,83,285,187,98
109,私立,一般大學,1013,華梵大學,76,54,22,16,2,17,8,16,8,4,3,1,1,67,49,18,74,53,21
109,私立,一般大學,1014,義守大學,540,376,164,110,32,131,39,111,68,19,23,5,2,491,352,139,533,371,162
109,私立,一般大學,1015,世新大學,346,205,141,62,25,60,61,57,43,23,8,3,4,308,179,129,339,202,137
109,私立,一般大學,1016,銘傳大學,568,332,236,88,33,117,108,105,80,20,13,2,2,531,310,221,564,330,234
109,私立,一般大學,1017,實踐大學,339,189,150,30,12,67,44,77,73,10,20,5,1,303,174,129,333,184,149
109,私立,技專校院,1018,朝陽科技大學,394,266,128,51,16,87,49,104,49,18,11,6,3,356,242,114,385,260,125
109,私立,一般大學,1019,高雄醫學大學,544,343,201,142,60,106,62,84,70,11,7,0,2,524,332,192,542,343,199
109,私立,一般大學,1020,南華大學,192,124,68,33,6,46,28,44,34,1,0,0,0,191,123,68,192,124,68
109,私立,一般大學,1021,真理大學,233,147,86,37,8,57,39,46,24,5,13,2,2,211,140,71,229,145,84
109,私立,一般大學,1022,大同大學,143,106,37,43,7,33,13,19,11,10,6,1,0,126,95,31,142,105,37
109,私立,技專校院,1023,南臺學校財團法人南臺科技大學,559,379,180,86,15,149,59,113,74,23,30,8,2,496,348,148,549,371,178
109,私立,技專校院,1024,崑山科技大學,313,228,85,56,2,86,44,64,32,19,7,3,0,284,206,78,310,225,85
109,私立,技專校院,1025,嘉藥學校財團法人嘉南藥理大學,391,217,174,44,20,74,58,78,79,16,13,5,4,353,196,157,382,212,170
109,私立,技專校院,1026,樹德科技大學,267,175,92,20,3,63,13,81,66,10,9,1,1,246,164,82,265,174,91
109,私立,一般大學,1027,慈濟學校財團法人慈濟大學,238,111,127,27,23,46,52,34,41,4,10,0,1,223,107,116,237,111,126
109,私立,一般大學,1028,臺北醫學大學,669,455,214,146,64,143,77,156,68,10,3,0,2,654,445,209,667,455,212
109,私立,一般大學,1029,中山醫學大學,404,247,157,101,41,71,57,52,45,20,13,3,1,367,224,143,400,244,156
109,私立,技專校院,1030,龍華科技大學,265,197,68,34,5,69,23,77,32,14,7,3,1,240,180,60,261,194,67
109,私立,技專校院,1031,輔英科技大學,323,104,219,17,7,39,48,40,74,5,25,3,65,225,96,129,255,101,154
109,私立,技專校院,1032,明新學校財團法人明新科技大學,323,209,114,29,5,85,38,58,45,32,22,5,4,260,172,88,314,204,110
109,私立,一般大學,1033,長榮大學,323,186,137,35,14,52,51,94,62,4,8,1,2,308,181,127,320,185,135
109,私立,技專校院,1034,弘光科技大學,343,134,209,31,20,47,44,41,86,7,8,8,51,269,119,150,284,126,158
109,私立,一般大學,1035,中國醫藥大學,521,366,155,154,47,108,66,102,41,2,0,0,1,518,364,154,520,366,154
109,私立,技專校院,1036,健行學校財團法人健行科技大學,285,198,87,28,1,75,22,61,46,24,17,10,1,233,164,69,274,188,86
109,私立,技專校院,1037,正修學校財團法人正修科技大學,425,298,127,74,8,106,49,80,41,31,25,7,4,358,260,98,414,291,123
109,私立,技專校院,1038,萬能學校財團法人萬能科技大學,251,163,88,15,4,52,22,73,39,23,21,0,2,205,140,65,249,163,86
109,私立,一般大學,1039,玄奘大學,112,67,45,11,3,18,9,31,26,7,7,0,0,98,60,38,112,67,45
109,私立,技專校院,1040,建國科技大學,223,152,71,19,3,63,19,46,28,22,18,2,3,178,128,50,218,150,68
109,私立,技專校院,1041,明志科技大學,199,165,34,44,5,50,9,51,15,17,4,3,1,174,145,29,195,162,33
109,私立,技專校院,1042,高苑科技大學,187,146,41,22,0,56,17,46,11,19,13,3,0,152,124,28,184,143,41
109,私立,技專校院,1043,大仁科技大學,180,105,75,15,2,45,27,21,25,23,20,1,1,135,81,54,178,104,74
109,私立,技專校院,1044,聖約翰科技大學,133,100,33,14,0,42,10,26,14,17,8,1,1,106,82,24,131,99,32
109,私立,技專校院,1045,嶺東科技大學,274,159,115,16,4,59,50,67,42,14,17,3,2,238,142,96,269,156,113
109,私立,技專校院,1046,中國科技大學,248,174,74,7,2,46,24,85,32,33,14,3,2,196,138,58,243,171,72
109,私立,技專校院,1047,中臺科技大學,242,120,122,23,14,46,37,37,46,11,23,3,2,203,106,97,237,117,120
109,私立,一般大學,1048,亞洲大學,394,227,167,70,25,71,39,70,83,15,18,1,2,358,211,147,391,226,165
109,私立,一般大學,1049,開南大學,204,124,80,20,9,52,28,45,37,6,6,1,0,191,117,74,203,123,80
109,私立,一般大學,1050,佛光大學,165,105,60,24,11,41,22,34,21,5,6,1,0,153,99,54,164,104,60
109,私立,技專校院,1051,台南家專學校財團法人台南應用科技大學,328,155,173,19,9,49,60,67,68,17,36,3,0,272,135,137,325,152,173
109,私立,技專校院,1052,遠東科技大學,183,137,46,31,1,43,15,49,17,13,11,1,2,156,123,33,180,136,44
109,私立,技專校院,1053,光宇學校財團法人元培醫事科技大學,184,99,85,13,6,32,19,41,42,11,13,2,5,153,86,67,177,97,80
109,私立,技專校院,1054,景文科技大學,172,95,77,13,4,27,29,37,22,15,19,3,3,132,77,55,166,92,74
109,私立,技專校院,1055,中華醫事科技大學,279,109,170,17,8,33,58,42,42,14,31,3,31,200,92,108,245,106,139
109,私立,技專校院,1056,東南科技大學,170,125,45,14,1,44,13,43,16,24,14,0,1,131,101,30,169,125,44
109,私立,技專校院,1057,德明財經科技大學,224,111,113,7,5,43,31,44,46,17,31,0,0,176,94,82,224,111,113
109,私立,一般大學,1058,明道學校財團法人明道大學,116,75,41,13,1,18,5,39,33,4,2,1,0,109,70,39,115,74,41
109,私立,技專校院,1060,南開科技大學,140,108,32,22,1,47,14,23,13,13,4,3,0,120,92,28,137,105,32
109,私立,技專校院,1061,中華學校財團法人中華科技大學,155,108,47,9,0,34,9,36,21,27,16,2,1,109,79,30,152,106,46
109,私立,技專校院,1062,僑光科技大學,237,147,90,13,1,58,35,55,26,18,26,3,2,188,126,62,232,144,88
109,私立,技專校院,1063,廣亞學校財團法人育達科技大學,96,55,41,7,0,15,11,22,20,10,8,1,2,75,44,31,93,54,39
109,私立,技專校院,1064,美和學校財團法人美和科技大學,212,82,130,4,3,33,17,28,37,12,26,5,47,122,65,57,160,77,83
109,私立,技專校院,1065,吳鳳科技大學,145,97,48,7,0,46,10,27,17,15,19,2,2,107,80,27,141,95,46
109,私立,技專校院,1066,環球學校財團法人環球科技大學,137,81,56,9,2,23,11,37,23,11,17,1,3,105,69,36,133,80,53
109,私立,一般大學,1067,台灣首府學校財團法人台灣首府大學,66,44,22,1,0,11,0,27,19,3,2,2,1,58,39,19,63,42,21
109,私立,技專校院,1068,中州學校財團法人中州科技大學,88,56,32,5,1,28,7,18,13,5,11,0,0,72,51,21,88,56,32
109,私立,技專校院,1069,修平學校財團法人修平科技大學,177,133,44,21,1,46,9,44,23,20,8,2,3,144,111,33,172,131,41
109,私立,技專校院,1070,長庚學校財團法人長庚科技大學,328,57,271,15,18,22,71,12,69,6,33,2,80,207,49,158,246,55,191
109,私立,技專校院,1071,城市學校財團法人臺北城市科技大學,251,171,80,10,2,66,19,58,29,30,24,7,6,184,134,50,238,164,74
109,私立,技專校院,1072,大華學校財團法人敏實科技大學,41,29,12,2,0,14,3,6,5,7,4,0,0,30,22,8,41,29,12
109,私立,技專校院,1073,醒吾學校財團法人醒吾科技大學,218,113,105,12,4,35,30,41,28,24,43,1,0,150,88,62,217,112,105
109,私立,技專校院,1075,文藻學校財團法人文藻外語大學,267,117,150,15,11,41,52,49,57,11,29,1,1,225,105,120,265,116,149
109,私立,技專校院,1076,華夏學校財團法人華夏科技大學,123,90,33,12,0,37,10,22,11,17,9,2,3,92,71,21,118,88,30
109,私立,技專校院,1077,慈濟學校財團法人慈濟科技大學,163,49,114,5,0,16,21,21,41,5,21,2,31,104,42,62,130,47,83
109,私立,技專校院,1078,致理學校財團法人致理科技大學,269,129,140,17,4,44,62,48,51,19,20,1,3,226,109,117,265,128,137
109,私立,一般大學,1079,康寧學校財團法人康寧大學,121,48,73,3,3,3,13,21,26,19,30,2,1,69,27,42,118,46,72
109,私立,技專校院,1080,宏國學校財團法人宏國德霖科技大學,181,123,58,7,1,41,13,41,27,32,17,2,0,130,89,41,179,121,58
109,私立,技專校院,1081,東方學校財團法人東方設計大學,95,64,31,6,0,29,10,18,9,6,8,5,4,72,53,19,86,59,27
109,私立,技專校院,1082,崇右學校財團法人崇右影藝科技大學,75,43,32,5,0,16,14,17,5,4,13,1,0,57,38,19,74,42,32
109,私立,技專校院,1083,台北海洋學校財團法人台北海洋科技大學,143,80,63,5,1,18,20,42,30,11,9,4,3,116,65,51,136,76,60
109,私立,一般大學,1125,中信學校財團法人中信金融管理學院,55,35,20,11,3,6,2,12,9,6,5,0,1,43,29,14,54,35,19
109,私立,技專校院,1148,大漢技術學院,42,32,10,3,0,12,3,12,1,4,6,1,0,31,27,4,41,31,10
109,私立,技專校院,1159,和春技術學院,48,32,16,1,1,8,1,14,7,9,7,0,0,32,23,9,48,32,16
109,私立,技專校院,1166,亞東技術學院,149,103,46,18,2,42,13,31,23,10,5,2,3,129,91,38,144,101,43
109,私立,技專校院,1168,南亞科技學校財團法人南亞技術學院,93,59,34,8,0,15,7,17,12,16,15,3,0,59,40,19,90,56,34
109,私立,一般大學,1176,稻江科技暨管理學院,17,10,7,0,0,2,1,7,4,1,2,0,0,14,9,5,17,10,7
109,私立,技專校院,1182,蘭陽技術學院,44,30,14,1,0,6,2,12,1,11,11,0,0,22,19,3,44,30,14
109,私立,技專校院,1183,黎明技術學院,169,116,53,7,0,37,10,38,20,32,22,2,1,112,82,30,166,114,52
109,私立,技專校院,1185,經國管理暨健康學院,139,47,92,3,2,18,19,17,29,8,21,1,21,88,38,50,117,46,71
109,私立,技專校院,1188,大同技術學院,52,25,27,2,0,7,9,12,11,2,5,2,2,41,21,20,48,23,25
109,私立,技專校院,1192,臺灣觀光學院,10,6,4,1,0,0,0,2,3,3,1,0,0,6,3,3,10,6,4
109,私立,一般大學,1195,馬偕學校財團法人馬偕醫學院,127,84,43,15,2,31,12,36,23,2,6,0,0,119,82,37,127,84,43
109,私立,一般大學,1196,法鼓學校財團法人法鼓文理學院,24,15,9,2,1,7,4,6,4,0,0,0,0,24,15,9,24,15,9
109,私立,技專校院,1282,馬偕學校財團法人馬偕醫護管理專科學校,145,48,97,4,0,7,5,21,18,12,51,4,23,55,32,23,118,44,74
109,私立,技專校院,1283,仁德醫護管理專科學校,216,76,140,2,0,0,0,22,24,44,75,8,41,48,24,24,167,68,99
109,私立,技專校院,1284,樹人醫護管理專科學校,224,60,164,1,0,3,1,25,32,22,96,9,35,62,29,33,180,51,129
109,私立,技專校院,1285,慈惠醫護管理專科學校,140,41,99,1,0,1,0,11,14,19,47,9,38,27,13,14,93,32,61
109,私立,技專校院,1286,耕莘健康管理專科學校,164,39,125,0,0,7,5,13,21,11,79,8,20,46,20,26,136,31,105
109,私立,技專校院,1287,敏惠醫護管理專科學校,128,37,91,1,0,7,0,11,10,12,64,6,17,29,19,10,105,31,74
109,私立,技專校院,1289,育英醫護管理專科學校,70,12,58,0,0,1,1,6,3,3,30,2,24,11,7,4,44,10,34
109,私立,技專校院,1291,聖母醫護管理專科學校,89,25,64,2,0,6,0,3,11,10,44,4,9,22,11,11,76,21,55
109,私立,技專校院,1292,新生醫護管理專科學校,214,42,172,0,0,2,1,12,31,19,101,9,39,46,14,32,166,33,133
109,私立,技專校院,1293,崇仁醫護管理專科學校,124,29,95,2,0,4,1,5,14,15,56,3,24,26,11,15,97,26,71
109,私立,宗教研修學院,1R02,學校財團法人中華浸信會基督教台灣浸會神學院,12,6,6,1,0,3,1,2,5,0,0,0,0,12,6,6,12,6,6
109,私立,宗教研修學院,1R03,臺北基督學院,10,6,4,0,1,0,0,5,2,1,1,0,0,8,5,3,10,6,4
109,私立,宗教研修學院,1R04,財團法人一貫道天皇基金會一貫道天皇學院,12,9,3,2,0,1,2,6,1,0,0,0,0,12,9,3,12,9,3
109,私立,宗教研修學院,1R05,台神學校財團法人台灣神學研究學院,19,12,7,2,2,2,2,8,3,0,0,0,0,19,12,7,19,12,7
109,私立,宗教研修學院,1R06,一貫道崇德學院,6,3,3,1,0,2,1,0,2,0,0,0,0,6,3,3,6,3,3
109,私立,宗教研修學院,1R07,台灣基督長老教會南神神學院,10,6,4,2,0,4,1,0,3,0,0,0,0,10,6,4,10,6,4
109,公立,一般大學,3002,臺北市立大學,323,170,153,65,53,67,50,29,42,6,4,3,4,306,161,145,316,167,149
110,公立,一般大學,0001,國立政治大學,726,420,306,197,114,128,92,82,63,11,18,2,19,676,407,269,705,418,287
110,公立,一般大學,0002,國立清華大學,859,581,278,360,104,137,107,78,58,2,9,4,0,844,575,269,855,577,278
110,公立,一般大學,0003,國立臺灣大學,2064,1427,637,878,271,320,215,216,130,12,10,1,11,2030,1414,616,2052,1426,626
110,公立,一般大學,0004,國立臺灣師範大學,825,477,348,288,166,113,100,60,50,14,21,2,11,777,461,316,812,475,337
110,公立,一般大學,0005,國立成功大學,1328,991,337,536,118,292,124,144,75,11,10,8,10,1289,972,317,1310,983,327
110,公立,一般大學,0006,國立中興大學,840,655,185,346,70,160,58,137,42,5,8,7,7,813,643,170,826,648,178
110,公立,一般大學,0007,國立陽明交通大學,1156,856,300,471,135,208,88,158,60,11,10,8,7,1120,837,283,1141,848,293
110,公立,一般大學,0008,國立中央大學,675,530,145,307,56,136,39,83,32,4,13,0,5,653,526,127,670,530,140
110,公立,一般大學,0009,國立中山大學,574,420,154,193,58,97,42,129,50,1,0,0,4,569,419,150,570,420,150
110,公立,一般大學,0012,國立臺灣海洋大學,443,356,87,168,25,93,22,88,30,4,0,3,10,426,349,77,430,353,77
110,公立,一般大學,0013,國立中正大學,532,380,152,222,67,96,61,57,19,3,3,2,2,522,375,147,528,378,150
110,公立,一般大學,0014,國立高雄師範大學,284,174,110,106,46,39,40,27,18,0,1,2,5,276,172,104,277,172,105
110,公立,一般大學,0015,國立彰化師範大學,382,259,123,148,56,67,36,40,27,4,3,0,1,374,255,119,381,259,122
110,公立,一般大學,0017,國立臺北大學,382,233,149,97,52,70,45,55,40,6,4,5,8,359,222,137,369,228,141
110,公立,一般大學,0018,國立嘉義大學,500,340,160,155,52,94,55,82,37,8,9,1,7,475,331,144,492,339,153
110,公立,一般大學,0019,國立高雄大學,238,183,55,96,21,49,23,34,10,3,0,1,1,233,179,54,236,182,54
110,公立,一般大學,0020,國立東華大學,456,297,159,141,58,102,66,40,25,14,10,0,0,432,283,149,456,297,159
110,公立,一般大學,0021,國立暨南國際大學,270,182,88,97,33,63,39,17,12,5,4,0,0,261,177,84,270,182,88
110,公立,技專校院,0022,國立臺灣科技大學,522,419,103,235,42,86,20,86,28,12,11,0,2,497,407,90,520,419,101
110,公立,技專校院,0023,國立雲林科技大學,418,322,96,138,23,93,26,78,37,10,4,3,6,395,309,86,409,319,90
110,公立,技專校院,0024,國立屏東科技大學,403,280,123,129,41,83,47,49,24,16,9,3,2,373,261,112,398,277,121
110,公立,技專校院,0025,國立臺北科技大學,463,374,89,183,25,111,37,62,18,9,5,9,4,436,356,80,450,365,85
110,公立,一般大學,0028,國立臺北藝術大學,168,85,83,28,15,23,35,24,18,8,5,2,10,143,75,68,156,83,73
110,公立,一般大學,0029,國立臺灣藝術大學,165,101,64,37,30,30,18,30,15,3,1,1,0,160,97,63,164,100,64
110,公立,一般大學,0030,國立臺東大學,206,140,66,46,15,52,29,34,16,6,4,2,2,192,132,60,202,138,64
110,公立,一般大學,0031,國立宜蘭大學,233,176,57,82,10,59,17,27,19,7,10,1,1,214,168,46,231,175,56
110,公立,一般大學,0032,國立聯合大學,283,217,66,69,13,94,24,43,20,9,8,2,1,263,206,57,280,215,65
110,公立,技專校院,0033,國立虎尾科技大學,349,288,61,128,17,89,21,59,19,9,4,3,0,333,276,57,346,285,61
110,公立,一般大學,0035,國立臺南藝術大學,107,60,47,18,14,16,15,24,17,2,1,0,0,104,58,46,107,60,47
110,公立,一般大學,0036,國立臺南大學,227,131,96,78,35,37,43,16,15,0,0,0,3,224,131,93,224,131,93
110,公立,一般大學,0037,國立臺北教育大學,245,136,109,64,40,26,41,41,24,5,1,0,3,236,131,105,242,136,106
110,公立,一般大學,0039,國立臺中教育大學,204,120,84,58,27,32,33,27,19,2,2,1,3,196,117,79,200,119,81
110,公立,技專校院,0042,國立澎湖科技大學,128,88,40,30,7,25,10,26,20,6,3,1,0,118,81,37,127,87,40
110,公立,技專校院,0043,國立勤益科技大學,314,235,79,93,22,70,25,57,26,9,5,6,1,293,220,73,307,229,78
110,公立,一般大學,0044,國立體育大學,102,69,33,29,10,24,11,6,8,3,2,7,2,88,59,29,93,62,31
110,公立,技專校院,0046,國立臺北護理健康大學,212,53,159,19,24,20,41,12,55,1,8,1,31,171,51,120,180,52,128
110,公立,技專校院,0047,國立高雄餐旅大學,164,109,55,27,10,33,25,41,12,5,7,3,1,148,101,47,160,106,54
110,公立,一般大學,0048,國立金門大學,148,103,45,29,3,50,27,20,15,3,0,1,0,144,99,45,147,102,45
110,公立,一般大學,0049,國立臺灣體育運動大學,126,90,36,18,8,34,11,15,8,4,3,19,6,94,67,27,101,71,30
110,公立,技專校院,0050,國立臺中科技大學,418,176,242,56,44,71,76,44,77,2,13,3,32,368,171,197,383,173,210
110,公立,技專校院,0051,國立臺北商業大學,220,127,93,36,19,45,41,30,18,7,11,9,4,189,111,78,207,118,89
110,公立,一般大學,0052,國立屏東大學,355,209,146,64,28,84,59,52,50,6,5,3,4,337,200,137,348,206,142
110,公立,技專校院,0053,國立高雄科技大學,860,658,202,296,52,214,75,121,47,19,17,8,11,805,631,174,841,650,191
110,公立,技專校院,0144,國立臺灣戲曲學院,35,21,14,4,0,8,8,9,4,0,2,0,0,33,21,12,35,21,14
110,公立,技專校院,0221,國立臺南護理專科學校,92,18,74,4,5,5,16,8,21,0,5,1,27,59,17,42,64,17,47
110,公立,技專校院,0222,國立臺東專科學校,64,43,21,6,1,13,2,21,10,3,8,0,0,53,40,13,64,43,21
110,私立,一般大學,1001,東海大學,554,375,179,129,33,111,61,108,62,16,11,11,12,504,348,156,531,364,167
110,私立,一般大學,1002,輔仁大學,732,407,325,104,69,157,114,116,117,18,18,12,7,677,377,300,713,395,318
110,私立,一般大學,1003,東吳大學,432,251,181,94,45,69,67,74,55,12,14,2,0,404,237,167,430,249,181
110,私立,一般大學,1004,中原大學,499,345,154,131,26,100,62,92,55,7,8,15,3,466,323,143,481,330,151
110,私立,一般大學,1005,淡江大學學校財團法人淡江大學,742,471,271,174,54,171,126,97,72,8,9,21,10,694,442,252,711,450,261
110,私立,一般大學,1006,中國文化大學,693,432,261,153,53,164,114,97,83,10,7,8,4,664,414,250,681,424,257
110,私立,一般大學,1007,逢甲大學,657,501,156,169,36,173,53,137,58,12,3,10,6,626,479,147,641,491,150
110,私立,一般大學,1008,靜宜大學,374,221,153,62,26,73,58,68,55,15,12,3,2,342,203,139,369,218,151
110,私立,一般大學,1009,長庚大學,592,401,191,164,54,116,52,104,75,14,9,3,1,565,384,181,588,398,190
110,私立,一般大學,1010,元智大學,296,212,84,76,18,67,34,58,31,7,1,4,0,284,201,83,292,208,84
110,私立,一般大學,1011,中華大學學校財團法人中華大學,207,131,76,45,13,46,29,34,19,4,13,2,2,186,125,61,203,129,74
110,私立,一般大學,1012,大葉大學,285,184,101,37,12,59,31,71,37,14,20,3,1,247,167,80,281,181,100
110,私立,一般大學,1013,華梵大學,70,50,20,16,2,14,6,15,9,4,2,1,1,62,45,17,68,49,19
110,私立,一般大學,1014,義守大學,532,367,165,113,32,123,44,109,64,19,23,3,2,485,345,140,527,364,163
110,私立,一般大學,1015,世新大學,339,205,134,65,29,57,57,57,39,23,7,3,2,304,179,125,334,202,132
110,私立,一般大學,1016,銘傳大學,556,322,234,82,33,113,109,108,80,17,11,2,1,525,303,222,553,320,233
110,私立,一般大學,1017,實踐大學,324,184,140,30,13,70,49,71,63,8,14,5,1,296,171,125,318,179,139
110,私立,技專校院,1018,朝陽科技大學,390,264,126,56,13,89,50,96,51,18,9,5,3,355,241,114,382,259,123
110,私立,一般大學,1019,高雄醫學大學,535,339,196,149,58,100,65,79,66,11,5,0,2,517,328,189,533,339,194
110,私立,一般大學,1020,南華大學,195,127,68,34,6,44,31,48,31,1,0,0,0,194,126,68,195,127,68
110,私立,一般大學,1021,真理大學,225,144,81,39,10,53,35,46,22,4,12,2,2,205,138,67,221,142,79
110,私立,一般大學,1022,大同大學,140,102,38,41,7,31,12,21,12,8,7,1,0,124,93,31,139,101,38
110,私立,技專校院,1023,南臺學校財團法人南臺科技大學,531,358,173,88,14,127,57,113,72,21,28,9,2,471,328,143,520,349,171
110,私立,技專校院,1024,崑山科技大學,293,213,80,53,2,79,44,60,26,20,8,1,0,264,192,72,292,212,80
110,私立,技專校院,1025,嘉藥學校財團法人嘉南藥理大學,352,192,160,41,18,60,54,68,74,18,11,5,3,315,169,146,344,187,157
110,私立,技專校院,1026,樹德科技大學,256,164,92,21,2,58,14,75,64,10,11,0,1,234,154,80,255,164,91
110,私立,一般大學,1027,慈濟學校財團法人慈濟大學,232,108,124,29,25,44,50,31,41,4,8,0,0,220,104,116,232,108,124
110,私立,一般大學,1028,臺北醫學大學,681,469,212,162,72,137,79,160,56,10,4,0,1,666,459,207,680,469,211
110,私立,一般大學,1029,中山醫學大學,410,252,158,102,46,76,53,53,46,20,12,1,1,376,231,145,408,251,157
110,私立,技專校院,1030,龍華科技大學,275,210,65,33,5,69,24,92,29,14,5,2,2,252,194,58,271,208,63
110,私立,技專校院,1031,輔英科技大學,321,101,220,18,5,38,47,38,77,5,23,2,68,223,94,129,251,99,152
110,私立,技專校院,1032,明新學校財團法人明新科技大學,308,202,106,30,5,84,35,61,41,25,22,2,3,256,175,81,303,200,103
110,私立,一般大學,1033,長榮大學,318,183,135,36,17,47,50,95,59,4,8,1,1,304,178,126,316,182,134
110,私立,技專校院,1034,弘光科技大學,337,131,206,32,18,46,43,40,88,7,6,6,51,267,118,149,280,125,155
110,私立,一般大學,1035,中國醫藥大學,518,364,154,163,50,104,65,95,38,2,0,0,1,515,362,153,517,364,153
110,私立,技專校院,1036,健行學校財團法人健行科技大學,277,191,86,27,1,70,22,64,48,21,14,9,1,232,161,71,267,182,85
110,私立,技專校院,1037,正修學校財團法人正修科技大學,411,283,128,68,10,98,50,82,42,30,22,5,4,350,248,102,402,278,124
110,私立,技專校院,1038,萬能學校財團法人萬能科技大學,238,153,85,16,4,50,19,65,39,22,21,0,2,193,131,62,236,153,83
110,私立,一般大學,1039,玄奘大學,107,66,41,11,3,19,9,30,22,6,7,0,0,94,60,34,107,66,41
110,私立,技專校院,1040,建國科技大學,195,130,65,21,3,51,17,41,27,15,15,2,3,160,113,47,190,128,62
110,私立,技專校院,1041,明志科技大學,199,166,33,50,5,44,10,54,13,15,4,3,1,176,148,28,195,163,32
110,私立,技專校院,1042,高苑科技大學,171,132,39,21,0,49,17,42,10,17,12,3,0,139,112,27,168,129,39
110,私立,技專校院,1043,大仁科技大學,164,93,71,16,2,43,27,16,28,18,13,0,1,132,75,57,163,93,70
110,私立,技專校院,1044,聖約翰科技大學,122,92,30,13,0,32,8,23,12,24,9,0,1,88,68,20,121,92,29
110,私立,技專校院,1045,嶺東科技大學,269,161,108,19,3,60,44,65,45,14,15,3,1,236,144,92,265,158,107
110,私立,技專校院,1046,中國科技大學,230,163,67,8,4,42,21,85,28,26,13,2,1,188,135,53,227,161,66
110,私立,技專校院,1047,中臺科技大學,232,115,117,20,15,45,34,38,47,8,20,4,1,199,103,96,227,111,116
110,私立,一般大學,1048,亞洲大學,387,225,162,77,23,70,40,65,80,12,18,1,1,355,212,143,385,224,161
110,私立,一般大學,1049,開南大學,186,108,78,18,10,44,29,42,33,3,6,1,0,176,104,72,185,107,78
110,私立,一般大學,1050,佛光大學,162,104,58,26,11,41,21,33,23,3,3,1,0,155,100,55,161,103,58
110,私立,技專校院,1051,台南家專學校財團法人台南應用科技大學,329,159,170,17,9,49,58,74,75,16,28,3,0,282,140,142,326,156,170
110,私立,技專校院,1052,遠東科技大學,166,123,43,28,2,39,15,44,15,11,9,1,2,143,111,32,163,122,41
110,私立,技專校院,1053,光宇學校財團法人元培醫事科技大學,169,93,76,12,6,32,18,37,37,10,11,2,4,142,81,61,163,91,72
110,私立,技專校院,1054,景文科技大學,166,96,70,15,3,24,27,39,21,15,18,3,1,129,78,51,162,93,69
110,私立,技專校院,1055,中華醫事科技大學,261,96,165,14,6,32,55,36,38,12,31,2,35,181,82,99,224,94,130
110,私立,技專校院,1056,東南科技大學,154,112,42,14,1,39,13,36,15,23,12,0,1,118,89,29,153,112,41
110,私立,技專校院,1057,德明財經科技大學,221,106,115,9,6,41,31,41,48,15,30,0,0,176,91,85,221,106,115
110,私立,一般大學,1058,明道學校財團法人明道大學,109,69,40,12,1,18,5,35,32,3,2,1,0,103,65,38,108,68,40
110,私立,技專校院,1060,南開科技大學,113,86,27,15,1,41,12,20,11,9,3,1,0,100,76,24,112,85,27
110,私立,技專校院,1061,中華學校財團法人中華科技大學,144,99,45,9,0,33,9,32,22,23,13,2,1,105,74,31,141,97,44
110,私立,技專校院,1062,僑光科技大學,227,141,86,12,2,56,34,54,26,16,23,3,1,184,122,62,223,138,85
110,私立,技專校院,1063,廣亞學校財團法人育達科技大學,90,49,41,5,0,14,12,21,20,8,7,1,2,72,40,32,87,48,39
110,私立,技專校院,1064,美和學校財團法人美和科技大學,196,76,120,7,4,28,12,26,36,10,28,5,40,113,61,52,151,71,80
110,私立,技專校院,1065,吳鳳科技大學,139,94,45,10,0,40,9,27,16,15,19,2,1,102,77,25,136,92,44
110,私立,技專校院,1066,環球學校財團法人環球科技大學,122,75,47,9,1,23,12,31,17,11,14,1,3,93,63,30,118,74,44
110,私立,一般大學,1067,台灣首府學校財團法人台灣首府大學,59,36,23,1,0,11,2,18,18,5,2,1,1,50,30,20,57,35,22
110,私立,技專校院,1068,中州學校財團法人中州科技大學,82,51,31,5,1,24,7,16,12,6,11,0,0,65,45,20,82,51,31
110,私立,技專校院,1069,修平學校財團法人修平科技大學,161,120,41,20,1,42,10,39,21,16,7,3,2,133,101,32,156,117,39
110,私立,技專校院,1070,長庚學校財團法人長庚科技大學,332,60,272,15,23,22,70,14,74,6,30,3,75,218,51,167,254,57,197
110,私立,技專校院,1071,城市學校財團法人臺北城市科技大學,243,165,78,7,2,62,17,64,31,24,23,8,5,183,133,50,230,157,73
110,私立,技專校院,1072,大華學校財團法人敏實科技大學,34,22,12,1,0,9,5,8,5,4,2,0,0,28,18,10,34,22,12
110,私立,技專校院,1073,醒吾學校財團法人醒吾科技大學,209,107,102,15,4,31,30,40,27,21,41,0,0,147,86,61,209,107,102
110,私立,技專校院,1075,文藻學校財團法人文藻外語大學,271,118,153,16,12,40,54,49,56,11,30,2,1,227,105,122,268,116,152
110,私立,技專校院,1076,華夏學校財團法人華夏科技大學,120,87,33,11,0,35,10,22,11,17,9,2,3,89,68,21,115,85,30
110,私立,技專校院,1077,慈濟學校財團法人慈濟科技大學,167,46,121,5,1,16,20,22,47,3,22,0,31,111,43,68,136,46,90
110,私立,技專校院,1078,致理學校財團法人致理科技大學,274,132,142,18,7,45,62,49,50,20,20,0,3,231,112,119,271,132,139
110,私立,一般大學,1079,康寧學校財團法人康寧大學,112,42,70,2,2,4,12,18,29,18,26,0,1,67,24,43,111,42,69
110,私立,技專校院,1080,宏國學校財團法人宏國德霖科技大學,171,115,56,7,1,36,13,40,24,30,18,2,0,121,83,38,169,113,56
110,私立,技專校院,1081,東方學校財團法人東方設計大學,75,50,25,5,0,21,9,16,6,6,6,2,4,57,42,15,69,48,21
110,私立,技專校院,1082,崇右學校財團法人崇右影藝科技大學,62,40,22,4,0,13,10,18,2,5,10,0,0,47,35,12,62,40,22
110,私立,技專校院,1083,台北海洋學校財團法人台北海洋科技大學,136,75,61,5,1,16,22,40,26,11,9,3,3,110,61,49,130,72,58
110,私立,技專校院,1084,亞東學校財團法人亞東科技大學,143,101,42,18,2,44,14,26,19,11,4,2,3,123,88,35,138,99,39
110,私立,一般大學,1125,中信學校財團法人中信金融管理學院,66,45,21,16,3,7,2,15,10,7,5,0,1,53,38,15,65,45,20
110,私立,技專校院,1148,大漢技術學院,38,28,10,4,0,10,3,10,1,3,6,1,0,28,24,4,37,27,10
110,私立,技專校院,1159,和春技術學院,36,26,10,2,1,8,1,9,2,6,6,1,0,23,19,4,35,25,10
110,私立,技專校院,1168,南亞科技學校財團法人南亞技術學院,81,51,30,5,0,13,6,15,10,15,14,3,0,49,33,16,78,48,30
110,私立,技專校院,1182,蘭陽技術學院,27,19,8,0,0,5,0,9,1,5,7,0,0,15,14,1,27,19,8
110,私立,技專校院,1183,黎明技術學院,156,107,49,7,0,34,10,36,20,27,19,3,0,107,77,30,153,104,49
110,私立,技專校院,1185,經國管理暨健康學院,138,46,92,2,4,17,17,19,32,7,18,1,21,91,38,53,116,45,71
110,私立,技專校院,1188,大同技術學院,46,21,25,2,0,4,8,11,10,2,5,2,2,35,17,18,42,19,23
110,私立,一般大學,1195,馬偕學校財團法人馬偕醫學院,130,85,45,19,2,37,18,28,20,1,5,0,0,124,84,40,130,85,45
110,私立,一般大學,1196,法鼓學校財團法人法鼓文理學院,25,15,10,3,1,6,4,6,5,0,0,0,0,25,15,10,25,15,10
110,私立,技專校院,1282,馬偕學校財團法人馬偕醫護管理專科學校,147,49,98,6,0,4,6,25,21,10,49,4,22,62,35,27,121,45,76
110,私立,技專校院,1283,仁德醫護管理專科學校,217,75,142,2,0,2,0,20,23,44,77,7,42,47,24,23,168,68,100
110,私立,技專校院,1284,樹人醫護管理專科學校,221,57,164,2,0,3,2,23,32,20,96,9,34,62,28,34,178,48,130
110,私立,技專校院,1285,慈惠醫護管理專科學校,128,36,92,1,0,1,0,10,16,16,41,8,35,28,12,16,85,28,57
110,私立,技專校院,1286,耕莘健康管理專科學校,166,40,126,0,0,7,4,13,22,10,75,10,25,46,20,26,131,30,101
110,私立,技專校院,1287,敏惠醫護管理專科學校,121,28,93,1,0,4,0,5,11,14,66,4,16,21,10,11,101,24,77
110,私立,技專校院,1289,育英醫護管理專科學校,68,14,54,0,0,1,1,6,4,3,27,4,22,12,7,5,42,10,32
110,私立,技專校院,1291,聖母醫護管理專科學校,85,25,60,3,0,6,0,4,10,9,40,3,10,23,13,10,72,22,50
110,私立,技專校院,1292,新生醫護管理專科學校,208,41,167,0,0,3,1,11,28,18,104,9,34,43,14,29,165,32,133
110,私立,技專校院,1293,崇仁醫護管理專科學校,120,26,94,1,0,4,1,4,15,14,54,3,24,25,9,16,93,23,70
110,私立,宗教研修學院,1R02,學校財團法人中華浸信會基督教台灣浸會神學院,11,5,6,1,0,2,1,2,5,0,0,0,0,11,5,6,11,5,6
110,私立,宗教研修學院,1R03,臺北基督學院,8,4,4,0,0,0,0,3,3,1,1,0,0,6,3,3,8,4,4
110,私立,宗教研修學院,1R04,財團法人一貫道天皇基金會一貫道天皇學院,10,7,3,1,0,1,2,5,1,0,0,0,0,10,7,3,10,7,3
110,私立,宗教研修學院,1R05,台神學校財團法人台灣神學研究學院,20,12,8,2,1,2,3,8,4,0,0,0,0,20,12,8,20,12,8
110,私立,宗教研修學院,1R06,一貫道崇德學院,6,3,3,1,0,2,1,0,2,0,0,0,0,6,3,3,6,3,3
110,私立,宗教研修學院,1R07,台灣基督長老教會南神神學院,10,5,5,2,0,3,2,0,3,0,0,0,0,10,5,5,10,5,5
110,私立,宗教研修學院,1R08,中華福音神學研究學院,15,11,4,2,0,0,0,9,4,0,0,0,0,15,11,4,15,11,4
110,私立,宗教研修學院,1R09,唯心聖教學院,6,4,2,0,0,4,0,0,2,0,0,0,0,6,4,2,6,4,2
110,公立,一般大學,3002,臺北市立大學,322,172,150,66,56,63,45,34,42,7,3,2,4,306,163,143,316,170,146
