學年度,設立別,學校類別,學校統計處代碼,學校名稱,在學學生數-小計,在學學生數-男,在學學生數-女,獲弱勢學生助學計畫補助之受惠學生人數-小計,獲弱勢學生助學計畫補助之受惠學生人數-男,獲弱勢學生助學計畫補助之受惠學生人數-女,每千名學生獲弱勢學生助學計畫補助之受惠學生人數比率(‰)
105,公立,一般大學,0001,國立政治大學,16372,7207,9165,243,85,158,14.84
105,公立,一般大學,0002,國立清華大學,12466,8348,4118,240,144,96,19.25
105,公立,一般大學,0003,國立臺灣大學,31783,19084,12699,403,229,174,12.68
105,公立,一般大學,0004,國立臺灣師範大學,15307,6444,8863,218,99,119,14.24
105,公立,一般大學,0005,國立成功大學,21119,13536,7583,536,328,208,25.38
105,公立,一般大學,0006,國立中興大學,15047,9015,6032,426,200,226,28.31
105,公立,一般大學,0007,國立陽明交通大學,14083,10055,4028,250,167,83,17.75
105,公立,一般大學,0008,國立中央大學,11943,7871,4072,253,145,108,21.18
105,公立,一般大學,0009,國立中山大學,9417,5851,3566,234,141,93,24.85
105,公立,一般大學,0012,國立臺灣海洋大學,8707,5980,2727,186,110,76,21.36
105,公立,一般大學,0013,國立中正大學,11535,6542,4993,290,141,149,25.14
105,公立,一般大學,0014,國立高雄師範大學,6608,2865,3743,109,46,63,16.50
105,公立,一般大學,0015,國立彰化師範大學,8192,4147,4045,240,106,134,29.30
105,公立,一般大學,0016,國立陽明大學,4335,2254,2081,57,24,33,13.15
105,公立,一般大學,0017,國立臺北大學,9767,4416,5351,235,87,148,24.06
105,公立,一般大學,0018,國立嘉義大學,12545,6477,6068,494,184,310,39.38
105,公立,一般大學,0019,國立高雄大學,5511,3293,2218,154,76,78,27.94
105,公立,一般大學,0020,國立東華大學,10245,5125,5120,239,95,144,23.33
105,公立,一般大學,0021,國立暨南國際大學,6353,3109,3244,230,84,146,36.20
105,公立,技專校院,0022,國立臺灣科技大學,10729,7518,3211,380,251,129,35.42
105,公立,技專校院,0023,國立雲林科技大學,9752,5868,3884,606,315,291,62.14
105,公立,技專校院,0024,國立屏東科技大學,11350,6092,5258,548,230,318,48.28
105,公立,技專校院,0025,國立臺北科技大學,12568,9205,3363,469,307,162,37.32
105,公立,技專校院,0026,國立高雄第一科技大學,7730,4194,3536,511,190,321,66.11
105,公立,技專校院,0027,國立高雄應用科技大學,12019,7859,4160,850,448,402,70.72
105,公立,一般大學,0028,國立臺北藝術大學,3116,1055,2061,33,10,23,10.59
105,公立,一般大學,0029,國立臺灣藝術大學,5682,1809,3873,105,27,78,18.48
105,公立,一般大學,0030,國立臺東大學,4647,2128,2519,195,87,108,41.96
105,公立,一般大學,0031,國立宜蘭大學,5487,3581,1906,330,174,156,60.14
105,公立,一般大學,0032,國立聯合大學,7875,5361,2514,285,165,120,36.19
105,公立,技專校院,0033,國立虎尾科技大學,10091,7656,2435,915,591,324,90.67
105,公立,技專校院,0034,國立高雄海洋科技大學,7738,5149,2589,604,282,322,78.06
105,公立,一般大學,0035,國立臺南藝術大學,1529,504,1025,39,13,26,25.51
105,公立,一般大學,0036,國立臺南大學,5879,2634,3245,185,86,99,31.47
105,公立,一般大學,0037,國立臺北教育大學,5657,1865,3792,52,15,37,9.19
105,公立,一般大學,0038,國立新竹教育大學,4081,1159,2922,98,23,75,24.01
105,公立,一般大學,0039,國立臺中教育大學,5021,1702,3319,118,40,78,23.50
105,公立,技專校院,0042,國立澎湖科技大學,3018,1695,1323,122,48,74,40.42
105,公立,技專校院,0043,國立勤益科技大學,11218,8306,2912,958,578,380,85.40
105,公立,一般大學,0044,國立體育大學,2437,1473,964,101,38,63,41.44
105,公立,技專校院,0046,國立臺北護理健康大學,4829,783,4046,407,60,347,84.28
105,公立,技專校院,0047,國立高雄餐旅大學,5331,1498,3833,283,51,232,53.09
105,公立,一般大學,0048,國立金門大學,4515,2373,2142,142,55,87,31.45
105,公立,一般大學,0049,國立臺灣體育運動大學,3123,1900,1223,178,88,90,57
105,公立,技專校院,0050,國立臺中科技大學,13757,3627,10130,1186,242,944,86.21
105,公立,技專校院,0051,國立臺北商業大學,6814,1829,4985,355,55,300,52.10
105,公立,一般大學,0052,國立屏東大學,8870,3478,5392,373,116,257,42.05
105,公立,技專校院,0144,國立臺灣戲曲學院,627,231,396,27,6,21,43.06
105,公立,技專校院,0221,國立臺南護理專科學校,1944,127,1817,44,2,42,22.63
105,公立,技專校院,0222,國立臺東專科學校,1263,734,529,19,6,13,15.04
105,私立,一般大學,1001,東海大學,16652,7759,8893,625,229,396,37.53
105,私立,一般大學,1002,輔仁大學,27546,11428,16118,796,266,530,28.90
105,私立,一般大學,1003,東吳大學,15917,6426,9491,439,118,321,27.58
105,私立,一般大學,1004,中原大學,16431,9394,7037,594,272,322,36.15
105,私立,一般大學,1005,淡江大學學校財團法人淡江大學,26619,13779,12840,773,320,453,29.04
105,私立,一般大學,1006,中國文化大學,26304,12436,13868,883,314,569,33.57
105,私立,一般大學,1007,逢甲大學,21238,13353,7885,834,419,415,39.27
105,私立,一般大學,1008,靜宜大學,12350,4747,7603,836,224,612,67.69
105,私立,一般大學,1009,長庚大學,7406,4035,3371,133,64,69,17.96
105,私立,一般大學,1010,元智大學,9364,5543,3821,242,107,135,25.84
105,私立,一般大學,1011,中華大學學校財團法人中華大學,7753,4753,3000,322,152,170,41.53
105,私立,一般大學,1012,大葉大學,11768,6328,5440,794,329,465,67.47
105,私立,一般大學,1013,華梵大學,2746,1420,1326,129,45,84,46.98
105,私立,一般大學,1014,義守大學,16373,8749,7624,814,340,474,49.72
105,私立,一般大學,1015,世新大學,11812,4582,7230,411,109,302,34.80
105,私立,一般大學,1016,銘傳大學,19349,7806,11543,756,210,546,39.07
105,私立,一般大學,1017,實踐大學,15460,5279,10181,686,157,529,44.37
105,私立,技專校院,1018,朝陽科技大學,16141,7174,8967,1926,671,1255,119.32
105,私立,一般大學,1019,高雄醫學大學,6896,3052,3844,166,50,116,24.07
105,私立,一般大學,1020,南華大學,5593,2684,2909,265,110,155,47.38
105,私立,一般大學,1021,真理大學,7722,3672,4050,390,130,260,50.51
105,私立,一般大學,1022,大同大學,4667,3055,1612,136,80,56,29.14
105,私立,技專校院,1023,南臺學校財團法人南臺科技大學,19135,10605,8530,2381,1035,1346,124.43
105,私立,技專校院,1024,崑山科技大學,12479,7711,4768,1948,953,995,156.10
105,私立,技專校院,1025,嘉藥學校財團法人嘉南藥理大學,16286,6838,9448,2174,777,1397,133.49
105,私立,技專校院,1026,樹德科技大學,10957,4847,6110,1301,399,902,118.74
105,私立,一般大學,1027,慈濟學校財團法人慈濟大學,3460,1361,2099,156,51,105,45.09
105,私立,一般大學,1028,臺北醫學大學,5973,2557,3416,126,39,87,21.09
105,私立,一般大學,1029,中山醫學大學,7385,3079,4306,256,69,187,34.66
105,私立,技專校院,1030,龍華科技大學,11105,7388,3717,1004,516,488,90.41
105,私立,技專校院,1031,輔英科技大學,9354,2547,6807,915,175,740,97.82
105,私立,技專校院,1032,明新學校財團法人明新科技大學,12804,7686,5118,870,372,498,67.95
105,私立,一般大學,1033,長榮大學,10284,4787,5497,755,256,499,73.42
105,私立,技專校院,1034,弘光科技大學,13100,4430,8670,1518,362,1156,115.88
105,私立,一般大學,1035,中國醫藥大學,7410,3378,4032,334,129,205,45.07
105,私立,技專校院,1036,健行學校財團法人健行科技大學,10984,7054,3930,1017,510,507,92.59
105,私立,技專校院,1037,正修學校財團法人正修科技大學,17227,10061,7166,1670,791,879,96.94
105,私立,技專校院,1038,萬能學校財團法人萬能科技大學,10876,5729,5147,530,179,351,48.73
105,私立,一般大學,1039,玄奘大學,5158,2257,2901,185,56,129,35.87
105,私立,技專校院,1040,建國科技大學,8572,5586,2986,907,489,418,105.81
105,私立,技專校院,1041,明志科技大學,4586,3213,1373,371,241,130,80.90
105,私立,技專校院,1042,高苑科技大學,6809,4812,1997,406,236,170,59.63
105,私立,技專校院,1043,大仁科技大學,6909,3102,3807,761,237,524,110.15
105,私立,技專校院,1044,聖約翰科技大學,4676,3327,1349,390,235,155,83.40
105,私立,技專校院,1045,嶺東科技大學,10389,4390,5999,1284,371,913,123.59
105,私立,技專校院,1046,中國科技大學,11888,5123,6765,985,292,693,82.86
105,私立,技專校院,1047,中臺科技大學,9439,3203,6236,941,244,697,99.69
105,私立,一般大學,1048,亞洲大學,12288,5194,7094,877,246,631,71.37
105,私立,一般大學,1049,開南大學,8265,4193,4072,338,117,221,40.90
105,私立,一般大學,1050,佛光大學,3983,1850,2133,75,31,44,18.83
105,私立,技專校院,1051,台南家專學校財團法人台南應用科技大學,12911,3609,9302,1668,332,1336,129.19
105,私立,技專校院,1052,遠東科技大學,7345,4642,2703,1013,553,460,137.92
105,私立,技專校院,1053,光宇學校財團法人元培醫事科技大學,6774,3043,3731,429,130,299,63.33
105,私立,技專校院,1054,景文科技大學,7697,3519,4178,496,151,345,64.44
105,私立,技專校院,1055,中華醫事科技大學,9526,3310,6216,1126,324,802,118.20
105,私立,技專校院,1056,東南科技大學,6911,4601,2310,512,283,229,74.08
105,私立,技專校院,1057,德明財經科技大學,8954,3506,5448,873,237,636,97.50
105,私立,一般大學,1058,明道學校財團法人明道大學,4968,2849,2119,465,230,235,93.60
105,私立,技專校院,1060,南開科技大學,5838,3950,1888,562,303,259,96.27
105,私立,技專校院,1061,中華學校財團法人中華科技大學,7426,4970,2456,442,249,193,59.52
105,私立,技專校院,1062,僑光科技大學,10657,4561,6096,1364,426,938,127.99
105,私立,技專校院,1063,廣亞學校財團法人育達科技大學,4917,2443,2474,489,169,320,99.45
105,私立,技專校院,1064,美和學校財團法人美和科技大學,7842,2451,5391,842,250,592,107.37
105,私立,技專校院,1065,吳鳳科技大學,5134,3527,1607,1132,660,472,220.49
105,私立,技專校院,1066,環球學校財團法人環球科技大學,5886,2789,3097,622,231,391,105.67
105,私立,一般大學,1067,台灣首府學校財團法人台灣首府大學,3305,1734,1571,311,133,178,94.10
105,私立,技專校院,1068,中州學校財團法人中州科技大學,3922,2229,1693,401,159,242,102.24
105,私立,技專校院,1069,修平學校財團法人修平科技大學,5992,3977,2015,677,351,326,112.98
105,私立,技專校院,1070,長庚學校財團法人長庚科技大學,7070,533,6537,867,37,830,122.63
105,私立,技專校院,1071,城市學校財團法人臺北城市科技大學,9933,6282,3651,887,466,421,89.30
105,私立,技專校院,1072,大華學校財團法人敏實科技大學,3591,2398,1193,148,76,72,41.21
105,私立,技專校院,1073,醒吾學校財團法人醒吾科技大學,8284,3424,4860,721,205,516,87.04
105,私立,技專校院,1074,南榮學校財團法人南榮科技大學,2904,1799,1105,226,116,110,77.82
105,私立,技專校院,1075,文藻學校財團法人文藻外語大學,9448,2063,7385,802,138,664,84.89
105,私立,技專校院,1076,華夏學校財團法人華夏科技大學,4926,3259,1667,363,183,180,73.69
105,私立,技專校院,1077,慈濟學校財團法人慈濟科技大學,2924,798,2126,145,36,109,49.59
105,私立,技專校院,1078,致理學校財團法人致理科技大學,11804,3547,8257,983,213,770,83.28
105,私立,一般大學,1079,康寧學校財團法人康寧大學,5262,1745,3517,168,47,121,31.93
105,私立,一般大學,1125,中信學校財團法人中信金融管理學院,331,152,179,5,4,1,15.11
105,私立,技專校院,1148,大漢技術學院,1497,930,567,24,12,12,16.03
105,私立,技專校院,1159,和春技術學院,3387,2288,1099,115,68,47,33.95
105,私立,技專校院,1166,亞東技術學院,4685,3174,1511,393,227,166,83.88
105,私立,技專校院,1168,南亞科技學校財團法人南亞技術學院,4440,2571,1869,337,145,192,75.90
105,私立,一般大學,1176,稻江科技暨管理學院,2186,1010,1176,218,60,158,99.73
105,私立,技專校院,1179,德霖技術學院,7257,4453,2804,323,169,154,44.51
105,私立,技專校院,1182,蘭陽技術學院,1463,871,592,33,17,16,22.56
105,私立,技專校院,1183,黎明技術學院,4709,2832,1877,427,201,226,90.68
105,私立,技專校院,1184,東方設計學院,3596,1642,1954,179,63,116,49.78
105,私立,技專校院,1185,經國管理暨健康學院,4122,1235,2887,210,42,168,50.95
105,私立,技專校院,1187,崇右技術學院,2912,1345,1567,294,90,204,100.96
105,私立,技專校院,1188,大同技術學院,2434,1057,1377,365,105,260,149.96
105,私立,技專校院,1189,亞太學校財團法人亞太創意技術學院,1410,442,968,102,30,72,72.34
105,私立,技專校院,1192,臺灣觀光學院,1300,589,711,68,16,52,52.31
105,私立,一般大學,1195,馬偕學校財團法人馬偕醫學院,648,262,386,13,2,11,20.06
105,私立,一般大學,1196,法鼓學校財團法人法鼓文理學院,238,73,165,2,0,2,8.40
105,私立,技專校院,1197,台北海洋技術學院,5914,3350,2564,334,132,202,56.48
105,私立,技專校院,1282,馬偕學校財團法人馬偕醫護管理專科學校,4330,598,3732,205,11,194,47.34
105,私立,技專校院,1283,仁德醫護管理專科學校,6630,1567,5063,246,40,206,37.10
105,私立,技專校院,1284,樹人醫護管理專科學校,7110,1928,5182,245,41,204,34.46
105,私立,技專校院,1285,慈惠醫護管理專科學校,6203,1557,4646,542,119,423,87.38
105,私立,技專校院,1286,耕莘健康管理專科學校,5257,536,4721,126,7,119,23.97
105,私立,技專校院,1287,敏惠醫護管理專科學校,3897,475,3422,492,51,441,126.25
105,私立,技專校院,1288,高美醫護管理專科學校,771,246,525,102,31,71,132.30
105,私立,技專校院,1289,育英醫護管理專科學校,1962,170,1792,184,11,173,93.78
105,私立,技專校院,1290,崇仁醫護管理專科學校,3478,426,3052,254,26,228,73.03
105,私立,技專校院,1291,聖母醫護管理專科學校,3525,835,2690,164,27,137,46.52
105,私立,技專校院,1292,新生醫護管理專科學校,6022,740,5282,446,26,420,74.06
105,私立,宗教研修學院,1R04,財團法人一貫道天皇基金會一貫道天皇學院,27,7,20,3,1,2,111.11
105,公立,一般大學,3002,臺北市立大學,7631,3165,4466,135,61,74,17.69
106,公立,一般大學,0001,國立政治大學,16353,7216,9137,232,94,138,14.19
106,公立,一般大學,0002,國立清華大學,16664,9534,7130,200,95,105,12
106,公立,一般大學,0003,國立臺灣大學,31802,19054,12748,330,189,141,10.38
106,公立,一般大學,0004,國立臺灣師範大學,15426,6514,8912,208,91,117,13.48
106,公立,一般大學,0005,國立成功大學,21252,13490,7762,432,250,182,20.33
106,公立,一般大學,0006,國立中興大學,14877,8859,6018,312,155,157,20.97
106,公立,一般大學,0007,國立陽明交通大學,14169,10018,4151,205,120,85,14.47
106,公立,一般大學,0008,國立中央大學,11924,7797,4127,234,134,100,19.62
106,公立,一般大學,0009,國立中山大學,9466,5837,3629,215,130,85,22.71
106,公立,一般大學,0012,國立臺灣海洋大學,8652,5889,2763,190,116,74,21.96
106,公立,一般大學,0013,國立中正大學,11512,6492,5020,263,109,154,22.85
106,公立,一般大學,0014,國立高雄師範大學,6654,2850,3804,111,44,67,16.68
106,公立,一般大學,0015,國立彰化師範大學,8235,4182,4053,203,92,111,24.65
106,公立,一般大學,0016,國立陽明大學,4332,2199,2133,67,35,32,15.47
106,公立,一般大學,0017,國立臺北大學,9853,4440,5413,224,77,147,22.73
106,公立,一般大學,0018,國立嘉義大學,12399,6405,5994,435,183,252,35.08
106,公立,一般大學,0019,國立高雄大學,5506,3230,2276,144,64,80,26.15
106,公立,一般大學,0020,國立東華大學,10154,5058,5096,199,76,123,19.60
106,公立,一般大學,0021,國立暨南國際大學,6361,3054,3307,184,59,125,28.93
106,公立,技專校院,0022,國立臺灣科技大學,11019,7745,3274,285,187,98,25.86
106,公立,技專校院,0023,國立雲林科技大學,9715,5869,3846,499,267,232,51.36
106,公立,技專校院,0024,國立屏東科技大學,11187,6044,5143,476,207,269,42.55
106,公立,技專校院,0025,國立臺北科技大學,12973,9490,3483,407,261,146,31.37
106,公立,技專校院,0026,國立高雄第一科技大學,7804,4264,3540,450,183,267,57.66
106,公立,技專校院,0027,國立高雄應用科技大學,11822,7720,4102,509,285,224,43.06
106,公立,一般大學,0028,國立臺北藝術大學,3131,1119,2012,40,15,25,12.78
106,公立,一般大學,0029,國立臺灣藝術大學,5683,1793,3890,104,33,71,18.30
106,公立,一般大學,0030,國立臺東大學,4616,2118,2498,163,65,98,35.31
106,公立,一般大學,0031,國立宜蘭大學,5511,3621,1890,283,166,117,51.35
106,公立,一般大學,0032,國立聯合大學,7729,5217,2512,235,123,112,30.40
106,公立,技專校院,0033,國立虎尾科技大學,10188,7768,2420,605,371,234,59.38
106,公立,技專校院,0034,國立高雄海洋科技大學,7694,5225,2469,492,258,234,63.95
106,公立,一般大學,0035,國立臺南藝術大學,1580,533,1047,32,10,22,20.25
106,公立,一般大學,0036,國立臺南大學,5745,2546,3199,193,90,103,33.59
106,公立,一般大學,0037,國立臺北教育大學,5808,1904,3904,58,18,40,9.99
106,公立,一般大學,0039,國立臺中教育大學,5006,1708,3298,100,42,58,19.98
106,公立,技專校院,0042,國立澎湖科技大學,3008,1718,1290,121,54,67,40.23
106,公立,技專校院,0043,國立勤益科技大學,11176,8237,2939,439,264,175,39.28
106,公立,一般大學,0044,國立體育大學,2464,1490,974,67,28,39,27.19
106,公立,技專校院,0046,國立臺北護理健康大學,5077,839,4238,360,47,313,70.91
106,公立,技專校院,0047,國立高雄餐旅大學,5267,1510,3757,258,52,206,48.98
106,公立,一般大學,0048,國立金門大學,4501,2427,2074,160,61,99,35.55
106,公立,一般大學,0049,國立臺灣體育運動大學,3154,1921,1233,189,88,101,59.92
106,公立,技專校院,0050,國立臺中科技大學,13599,3632,9967,873,156,717,64.20
106,公立,技專校院,0051,國立臺北商業大學,6730,1856,4874,263,38,225,39.08
106,公立,一般大學,0052,國立屏東大學,8963,3578,5385,360,133,227,40.17
106,公立,技專校院,0144,國立臺灣戲曲學院,614,218,396,29,6,23,47.23
106,公立,技專校院,0221,國立臺南護理專科學校,1955,140,1815,39,3,36,19.95
106,公立,技專校院,0222,國立臺東專科學校,1244,747,497,18,9,9,14.47
106,私立,一般大學,1001,東海大學,16429,7662,8767,562,197,365,34.21
106,私立,一般大學,1002,輔仁大學,27017,11287,15730,659,224,435,24.39
106,私立,一般大學,1003,東吳大學,15850,6369,9481,372,92,280,23.47
106,私立,一般大學,1004,中原大學,16342,9261,7081,463,200,263,28.33
106,私立,一般大學,1005,淡江大學學校財團法人淡江大學,26032,13476,12556,641,252,389,24.62
106,私立,一般大學,1006,中國文化大學,25885,12331,13554,774,256,518,29.90
106,私立,一般大學,1007,逢甲大學,21146,13248,7898,762,381,381,36.04
106,私立,一般大學,1008,靜宜大學,12289,4745,7544,798,211,587,64.94
106,私立,一般大學,1009,長庚大學,7187,3807,3380,118,52,66,16.42
106,私立,一般大學,1010,元智大學,9135,5379,3756,214,104,110,23.43
106,私立,一般大學,1011,中華大學學校財團法人中華大學,6722,4173,2549,229,112,117,34.07
106,私立,一般大學,1012,大葉大學,11147,5887,5260,629,264,365,56.43
106,私立,一般大學,1013,華梵大學,2320,1229,1091,82,26,56,35.34
106,私立,一般大學,1014,義守大學,16209,8738,7471,675,293,382,41.64
106,私立,一般大學,1015,世新大學,11723,4447,7276,376,95,281,32.07
106,私立,一般大學,1016,銘傳大學,19129,7634,11495,716,200,516,37.43
106,私立,一般大學,1017,實踐大學,14579,4894,9685,606,131,475,41.57
106,私立,技專校院,1018,朝陽科技大學,15792,7070,8722,1584,520,1064,100.30
106,私立,一般大學,1019,高雄醫學大學,6881,3033,3848,162,54,108,23.54
106,私立,一般大學,1020,南華大學,5600,2644,2956,237,74,163,42.32
106,私立,一般大學,1021,真理大學,6773,3320,3453,327,132,195,48.28
106,私立,一般大學,1022,大同大學,4497,2872,1625,129,72,57,28.69
106,私立,技專校院,1023,南臺學校財團法人南臺科技大學,18855,10634,8221,1954,872,1082,103.63
106,私立,技專校院,1024,崑山科技大學,12174,7504,4670,1549,781,768,127.24
106,私立,技專校院,1025,嘉藥學校財團法人嘉南藥理大學,15702,6684,9018,1780,583,1197,113.36
106,私立,技專校院,1026,樹德科技大學,10699,4747,5952,1078,347,731,100.76
106,私立,一般大學,1027,慈濟學校財團法人慈濟大學,3460,1325,2135,130,40,90,37.57
106,私立,一般大學,1028,臺北醫學大學,6112,2586,3526,123,48,75,20.12
106,私立,一般大學,1029,中山醫學大學,7237,2923,4314,226,62,164,31.23
106,私立,技專校院,1030,龍華科技大學,11086,7486,3600,775,424,351,69.91
106,私立,技專校院,1031,輔英科技大學,9306,2549,6757,745,154,591,80.06
106,私立,技專校院,1032,明新學校財團法人明新科技大學,12319,7550,4769,787,361,426,63.89
106,私立,一般大學,1033,長榮大學,9680,4484,5196,624,201,423,64.46
106,私立,技專校院,1034,弘光科技大學,12959,4376,8583,1309,321,988,101.01
106,私立,一般大學,1035,中國醫藥大學,7468,3383,4085,264,103,161,35.35
106,私立,技專校院,1036,健行學校財團法人健行科技大學,10765,6957,3808,849,380,469,78.87
106,私立,技專校院,1037,正修學校財團法人正修科技大學,16903,9891,7012,1457,648,809,86.20
106,私立,技專校院,1038,萬能學校財團法人萬能科技大學,10472,5604,4868,427,155,272,40.78
106,私立,一般大學,1039,玄奘大學,4367,1908,2459,141,46,95,32.29
106,私立,技專校院,1040,建國科技大學,7839,5152,2687,711,384,327,90.70
106,私立,技專校院,1041,明志科技大學,4561,3267,1294,324,210,114,71.04
106,私立,技專校院,1042,高苑科技大學,5587,4000,1587,298,163,135,53.34
106,私立,技專校院,1043,大仁科技大學,6615,2970,3645,635,212,423,95.99
106,私立,技專校院,1044,聖約翰科技大學,3967,2735,1232,290,159,131,73.10
106,私立,技專校院,1045,嶺東科技大學,10312,4347,5965,1092,319,773,105.90
106,私立,技專校院,1046,中國科技大學,10969,4922,6047,792,251,541,72.20
106,私立,技專校院,1047,中臺科技大學,9007,3112,5895,769,205,564,85.38
106,私立,一般大學,1048,亞洲大學,12123,4878,7245,797,218,579,65.74
106,私立,一般大學,1049,開南大學,7330,3733,3597,279,85,194,38.06
106,私立,一般大學,1050,佛光大學,3822,1801,2021,69,27,42,18.05
106,私立,技專校院,1051,台南家專學校財團法人台南應用科技大學,12733,3606,9127,1340,267,1073,105.24
106,私立,技專校院,1052,遠東科技大學,6247,4063,2184,704,354,350,112.69
106,私立,技專校院,1053,光宇學校財團法人元培醫事科技大學,6437,2917,3520,325,99,226,50.49
106,私立,技專校院,1054,景文科技大學,7299,3342,3957,409,125,284,56.04
106,私立,技專校院,1055,中華醫事科技大學,9240,3174,6066,960,271,689,103.90
106,私立,技專校院,1056,東南科技大學,6241,4232,2009,364,196,168,58.32
106,私立,技專校院,1057,德明財經科技大學,8420,3363,5057,670,183,487,79.57
106,私立,一般大學,1058,明道學校財團法人明道大學,4469,2574,1895,357,176,181,79.88
106,私立,技專校院,1060,南開科技大學,5217,3551,1666,456,250,206,87.41
106,私立,技專校院,1061,中華學校財團法人中華科技大學,6538,4419,2119,371,202,169,56.75
106,私立,技專校院,1062,僑光科技大學,10856,4845,6011,1142,359,783,105.20
106,私立,技專校院,1063,廣亞學校財團法人育達科技大學,4582,2260,2322,354,124,230,77.26
106,私立,技專校院,1064,美和學校財團法人美和科技大學,7466,2263,5203,698,177,521,93.49
106,私立,技專校院,1065,吳鳳科技大學,4709,3265,1444,981,579,402,208.32
106,私立,技專校院,1066,環球學校財團法人環球科技大學,5295,2529,2766,576,199,377,108.78
106,私立,一般大學,1067,台灣首府學校財團法人台灣首府大學,2730,1449,1281,261,110,151,95.60
106,私立,技專校院,1068,中州學校財團法人中州科技大學,3473,1945,1528,307,129,178,88.40
106,私立,技專校院,1069,修平學校財團法人修平科技大學,5211,3514,1697,527,260,267,101.13
106,私立,技專校院,1070,長庚學校財團法人長庚科技大學,6712,563,6149,715,41,674,106.53
106,私立,技專校院,1071,城市學校財團法人臺北城市科技大學,9677,6170,3507,742,400,342,76.68
106,私立,技專校院,1072,大華學校財團法人敏實科技大學,2940,1996,944,91,53,38,30.95
106,私立,技專校院,1073,醒吾學校財團法人醒吾科技大學,8198,3372,4826,603,152,451,73.55
106,私立,技專校院,1074,南榮學校財團法人南榮科技大學,2211,1397,814,134,69,65,60.61
106,私立,技專校院,1075,文藻學校財團法人文藻外語大學,9419,2151,7268,658,111,547,69.86
106,私立,技專校院,1076,華夏學校財團法人華夏科技大學,4799,3182,1617,304,149,155,63.35
106,私立,技專校院,1077,慈濟學校財團法人慈濟科技大學,2947,769,2178,122,28,94,41.40
106,私立,技專校院,1078,致理學校財團法人致理科技大學,11624,3526,8098,866,182,684,74.50
106,私立,一般大學,1079,康寧學校財團法人康寧大學,4968,1628,3340,131,27,104,26.37
106,私立,技專校院,1080,宏國學校財團法人宏國德霖科技大學,6568,3964,2604,246,114,132,37.45
106,私立,技專校院,1081,東方學校財團法人東方設計大學,3192,1512,1680,153,60,93,47.93
106,私立,技專校院,1082,崇右學校財團法人崇右影藝科技大學,2685,1226,1459,255,139,116,94.97
106,私立,技專校院,1083,台北海洋學校財團法人台北海洋科技大學,5330,3010,2320,258,90,168,48.41
106,私立,一般大學,1125,中信學校財團法人中信金融管理學院,485,227,258,7,3,4,14.43
106,私立,技專校院,1148,大漢技術學院,1305,809,496,21,13,8,16.09
106,私立,技專校院,1159,和春技術學院,2475,1624,851,71,38,33,28.69
106,私立,技專校院,1166,亞東技術學院,4484,3005,1479,324,177,147,72.26
106,私立,技專校院,1168,南亞科技學校財團法人南亞技術學院,3542,2116,1426,200,69,131,56.47
106,私立,一般大學,1176,稻江科技暨管理學院,2267,1076,1191,246,76,170,108.51
106,私立,技專校院,1182,蘭陽技術學院,1058,606,452,20,8,12,18.90
106,私立,技專校院,1183,黎明技術學院,4576,2674,1902,278,121,157,60.75
106,私立,技專校院,1185,經國管理暨健康學院,3874,1197,2677,176,33,143,45.43
106,私立,技專校院,1188,大同技術學院,2112,898,1214,259,67,192,122.63
106,私立,技專校院,1192,臺灣觀光學院,896,404,492,43,15,28,47.99
106,私立,一般大學,1195,馬偕學校財團法人馬偕醫學院,666,266,400,16,1,15,24.02
106,私立,技專校院,1282,馬偕學校財團法人馬偕醫護管理專科學校,4381,632,3749,179,12,167,40.86
106,私立,技專校院,1283,仁德醫護管理專科學校,6601,1548,5053,168,32,136,25.45
106,私立,技專校院,1284,樹人醫護管理專科學校,7097,1898,5199,215,39,176,30.29
106,私立,技專校院,1285,慈惠醫護管理專科學校,5556,1372,4184,402,93,309,72.35
106,私立,技專校院,1286,耕莘健康管理專科學校,5217,532,4685,115,4,111,22.04
106,私立,技專校院,1287,敏惠醫護管理專科學校,3858,466,3392,314,26,288,81.39
106,私立,技專校院,1289,育英醫護管理專科學校,1969,175,1794,162,9,153,82.28
106,私立,技專校院,1290,崇仁醫護管理專科學校,3503,428,3075,214,22,192,61.09
106,私立,技專校院,1291,聖母醫護管理專科學校,3155,715,2440,141,24,117,44.69
106,私立,技專校院,1292,新生醫護管理專科學校,6024,771,5253,318,24,294,52.79
106,私立,宗教研修學院,1R04,財團法人一貫道天皇基金會一貫道天皇學院,72,27,45,9,2,7,125
106,公立,一般大學,3002,臺北市立大學,7675,3168,4507,97,42,55,12.64
107,公立,一般大學,0001,國立政治大學,16343,7284,9059,234,95,139,14.32
107,公立,一般大學,0002,國立清華大學,16657,9558,7099,201,98,103,12.07
107,公立,一般大學,0003,國立臺灣大學,31745,18934,12811,369,222,147,11.62
107,公立,一般大學,0004,國立臺灣師範大學,15582,6578,9004,218,88,130,13.99
107,公立,一般大學,0005,國立成功大學,21276,13481,7795,418,235,183,19.65
107,公立,一般大學,0006,國立中興大學,14884,8801,6083,328,168,160,22.04
107,公立,一般大學,0007,國立陽明交通大學,14271,9987,4284,168,98,70,11.77
107,公立,一般大學,0008,國立中央大學,11960,7867,4093,223,149,74,18.65
107,公立,一般大學,0009,國立中山大學,9425,5851,3574,224,134,90,23.77
107,公立,一般大學,0012,國立臺灣海洋大學,8655,5868,2787,219,131,88,25.30
107,公立,一般大學,0013,國立中正大學,11328,6377,4951,231,105,126,20.39
107,公立,一般大學,0014,國立高雄師範大學,6678,2900,3778,105,41,64,15.72
107,公立,一般大學,0015,國立彰化師範大學,8333,4245,4088,206,90,116,24.72
107,公立,一般大學,0016,國立陽明大學,4334,2223,2111,44,17,27,10.15
107,公立,一般大學,0017,國立臺北大學,9923,4460,5463,209,66,143,21.06
107,公立,一般大學,0018,國立嘉義大學,12219,6347,5872,425,175,250,34.78
107,公立,一般大學,0019,國立高雄大學,5565,3293,2272,181,93,88,32.52
107,公立,一般大學,0020,國立東華大學,9928,4839,5089,200,75,125,20.15
107,公立,一般大學,0021,國立暨南國際大學,6200,2878,3322,179,67,112,28.87
107,公立,技專校院,0022,國立臺灣科技大學,11137,7790,3347,314,216,98,28.19
107,公立,技專校院,0023,國立雲林科技大學,9732,5791,3941,462,234,228,47.47
107,公立,技專校院,0024,國立屏東科技大學,11122,6052,5070,451,196,255,40.55
107,公立,技專校院,0025,國立臺北科技大學,13119,9643,3476,386,254,132,29.42
107,公立,一般大學,0028,國立臺北藝術大學,3072,1085,1987,37,15,22,12.04
107,公立,一般大學,0029,國立臺灣藝術大學,5714,1829,3885,109,27,82,19.08
107,公立,一般大學,0030,國立臺東大學,4583,2089,2494,143,53,90,31.20
107,公立,一般大學,0031,國立宜蘭大學,5470,3586,1884,268,157,111,48.99
107,公立,一般大學,0032,國立聯合大學,7622,5144,2478,280,152,128,36.74
107,公立,技專校院,0033,國立虎尾科技大學,10486,8025,2461,616,408,208,58.74
107,公立,一般大學,0035,國立臺南藝術大學,1564,517,1047,31,8,23,19.82
107,公立,一般大學,0036,國立臺南大學,5692,2548,3144,239,106,133,41.99
107,公立,一般大學,0037,國立臺北教育大學,5814,1891,3923,46,15,31,7.91
107,公立,一般大學,0039,國立臺中教育大學,4966,1703,3263,108,40,68,21.75
107,公立,技專校院,0042,國立澎湖科技大學,3025,1749,1276,117,46,71,38.68
107,公立,技專校院,0043,國立勤益科技大學,11896,8727,3169,602,376,226,50.61
107,公立,一般大學,0044,國立體育大學,2465,1559,906,64,25,39,25.96
107,公立,技專校院,0046,國立臺北護理健康大學,5247,922,4325,281,35,246,53.55
107,公立,技專校院,0047,國立高雄餐旅大學,5197,1538,3659,262,57,205,50.41
107,公立,一般大學,0048,國立金門大學,4303,2276,2027,173,63,110,40.20
107,公立,一般大學,0049,國立臺灣體育運動大學,3100,1842,1258,180,91,89,58.06
107,公立,技專校院,0050,國立臺中科技大學,16212,4661,11551,845,149,696,52.12
107,公立,技專校院,0051,國立臺北商業大學,7769,2280,5489,226,43,183,29.09
107,公立,一般大學,0052,國立屏東大學,8969,3585,5384,358,117,241,39.92
107,公立,技專校院,0053,國立高雄科技大學,28010,17805,10205,1480,734,746,52.84
107,公立,技專校院,0144,國立臺灣戲曲學院,607,219,388,28,7,21,46.13
107,公立,技專校院,0221,國立臺南護理專科學校,1958,135,1823,50,3,47,25.54
107,公立,技專校院,0222,國立臺東專科學校,1174,710,464,13,7,6,11.07
107,私立,一般大學,1001,東海大學,16080,7428,8652,602,217,385,37.44
107,私立,一般大學,1002,輔仁大學,26176,10982,15194,618,198,420,23.61
107,私立,一般大學,1003,東吳大學,15665,6299,9366,357,97,260,22.79
107,私立,一般大學,1004,中原大學,16189,9029,7160,481,221,260,29.71
107,私立,一般大學,1005,淡江大學學校財團法人淡江大學,25343,13074,12269,618,227,391,24.39
107,私立,一般大學,1006,中國文化大學,25225,12019,13206,761,260,501,30.17
107,私立,一般大學,1007,逢甲大學,20812,12912,7900,808,384,424,38.82
107,私立,一般大學,1008,靜宜大學,12104,4658,7446,835,206,629,68.99
107,私立,一般大學,1009,長庚大學,7052,3638,3414,129,51,78,18.29
107,私立,一般大學,1010,元智大學,8882,5226,3656,209,98,111,23.53
107,私立,一般大學,1011,中華大學學校財團法人中華大學,6267,3857,2410,183,90,93,29.20
107,私立,一般大學,1012,大葉大學,10311,5422,4889,632,266,366,61.29
107,私立,一般大學,1013,華梵大學,1871,985,886,74,28,46,39.55
107,私立,一般大學,1014,義守大學,15532,8236,7296,663,256,407,42.69
107,私立,一般大學,1015,世新大學,11590,4333,7257,439,109,330,37.88
107,私立,一般大學,1016,銘傳大學,18975,7610,11365,705,202,503,37.15
107,私立,一般大學,1017,實踐大學,13968,4604,9364,609,147,462,43.60
107,私立,技專校院,1018,朝陽科技大學,15612,6986,8626,1396,470,926,89.42
107,私立,一般大學,1019,高雄醫學大學,6802,2922,3880,154,61,93,22.64
107,私立,一般大學,1020,南華大學,5898,2803,3095,243,81,162,41.20
107,私立,一般大學,1021,真理大學,6204,3051,3153,307,103,204,49.48
107,私立,一般大學,1022,大同大學,4390,2734,1656,134,71,63,30.52
107,私立,技專校院,1023,南臺學校財團法人南臺科技大學,18622,10653,7969,1758,791,967,94.40
107,私立,技專校院,1024,崑山科技大學,11794,7298,4496,1315,669,646,111.50
107,私立,技專校院,1025,嘉藥學校財團法人嘉南藥理大學,14348,6076,8272,1523,469,1054,106.15
107,私立,技專校院,1026,樹德科技大學,11123,4841,6282,1044,339,705,93.86
107,私立,一般大學,1027,慈濟學校財團法人慈濟大學,3448,1329,2119,140,38,102,40.60
107,私立,一般大學,1028,臺北醫學大學,6140,2562,3578,125,51,74,20.36
107,私立,一般大學,1029,中山醫學大學,7096,2724,4372,233,58,175,32.84
107,私立,技專校院,1030,龍華科技大學,11229,7702,3527,665,359,306,59.22
107,私立,技專校院,1031,輔英科技大學,9401,2567,6834,687,138,549,73.08
107,私立,技專校院,1032,明新學校財團法人明新科技大學,12786,7925,4861,707,337,370,55.29
107,私立,一般大學,1033,長榮大學,9259,4122,5137,610,189,421,65.88
107,私立,技專校院,1034,弘光科技大學,12971,4391,8580,1167,290,877,89.97
107,私立,一般大學,1035,中國醫藥大學,7425,3328,4097,277,108,169,37.31
107,私立,技專校院,1036,健行學校財團法人健行科技大學,11333,7368,3965,815,380,435,71.91
107,私立,技專校院,1037,正修學校財團法人正修科技大學,18272,10810,7462,1361,604,757,74.49
107,私立,技專校院,1038,萬能學校財團法人萬能科技大學,10526,5618,4908,350,117,233,33.25
107,私立,一般大學,1039,玄奘大學,3674,1508,2166,126,44,82,34.30
107,私立,技專校院,1040,建國科技大學,7921,5318,2603,606,323,283,76.51
107,私立,技專校院,1041,明志科技大學,4559,3327,1232,274,173,101,60.10
107,私立,技專校院,1042,高苑科技大學,5247,3781,1466,249,157,92,47.46
107,私立,技專校院,1043,大仁科技大學,6404,2854,3550,539,182,357,84.17
107,私立,技專校院,1044,聖約翰科技大學,3807,2660,1147,216,119,97,56.74
107,私立,技專校院,1045,嶺東科技大學,10348,4396,5952,998,303,695,96.44
107,私立,技專校院,1046,中國科技大學,11170,5217,5953,679,218,461,60.79
107,私立,技專校院,1047,中臺科技大學,8685,2990,5695,722,166,556,83.13
107,私立,一般大學,1048,亞洲大學,11779,4544,7235,828,222,606,70.29
107,私立,一般大學,1049,開南大學,6665,3394,3271,210,68,142,31.51
107,私立,一般大學,1050,佛光大學,3696,1707,1989,65,25,40,17.59
107,私立,技專校院,1051,台南家專學校財團法人台南應用科技大學,12731,3692,9039,1223,257,966,96.06
107,私立,技專校院,1052,遠東科技大學,5938,3831,2107,585,305,280,98.52
107,私立,技專校院,1053,光宇學校財團法人元培醫事科技大學,6397,2844,3553,263,67,196,41.11
107,私立,技專校院,1054,景文科技大學,7283,3409,3874,346,119,227,47.51
107,私立,技專校院,1055,中華醫事科技大學,9162,3115,6047,729,201,528,79.57
107,私立,技專校院,1056,東南科技大學,5938,4041,1897,309,180,129,52.04
107,私立,技專校院,1057,德明財經科技大學,8289,3389,4900,547,152,395,65.99
107,私立,一般大學,1058,明道學校財團法人明道大學,3913,2262,1651,282,144,138,72.07
107,私立,技專校院,1060,南開科技大學,4997,3354,1643,424,228,196,84.85
107,私立,技專校院,1061,中華學校財團法人中華科技大學,5977,4067,1910,294,160,134,49.19
107,私立,技專校院,1062,僑光科技大學,10970,5048,5922,1000,329,671,91.16
107,私立,技專校院,1063,廣亞學校財團法人育達科技大學,4840,2315,2525,269,91,178,55.58
107,私立,技專校院,1064,美和學校財團法人美和科技大學,8313,2562,5751,728,180,548,87.57
107,私立,技專校院,1065,吳鳳科技大學,5238,3451,1787,901,520,381,172.01
107,私立,技專校院,1066,環球學校財團法人環球科技大學,5294,2386,2908,543,174,369,102.57
107,私立,一般大學,1067,台灣首府學校財團法人台灣首府大學,2194,1133,1061,171,64,107,77.94
107,私立,技專校院,1068,中州學校財團法人中州科技大學,3383,1745,1638,249,96,153,73.60
107,私立,技專校院,1069,修平學校財團法人修平科技大學,5285,3764,1521,423,246,177,80.04
107,私立,技專校院,1070,長庚學校財團法人長庚科技大學,6635,640,5995,735,51,684,110.78
107,私立,技專校院,1071,城市學校財團法人臺北城市科技大學,10431,6553,3878,639,359,280,61.26
107,私立,技專校院,1072,大華學校財團法人敏實科技大學,2019,1297,722,61,37,24,30.21
107,私立,技專校院,1073,醒吾學校財團法人醒吾科技大學,9274,3896,5378,552,175,377,59.52
107,私立,技專校院,1075,文藻學校財團法人文藻外語大學,9437,2324,7113,608,115,493,64.43
107,私立,技專校院,1076,華夏學校財團法人華夏科技大學,4575,2941,1634,271,115,156,59.23
107,私立,技專校院,1077,慈濟學校財團法人慈濟科技大學,3041,762,2279,107,21,86,35.19
107,私立,技專校院,1078,致理學校財團法人致理科技大學,11513,3620,7893,756,170,586,65.66
107,私立,一般大學,1079,康寧學校財團法人康寧大學,4304,1277,3027,96,16,80,22.30
107,私立,技專校院,1080,宏國學校財團法人宏國德霖科技大學,6344,3821,2523,215,109,106,33.89
107,私立,技專校院,1081,東方學校財團法人東方設計大學,3600,1765,1835,135,45,90,37.50
107,私立,技專校院,1082,崇右學校財團法人崇右影藝科技大學,3417,1580,1837,201,62,139,58.82
107,私立,技專校院,1083,台北海洋學校財團法人台北海洋科技大學,4947,2772,2175,205,66,139,41.44
107,私立,一般大學,1125,中信學校財團法人中信金融管理學院,661,330,331,9,5,4,13.62
107,私立,技專校院,1148,大漢技術學院,1163,696,467,15,4,11,12.90
107,私立,技專校院,1159,和春技術學院,1553,1011,542,35,14,21,22.54
107,私立,技專校院,1166,亞東技術學院,4522,3065,1457,299,163,136,66.12
107,私立,技專校院,1168,南亞科技學校財團法人南亞技術學院,3969,2254,1715,183,66,117,46.11
107,私立,一般大學,1176,稻江科技暨管理學院,2334,1102,1232,242,70,172,103.68
107,私立,技專校院,1182,蘭陽技術學院,1313,766,547,15,10,5,11.42
107,私立,技專校院,1183,黎明技術學院,4925,2843,2082,243,108,135,49.34
107,私立,技專校院,1185,經國管理暨健康學院,4614,1316,3298,160,29,131,34.68
107,私立,技專校院,1188,大同技術學院,1891,801,1090,216,65,151,114.23
107,私立,技專校院,1192,臺灣觀光學院,751,351,400,29,10,19,38.62
107,私立,一般大學,1195,馬偕學校財團法人馬偕醫學院,708,273,435,21,7,14,29.66
107,私立,技專校院,1282,馬偕學校財團法人馬偕醫護管理專科學校,4276,615,3661,161,15,146,37.65
107,私立,技專校院,1283,仁德醫護管理專科學校,6425,1510,4915,148,37,111,23.04
107,私立,技專校院,1284,樹人醫護管理專科學校,7149,1888,5261,153,34,119,21.40
107,私立,技專校院,1285,慈惠醫護管理專科學校,5040,1192,3848,292,69,223,57.94
107,私立,技專校院,1286,耕莘健康管理專科學校,5093,507,4586,124,7,117,24.35
107,私立,技專校院,1287,敏惠醫護管理專科學校,3869,470,3399,174,12,162,44.97
107,私立,技專校院,1289,育英醫護管理專科學校,2013,202,1811,109,10,99,54.15
107,私立,技專校院,1291,聖母醫護管理專科學校,2777,588,2189,75,7,68,27.01
107,私立,技專校院,1292,新生醫護管理專科學校,6058,758,5300,187,12,175,30.87
107,私立,技專校院,1293,崇仁醫護管理專科學校,3392,418,2974,227,19,208,66.92
107,私立,宗教研修學院,1R04,財團法人一貫道天皇基金會一貫道天皇學院,128,53,75,12,4,8,93.75
107,私立,宗教研修學院,1R07,台灣基督長老教會南神神學院,47,16,31,2,0,2,42.55
107,公立,一般大學,3002,臺北市立大學,7774,3151,4623,105,41,64,13.51
108,公立,一般大學,0001,國立政治大學,16390,7263,9127,248,100,148,15.13
108,公立,一般大學,0002,國立清華大學,16678,9594,7084,151,76,75,9.05
108,公立,一般大學,0003,國立臺灣大學,31945,19027,12918,339,194,145,10.61
108,公立,一般大學,0004,國立臺灣師範大學,15716,6658,9058,239,101,138,15.21
108,公立,一般大學,0005,國立成功大學,21456,13497,7959,448,255,193,20.88
108,公立,一般大學,0006,國立中興大學,14983,8853,6130,299,162,137,19.96
108,公立,一般大學,0007,國立陽明交通大學,14742,10185,4557,172,100,72,11.67
108,公立,一般大學,0008,國立中央大學,11822,7663,4159,201,135,66,17
108,公立,一般大學,0009,國立中山大學,9563,5906,3657,217,121,96,22.69
108,公立,一般大學,0012,國立臺灣海洋大學,8838,5976,2862,208,126,82,23.53
108,公立,一般大學,0013,國立中正大學,11205,6276,4929,248,99,149,22.13
108,公立,一般大學,0014,國立高雄師範大學,6690,2912,3778,105,45,60,15.70
108,公立,一般大學,0015,國立彰化師範大學,8385,4268,4117,228,105,123,27.19
108,公立,一般大學,0016,國立陽明大學,4336,2189,2147,45,23,22,10.38
108,公立,一般大學,0017,國立臺北大學,9954,4513,5441,213,76,137,21.40
108,公立,一般大學,0018,國立嘉義大學,11885,6115,5770,393,164,229,33.07
108,公立,一般大學,0019,國立高雄大學,5663,3379,2284,185,93,92,32.67
108,公立,一般大學,0020,國立東華大學,9907,4793,5114,181,63,118,18.27
108,公立,一般大學,0021,國立暨南國際大學,6108,2793,3315,179,72,107,29.31
108,公立,技專校院,0022,國立臺灣科技大學,11274,7842,3432,314,207,107,27.85
108,公立,技專校院,0023,國立雲林科技大學,9716,5809,3907,421,215,206,43.33
108,公立,技專校院,0024,國立屏東科技大學,10863,5989,4874,449,198,251,41.33
108,公立,技專校院,0025,國立臺北科技大學,13485,9816,3669,347,223,124,25.73
108,公立,一般大學,0028,國立臺北藝術大學,3098,1145,1953,36,12,24,11.62
108,公立,一般大學,0029,國立臺灣藝術大學,5601,1747,3854,91,17,74,16.25
108,公立,一般大學,0030,國立臺東大學,4722,2163,2559,146,50,96,30.92
108,公立,一般大學,0031,國立宜蘭大學,5419,3497,1922,250,145,105,46.13
108,公立,一般大學,0032,國立聯合大學,7588,5162,2426,244,123,121,32.16
108,公立,技專校院,0033,國立虎尾科技大學,10914,8415,2499,628,418,210,57.54
108,公立,一般大學,0035,國立臺南藝術大學,1607,529,1078,29,8,21,18.05
108,公立,一般大學,0036,國立臺南大學,5667,2519,3148,222,85,137,39.17
108,公立,一般大學,0037,國立臺北教育大學,5790,1836,3954,61,13,48,10.54
108,公立,一般大學,0039,國立臺中教育大學,4929,1667,3262,92,24,68,18.67
108,公立,技專校院,0042,國立澎湖科技大學,3051,1782,1269,101,44,57,33.10
108,公立,技專校院,0043,國立勤益科技大學,11982,8900,3082,495,319,176,41.31
108,公立,一般大學,0044,國立體育大學,2525,1559,966,63,29,34,24.95
108,公立,技專校院,0046,國立臺北護理健康大學,5227,963,4264,264,36,228,50.51
108,公立,技專校院,0047,國立高雄餐旅大學,5036,1551,3485,238,48,190,47.26
108,公立,一般大學,0048,國立金門大學,4387,2374,2013,186,77,109,42.40
108,公立,一般大學,0049,國立臺灣體育運動大學,3107,1827,1280,158,85,73,50.85
108,公立,技專校院,0050,國立臺中科技大學,16071,4805,11266,682,118,564,42.44
108,公立,技專校院,0051,國立臺北商業大學,7782,2356,5426,238,39,199,30.58
108,公立,一般大學,0052,國立屏東大學,8964,3642,5322,352,117,235,39.27
108,公立,技專校院,0053,國立高雄科技大學,28030,17893,10137,1254,604,650,44.74
108,公立,技專校院,0144,國立臺灣戲曲學院,595,200,395,27,5,22,45.38
108,公立,技專校院,0221,國立臺南護理專科學校,1939,143,1796,45,3,42,23.21
108,公立,技專校院,0222,國立臺東專科學校,1120,689,431,11,5,6,9.82
108,私立,一般大學,1001,東海大學,15751,7134,8617,580,195,385,36.82
108,私立,一般大學,1002,輔仁大學,25709,10707,15002,607,196,411,23.61
108,私立,一般大學,1003,東吳大學,15444,6171,9273,352,101,251,22.79
108,私立,一般大學,1004,中原大學,16217,8844,7373,465,204,261,28.67
108,私立,一般大學,1005,淡江大學學校財團法人淡江大學,24635,12765,11870,649,246,403,26.34
108,私立,一般大學,1006,中國文化大學,25186,12235,12951,772,289,483,30.65
108,私立,一般大學,1007,逢甲大學,20544,12542,8002,759,374,385,36.95
108,私立,一般大學,1008,靜宜大學,12007,4558,7449,775,209,566,64.55
108,私立,一般大學,1009,長庚大學,6834,3481,3353,130,51,79,19.02
108,私立,一般大學,1010,元智大學,8703,5093,3610,181,83,98,20.80
108,私立,一般大學,1011,中華大學學校財團法人中華大學,5471,3520,1951,126,60,66,23.03
108,私立,一般大學,1012,大葉大學,9166,4783,4383,517,206,311,56.40
108,私立,一般大學,1013,華梵大學,1518,830,688,35,16,19,23.06
108,私立,一般大學,1014,義守大學,14933,7903,7030,614,231,383,41.12
108,私立,一般大學,1015,世新大學,11387,4282,7105,415,106,309,36.45
108,私立,一般大學,1016,銘傳大學,18791,7459,11332,656,183,473,34.91
108,私立,一般大學,1017,實踐大學,13555,4405,9150,570,149,421,42.05
108,私立,技專校院,1018,朝陽科技大學,15364,6956,8408,1294,423,871,84.22
108,私立,一般大學,1019,高雄醫學大學,6487,2723,3764,142,57,85,21.89
108,私立,一般大學,1020,南華大學,5690,2679,3011,235,85,150,41.30
108,私立,一般大學,1021,真理大學,5587,2761,2826,278,99,179,49.76
108,私立,一般大學,1022,大同大學,4167,2569,1598,115,65,50,27.60
108,私立,技專校院,1023,南臺學校財團法人南臺科技大學,18563,10769,7794,1679,796,883,90.45
108,私立,技專校院,1024,崑山科技大學,11357,7020,4337,1138,585,553,100.20
108,私立,技專校院,1025,嘉藥學校財團法人嘉南藥理大學,13139,5562,7577,1343,424,919,102.21
108,私立,技專校院,1026,樹德科技大學,10984,4871,6113,928,327,601,84.49
108,私立,一般大學,1027,慈濟學校財團法人慈濟大學,3373,1278,2095,142,37,105,42.10
108,私立,一般大學,1028,臺北醫學大學,5946,2505,3441,125,44,81,21.02
108,私立,一般大學,1029,中山醫學大學,6913,2516,4397,216,58,158,31.25
108,私立,技專校院,1030,龍華科技大學,11330,7866,3464,527,310,217,46.51
108,私立,技專校院,1031,輔英科技大學,9532,2590,6942,618,123,495,64.83
108,私立,技專校院,1032,明新學校財團法人明新科技大學,12574,7777,4797,639,314,325,50.82
108,私立,一般大學,1033,長榮大學,8609,3753,4856,572,159,413,66.44
108,私立,技專校院,1034,弘光科技大學,12779,4361,8418,1001,250,751,78.33
108,私立,一般大學,1035,中國醫藥大學,7212,3176,4036,235,80,155,32.58
108,私立,技專校院,1036,健行學校財團法人健行科技大學,11269,7401,3868,663,314,349,58.83
108,私立,技專校院,1037,正修學校財團法人正修科技大學,18121,10979,7142,1163,542,621,64.18
108,私立,技專校院,1038,萬能學校財團法人萬能科技大學,10204,5518,4686,281,102,179,27.54
108,私立,一般大學,1039,玄奘大學,2889,1201,1688,102,27,75,35.31
108,私立,技專校院,1040,建國科技大學,7537,5208,2329,517,296,221,68.59
108,私立,技專校院,1041,明志科技大學,4572,3375,1197,234,142,92,51.18
108,私立,技專校院,1042,高苑科技大學,4203,3040,1163,159,103,56,37.83
108,私立,技專校院,1043,大仁科技大學,5876,2653,3223,488,165,323,83.05
108,私立,技專校院,1044,聖約翰科技大學,3073,2160,913,147,84,63,47.84
108,私立,技專校院,1045,嶺東科技大學,10454,4380,6074,850,246,604,81.31
108,私立,技專校院,1046,中國科技大學,10229,4860,5369,515,156,359,50.35
108,私立,技專校院,1047,中臺科技大學,8402,2919,5483,619,140,479,73.67
108,私立,一般大學,1048,亞洲大學,11689,4428,7261,819,199,620,70.07
108,私立,一般大學,1049,開南大學,5894,2912,2982,145,47,98,24.60
108,私立,一般大學,1050,佛光大學,3550,1621,1929,65,18,47,18.31
108,私立,技專校院,1051,台南家專學校財團法人台南應用科技大學,12714,3821,8893,990,213,777,77.87
108,私立,技專校院,1052,遠東科技大學,5491,3697,1794,441,245,196,80.31
108,私立,技專校院,1053,光宇學校財團法人元培醫事科技大學,6239,2780,3459,230,63,167,36.86
108,私立,技專校院,1054,景文科技大學,7034,3286,3748,285,101,184,40.52
108,私立,技專校院,1055,中華醫事科技大學,8990,2932,6058,625,158,467,69.52
108,私立,技專校院,1056,東南科技大學,5576,3770,1806,261,151,110,46.81
108,私立,技專校院,1057,德明財經科技大學,7903,3343,4560,461,133,328,58.33
108,私立,一般大學,1058,明道學校財團法人明道大學,3262,1926,1336,214,117,97,65.60
108,私立,技專校院,1060,南開科技大學,4382,2939,1443,339,172,167,77.36
108,私立,技專校院,1061,中華學校財團法人中華科技大學,5352,3702,1650,244,141,103,45.59
108,私立,技專校院,1062,僑光科技大學,11056,5192,5864,876,309,567,79.23
108,私立,技專校院,1063,廣亞學校財團法人育達科技大學,4225,2064,2161,243,79,164,57.51
108,私立,技專校院,1064,美和學校財團法人美和科技大學,7378,2243,5135,613,152,461,83.08
108,私立,技專校院,1065,吳鳳科技大學,5182,3399,1783,826,461,365,159.40
108,私立,技專校院,1066,環球學校財團法人環球科技大學,4488,1987,2501,420,143,277,93.58
108,私立,一般大學,1067,台灣首府學校財團法人台灣首府大學,1539,785,754,109,39,70,70.83
108,私立,技專校院,1068,中州學校財團法人中州科技大學,3173,1660,1513,238,67,171,75.01
108,私立,技專校院,1069,修平學校財團法人修平科技大學,5070,3745,1325,307,183,124,60.55
108,私立,技專校院,1070,長庚學校財團法人長庚科技大學,6437,653,5784,636,44,592,98.80
108,私立,技專校院,1071,城市學校財團法人臺北城市科技大學,10393,6514,3879,608,344,264,58.50
108,私立,技專校院,1072,大華學校財團法人敏實科技大學,1157,726,431,36,17,19,31.11
108,私立,技專校院,1073,醒吾學校財團法人醒吾科技大學,8430,3601,4829,406,134,272,48.16
108,私立,技專校院,1075,文藻學校財團法人文藻外語大學,9321,2389,6932,486,94,392,52.14
108,私立,技專校院,1076,華夏學校財團法人華夏科技大學,4118,2603,1515,211,89,122,51.24
108,私立,技專校院,1077,慈濟學校財團法人慈濟科技大學,3136,770,2366,103,22,81,32.84
108,私立,技專校院,1078,致理學校財團法人致理科技大學,11373,3618,7755,625,131,494,54.95
108,私立,一般大學,1079,康寧學校財團法人康寧大學,3641,915,2726,49,5,44,13.46
108,私立,技專校院,1080,宏國學校財團法人宏國德霖科技大學,5732,3471,2261,186,99,87,32.45
108,私立,技專校院,1081,東方學校財團法人東方設計大學,2857,1425,1432,126,39,87,44.10
108,私立,技專校院,1082,崇右學校財團法人崇右影藝科技大學,2949,1430,1519,136,46,90,46.12
108,私立,技專校院,1083,台北海洋學校財團法人台北海洋科技大學,4491,2571,1920,165,53,112,36.74
108,私立,一般大學,1125,中信學校財團法人中信金融管理學院,718,391,327,9,7,2,12.53
108,私立,技專校院,1148,大漢技術學院,1075,644,431,8,3,5,7.44
108,私立,技專校院,1159,和春技術學院,990,659,331,32,18,14,32.32
108,私立,技專校院,1166,亞東技術學院,4497,3036,1461,288,155,133,64.04
108,私立,技專校院,1168,南亞科技學校財團法人南亞技術學院,3728,2162,1566,138,38,100,37.02
108,私立,一般大學,1176,稻江科技暨管理學院,1855,910,945,161,44,117,86.79
108,私立,技專校院,1182,蘭陽技術學院,934,522,412,10,7,3,10.71
108,私立,技專校院,1183,黎明技術學院,5060,2882,2178,218,89,129,43.08
108,私立,技專校院,1185,經國管理暨健康學院,4528,1341,3187,149,29,120,32.91
108,私立,技專校院,1188,大同技術學院,1410,536,874,166,47,119,117.73
108,私立,技專校院,1192,臺灣觀光學院,608,283,325,17,3,14,27.96
108,私立,一般大學,1195,馬偕學校財團法人馬偕醫學院,684,237,447,18,5,13,26.32
108,私立,一般大學,1196,法鼓學校財團法人法鼓文理學院,305,98,207,1,1,0,3.28
108,私立,技專校院,1282,馬偕學校財團法人馬偕醫護管理專科學校,4223,592,3631,128,9,119,30.31
108,私立,技專校院,1283,仁德醫護管理專科學校,6433,1492,4941,169,32,137,26.27
108,私立,技專校院,1284,樹人醫護管理專科學校,7286,1867,5419,170,38,132,23.33
108,私立,技專校院,1285,慈惠醫護管理專科學校,4504,1026,3478,283,80,203,62.83
108,私立,技專校院,1286,耕莘健康管理專科學校,4911,457,4454,110,8,102,22.40
108,私立,技專校院,1287,敏惠醫護管理專科學校,3904,467,3437,158,12,146,40.47
108,私立,技專校院,1289,育英醫護管理專科學校,1996,227,1769,70,7,63,35.07
108,私立,技專校院,1291,聖母醫護管理專科學校,2561,541,2020,81,14,67,31.63
108,私立,技專校院,1292,新生醫護管理專科學校,6031,745,5286,163,13,150,27.03
108,私立,技專校院,1293,崇仁醫護管理專科學校,3330,410,2920,231,19,212,69.37
108,私立,宗教研修學院,1R04,財團法人一貫道天皇基金會一貫道天皇學院,171,72,99,12,3,9,70.18
108,私立,宗教研修學院,1R07,台灣基督長老教會南神神學院,67,24,43,2,0,2,29.85
108,公立,一般大學,3002,臺北市立大學,7809,3154,4655,132,45,87,16.90
109,公立,一般大學,0001,國立政治大學,16351,7282,9069,223,89,134,13.64
109,公立,一般大學,0002,國立清華大學,16917,9608,7309,142,60,82,8.39
109,公立,一般大學,0003,國立臺灣大學,32527,19253,13274,405,223,182,12.45
109,公立,一般大學,0004,國立臺灣師範大學,15920,6745,9175,253,106,147,15.89
109,公立,一般大學,0005,國立成功大學,21773,13664,8109,441,251,190,20.25
109,公立,一般大學,0006,國立中興大學,14974,8726,6248,299,158,141,19.97
109,公立,一般大學,0007,國立陽明交通大學,15182,10519,4663,188,114,74,12.38
109,公立,一般大學,0008,國立中央大學,11938,7661,4277,232,137,95,19.43
109,公立,一般大學,0009,國立中山大學,9706,5928,3778,182,101,81,18.75
109,公立,一般大學,0012,國立臺灣海洋大學,8905,6009,2896,197,112,85,22.12
109,公立,一般大學,0013,國立中正大學,11128,6185,4943,267,108,159,23.99
109,公立,一般大學,0014,國立高雄師範大學,6845,2930,3915,90,41,49,13.15
109,公立,一般大學,0015,國立彰化師範大學,8453,4367,4086,248,121,127,29.34
109,公立,一般大學,0016,國立陽明大學,4534,2233,2301,50,23,27,11.03
109,公立,一般大學,0017,國立臺北大學,10080,4591,5489,189,64,125,18.75
109,公立,一般大學,0018,國立嘉義大學,11689,6069,5620,353,150,203,30.20
109,公立,一般大學,0019,國立高雄大學,5741,3390,2351,182,97,85,31.70
109,公立,一般大學,0020,國立東華大學,10008,4785,5223,164,52,112,16.39
109,公立,一般大學,0021,國立暨南國際大學,6016,2776,3240,184,70,114,30.59
109,公立,技專校院,0022,國立臺灣科技大學,11171,7787,3384,305,204,101,27.30
109,公立,技專校院,0023,國立雲林科技大學,9808,5879,3929,377,177,200,38.44
109,公立,技專校院,0024,國立屏東科技大學,10818,5994,4824,398,178,220,36.79
109,公立,技專校院,0025,國立臺北科技大學,13852,10147,3705,308,184,124,22.24
109,公立,一般大學,0028,國立臺北藝術大學,3144,1153,1991,41,16,25,13.04
109,公立,一般大學,0029,國立臺灣藝術大學,5545,1729,3816,92,14,78,16.59
109,公立,一般大學,0030,國立臺東大學,4939,2261,2678,158,58,100,31.99
109,公立,一般大學,0031,國立宜蘭大學,5476,3519,1957,201,114,87,36.71
109,公立,一般大學,0032,國立聯合大學,7559,5183,2376,230,130,100,30.43
109,公立,技專校院,0033,國立虎尾科技大學,11134,8649,2485,583,387,196,52.36
109,公立,一般大學,0035,國立臺南藝術大學,1599,551,1048,41,8,33,25.64
109,公立,一般大學,0036,國立臺南大學,5773,2603,3170,226,100,126,39.15
109,公立,一般大學,0037,國立臺北教育大學,5885,1860,4025,80,25,55,13.59
109,公立,一般大學,0039,國立臺中教育大學,4902,1625,3277,77,21,56,15.71
109,公立,技專校院,0042,國立澎湖科技大學,3047,1806,1241,73,31,42,23.96
109,公立,技專校院,0043,國立勤益科技大學,12134,9039,3095,438,265,173,36.10
109,公立,一般大學,0044,國立體育大學,2586,1613,973,53,25,28,20.49
109,公立,技專校院,0046,國立臺北護理健康大學,5338,990,4348,209,31,178,39.15
109,公立,技專校院,0047,國立高雄餐旅大學,4929,1552,3377,214,48,166,43.42
109,公立,一般大學,0048,國立金門大學,4131,2247,1884,178,67,111,43.09
109,公立,一般大學,0049,國立臺灣體育運動大學,3122,1818,1304,152,66,86,48.69
109,公立,技專校院,0050,國立臺中科技大學,16091,4953,11138,596,114,482,37.04
109,公立,技專校院,0051,國立臺北商業大學,7632,2395,5237,180,32,148,23.58
109,公立,一般大學,0052,國立屏東大學,9027,3681,5346,337,104,233,37.33
109,公立,技專校院,0053,國立高雄科技大學,28128,18073,10055,1094,547,547,38.89
109,公立,技專校院,0144,國立臺灣戲曲學院,546,184,362,20,3,17,36.63
109,公立,技專校院,0221,國立臺南護理專科學校,1917,162,1755,39,1,38,20.34
109,公立,技專校院,0222,國立臺東專科學校,1041,655,386,12,10,2,11.53
109,私立,一般大學,1001,東海大學,15710,7074,8636,539,184,355,34.31
109,私立,一般大學,1002,輔仁大學,25651,10523,15128,588,182,406,22.92
109,私立,一般大學,1003,東吳大學,15374,6172,9202,360,108,252,23.42
109,私立,一般大學,1004,中原大學,16405,8928,7477,401,170,231,24.44
109,私立,一般大學,1005,淡江大學學校財團法人淡江大學,24209,12695,11514,597,217,380,24.66
109,私立,一般大學,1006,中國文化大學,24788,12175,12613,719,285,434,29.01
109,私立,一般大學,1007,逢甲大學,21059,12717,8342,805,397,408,38.23
109,私立,一般大學,1008,靜宜大學,12018,4585,7433,723,207,516,60.16
109,私立,一般大學,1009,長庚大學,6811,3467,3344,121,46,75,17.77
109,私立,一般大學,1010,元智大學,8739,5114,3625,203,90,113,23.23
109,私立,一般大學,1011,中華大學學校財團法人中華大學,4948,3196,1752,110,63,47,22.23
109,私立,一般大學,1012,大葉大學,7770,4163,3607,380,152,228,48.91
109,私立,一般大學,1013,華梵大學,1165,600,565,27,12,15,23.18
109,私立,一般大學,1014,義守大學,14351,7539,6812,542,205,337,37.77
109,私立,一般大學,1015,世新大學,11223,4175,7048,408,111,297,36.35
109,私立,一般大學,1016,銘傳大學,18614,7295,11319,623,165,458,33.47
109,私立,一般大學,1017,實踐大學,13216,4311,8905,501,128,373,37.91
109,私立,技專校院,1018,朝陽科技大學,15050,6752,8298,1144,373,771,76.01
109,私立,一般大學,1019,高雄醫學大學,6490,2647,3843,129,51,78,19.88
109,私立,一般大學,1020,南華大學,5701,2648,3053,226,74,152,39.64
109,私立,一般大學,1021,真理大學,5255,2628,2627,248,99,149,47.19
109,私立,一般大學,1022,大同大學,4012,2494,1518,104,63,41,25.92
109,私立,技專校院,1023,南臺學校財團法人南臺科技大學,18024,10547,7477,1496,694,802,83
109,私立,技專校院,1024,崑山科技大學,10537,6512,4025,897,441,456,85.13
109,私立,技專校院,1025,嘉藥學校財團法人嘉南藥理大學,12234,5192,7042,1108,367,741,90.57
109,私立,技專校院,1026,樹德科技大學,10496,4678,5818,747,238,509,71.17
109,私立,一般大學,1027,慈濟學校財團法人慈濟大學,3383,1284,2099,130,31,99,38.43
109,私立,一般大學,1028,臺北醫學大學,5993,2462,3531,114,42,72,19.02
109,私立,一般大學,1029,中山醫學大學,6833,2433,4400,197,52,145,28.83
109,私立,技專校院,1030,龍華科技大學,11606,8193,3413,409,248,161,35.24
109,私立,技專校院,1031,輔英科技大學,9791,2612,7179,496,97,399,50.66
109,私立,技專校院,1032,明新學校財團法人明新科技大學,11886,7314,4572,486,218,268,40.89
109,私立,一般大學,1033,長榮大學,8248,3711,4537,504,149,355,61.11
109,私立,技專校院,1034,弘光科技大學,12700,4398,8302,921,239,682,72.52
109,私立,一般大學,1035,中國醫藥大學,7203,3085,4118,214,72,142,29.71
109,私立,技專校院,1036,健行學校財團法人健行科技大學,11279,7401,3878,559,274,285,49.56
109,私立,技專校院,1037,正修學校財團法人正修科技大學,17473,10772,6701,908,419,489,51.97
109,私立,技專校院,1038,萬能學校財團法人萬能科技大學,9691,5303,4388,210,78,132,21.67
109,私立,一般大學,1039,玄奘大學,2408,978,1430,75,15,60,31.15
109,私立,技專校院,1040,建國科技大學,6620,4604,2016,504,291,213,76.13
109,私立,技專校院,1041,明志科技大學,4492,3354,1138,185,108,77,41.18
109,私立,技專校院,1042,高苑科技大學,3510,2466,1044,90,59,31,25.64
109,私立,技專校院,1043,大仁科技大學,5389,2415,2974,414,139,275,76.82
109,私立,技專校院,1044,聖約翰科技大學,2391,1655,736,78,39,39,32.62
109,私立,技專校院,1045,嶺東科技大學,10510,4429,6081,717,229,488,68.22
109,私立,技專校院,1046,中國科技大學,9129,4458,4671,359,107,252,39.33
109,私立,技專校院,1047,中臺科技大學,8170,2809,5361,524,117,407,64.14
109,私立,一般大學,1048,亞洲大學,11421,4322,7099,771,189,582,67.51
109,私立,一般大學,1049,開南大學,5587,2813,2774,132,41,91,23.63
109,私立,一般大學,1050,佛光大學,3458,1568,1890,59,12,47,17.06
109,私立,技專校院,1051,台南家專學校財團法人台南應用科技大學,12363,3742,8621,812,171,641,65.68
109,私立,技專校院,1052,遠東科技大學,4724,3261,1463,323,182,141,68.37
109,私立,技專校院,1053,光宇學校財團法人元培醫事科技大學,6186,2723,3463,170,52,118,27.48
109,私立,技專校院,1054,景文科技大學,6656,3108,3548,261,99,162,39.21
109,私立,技專校院,1055,中華醫事科技大學,8724,2690,6034,544,125,419,62.36
109,私立,技專校院,1056,東南科技大學,5168,3493,1675,200,115,85,38.70
109,私立,技專校院,1057,德明財經科技大學,7419,3194,4225,334,95,239,45.02
109,私立,一般大學,1058,明道學校財團法人明道大學,2525,1500,1025,148,80,68,58.61
109,私立,技專校院,1060,南開科技大學,3755,2545,1210,229,122,107,60.99
109,私立,技專校院,1061,中華學校財團法人中華科技大學,4773,3366,1407,210,125,85,44
109,私立,技專校院,1062,僑光科技大學,10610,5081,5529,683,227,456,64.37
109,私立,技專校院,1063,廣亞學校財團法人育達科技大學,3962,1926,2036,209,53,156,52.75
109,私立,技專校院,1064,美和學校財團法人美和科技大學,6560,1911,4649,430,106,324,65.55
109,私立,技專校院,1065,吳鳳科技大學,5058,3324,1734,736,410,326,145.51
109,私立,技專校院,1066,環球學校財團法人環球科技大學,3673,1763,1910,307,108,199,83.58
109,私立,一般大學,1067,台灣首府學校財團法人台灣首府大學,1130,569,561,74,34,40,65.49
109,私立,技專校院,1068,中州學校財團法人中州科技大學,2668,1375,1293,148,27,121,55.47
109,私立,技專校院,1069,修平學校財團法人修平科技大學,5030,3836,1194,275,177,98,54.67
109,私立,技專校院,1070,長庚學校財團法人長庚科技大學,6333,645,5688,564,48,516,89.06
109,私立,技專校院,1071,城市學校財團法人臺北城市科技大學,9858,6218,3640,482,263,219,48.89
109,私立,技專校院,1072,大華學校財團法人敏實科技大學,771,487,284,22,13,9,28.53
109,私立,技專校院,1073,醒吾學校財團法人醒吾科技大學,7943,3499,4444,360,123,237,45.32
109,私立,技專校院,1075,文藻學校財團法人文藻外語大學,9012,2403,6609,422,98,324,46.83
109,私立,技專校院,1076,華夏學校財團法人華夏科技大學,4043,2543,1500,171,63,108,42.30
109,私立,技專校院,1077,慈濟學校財團法人慈濟科技大學,3163,759,2404,85,15,70,26.87
109,私立,技專校院,1078,致理學校財團法人致理科技大學,11576,3840,7736,567,136,431,48.98
109,私立,一般大學,1079,康寧學校財團法人康寧大學,3465,855,2610,34,2,32,9.81
109,私立,技專校院,1080,宏國學校財團法人宏國德霖科技大學,5370,3226,2144,138,72,66,25.70
109,私立,技專校院,1081,東方學校財團法人東方設計大學,2072,1056,1016,92,25,67,44.40
109,私立,技專校院,1082,崇右學校財團法人崇右影藝科技大學,2609,1234,1375,130,53,77,49.83
109,私立,技專校院,1083,台北海洋學校財團法人台北海洋科技大學,4192,2380,1812,109,38,71,26
109,私立,一般大學,1125,中信學校財團法人中信金融管理學院,825,460,365,11,5,6,13.33
109,私立,技專校院,1148,大漢技術學院,999,605,394,10,1,9,10.01
109,私立,技專校院,1159,和春技術學院,688,493,195,23,13,10,33.43
109,私立,技專校院,1166,亞東技術學院,4388,2959,1429,259,151,108,59.02
109,私立,技專校院,1168,南亞科技學校財團法人南亞技術學院,3363,1916,1447,112,25,87,33.30
109,私立,技專校院,1182,蘭陽技術學院,577,314,263,4,3,1,6.93
109,私立,技專校院,1183,黎明技術學院,5191,2979,2212,190,95,95,36.60
109,私立,技專校院,1185,經國管理暨健康學院,4221,1234,2987,119,26,93,28.19
109,私立,技專校院,1188,大同技術學院,1137,452,685,95,23,72,83.55
109,私立,一般大學,1195,馬偕學校財團法人馬偕醫學院,816,277,539,13,4,9,15.93
109,私立,一般大學,1196,法鼓學校財團法人法鼓文理學院,302,96,206,1,1,0,3.31
109,私立,技專校院,1282,馬偕學校財團法人馬偕醫護管理專科學校,4106,588,3518,98,7,91,23.87
109,私立,技專校院,1283,仁德醫護管理專科學校,6515,1546,4969,136,22,114,20.87
109,私立,技專校院,1284,樹人醫護管理專科學校,7279,1785,5494,192,43,149,26.38
109,私立,技專校院,1285,慈惠醫護管理專科學校,3977,911,3066,268,61,207,67.39
109,私立,技專校院,1286,耕莘健康管理專科學校,4698,446,4252,105,11,94,22.35
109,私立,技專校院,1287,敏惠醫護管理專科學校,3936,502,3434,191,11,180,48.53
109,私立,技專校院,1289,育英醫護管理專科學校,1991,224,1767,59,6,53,29.63
109,私立,技專校院,1291,聖母醫護管理專科學校,2227,449,1778,74,15,59,33.23
109,私立,技專校院,1292,新生醫護管理專科學校,6064,772,5292,183,11,172,30.18
109,私立,技專校院,1293,崇仁醫護管理專科學校,3293,425,2868,205,15,190,62.25
109,私立,宗教研修學院,1R02,學校財團法人中華浸信會基督教台灣浸會神學院,43,22,21,0,0,0,0
109,私立,宗教研修學院,1R03,臺北基督學院,74,32,42,0,0,0,0
109,私立,宗教研修學院,1R04,財團法人一貫道天皇基金會一貫道天皇學院,178,77,101,22,9,13,123.60
109,私立,宗教研修學院,1R05,台神學校財團法人台灣神學研究學院,111,42,69,0,0,0,0
109,私立,宗教研修學院,1R06,一貫道崇德學院,69,30,39,0,0,0,0
109,私立,宗教研修學院,1R07,台灣基督長老教會南神神學院,75,32,43,2,0,2,26.67
109,公立,一般大學,3002,臺北市立大學,7986,3224,4762,119,41,78,14.90
