學年度,設立別,學校類別,學校統計處代碼,學校名稱,單位代碼,單位名稱,學制班別,授課語言,修習全外語院、系所、學位學程之學生人數-本國學生數-小計,修習全外語院、系所、學位學程之學生人數-本國學生數-男,修習全外語院、系所、學位學程之學生人數-本國學生數-女,修習全外語院、系所、學位學程之學生人數-境外學生數-小計,修習全外語院、系所、學位學程之學生人數-境外學生數-男,修習全外語院、系所、學位學程之學生人數-境外學生數-女
107,公立,一般大學,0001,國立政治大學,03143040,亞太研究英語博士學位學程,博士班,英語,14,6,8,64,36,28
107,公立,一般大學,0001,國立政治大學,03143040,亞太研究英語碩士學位學程,碩士班(日間),英語,27,11,16,46,27,19
107,公立,一般大學,0001,國立政治大學,06131082,社群網路與人智計算國際研究生博士學位學程,博士班,英語,3,3,0,11,10,1
107,公立,一般大學,0001,國立政治大學,03122046,國際研究英語碩士學位學程,碩士班(日間),英語,15,4,11,46,28,18
107,公立,一般大學,0001,國立政治大學,03211050,國際傳播英語碩士學位學程,碩士班(日間),英語,34,6,28,21,2,19
107,公立,一般大學,0001,國立政治大學,04131064,國際經營管理英語碩士學位學程,碩士班(日間),英語,107,52,55,70,38,32
107,公立,一般大學,0001,國立政治大學,03111025,應用經濟與社會發展英語碩士學位學程,碩士班(日間),英語,22,9,13,16,9,7
107,公立,一般大學,0002,國立清華大學,05311035,分子科學與技術學程,博士班,英語,3,1,2,12,10,2
107,公立,一般大學,0002,國立清華大學,05311036,化學生物學與分子生物物理學學程,博士班,英語,8,5,3,17,9,8
107,公立,一般大學,0002,國立清華大學,05121031,生物資訊學學程,博士班,英語,1,0,1,7,7,0
107,公立,一般大學,0002,國立清華大學,07199070,全球營運管理碩士雙聯學位學程,碩士班(日間),英語,17,10,7,1,0,1
107,公立,一般大學,0002,國立清華大學,07194067,奈米科學與技術學程,博士班,英語,11,8,3,24,18,6
107,公立,一般大學,0002,國立清華大學,06134048,社群網路與人智計算國際研究生博士學位學程,博士班,英語,0,0,0,17,15,2
107,公立,一般大學,0002,國立清華大學,01131105,英語教學系,碩士班(日間),英語,29,1,28,2,0,2
107,公立,一般大學,0002,國立清華大學,04121020,計量財務金融學系,博士班,英語,3,2,1,0,0,0
107,公立,一般大學,0002,國立清華大學,06134045,計算語言學與中文語言處理學程,博士班,英語,0,0,0,1,0,1
107,公立,一般大學,0002,國立清華大學,04131018,國際專業管理碩士班,碩士班(日間),英語,13,4,9,50,23,27
107,公立,一般大學,0002,國立清華大學,06134047,國際資訊科技與應用碩士學程,碩士班(日間),英語,0,0,0,15,10,5
107,公立,一般大學,0002,國立清華大學,99999074,跨院國際博士班學位學程,博士班,英語,49,39,10,15,9,6
107,公立,一般大學,0003,國立臺灣大學,07112154,分子科學與技術國際研究生博士學位學程,博士班,英語,2,2,0,3,1,2
107,公立,一般大學,0003,國立臺灣大學,05124155,生物資訊學國際研究生博士學位學程,博士班,英語,2,1,1,1,1,0
107,公立,一般大學,0003,國立臺灣大學,09199159,國際三校農業生技與健康醫療碩士學位學程,碩士班(日間),英語,10,5,5,0,0,0
107,公立,一般大學,0003,國立臺灣大學,05199156,跨領域神經科學國際研究生博士學位學程,博士班,英語,4,2,2,2,1,1
107,公立,一般大學,0003,國立臺灣大學,04131028,管理學院企業管理碩士專班,碩士班(日間),英語,79,24,55,62,35,27
107,公立,一般大學,0003,國立臺灣大學,09121119,轉譯醫學博士學位學程,博士班,英語,5,2,3,0,0,0
107,公立,一般大學,0004,國立臺灣師範大學,05111057,生物多樣性國際研究生博士學位學程,博士班,英語,11,5,6,28,20,8
107,公立,一般大學,0004,國立臺灣師範大學,04191054,國際人力資源發展研究所,碩士班(日間),英語,32,9,23,31,7,24
107,公立,一般大學,0005,國立成功大學,07193061,生物醫學工程學系醫療器材創新國際碩士班,碩士班(日間),英語,9,4,5,16,11,5
107,公立,一般大學,0005,國立成功大學,07112065,尖端材料國際碩士學位學程,碩士班(日間),英語,0,0,0,19,9,10
107,公立,一般大學,0005,國立成功大學,05291025,自然災害減災及管理國際碩士學位學程,碩士班(日間),英語,12,11,1,7,4,3
107,公立,一般大學,0005,國立成功大學,07132052,能源工程國際博士學位學程,博士班,英語,1,0,1,3,2,1
107,公立,一般大學,0005,國立成功大學,07132052,能源工程國際碩士學位學程,碩士班(日間),英語,10,7,3,10,9,1
107,公立,一般大學,0005,國立成功大學,07132074,能源國際學士學位學程,學士班(日間),英語,68,44,24,54,42,12
107,公立,一般大學,0005,國立成功大學,04131125,國際經營管理研究所(IMBA),博士班,英語,1,1,0,12,6,6
107,公立,一般大學,0005,國立成功大學,04131125,國際經營管理研究所(IMBA),碩士班(日間),英語,0,0,0,97,37,60
107,公立,一般大學,0005,國立成功大學,04131125,國際經營管理研究所(IMBA),碩士在職專班,英語,84,33,51,0,0,0
107,公立,一般大學,0005,國立成功大學,02122112,創意產業設計研究所,博士班,英語,21,8,13,16,4,12
107,公立,一般大學,0005,國立成功大學,02122112,創意產業設計研究所,碩士班(日間),英語,32,10,22,19,5,14
107,公立,一般大學,0005,國立成功大學,05199016,跨領域神經科學國際博士學位學程,博士班,英語,9,5,4,10,9,1
107,公立,一般大學,0006,國立中興大學,08193078,國際農企業學士學位學程,學士班(日間),英語,65,22,43,38,23,15
107,公立,一般大學,0006,國立中興大學,08111064,國際農學碩士學位學程,碩士班(日間),英語,4,2,2,27,20,7
107,公立,一般大學,0007,國立陽明交通大學,05311039,永續化學科技國際研究生博士學位學程,博士班,英語,3,1,2,50,40,10
107,公立,一般大學,0007,國立陽明交通大學,07141054,光電博士學位學程(台灣聯合大學系統),博士班,英語,0,0,0,11,10,1
107,公立,一般大學,0007,國立陽明交通大學,07141066,國際半導體產業學院博士班,博士班,英語,29,26,3,9,7,2
107,公立,一般大學,0007,國立陽明交通大學,07141066,國際半導體產業學院碩士班,碩士班(日間),英語,50,38,12,7,5,2
107,公立,一般大學,0007,國立陽明交通大學,07141068,電機資訊國際博士學位學程,博士班,英語,0,0,0,80,70,10
107,公立,一般大學,0007,國立陽明交通大學,07141068,電機資訊國際碩士學位學程,碩士班(日間),英語,0,0,0,68,49,19
107,公立,一般大學,0007,國立陽明交通大學,04131016,管理學院企業管理碩士學位學程,碩士班(日間),英語,31,10,21,27,12,15
107,公立,一般大學,0007,國立陽明交通大學,05211043,環境科技博士學位學程(台灣聯合大學系統),博士班,英語,0,0,0,1,1,0
107,公立,一般大學,0008,國立中央大學,05321041,地球系統科學國際研究生博士學位學程,博士班,英語,10,7,3,38,26,12
107,公立,一般大學,0008,國立中央大學,07121073,國際永續發展碩士在職專班,碩士在職專班,英語,0,0,0,7,4,3
107,公立,一般大學,0008,國立中央大學,07112071,應用材料科學國際研究生碩士學位學程,碩士班(日間),英語,0,0,0,4,3,1
107,公立,一般大學,0009,國立中山大學,04131028,人力資源管理全英語碩士學位學程,碩士班(日間),英語,27,8,19,36,21,15
107,公立,一般大學,0009,國立中山大學,03122019,亞太事務英語碩士學位學程,碩士班(日間),英語,0,0,0,20,13,7
107,公立,一般大學,0009,國立中山大學,05399070,理學國際博士學位學程,博士班,英語,9,9,0,1,1,0
107,公立,一般大學,0009,國立中山大學,07141056,電信工程國際碩士學位學程,碩士班(日間),英語,0,0,0,11,9,2
107,公立,一般大學,0009,國立中山大學,07141058,電機電力工程國際碩士學位學程,碩士班(日間),英語,0,0,0,12,11,1
107,公立,一般大學,0009,國立中山大學,04131022,管理學院國際經營管理碩士學程,碩士班(日間),英語,82,24,58,54,19,35
107,公立,一般大學,0012,國立臺灣海洋大學,08312046,水產養殖學系,博士班,英語,1,0,1,3,2,1
107,公立,一般大學,0012,國立臺灣海洋大學,08312046,水產養殖學系,碩士班(日間),英語,11,5,6,27,16,11
107,公立,一般大學,0013,國立中正大學,07151071,前瞻製造系統碩士學位學程,碩士班(日間),英語,5,3,2,5,5,0
107,公立,一般大學,0013,國立中正大學,01114007,教育領導與管理發展國際博士學位學程,博士班,英語,0,0,0,5,2,3
107,公立,一般大學,0013,國立中正大學,01114007,教育領導與管理發展國際碩士學位學程,碩士班(日間),英語,0,0,0,19,11,8
107,公立,一般大學,0013,國立中正大學,07199076,環境智能及智慧系統博士學位學程,博士班,英語,1,1,0,1,1,0
107,公立,一般大學,0014,國立高雄師範大學,07141044,工程國際碩士學位學程,碩士班(日間),英語,0,0,0,1,1,0
107,公立,一般大學,0016,國立陽明大學,07193018,光電博士學位學程(台灣聯合大學系統),博士班,英語,0,0,0,1,0,1
107,公立,一般大學,0016,國立陽明大學,09191040,國際衛生碩士學位學程,碩士班(日間),英語,2,1,1,14,2,12
107,公立,一般大學,0016,國立陽明大學,09121016,跨領域神經科學國際研究生博士學位學程,博士班,英語,13,3,10,7,4,3
107,公立,一般大學,0017,國立臺北大學,07399040,城市治理英語碩士學位學程,碩士班(日間),英語,0,0,0,7,4,3
107,公立,一般大學,0017,國立臺北大學,04121020,財務金融英語碩士學位學程,碩士班(日間),英語,0,0,0,11,4,7
107,公立,一般大學,0018,國立嘉義大學,05111048,生命科學全英文碩士學位學程,碩士班(日間),英語,0,0,0,4,0,4
107,公立,一般大學,0018,國立嘉義大學,01111006,師範學院教學專業國際碩士學位學程,碩士班(日間),英語,0,0,0,14,8,6
107,公立,一般大學,0018,國立嘉義大學,08192094,農學院農業科技全英碩士學位學程,碩士班(日間),英語,0,0,0,9,0,9
107,公立,一般大學,0018,國立嘉義大學,10151110,管理學院外籍生全英文授課觀光暨管理碩士學位學程,碩士班(日間),英語,0,0,0,30,10,20
107,公立,一般大學,0019,國立高雄大學,04131010,國際商業管理碩士學位學程,碩士班(日間),英語,1,1,0,23,11,12
107,公立,一般大學,0019,國立高雄大學,05499037,應用科學碩士學位學程,碩士班(日間),英語,0,0,0,2,2,0
107,公立,一般大學,0020,國立東華大學,05211100,人文與環境碩士學位學程,碩士班(日間),英語,1,1,0,5,3,2
107,公立,一般大學,0020,國立東華大學,05311071,化學系,博士班,英語,0,0,0,5,3,2
107,公立,一般大學,0020,國立東華大學,07112090,材料科學與工程學系,博士班,英語,0,0,0,4,3,1
107,公立,一般大學,0020,國立東華大學,05331072,物理學系應用物理博士班,博士班,英語,0,0,0,12,7,5
107,公立,一般大學,0020,國立東華大學,05331072,物理學系應用物理碩士班,碩士班(日間),英語,0,0,0,9,3,6
107,公立,一般大學,0020,國立東華大學,06131086,資訊工程學系,學士班(日間),英語,55,42,13,36,30,6
107,公立,一般大學,0020,國立東華大學,06131086,資訊工程學系,碩士班(日間),英語,0,0,0,2,1,1
107,公立,一般大學,0020,國立東華大學,04191066,管理學院管理科學與財金國際學士學位學程,學士班(日間),英語,47,18,29,30,13,17
107,公立,技專校院,0022,國立臺灣科技大學,07199033,工程學院_大學部先進科技全英語外國學生專班,學士班(日間),英語,0,0,0,20,16,4
107,公立,技專校院,0022,國立臺灣科技大學,07191012,工業管理系,博士班,英語,0,0,0,30,24,6
107,公立,技專校院,0022,國立臺灣科技大學,07191012,工業管理系,碩士班(日間),英語,0,0,0,52,28,24
107,公立,技專校院,0022,國立臺灣科技大學,07111026,化學工程系,學士班(日間),英語,0,0,0,25,13,12
107,公立,技專校院,0022,國立臺灣科技大學,07111026,化學工程系,博士班,英語,0,0,0,56,42,14
107,公立,技專校院,0022,國立臺灣科技大學,07111026,化學工程系,碩士班(日間),英語,0,0,0,25,14,11
107,公立,技專校院,0022,國立臺灣科技大學,07111026,化學工程系_化工醫檢分析器材國際學生產學合作專班,學士班(日間),英語,0,0,0,5,2,3
107,公立,技專校院,0022,國立臺灣科技大學,04131008,企業管理系,博士班,英語,0,0,0,14,8,6
107,公立,技專校院,0022,國立臺灣科技大學,04131008,企業管理系,碩士班(日間),英語,0,0,0,21,5,16
107,公立,技專校院,0022,國立臺灣科技大學,07141019,光電工程研究所,博士班,英語,0,0,0,3,3,0
107,公立,技專校院,0022,國立臺灣科技大學,07141019,光電工程研究所,碩士班(日間),英語,0,0,0,1,0,1
107,公立,技專校院,0022,國立臺灣科技大學,07151024,自動化及控制研究所,博士班,英語,0,0,0,2,2,0
107,公立,技專校院,0022,國立臺灣科技大學,07151024,自動化及控制研究所,碩士班(日間),英語,0,0,0,6,4,2
107,公立,技專校院,0022,國立臺灣科技大學,07112028,材料科學與工程系,博士班,英語,0,0,0,36,28,8
107,公立,技專校院,0022,國立臺灣科技大學,07112028,材料科學與工程系,碩士班(日間),英語,0,0,0,12,6,6
107,公立,技專校院,0022,國立臺灣科技大學,07311038,建築系,博士班,英語,0,0,0,4,0,4
107,公立,技專校院,0022,國立臺灣科技大學,07311038,建築系,碩士班(日間),英語,0,0,0,19,7,12
107,公立,技專校院,0022,國立臺灣科技大學,04199011,科技管理研究所,碩士班(日間),英語,0,0,0,2,0,2
107,公立,技專校院,0022,國立臺灣科技大學,04121010,財務金融研究所,博士班,英語,0,0,0,2,1,1
107,公立,技專校院,0022,國立臺灣科技大學,04121010,財務金融研究所,碩士班(日間),英語,0,0,0,19,8,11
107,公立,技專校院,0022,國立臺灣科技大學,06131020,資訊工程系,博士班,英語,0,0,0,24,19,5
107,公立,技專校院,0022,國立臺灣科技大學,06131020,資訊工程系,碩士班(日間),英語,0,0,0,22,21,1
107,公立,技專校院,0022,國立臺灣科技大學,06131016,資訊管理系,博士班,英語,0,0,0,16,10,6
107,公立,技專校院,0022,國立臺灣科技大學,06131016,資訊管理系,碩士班(日間),英語,0,0,0,25,15,10
107,公立,技專校院,0022,國立臺灣科技大學,07141018,電子工程系,博士班,英語,0,0,0,24,21,3
107,公立,技專校院,0022,國立臺灣科技大學,07141018,電子工程系,碩士班(日間),英語,0,0,0,30,24,6
107,公立,技專校院,0022,國立臺灣科技大學,07141017,電機工程系,博士班,英語,0,0,0,16,15,1
107,公立,技專校院,0022,國立臺灣科技大學,07141017,電機工程系,碩士班(日間),英語,0,0,0,19,15,4
107,公立,技專校院,0022,國立臺灣科技大學,04199013,管理學院MBA,碩士班(日間),英語,0,0,0,51,20,31
107,公立,技專校院,0022,國立臺灣科技大學,01116002,數位學習與教育研究所,博士班,英語,0,0,0,12,7,5
107,公立,技專校院,0022,國立臺灣科技大學,01116002,數位學習與教育研究所,碩士班(日間),英語,0,0,0,6,3,3
107,公立,技專校院,0022,國立臺灣科技大學,07151023,機械工程系,博士班,英語,0,0,0,49,46,3
107,公立,技專校院,0022,國立臺灣科技大學,07151023,機械工程系,碩士班(日間),英語,0,0,0,28,24,4
107,公立,技專校院,0022,國立臺灣科技大學,07151023,機械工程系_新南向精密機械及創新工程技術國際學生產學合作專班,學士班(日間),英語,0,0,0,20,14,6
107,公立,技專校院,0022,國立臺灣科技大學,02311003,應用外語系,碩士班(日間),英語,0,0,0,12,4,8
107,公立,技專校院,0022,國立臺灣科技大學,05399015,應用科技研究所,博士班,英語,0,0,0,45,38,7
107,公立,技專校院,0022,國立臺灣科技大學,05399015,應用科技研究所,碩士班(日間),英語,0,0,0,13,6,7
107,公立,技專校院,0022,國立臺灣科技大學,07321025,營建工程系,博士班,英語,0,0,0,21,18,3
107,公立,技專校院,0022,國立臺灣科技大學,07321025,營建工程系,碩士班(日間),英語,0,0,0,39,31,8
107,公立,技專校院,0022,國立臺灣科技大學,09171034,醫學工程研究所,碩士班(日間),英語,0,0,0,3,3,0
107,公立,技專校院,0023,國立雲林科技大學,04131019,企業管理系_越南河內商業大學進修學制碩士在職專班,碩士在職專班,英語,0,0,0,24,15,9
107,公立,技專校院,0023,國立雲林科技大學,02311004,應用外語系,碩士班(日間),英語,50,10,40,1,1,0
107,公立,技專校院,0023,國立雲林科技大學,02311004,應用外語系,碩士在職專班,英語,22,3,19,0,0,0
107,公立,技專校院,0024,國立屏東科技大學,07321022,土壤與水工程國際碩士學位學程,碩士班(日間),英語,2,1,1,6,3,3
107,公立,技專校院,0024,國立屏東科技大學,07211037,食品科學國際碩士學位學程,碩士班(日間),英語,7,5,2,14,5,9
107,公立,技專校院,0024,國立屏東科技大學,04121007,財務金融國際學士學位學程,學士班(日間),英語,64,17,47,2,0,2
107,公立,技專校院,0024,國立屏東科技大學,05121050,動物用疫苗國際學位專班,博士班,英語,3,0,3,4,0,4
107,公立,技專校院,0024,國立屏東科技大學,05121050,動物用疫苗國際學位專班,碩士班(日間),英語,0,0,0,3,2,1
107,公立,技專校院,0024,國立屏東科技大學,08193036,農企業管理國際碩士學位學程,碩士班(日間),英語,5,1,4,20,4,16
107,公立,技專校院,0024,國立屏東科技大學,08199030,熱帶農業暨國際合作系,學士班(日間),英語,102,51,51,36,17,19
107,公立,技專校院,0024,國立屏東科技大學,08199030,熱帶農業暨國際合作系,博士班,英語,14,11,3,72,41,31
107,公立,技專校院,0024,國立屏東科技大學,08199030,熱帶農業暨國際合作系,碩士班(日間),英語,9,5,4,22,13,9
107,公立,技專校院,0024,國立屏東科技大學,08199030,熱帶農業暨國際合作系_國際熱帶農業科技國際學生產學合作專班,學士班(日間),英語,0,0,0,33,13,20
107,公立,技專校院,0024,國立屏東科技大學,08312068,觀賞魚科技及水生動物健康國際學位專班,博士班,英語,1,1,0,1,1,0
107,公立,技專校院,0024,國立屏東科技大學,08312068,觀賞魚科技及水生動物健康國際學位專班,碩士班(日間),英語,2,2,0,3,1,2
107,公立,技專校院,0025,國立臺北科技大學,07141036,工程學院_能源與光電材料外國學生專班,博士班,英語,0,0,0,39,27,12
107,公立,技專校院,0025,國立臺北科技大學,02112007,互動設計系_互動設計與創新外國學生專班,碩士班(日間),英語,0,0,0,9,3,6
107,公立,技專校院,0025,國立臺北科技大學,07132068,能源與冷凍空調工程系_能源冷凍空調與車輛外國學生專班,碩士班(日間),英語,0,0,0,5,5,0
107,公立,技專校院,0025,國立臺北科技大學,04131072,高階管理碩士雙聯學位學程,碩士在職專班,英語,67,44,23,0,0,0
107,公立,技專校院,0025,國立臺北科技大學,07141036,電資學院_外國學生專班,學士班(日間),英語,0,0,0,8,7,1
107,公立,技專校院,0025,國立臺北科技大學,07141036,電資學院_外國學生專班,博士班,英語,0,0,0,14,13,1
107,公立,技專校院,0025,國立臺北科技大學,07141036,電資學院_外國學生專班,碩士班(日間),英語,0,0,0,28,22,6
107,公立,技專校院,0025,國立臺北科技大學,04199021,管理學院_外國學生專班IMBA專班,碩士班(日間),英語,0,0,0,45,19,26
107,公立,技專校院,0025,國立臺北科技大學,04199021,管理學院_金融科技與創新創業外國學生(IMFI)專班,碩士班(日間),英語,0,0,0,12,8,4
107,公立,技專校院,0025,國立臺北科技大學,07151038,機電學院_機械與自動化碩士外國學生專班,碩士班(日間),英語,0,0,0,10,9,1
107,公立,技專校院,0025,國立臺北科技大學,07151040,機電學院_機電科技博士班外國學生專班,博士班,英語,0,0,0,7,7,0
107,公立,技專校院,0025,國立臺北科技大學,02311002,應用英文系,碩士班(日間),英語,37,15,22,8,5,3
107,公立,一般大學,0028,國立臺北藝術大學,02192026,文創產業國際藝術碩士學位學程,碩士班(日間),英語,5,1,4,23,8,15
107,公立,一般大學,0032,國立聯合大學,07111043,工程科技轉譯醫學國際碩士學位學程,碩士班(日間),英語,1,1,0,0,0,0
107,公立,一般大學,0037,國立臺北教育大學,02192027,當代藝術評論與策展研究全英語碩士學位學程,碩士班(日間),英語,1,1,0,16,5,11
107,公立,一般大學,0037,國立臺北教育大學,01115047,學習與教學國際碩士學位學程,碩士班(日間),英語,0,0,0,8,2,6
107,公立,一般大學,0039,國立臺中教育大學,04131040,管理學院國際經營管理碩士學位學程,碩士班(日間),英語,0,0,0,26,11,15
107,公立,技專校院,0043,國立勤益科技大學,07132026,冷凍空調與能源系_機電能源與環境控制國際學生產學合作專班,學士班(日間),英語,0,0,0,22,19,3
107,公立,一般大學,0044,國立體育大學,10141009,國際運動教練科學碩士學位學程,碩士班(日間),英語,0,0,0,2,2,0
107,公立,技專校院,0046,國立臺北護理健康大學,04133004,健康事業管理系_國際健康科技碩士學程外國學生專班,碩士班(日間),英語,0,0,0,1,1,0
107,公立,技專校院,0046,國立臺北護理健康大學,01121020,國際蒙特梭利碩士專班,碩士班(日間),英語,2,0,2,3,0,3
107,公立,技專校院,0046,國立臺北護理健康大學,09131021,護理助產及婦女健康系護理助產碩士班,碩士班(日間),英語,0,0,0,10,0,10
107,公立,技專校院,0046,國立臺北護理健康大學,09131009,護理系,博士班,英語,0,0,0,8,4,4
107,公立,技專校院,0046,國立臺北護理健康大學,09131009,護理系,碩士班(日間),英語,0,0,0,14,4,10
107,公立,技專校院,0047,國立高雄餐旅大學,10131009,國際廚藝學士學位學程,學士班(日間),英語,67,30,37,36,12,24
107,公立,技專校院,0047,國立高雄餐旅大學,10151016,國際觀光學士學位學程,學士班(日間),英語,105,27,78,35,11,24
107,公立,技專校院,0051,國立臺北商業大學,04199021,貿易實務法律暨談判碩士學位學程,碩士班(日間),英語,19,8,11,2,2,0
107,公立,技專校院,0053,國立高雄科技大學,04121040,財務管理系_外國學生專班,碩士班(日間),英語,0,0,0,23,7,16
107,公立,技專校院,0053,國立高雄科技大學,04131031,國際管理碩士學位學程,碩士班(日間),英語,17,4,13,22,8,14
107,私立,一般大學,1001,東海大學,05211056,永續科學與工程學士學位學程,學士班(日間),英語,75,43,32,17,8,9
107,私立,一般大學,1001,東海大學,04131059,國際企業管理碩士學位學程,碩士班(日間),英語,7,1,6,7,4,3
107,私立,一般大學,1001,東海大學,04131021,國際學院國際經營管理學位學程,學士班(日間),英語,146,46,100,50,28,22
107,私立,一般大學,1002,輔仁大學,02122029,品牌與時尚經營管理碩士學位學程,碩士班(日間),英語,7,0,7,15,3,12
107,私立,一般大學,1002,輔仁大學,04131044,國際經營管理碩士學位學程,碩士班(日間),英語,18,5,13,17,12,5
107,私立,一般大學,1004,中原大學,07191041,工業與系統工程學系國際碩士班,碩士班(日間),英語,0,0,0,0,0,0
107,私立,一般大學,1004,中原大學,07111049,化學工程與材料科學國際碩士學位學程,碩士班(日間),英語,0,0,0,2,1,1
107,私立,一般大學,1004,中原大學,07121051,永續環境與能源國際碩士學位學程,碩士班(日間),英語,0,0,0,11,2,9
107,私立,一般大學,1004,中原大學,07193044,生物醫學材料與科技國際碩士學位學程,碩士班(日間),英語,0,0,0,7,2,5
107,私立,一般大學,1004,中原大學,04191017,國際商學碩士學位學程,碩士班(日間),英語,7,2,5,18,10,8
107,私立,一般大學,1004,中原大學,04191017,國際商學學士學位學程,學士班(日間),英語,0,0,0,10,4,6
107,私立,一般大學,1004,中原大學,07141031,資訊工程學系資訊科技與雲端運算國際碩士班,碩士班(日間),英語,0,0,0,0,0,0
107,私立,一般大學,1004,中原大學,07141029,電機工程學系國際碩士班,碩士班(日間),英語,0,0,0,2,0,2
107,私立,一般大學,1005,淡江大學學校財團法人淡江大學,03122059,外交與國際關係學系全英語學士班,學士班(日間),英語,130,31,99,100,36,64
107,私立,一般大學,1005,淡江大學學校財團法人淡江大學,03121074,全球政治經濟學系全英語學士班,學士班(日間),英語,147,44,103,31,17,14
107,私立,一般大學,1005,淡江大學學校財團法人淡江大學,03143064,拉丁美洲研究所亞太研究數位學習碩士在職專班,碩士在職專班,西班牙語,0,0,0,8,2,6
107,私立,一般大學,1005,淡江大學學校財團法人淡江大學,03143065,美洲研究所,博士班,英語,4,3,1,0,0,0
107,私立,一般大學,1005,淡江大學學校財團法人淡江大學,03143065,美洲研究所亞太研究數位學習碩士在職專班,碩士在職專班,西班牙語,0,0,0,29,16,13
107,私立,一般大學,1005,淡江大學學校財團法人淡江大學,02311079,英美語言文化學系全英語學士班,學士班(日間),英語,159,45,114,12,3,9
107,私立,一般大學,1005,淡江大學學校財團法人淡江大學,04121035,商管學院全球財務管理全英語學士學位學程,學士班(日間),英語,160,61,99,58,28,30
107,私立,一般大學,1005,淡江大學學校財團法人淡江大學,04131045,商管學院經營管理全英語碩士學位學程,碩士班(日間),英語,4,1,3,31,13,18
107,私立,一般大學,1005,淡江大學學校財團法人淡江大學,04131040,國際企業學系,學士班(日間),英語,191,76,115,131,63,68
107,私立,一般大學,1005,淡江大學學校財團法人淡江大學,10151005,國際觀光管理學系全英語學士班,學士班(日間),英語,324,89,235,40,11,29
107,私立,一般大學,1005,淡江大學學校財團法人淡江大學,04121037,淡江大學暨澳洲昆士蘭理工大學財金全英語雙碩士學位學程,碩士班(日間),英語,17,5,12,5,3,2
107,私立,一般大學,1005,淡江大學學校財團法人淡江大學,06131018,資訊工程學系全英語碩士班,碩士班(日間),英語,4,1,3,3,1,2
107,私立,一般大學,1005,淡江大學學校財團法人淡江大學,06132022,資訊創新與科技學系,學士班(日間),英語,252,157,95,30,21,9
107,私立,一般大學,1005,淡江大學學校財團法人淡江大學,03143063,臺灣與亞太研究全英語碩士學位學程,碩士班(日間),英語,1,0,1,11,6,5
107,私立,一般大學,1006,中國文化大學,04191014,全球商務碩士學位學程,碩士班(日間),英語,4,3,1,32,14,18
107,私立,一般大學,1006,中國文化大學,04191014,全球商務學士學位學程,學士班(日間),英語,172,77,95,46,22,24
107,私立,一般大學,1007,逢甲大學,99999094,全校國際生大一不分系學士班,學士班(日間),英語,0,0,0,41,25,16
107,私立,一般大學,1007,逢甲大學,04131034,西班牙薩拉戈薩大學物流供應鏈管理與創新創業雙碩士學位學程,碩士班(日間),英語,3,3,0,0,0,0
107,私立,一般大學,1007,逢甲大學,07141095,美國普渡大學電機資訊雙學士學位學程,學士班(日間),英語,44,33,11,2,2,0
107,私立,一般大學,1007,逢甲大學,04199092,美國聖荷西州立大學商學大數據分析雙學士學位學程,學士班(日間),英語,91,48,43,1,0,1
107,私立,一般大學,1007,逢甲大學,04131021,國際企業管理學士學位學程(英語專班),學士班(日間),英語,49,14,35,29,12,17
107,私立,一般大學,1007,逢甲大學,04131022,國際經營管理碩士學位學程,碩士班(日間),英語,0,0,0,1,0,1
107,私立,一般大學,1007,逢甲大學,04141024,國際經營與貿易學系國際企業管理全英語學士班,學士班(日間),英語,103,29,74,84,33,51
107,私立,一般大學,1007,逢甲大學,04199035,澳洲墨爾本皇家理工大學商學與創新雙學士學位學程,學士班(日間),英語,90,46,44,6,4,2
107,私立,一般大學,1008,靜宜大學,04131010,寰宇管理碩士學位學程,碩士班(日間),英語,5,0,5,45,21,24
107,私立,一般大學,1009,長庚大學,05123032,分子醫學全英語碩士學位學程,碩士班(日間),英語,0,0,0,1,0,1
107,私立,一般大學,1009,長庚大學,07141052,奈米工程及設計碩士學位學程,碩士班(日間),英語,0,0,0,6,5,1
107,私立,一般大學,1009,長庚大學,09121034,顯微手術國際碩士學位學程,碩士班(日間),英語,0,0,0,16,11,5
107,私立,一般大學,1012,大葉大學,02311008,文創產業國際人才學士學位學程,學士班(日間),英語,34,14,20,1,0,1
107,私立,一般大學,1012,大葉大學,02311009,外語服務產業碩士學位學程,碩士班(日間),英語,2,2,0,0,0,0
107,私立,一般大學,1014,義守大學,10199058,娛樂事業管理學系,學士班(日間),英語,90,27,63,44,16,28
107,私立,一般大學,1014,義守大學,04131013,國際企業經營學系,學士班(日間),英語,96,41,55,76,45,31
107,私立,一般大學,1014,義守大學,04121017,國際財務金融學系,學士班(日間),英語,81,34,47,32,17,15
107,私立,一般大學,1014,義守大學,10151055,國際觀光餐旅學系,學士班(日間),英語,154,42,112,101,43,58
107,私立,一般大學,1014,義守大學,07194062,智慧化自動控制英語學士學位學程,學士班(日間),英語,16,11,5,9,9,0
107,私立,一般大學,1014,義守大學,03214063,傳播產製英語學士學位學程,學士班(日間),英語,11,3,8,4,2,2
107,私立,一般大學,1014,義守大學,04131012,管理學院管理碩士班,碩士班(日間),英語,15,11,4,63,25,38
107,私立,一般大學,1014,義守大學,09121011,學士後醫學系外國學生專班,學士班(日間),英語,0,0,0,159,72,87
107,私立,一般大學,1016,銘傳大學,04131036,企業管理學系,碩士班(日間),英語,0,0,0,11,5,6
107,私立,一般大學,1016,銘傳大學,10151008,旅遊與觀光學士學位學程,學士班(日間),英語,31,2,29,37,16,21
107,私立,一般大學,1016,銘傳大學,04199027,時尚創意管理學士學位學程,學士班(日間),英語,21,3,18,11,2,9
107,私立,一般大學,1016,銘傳大學,04121020,財務金融學系,學士班(日間),英語,0,0,0,0,0,0
107,私立,一般大學,1016,銘傳大學,04131017,國際企業與貿易學士學位學程,學士班(日間),英語,101,32,69,253,105,148
107,私立,一般大學,1016,銘傳大學,04131061,國際企業學系,碩士班(日間),英語,0,0,0,25,13,12
107,私立,一般大學,1016,銘傳大學,03122004,國際事務碩士學位學程(外國學生專班),碩士班(日間),英語,0,0,0,16,7,9
107,私立,一般大學,1016,銘傳大學,03122005,國際事務與外交學士學位學程,學士班(日間),英語,60,11,49,30,9,21
107,私立,一般大學,1016,銘傳大學,01131042,華語文教學碩士學位學程,碩士班(日間),英語,0,0,0,12,5,7
107,私立,一般大學,1016,銘傳大學,03213064,新媒體暨傳播管理碩士學位學程,碩士班(日間),英語,0,0,0,9,4,5
107,私立,一般大學,1016,銘傳大學,03211063,新聞與大眾傳播學士學位學程,學士班(日間),英語,46,8,38,59,24,35
107,私立,一般大學,1016,銘傳大學,06134068,資訊科技應用學士學位學程,學士班(日間),英語,32,20,12,30,24,6
107,私立,一般大學,1017,實踐大學,04131023,管理學院國際企業英語碩士學位學程,碩士班(日間),英語,8,4,4,10,2,8
107,私立,一般大學,1017,實踐大學,04131023,管理學院國際企業英語學士學位學程,學士班(日間),英語,83,25,58,11,8,3
107,私立,一般大學,1019,高雄醫學大學,09121020,轉譯醫學博士學位學程,博士班,英語,7,5,2,0,0,0
107,私立,一般大學,1020,南華大學,10151048,管理學院旅遊管理越南境外學士班(越南外貿大學河內校區),學士班(日間),英語,0,0,0,9,3,6
107,私立,一般大學,1020,南華大學,10151048,管理學院旅遊管理越南境外學士班(越南外貿大學胡志明校區),學士班(日間),英語,0,0,0,15,4,11
107,私立,技專校院,1023,南臺學校財團法人南臺科技大學,04131030,商管專業學院碩士班,碩士班(日間),英語,10,3,7,48,19,29
107,私立,技專校院,1023,南臺學校財團法人南臺科技大學,04121022,國際金融學士學位學程,學士班(日間),英語,28,11,17,22,10,12
107,私立,技專校院,1023,南臺學校財團法人南臺科技大學,04131020,國際商務學士學位學程,學士班(日間),英語,52,16,36,56,29,27
107,私立,技專校院,1023,南臺學校財團法人南臺科技大學,04131016,經營管理博士學位學程,博士班,英語,0,0,0,28,17,11
107,私立,技專校院,1023,南臺學校財團法人南臺科技大學,07141039,電機工程系,博士班,英語,0,0,0,14,11,3
107,私立,技專校院,1023,南臺學校財團法人南臺科技大學,07141039,電機工程系,碩士班(日間),英語,0,0,0,3,1,2
107,私立,技專校院,1023,南臺學校財團法人南臺科技大學,07141039,電機工程系_自動化國際學生產學合作專班,學士班(日間),英語,0,0,0,20,20,0
107,私立,技專校院,1023,南臺學校財團法人南臺科技大學,07151045,機械工程系,碩士班(日間),英語,0,0,0,8,7,1
107,私立,技專校院,1023,南臺學校財團法人南臺科技大學,07151045,機械工程系機電科技博士班,博士班,英語,11,10,1,9,9,0
107,私立,技專校院,1024,崑山科技大學,04131015,企業管理系_企業管理研究所外國學生專班,碩士班(日間),英語,0,0,0,10,8,2
107,私立,技專校院,1024,崑山科技大學,04131015,企業管理系_製造業提昇廠務管理效能產業國際學生產學合作專班,學士班(日間),英語,0,0,0,74,36,38
107,私立,技專校院,1024,崑山科技大學,06131028,資訊工程系_國際學生產學合作專班,學士班(日間),英語,0,0,0,37,24,13
107,私立,技專校院,1024,崑山科技大學,07141029,電腦與通訊系_國際學生產學合作專班,學士班(日間),英語,0,0,0,31,16,15
107,私立,技專校院,1024,崑山科技大學,07141025,電機工程系_國際太陽光電國際學生產學合作專班,學士班(日間),英語,0,0,0,28,7,21
107,私立,技專校院,1024,崑山科技大學,07151030,機械工程系_外國學生專班,學士班(日間),英語,0,0,0,18,11,7
107,私立,技專校院,1024,崑山科技大學,07151030,機械工程系_機械工程碩士學程外國學生專班,碩士班(日間),英語,0,0,0,7,7,0
107,私立,技專校院,1024,崑山科技大學,07151030,機械工程系_機械工程學士學程外國學生專班,學士班(日間),英語,0,0,0,32,26,6
107,私立,技專校院,1025,嘉藥學校財團法人嘉南藥理大學,10152021,休閒保健管理系,碩士班(日間),英語,13,6,7,0,0,0
107,私立,技專校院,1025,嘉藥學校財團法人嘉南藥理大學,07121009,環境工程與科學系,碩士班(日間),英語,14,12,2,0,0,0
107,私立,技專校院,1025,嘉藥學校財團法人嘉南藥理大學,04133003,醫務管理系,碩士班(日間),英語,38,6,32,0,0,0
107,私立,技專校院,1025,嘉藥學校財團法人嘉南藥理大學,10151020,觀光事業管理系溫泉產業碩士班,碩士班(日間),英語,4,1,3,0,0,0
107,私立,技專校院,1026,樹德科技大學,02122005,應用設計研究所,碩士在職專班,英語,0,0,0,19,12,7
107,私立,一般大學,1028,臺北醫學大學,07193053,生醫光機電研究所,碩士班(日間),英語,3,3,0,1,1,0
107,私立,一般大學,1028,臺北醫學大學,09191023,全球衛生暨發展碩士學位學程,碩士班(日間),英語,3,1,2,7,4,3
107,私立,一般大學,1028,臺北醫學大學,09191056,全球衛生暨衛生安全博士學位學程,博士班,英語,1,1,0,3,1,2
107,私立,一般大學,1028,臺北醫學大學,07193011,國際生醫工程博士學位學程,博士班,英語,0,0,0,5,3,2
107,私立,一般大學,1028,臺北醫學大學,09121019,國際醫學研究博士學位學程,博士班,英語,0,0,0,28,19,9
107,私立,一般大學,1028,臺北醫學大學,09121019,國際醫學研究碩士學位學程,碩士班(日間),英語,0,0,0,19,9,10
107,私立,一般大學,1028,臺北醫學大學,09121054,細胞治療與再生醫學國際博士學位學程,博士班,英語,2,2,0,6,2,4
107,私立,一般大學,1028,臺北醫學大學,09161028,癌症生物學與藥物研發研究所,碩士班(日間),英語,2,2,0,1,0,1
107,私立,技專校院,1031,輔英科技大學,09131019,護理系_越南境外碩士在職護理專班,碩士在職專班,英語,0,0,0,55,8,47
107,私立,一般大學,1033,長榮大學,04191022,國際財務與商務管理學士學位學程,學士班(日間),英語,76,20,56,14,7,7
107,私立,一般大學,1035,中國醫藥大學,09191026,公共衛生國際碩士學位學程,碩士班(日間),英語,0,0,0,4,2,2
107,私立,一般大學,1035,中國醫藥大學,09121020,國際生物醫學碩士學位學程,碩士班(日間),英語,0,0,0,14,4,10
107,私立,一般大學,1035,中國醫藥大學,09171048,國際針灸碩士學位學程,碩士班(日間),英語,0,0,0,4,2,2
107,私立,技專校院,1041,明志科技大學,07132021,能源電池科技博士學位學程,博士班,英語,3,3,0,10,9,1
107,私立,技專校院,1041,明志科技大學,04131030,國際企業管理碩士學位學程(IMBA),碩士班(日間),英語,0,0,0,7,1,6
107,私立,一般大學,1048,亞洲大學,03131013,心理學系,學士班(日間),英語,1,0,1,0,0,0
107,私立,一般大學,1048,亞洲大學,03131013,心理學系,碩士班(日間),英語,0,0,0,13,3,10
107,私立,一般大學,1048,亞洲大學,02311002,外國語文學系,學士班(日間),英語,0,0,0,11,1,10
107,私立,一般大學,1048,亞洲大學,05121028,生物科技學系,碩士班(日間),英語,0,0,0,8,4,4
107,私立,一般大學,1048,亞洲大學,07193029,生物資訊與醫學工程學系,博士班,英語,2,2,0,8,7,1
107,私立,一般大學,1048,亞洲大學,07193029,生物資訊與醫學工程學系,碩士班(日間),英語,1,1,0,2,2,0
107,私立,一般大學,1048,亞洲大學,02122004,時尚設計學系,學士班(日間),英語,2,0,2,0,0,0
107,私立,一般大學,1048,亞洲大學,04121019,財務金融學系,學士班(日間),英語,29,28,1,50,50,0
107,私立,一般大學,1048,亞洲大學,04212027,財經法律學系,學士班(日間),英語,79,31,48,83,55,28
107,私立,一般大學,1048,亞洲大學,04212027,財經法律學系,碩士班(日間),英語,10,8,2,14,9,5
107,私立,一般大學,1048,亞洲大學,09191021,健康產業管理學系,博士班,英語,0,0,0,2,1,1
107,私立,一般大學,1048,亞洲大學,09191021,健康產業管理學系,碩士班(日間),英語,8,4,4,2,1,1
107,私立,一般大學,1048,亞洲大學,04121020,國際財務金融管理學士學位學程,學士班(日間),英語,19,19,0,18,15,3
107,私立,一般大學,1048,亞洲大學,04111015,會計與資訊學系,學士班(日間),英語,58,12,46,2,2,0
107,私立,一般大學,1048,亞洲大學,04131017,經營管理學系,博士班,英語,24,16,8,5,3,2
107,私立,一般大學,1048,亞洲大學,04131017,經營管理學系,碩士班(日間),英語,1,0,1,43,17,26
107,私立,一般大學,1048,亞洲大學,04131017,經營管理學系,碩士在職專班,英語,1,1,0,0,0,0
107,私立,一般大學,1048,亞洲大學,06134037,資訊工程學系,學士班(日間),英語,1,1,0,4,3,1
107,私立,一般大學,1048,亞洲大學,06134037,資訊工程學系,博士班,英語,17,15,2,3,3,0
107,私立,一般大學,1048,亞洲大學,06134037,資訊工程學系,碩士班(日間),英語,16,9,7,16,14,2
107,私立,一般大學,1048,亞洲大學,06134037,資訊工程學系,碩士在職專班,英語,4,3,1,0,0,0
107,私立,一般大學,1048,亞洲大學,03213014,資訊傳播學系,碩士班(日間),英語,1,1,0,0,0,0
107,私立,一般大學,1048,亞洲大學,02112007,數位媒體設計學系,博士班,英語,1,1,0,1,1,0
107,私立,一般大學,1049,開南大學,04131031,商學院國際榮譽學士學位學程,學士班(日間),英語,0,0,0,82,40,42
107,私立,技專校院,1052,遠東科技大學,99999Z01,通識教育中心,學士班(日間),英語,276,115,161,13,8,5
107,私立,技專校院,1064,美和學校財團法人美和科技大學,05121008,生物科技系_四技日間部(越南胡志明食品工業大學),學士班(日間),英語,0,0,0,17,8,9
107,私立,技專校院,1064,美和學校財團法人美和科技大學,04131004,企業管理系_越南境外四技專班,學士班(日間),英語,0,0,0,39,13,26
107,私立,技專校院,1064,美和學校財團法人美和科技大學,04131004,企業管理系_越南境外專班,學士班(日間),英語,0,0,0,11,3,8
107,私立,技專校院,1064,美和學校財團法人美和科技大學,04131004,企業管理系經營管理所_境外進修學制碩士在職專班,碩士在職專班,英語,0,0,0,12,6,6
107,私立,技專校院,1064,美和學校財團法人美和科技大學,05191012,食品營養系_日間學士境外專班,學士班(日間),英語,0,0,0,49,20,29
107,私立,技專校院,1064,美和學校財團法人美和科技大學,06121011,資訊管理系_國際學生產學合作專班,學士班(日間),英語,0,0,0,27,10,17
107,私立,技專校院,1064,美和學校財團法人美和科技大學,10131018,餐旅管理系,學士班(日間),英語,36,13,23,0,0,0
107,私立,技專校院,1064,美和學校財團法人美和科技大學,10131018,餐旅管理科,五專,英語,112,47,65,0,0,0
107,私立,技專校院,1064,美和學校財團法人美和科技大學,09131013,護理系_健康照護境外碩士在職專班,碩士在職專班,英語,0,0,0,30,4,26
107,私立,技專校院,1064,美和學校財團法人美和科技大學,09131013,護理系_境外專班,碩士在職專班,英語,0,0,0,11,3,8
107,私立,技專校院,1075,文藻學校財團法人文藻外語大學,02311005,外語文教事業發展研究所,碩士班(日間),英語,5,1,4,5,3,2
107,私立,技專校院,1075,文藻學校財團法人文藻外語大學,02311007,英國語文系,碩士班(日間),英語,14,2,12,5,0,5
107,私立,技專校院,1075,文藻學校財團法人文藻外語大學,03122016,國際事務碩士學位學程,碩士班(日間),英語,6,1,5,7,4,3
107,私立,技專校院,1166,亞東技術學院,07141010,電子工程系,學士班(日間),英語,76,71,5,0,0,0
107,私立,技專校院,1166,亞東技術學院,07151014,機械工程系,學士班(日間),英語,34,34,0,0,0,0
107,私立,技專校院,1166,亞東技術學院,04133005,醫務管理系,學士班(日間),英語,42,9,33,0,0,0
108,公立,一般大學,0001,國立政治大學,03143040,亞太研究英語博士學位學程,博士班,英語,14,7,7,63,34,29
108,公立,一般大學,0001,國立政治大學,03143040,亞太研究英語碩士學位學程,碩士班(日間),英語,20,5,15,51,28,23
108,公立,一般大學,0001,國立政治大學,06131082,社群網路與人智計算國際研究生博士學位學程,博士班,英語,5,4,1,10,9,1
108,公立,一般大學,0001,國立政治大學,03122046,國際研究英語碩士學位學程,碩士班(日間),英語,14,5,9,42,29,13
108,公立,一般大學,0001,國立政治大學,03211050,國際傳播英語碩士學位學程,碩士班(日間),英語,33,7,26,28,5,23
108,公立,一般大學,0001,國立政治大學,04131064,國際經營管理英語碩士學位學程,碩士班(日間),英語,103,50,53,74,35,39
108,公立,一般大學,0001,國立政治大學,03111025,應用經濟與社會發展英語碩士學位學程,碩士班(日間),英語,14,4,10,20,9,11
108,公立,一般大學,0002,國立清華大學,05311035,分子科學與技術學程,博士班,英語,1,0,1,10,9,1
108,公立,一般大學,0002,國立清華大學,05311036,化學生物學與分子生物物理學學程,博士班,英語,7,5,2,19,10,9
108,公立,一般大學,0002,國立清華大學,05121031,生物資訊學學程,博士班,英語,1,0,1,6,6,0
108,公立,一般大學,0002,國立清華大學,07199070,全球營運管理碩士雙聯學位學程,碩士班(日間),英語,18,9,9,1,0,1
108,公立,一般大學,0002,國立清華大學,07194067,奈米科學與技術學程,博士班,英語,10,7,3,22,17,5
108,公立,一般大學,0002,國立清華大學,06134048,社群網路與人智計算國際研究生博士學位學程,博士班,英語,0,0,0,19,15,4
108,公立,一般大學,0002,國立清華大學,01131105,英語教學系,碩士班(日間),英語,16,2,14,5,1,4
108,公立,一般大學,0002,國立清華大學,04121020,計量財務金融學系,博士班,英語,5,4,1,1,1,0
108,公立,一般大學,0002,國立清華大學,04131018,國際專業管理碩士班,碩士班(日間),英語,12,4,8,42,15,27
108,公立,一般大學,0002,國立清華大學,06134047,國際資訊科技與應用碩士學程,碩士班(日間),英語,0,0,0,15,9,6
108,公立,一般大學,0002,國立清華大學,99999074,跨院國際博士班學位學程,博士班,英語,68,52,16,23,9,14
108,公立,一般大學,0003,國立臺灣大學,07112154,分子科學與技術國際研究生博士學位學程,博士班,英語,5,5,0,6,3,3
108,公立,一般大學,0003,國立臺灣大學,05124155,生物資訊學國際研究生博士學位學程,博士班,英語,3,2,1,1,1,0
108,公立,一般大學,0003,國立臺灣大學,09191163,全球衛生碩士學位學程,碩士班(日間),英語,0,0,0,11,4,7
108,公立,一般大學,0003,國立臺灣大學,09199159,國際三校農業生技與健康醫療碩士學位學程,碩士班(日間),英語,10,5,5,0,0,0
108,公立,一般大學,0003,國立臺灣大學,05199156,跨領域神經科學國際研究生博士學位學程,博士班,英語,5,3,2,3,2,1
108,公立,一般大學,0003,國立臺灣大學,04131028,管理學院企業管理碩士專班,碩士班(日間),英語,74,31,43,70,42,28
108,公立,一般大學,0003,國立臺灣大學,09121119,轉譯醫學博士學位學程,博士班,英語,3,2,1,0,0,0
108,公立,一般大學,0004,國立臺灣師範大學,05111057,生物多樣性國際研究生博士學位學程,博士班,英語,11,4,7,20,16,4
108,公立,一般大學,0004,國立臺灣師範大學,04191054,國際人力資源發展研究所,碩士班(日間),英語,34,9,25,25,7,18
108,公立,一般大學,0005,國立成功大學,07193061,生物醫學工程學系醫療器材創新國際碩士班,碩士班(日間),英語,12,5,7,20,8,12
108,公立,一般大學,0005,國立成功大學,07112065,尖端材料國際碩士學位學程,碩士班(日間),英語,0,0,0,15,8,7
108,公立,一般大學,0005,國立成功大學,05291025,自然災害減災及管理國際碩士學位學程,碩士班(日間),英語,11,10,1,10,5,5
108,公立,一般大學,0005,國立成功大學,07132052,能源工程國際博士學位學程,博士班,英語,1,1,0,3,2,1
108,公立,一般大學,0005,國立成功大學,07132052,能源工程國際碩士學位學程,碩士班(日間),英語,16,12,4,9,9,0
108,公立,一般大學,0005,國立成功大學,07132052,能源工程國際學士學位學程,學士班(日間),英語,65,47,18,52,38,14
108,公立,一般大學,0005,國立成功大學,04131125,國際經營管理研究所(IMBA),博士班,英語,1,1,0,14,7,7
108,公立,一般大學,0005,國立成功大學,04131125,國際經營管理研究所(IMBA),碩士班(日間),英語,0,0,0,104,35,69
108,公立,一般大學,0005,國立成功大學,04131125,國際經營管理研究所(IMBA),碩士在職專班,英語,85,32,53,0,0,0
108,公立,一般大學,0005,國立成功大學,02122112,創意產業設計研究所,博士班,英語,19,5,14,20,3,17
108,公立,一般大學,0005,國立成功大學,02122112,創意產業設計研究所,碩士班(日間),英語,33,12,21,8,5,3
108,公立,一般大學,0005,國立成功大學,05199016,跨領域神經科學國際博士學位學程,博士班,英語,9,5,4,9,8,1
108,公立,一般大學,0006,國立中興大學,08193078,國際農企業學士學位學程,學士班(日間),英語,65,23,42,38,21,17
108,公立,一般大學,0006,國立中興大學,08111064,國際農學碩士學位學程,碩士班(日間),英語,8,5,3,30,22,8
108,公立,一般大學,0007,國立陽明交通大學,05311039,永續化學科技國際研究生博士學位學程,博士班,英語,3,1,2,54,45,9
108,公立,一般大學,0007,國立陽明交通大學,07141054,光電博士學位學程(台灣聯合大學系統),博士班,英語,0,0,0,14,13,1
108,公立,一般大學,0007,國立陽明交通大學,07141066,國際半導體產業學院博士班,博士班,英語,32,29,3,17,16,1
108,公立,一般大學,0007,國立陽明交通大學,07141066,國際半導體產業學院碩士班,碩士班(日間),英語,54,44,10,13,10,3
108,公立,一般大學,0007,國立陽明交通大學,07141068,電機資訊國際博士學位學程,博士班,英語,0,0,0,98,84,14
108,公立,一般大學,0007,國立陽明交通大學,07141068,電機資訊國際碩士學位學程,碩士班(日間),英語,0,0,0,73,58,15
108,公立,一般大學,0007,國立陽明交通大學,04131016,管理學院企業管理碩士學位學程,碩士班(日間),英語,36,11,25,27,13,14
108,公立,一般大學,0007,國立陽明交通大學,05211043,環境科技博士學位學程(台灣聯合大學系統),博士班,英語,0,0,0,1,1,0
108,公立,一般大學,0008,國立中央大學,05321041,地球系統科學國際研究生博士學位學程,博士班,英語,11,5,6,42,27,15
108,公立,一般大學,0008,國立中央大學,02299012,亞際文化研究國際碩士學位學程(台灣聯合大學系統),碩士班(日間),英語,4,1,3,12,4,8
108,公立,一般大學,0008,國立中央大學,07121073,國際永續發展碩士在職專班,碩士在職專班,英語,0,0,0,13,8,5
108,公立,一般大學,0008,國立中央大學,05211048,遙測科技碩士學位學程,碩士班(日間),英語,16,9,7,8,4,4
108,公立,一般大學,0008,國立中央大學,07112071,應用材料科學國際研究生碩士學位學程,碩士班(日間),英語,0,0,0,4,3,1
108,公立,一般大學,0009,國立中山大學,04131028,人力資源管理全英語碩士學位學程,碩士班(日間),英語,26,7,19,39,20,19
108,公立,一般大學,0009,國立中山大學,03122019,亞太事務英語碩士學位學程,碩士班(日間),英語,0,0,0,20,12,8
108,公立,一般大學,0009,國立中山大學,05399070,理學國際博士學位學程,博士班,英語,10,6,4,13,7,6
108,公立,一般大學,0009,國立中山大學,07141056,電信工程國際碩士學位學程,碩士班(日間),英語,0,0,0,10,9,1
108,公立,一般大學,0009,國立中山大學,07141058,電機電力工程國際碩士學位學程,碩士班(日間),英語,0,0,0,9,8,1
108,公立,一般大學,0009,國立中山大學,04131022,管理學院國際經營管理碩士學程,碩士班(日間),英語,80,27,53,61,24,37
108,公立,一般大學,0012,國立臺灣海洋大學,08312046,水產養殖學系,博士班,英語,0,0,0,3,2,1
108,公立,一般大學,0012,國立臺灣海洋大學,08312046,水產養殖學系,碩士班(日間),英語,20,17,3,13,5,8
108,公立,一般大學,0013,國立中正大學,07151071,前瞻製造系統碩士學位學程,碩士班(日間),英語,4,3,1,7,5,2
108,公立,一般大學,0013,國立中正大學,04121035,國際財務金融管理碩士學位學程,碩士班(日間),英語,2,1,1,17,8,9
108,公立,一般大學,0013,國立中正大學,01114007,教育領導與管理發展國際博士學位學程,博士班,英語,0,0,0,6,3,3
108,公立,一般大學,0013,國立中正大學,01114007,教育領導與管理發展國際碩士學位學程,碩士班(日間),英語,0,0,0,24,9,15
108,公立,一般大學,0013,國立中正大學,03199022,認知科學博士學位學程,博士班,英語,4,2,2,5,2,3
108,公立,一般大學,0013,國立中正大學,07199076,環境智能及智慧系統博士學位學程,博士班,英語,1,1,0,1,1,0
108,公立,一般大學,0016,國立陽明大學,07193018,光電博士學位學程(台灣聯合大學系統),博士班,英語,0,0,0,1,0,1
108,公立,一般大學,0016,國立陽明大學,09191040,國際衛生碩士學位學程,碩士班(日間),英語,4,1,3,17,5,12
108,公立,一般大學,0016,國立陽明大學,09121016,跨領域神經科學國際研究生博士學位學程,博士班,英語,13,3,10,6,3,3
108,公立,一般大學,0016,國立陽明大學,05211017,環境科技博士學位學程(台灣聯合大學系統),博士班,英語,0,0,0,1,1,0
108,公立,一般大學,0017,國立臺北大學,07399040,城市治理英語碩士學位學程,碩士班(日間),英語,0,0,0,5,2,3
108,公立,一般大學,0017,國立臺北大學,04121020,財務金融英語碩士學位學程,碩士班(日間),英語,0,0,0,14,5,9
108,公立,一般大學,0018,國立嘉義大學,05111048,生命科學全英文碩士學位學程,碩士班(日間),英語,0,0,0,36,8,28
108,公立,一般大學,0018,國立嘉義大學,01111006,師範學院教學專業國際碩士學位學程,碩士班(日間),英語,0,0,0,20,4,16
108,公立,一般大學,0018,國立嘉義大學,08192094,農學院農業科技全英碩士學位學程,碩士班(日間),英語,0,0,0,10,4,6
108,公立,一般大學,0018,國立嘉義大學,10151110,管理學院外籍生全英文授課觀光暨管理碩士學位學程,碩士班(日間),英語,0,0,0,36,4,32
108,公立,一般大學,0019,國立高雄大學,04131010,國際商業管理碩士學位學程,碩士班(日間),英語,5,4,1,25,9,16
108,公立,一般大學,0019,國立高雄大學,05499037,應用科學碩士學位學程,碩士班(日間),英語,0,0,0,2,2,0
108,公立,一般大學,0020,國立東華大學,05211100,人文與環境碩士學位學程,碩士班(日間),英語,1,1,0,7,3,4
108,公立,一般大學,0020,國立東華大學,05311071,化學系,博士班,英語,0,0,0,5,2,3
108,公立,一般大學,0020,國立東華大學,04131059,企業管理學系,碩士班(日間),英語,0,0,0,8,5,3
108,公立,一般大學,0020,國立東華大學,07112090,材料科學與工程學系,博士班,英語,0,0,0,5,4,1
108,公立,一般大學,0020,國立東華大學,05331072,物理學系應用物理博士班,博士班,英語,0,0,0,17,10,7
108,公立,一般大學,0020,國立東華大學,05331072,物理學系應用物理碩士班,碩士班(日間),英語,0,0,0,8,6,2
108,公立,一般大學,0020,國立東華大學,06131086,資訊工程學系,學士班(日間),英語,57,47,10,54,42,12
108,公立,一般大學,0020,國立東華大學,06131086,資訊工程學系,碩士班(日間),英語,0,0,0,15,11,4
108,公立,一般大學,0020,國立東華大學,06134081,資訊管理學系,碩士班(日間),英語,0,0,0,1,1,0
108,公立,一般大學,0020,國立東華大學,04191066,管理學院管理科學與財金國際學士學位學程,學士班(日間),英語,48,17,31,30,14,16
108,公立,技專校院,0022,國立臺灣科技大學,07199033,工程學院_大學部先進科技全英語外國學生專班,學士班(日間),英語,0,0,0,41,30,11
108,公立,技專校院,0022,國立臺灣科技大學,07191012,工業管理系,博士班,英語,0,0,0,29,22,7
108,公立,技專校院,0022,國立臺灣科技大學,07191012,工業管理系,碩士班(日間),英語,0,0,0,64,31,33
108,公立,技專校院,0022,國立臺灣科技大學,07111026,化學工程系,學士班(日間),英語,0,0,0,30,16,14
108,公立,技專校院,0022,國立臺灣科技大學,07111026,化學工程系,博士班,英語,0,0,0,47,36,11
108,公立,技專校院,0022,國立臺灣科技大學,07111026,化學工程系,碩士班(日間),英語,0,0,0,35,14,21
108,公立,技專校院,0022,國立臺灣科技大學,07111026,化學工程系_化工醫檢分析器材國際學生產學合作專班,學士班(日間),英語,0,0,0,5,2,3
108,公立,技專校院,0022,國立臺灣科技大學,04131008,企業管理系,博士班,英語,0,0,0,16,9,7
108,公立,技專校院,0022,國立臺灣科技大學,04131008,企業管理系,碩士班(日間),英語,0,0,0,17,3,14
108,公立,技專校院,0022,國立臺灣科技大學,07141019,光電工程研究所,博士班,英語,0,0,0,3,2,1
108,公立,技專校院,0022,國立臺灣科技大學,07141019,光電工程研究所,碩士班(日間),英語,0,0,0,3,0,3
108,公立,技專校院,0022,國立臺灣科技大學,07151024,自動化及控制研究所,博士班,英語,0,0,0,2,2,0
108,公立,技專校院,0022,國立臺灣科技大學,07151024,自動化及控制研究所,碩士班(日間),英語,0,0,0,8,5,3
108,公立,技專校院,0022,國立臺灣科技大學,07112028,材料科學與工程系,博士班,英語,0,0,0,40,32,8
108,公立,技專校院,0022,國立臺灣科技大學,07112028,材料科學與工程系,碩士班(日間),英語,0,0,0,11,10,1
108,公立,技專校院,0022,國立臺灣科技大學,07311038,建築系,博士班,英語,0,0,0,3,0,3
108,公立,技專校院,0022,國立臺灣科技大學,07311038,建築系,碩士班(日間),英語,0,0,0,22,8,14
108,公立,技專校院,0022,國立臺灣科技大學,04199011,科技管理研究所,碩士班(日間),英語,0,0,0,4,2,2
108,公立,技專校院,0022,國立臺灣科技大學,04121010,財務金融研究所,博士班,英語,0,0,0,2,1,1
108,公立,技專校院,0022,國立臺灣科技大學,04121010,財務金融研究所,碩士班(日間),英語,0,0,0,15,8,7
108,公立,技專校院,0022,國立臺灣科技大學,06131020,資訊工程系,博士班,英語,0,0,0,25,20,5
108,公立,技專校院,0022,國立臺灣科技大學,06131020,資訊工程系,碩士班(日間),英語,0,0,0,21,16,5
108,公立,技專校院,0022,國立臺灣科技大學,06131016,資訊管理系,博士班,英語,0,0,0,16,9,7
108,公立,技專校院,0022,國立臺灣科技大學,06131016,資訊管理系,碩士班(日間),英語,0,0,0,21,13,8
108,公立,技專校院,0022,國立臺灣科技大學,07141018,電子工程系,博士班,英語,0,0,0,27,23,4
108,公立,技專校院,0022,國立臺灣科技大學,07141018,電子工程系,碩士班(日間),英語,0,0,0,28,24,4
108,公立,技專校院,0022,國立臺灣科技大學,07141017,電機工程系,博士班,英語,0,0,0,23,19,4
108,公立,技專校院,0022,國立臺灣科技大學,07141017,電機工程系,碩士班(日間),英語,0,0,0,20,13,7
108,公立,技專校院,0022,國立臺灣科技大學,04199013,管理學院MBA,碩士班(日間),英語,0,0,0,49,16,33
108,公立,技專校院,0022,國立臺灣科技大學,01116002,數位學習與教育研究所,博士班,英語,0,0,0,16,8,8
108,公立,技專校院,0022,國立臺灣科技大學,01116002,數位學習與教育研究所,碩士班(日間),英語,0,0,0,4,2,2
108,公立,技專校院,0022,國立臺灣科技大學,07151023,機械工程系,博士班,英語,0,0,0,57,53,4
108,公立,技專校院,0022,國立臺灣科技大學,07151023,機械工程系,碩士班(日間),英語,0,0,0,30,25,5
108,公立,技專校院,0022,國立臺灣科技大學,07151023,機械工程系_新南向精密機械及創新工程技術國際學生產學合作專班,學士班(日間),英語,0,0,0,31,22,9
108,公立,技專校院,0022,國立臺灣科技大學,02311003,應用外語系,碩士班(日間),英語,0,0,0,14,6,8
108,公立,技專校院,0022,國立臺灣科技大學,05399015,應用科技研究所,博士班,英語,0,0,0,50,42,8
108,公立,技專校院,0022,國立臺灣科技大學,05399015,應用科技研究所,碩士班(日間),英語,0,0,0,18,8,10
108,公立,技專校院,0022,國立臺灣科技大學,07321025,營建工程系,學士班(日間),英語,0,0,0,2,2,0
108,公立,技專校院,0022,國立臺灣科技大學,07321025,營建工程系,博士班,英語,0,0,0,25,22,3
108,公立,技專校院,0022,國立臺灣科技大學,07321025,營建工程系,碩士班(日間),英語,0,0,0,41,34,7
108,公立,技專校院,0022,國立臺灣科技大學,09171034,醫學工程研究所,碩士班(日間),英語,0,0,0,3,3,0
108,公立,技專校院,0023,國立雲林科技大學,04131019,企業管理系,碩士班(日間),英語,12,3,9,29,10,19
108,公立,技專校院,0023,國立雲林科技大學,02311004,應用外語系,碩士班(日間),英語,44,11,33,1,1,0
108,公立,技專校院,0023,國立雲林科技大學,02311004,應用外語系,碩士在職專班,英語,32,4,28,0,0,0
108,公立,技專校院,0024,國立屏東科技大學,07321022,土壤與水工程國際碩士學位學程,碩士班(日間),英語,2,1,1,6,2,4
108,公立,技專校院,0024,國立屏東科技大學,07211037,食品科學國際碩士學位學程,碩士班(日間),英語,4,3,1,19,9,10
108,公立,技專校院,0024,國立屏東科技大學,04121007,財務金融國際學士學位學程,學士班(日間),英語,62,17,45,3,0,3
108,公立,技專校院,0024,國立屏東科技大學,05121050,動物用疫苗國際學位專班,博士班,英語,5,0,5,4,0,4
108,公立,技專校院,0024,國立屏東科技大學,05121050,動物用疫苗國際學位專班,碩士班(日間),英語,1,1,0,5,3,2
108,公立,技專校院,0024,國立屏東科技大學,08193036,農企業管理國際碩士學位學程,碩士班(日間),英語,3,1,2,12,3,9
108,公立,技專校院,0024,國立屏東科技大學,08199030,熱帶農業暨國際合作系,學士班(日間),英語,113,56,57,50,26,24
108,公立,技專校院,0024,國立屏東科技大學,08199030,熱帶農業暨國際合作系,博士班,英語,15,11,4,73,40,33
108,公立,技專校院,0024,國立屏東科技大學,08199030,熱帶農業暨國際合作系,碩士班(日間),英語,9,6,3,27,11,16
108,公立,技專校院,0024,國立屏東科技大學,08199030,熱帶農業暨國際合作系_國際熱帶農業科技國際學生產學合作專班,學士班(日間),英語,0,0,0,33,13,20
108,公立,技專校院,0024,國立屏東科技大學,08312068,觀賞魚科技及水生動物健康國際學位專班,博士班,英語,1,1,0,3,1,2
108,公立,技專校院,0024,國立屏東科技大學,08312068,觀賞魚科技及水生動物健康國際學位專班,碩士班(日間),英語,1,1,0,4,1,3
108,公立,技專校院,0025,國立臺北科技大學,07112067,工程學院_能源與光電材料外國學生專班,博士班,英語,0,0,0,43,29,14
108,公立,技專校院,0025,國立臺北科技大學,02112007,互動設計系_互動設計與創新外國學生專班,碩士班(日間),英語,0,0,0,19,9,10
108,公立,技專校院,0025,國立臺北科技大學,07132068,能源與冷凍空調工程系_能源冷凍空調與車輛外國學生專班,碩士班(日間),英語,0,0,0,9,8,1
108,公立,技專校院,0025,國立臺北科技大學,04131072,高階管理碩士雙聯學位學程,碩士在職專班,英語,37,15,22,0,0,0
108,公立,技專校院,0025,國立臺北科技大學,07141036,電資學院_外國學生專班,學士班(日間),英語,0,0,0,14,12,2
108,公立,技專校院,0025,國立臺北科技大學,07141036,電資學院_外國學生專班,博士班,英語,0,0,0,18,15,3
108,公立,技專校院,0025,國立臺北科技大學,07141036,電資學院_外國學生專班,碩士班(日間),英語,0,0,0,25,20,5
108,公立,技專校院,0025,國立臺北科技大學,04199021,管理學院_外國學生專班IMBA專班,碩士班(日間),英語,0,0,0,43,15,28
108,公立,技專校院,0025,國立臺北科技大學,04199021,管理學院_金融科技與創新創業外國學生(IMFI)專班,碩士班(日間),英語,0,0,0,21,10,11
108,公立,技專校院,0025,國立臺北科技大學,07151038,機電學院_機械與自動化碩士外國學生專班,碩士班(日間),英語,0,0,0,6,6,0
108,公立,技專校院,0025,國立臺北科技大學,07151040,機電學院_機電科技博士班外國學生專班,博士班,英語,0,0,0,7,7,0
108,公立,技專校院,0025,國立臺北科技大學,02311002,應用英文系,碩士班(日間),英語,39,14,25,6,3,3
108,公立,一般大學,0028,國立臺北藝術大學,02192026,文創產業國際藝術碩士學位學程,碩士班(日間),英語,6,1,5,21,6,15
108,公立,一般大學,0037,國立臺北教育大學,02192027,當代藝術評論與策展研究全英語碩士學位學程,碩士班(日間),英語,2,1,1,20,6,14
108,公立,一般大學,0037,國立臺北教育大學,01115047,學習與教學國際碩士學位學程,碩士班(日間),英語,0,0,0,8,4,4
108,公立,一般大學,0039,國立臺中教育大學,04131040,管理學院國際經營管理碩士學位學程,碩士班(日間),英語,0,0,0,15,7,8
108,公立,技專校院,0043,國立勤益科技大學,07132026,冷凍空調與能源系_機械工程專班,學士班(日間),英語,0,0,0,38,24,14
108,公立,技專校院,0043,國立勤益科技大學,07132026,冷凍空調與能源系_機電能源與環境控制國際學生產學合作專班,學士班(日間),英語,0,0,0,22,19,3
108,公立,技專校院,0043,國立勤益科技大學,06131013,資訊工程系_資通訊國際學生產學合作專班,學士班(日間),英語,0,0,0,20,10,10
108,公立,技專校院,0043,國立勤益科技大學,04199033,管理學院_管理與資訊國際學生產學合作專班,學士班(日間),英語,0,0,0,2,0,2
108,公立,一般大學,0044,國立體育大學,10141009,國際運動教練科學碩士學位學程,碩士班(日間),英語,1,1,0,2,2,0
108,公立,技專校院,0046,國立臺北護理健康大學,04133004,健康事業管理系_國際健康科技碩士學程外國學生專班,碩士班(日間),英語,0,0,0,3,2,1
108,公立,技專校院,0046,國立臺北護理健康大學,01121020,國際蒙特梭利碩士專班,碩士班(日間),英語,4,0,4,9,1,8
108,公立,技專校院,0046,國立臺北護理健康大學,09131012,護理助產研究所_外國學生專班,碩士班(日間),英語,0,0,0,8,0,8
108,公立,技專校院,0046,國立臺北護理健康大學,09131009,護理系_外國學生專班,碩士班(日間),英語,0,0,0,14,3,11
108,公立,技專校院,0046,國立臺北護理健康大學,09131009,護理系_國際護理博士外國學生專班,博士班,英語,0,0,0,11,5,6
108,公立,技專校院,0047,國立高雄餐旅大學,10131009,國際廚藝學士學位學程,學士班(日間),英語,66,31,35,41,11,30
108,公立,技專校院,0047,國立高雄餐旅大學,10151016,國際觀光學士學位學程,學士班(日間),英語,104,26,78,37,8,29
108,公立,技專校院,0047,國立高雄餐旅大學,10151031,國際觀光餐旅全英文碩士學位學程,碩士班(日間),英語,3,1,2,7,4,3
108,公立,一般大學,0049,國立臺灣體育運動大學,04199010,運動事業管理學系東南亞博士班,博士班,英語,0,0,0,3,1,2
108,公立,技專校院,0050,國立臺中科技大學,04122028,財政稅務系,學士班(日間),英語,100,24,76,0,0,0
108,公立,技專校院,0050,國立臺中科技大學,04141020,國際貿易與經營系,學士班(日間),英語,55,13,42,1,0,1
108,公立,技專校院,0051,國立臺北商業大學,04199021,貿易實務法律暨談判碩士學位學程,碩士班(日間),英語,24,6,18,1,1,0
108,私立,一般大學,1001,東海大學,05211056,永續科學與工程學士學位學程,學士班(日間),英語,84,52,32,23,13,10
108,私立,一般大學,1001,東海大學,04131059,國際企業管理碩士學位學程,碩士班(日間),英語,10,3,7,9,5,4
108,私立,一般大學,1001,東海大學,04131021,國際學院國際經營管理學位學程,學士班(日間),英語,146,45,101,67,43,24
108,私立,一般大學,1002,輔仁大學,02122029,品牌與時尚經營管理碩士學位學程,碩士班(日間),英語,2,2,0,10,2,8
108,私立,一般大學,1002,輔仁大學,04131044,國際經營管理碩士學位學程,碩士班(日間),英語,17,6,11,8,8,0
108,私立,一般大學,1004,中原大學,07191041,工業與系統工程學系國際碩士班,碩士班(日間),英語,0,0,0,9,5,4
108,私立,一般大學,1004,中原大學,04191057,中原大學與美國天普大學商學管理雙學士學位學程,學士班(日間),英語,17,9,8,1,1,0
108,私立,一般大學,1004,中原大學,07111049,化學工程與材料科學國際碩士學位學程,碩士班(日間),英語,0,0,0,3,2,1
108,私立,一般大學,1004,中原大學,07193044,生物醫學材料與科技國際碩士學位學程,碩士班(日間),英語,0,0,0,1,0,1
108,私立,一般大學,1004,中原大學,04191017,國際商學碩士學位學程,碩士班(日間),英語,6,1,5,22,12,10
108,私立,一般大學,1004,中原大學,04191017,國際商學學士學位學程,學士班(日間),英語,0,0,0,34,17,17
108,私立,一般大學,1004,中原大學,07141031,資訊工程學系資訊科技與雲端運算國際碩士班,碩士班(日間),英語,0,0,0,2,1,1
108,私立,一般大學,1004,中原大學,07141029,電機工程學系國際碩士班,碩士班(日間),英語,0,0,0,1,0,1
108,私立,一般大學,1005,淡江大學學校財團法人淡江大學,03122059,外交與國際關係學系全英語學士班,學士班(日間),英語,141,36,105,116,45,71
108,私立,一般大學,1005,淡江大學學校財團法人淡江大學,03121074,全球政治經濟學系全英語學士班,學士班(日間),英語,131,49,82,23,13,10
108,私立,一般大學,1005,淡江大學學校財團法人淡江大學,03143064,拉丁美洲研究所亞太研究數位學習碩士在職專班,碩士在職專班,西班牙語,0,0,0,17,6,11
108,私立,一般大學,1005,淡江大學學校財團法人淡江大學,03143065,美洲研究所,博士班,英語,4,2,2,0,0,0
108,私立,一般大學,1005,淡江大學學校財團法人淡江大學,03143065,美洲研究所亞太研究數位學習碩士在職專班,碩士在職專班,西班牙語,0,0,0,11,5,6
108,私立,一般大學,1005,淡江大學學校財團法人淡江大學,02311079,英美語言文化學系全英語學士班,學士班(日間),英語,133,40,93,8,0,8
108,私立,一般大學,1005,淡江大學學校財團法人淡江大學,04121035,商管學院全球財務管理全英語學士學位學程,學士班(日間),英語,166,67,99,75,35,40
108,私立,一般大學,1005,淡江大學學校財團法人淡江大學,04131045,商管學院經營管理全英語碩士學位學程,碩士班(日間),英語,1,0,1,26,9,17
108,私立,一般大學,1005,淡江大學學校財團法人淡江大學,04131040,國際企業學系,學士班(日間),英語,190,85,105,173,80,93
108,私立,一般大學,1005,淡江大學學校財團法人淡江大學,10151005,國際觀光管理學系全英語學士班,學士班(日間),英語,307,93,214,38,7,31
108,私立,一般大學,1005,淡江大學學校財團法人淡江大學,04121037,淡江大學暨澳洲昆士蘭理工大學財金全英語雙碩士學位學程,碩士班(日間),英語,15,4,11,7,2,5
108,私立,一般大學,1005,淡江大學學校財團法人淡江大學,06131018,資訊工程學系全英語碩士班,碩士班(日間),英語,3,1,2,2,2,0
108,私立,一般大學,1005,淡江大學學校財團法人淡江大學,06132022,資訊創新與科技學系,學士班(日間),英語,215,141,74,23,16,7
108,私立,一般大學,1005,淡江大學學校財團法人淡江大學,03143063,臺灣與亞太研究全英語碩士學位學程,碩士班(日間),英語,0,0,0,6,5,1
108,私立,一般大學,1006,中國文化大學,04191014,全球商務碩士學位學程,碩士班(日間),英語,2,1,1,38,19,19
108,私立,一般大學,1006,中國文化大學,04191014,全球商務學士學位學程,學士班(日間),英語,161,70,91,74,37,37
108,私立,一般大學,1007,逢甲大學,99999094,全校國際生大一不分系學士班,學士班(日間),英語,0,0,0,43,15,28
108,私立,一般大學,1007,逢甲大學,07141107,美國加州聖荷西州立大學工程雙學士學位學程,學士班(日間),英語,15,12,3,0,0,0
108,私立,一般大學,1007,逢甲大學,04199092,美國加州聖荷西州立大學商學大數據分析雙學士學位學程,學士班(日間),英語,107,59,48,17,6,11
108,私立,一般大學,1007,逢甲大學,07141095,美國普渡大學電機資訊雙學士學位學程,學士班(日間),英語,55,46,9,5,3,2
108,私立,一般大學,1007,逢甲大學,04131021,國際企業管理學士學位學程(英語專班),學士班(日間),英語,0,0,0,1,0,1
108,私立,一般大學,1007,逢甲大學,04131022,國際經營管理碩士學位學程,碩士班(日間),英語,1,1,0,0,0,0
108,私立,一般大學,1007,逢甲大學,04141024,國際經營與貿易學系國際企業管理全英語學士班,學士班(日間),英語,136,41,95,114,46,68
108,私立,一般大學,1007,逢甲大學,04199035,澳洲墨爾本皇家理工大學商學與創新雙學士學位學程,學士班(日間),英語,87,42,45,20,13,7
108,私立,一般大學,1008,靜宜大學,04131010,寰宇管理碩士學位學程,碩士班(日間),英語,5,0,5,56,22,34
108,私立,一般大學,1009,長庚大學,07141052,奈米工程及設計碩士學位學程,碩士班(日間),英語,3,3,0,17,16,1
108,私立,一般大學,1009,長庚大學,09121034,顯微手術國際碩士學位學程,碩士班(日間),英語,0,0,0,17,13,4
108,私立,一般大學,1011,中華大學學校財團法人中華大學,04131007,英國西英格蘭大學企業管理雙學士學位學程,學士班(日間),英語,6,6,0,0,0,0
108,私立,一般大學,1011,中華大學學校財團法人中華大學,10151056,國際觀光與酒店管理雙學士學位學程,學士班(日間),英語,5,2,3,0,0,0
108,私立,一般大學,1012,大葉大學,02311008,文創產業國際人才學士學位學程,學士班(日間),英語,17,9,8,1,0,1
108,私立,一般大學,1014,義守大學,10199058,娛樂事業管理學系,學士班(日間),英語,93,26,67,39,9,30
108,私立,一般大學,1014,義守大學,04131013,國際企業經營學系,學士班(日間),英語,79,38,41,79,53,26
108,私立,一般大學,1014,義守大學,04121017,國際財務金融學系,學士班(日間),英語,85,36,49,29,14,15
108,私立,一般大學,1014,義守大學,10151055,國際觀光餐旅學系,學士班(日間),英語,127,38,89,104,39,65
108,私立,一般大學,1014,義守大學,07194062,智慧化自動控制英語學士學位學程,學士班(日間),英語,24,17,7,20,19,1
108,私立,一般大學,1014,義守大學,03214063,傳播產製英語學士學位學程,學士班(日間),英語,12,2,10,6,3,3
108,私立,一般大學,1014,義守大學,04131012,管理學院管理碩士班,碩士班(日間),英語,18,13,5,72,22,50
108,私立,一般大學,1014,義守大學,09121011,學士後醫學系外國學生專班,學士班(日間),英語,0,0,0,143,56,87
108,私立,一般大學,1016,銘傳大學,04131036,企業管理學系,碩士班(日間),英語,0,0,0,12,5,7
108,私立,一般大學,1016,銘傳大學,10151008,旅遊與觀光學士學位學程,學士班(日間),英語,31,5,26,45,19,26
108,私立,一般大學,1016,銘傳大學,04199027,時尚創意管理學士學位學程,學士班(日間),英語,29,5,24,16,1,15
108,私立,一般大學,1016,銘傳大學,04131017,國際企業與貿易學士學位學程,學士班(日間),英語,98,35,63,306,121,185
108,私立,一般大學,1016,銘傳大學,04131061,國際企業學系,碩士班(日間),英語,0,0,0,22,10,12
108,私立,一般大學,1016,銘傳大學,03122004,國際事務碩士學位學程(外國學生專班),碩士班(日間),英語,0,0,0,14,4,10
108,私立,一般大學,1016,銘傳大學,03122005,國際事務與外交學士學位學程,學士班(日間),英語,88,27,61,38,14,24
108,私立,一般大學,1016,銘傳大學,01131042,華語文教學碩士學位學程,碩士班(日間),英語,0,0,0,13,6,7
108,私立,一般大學,1016,銘傳大學,03213064,新媒體暨傳播管理碩士學位學程,碩士班(日間),英語,0,0,0,6,3,3
108,私立,一般大學,1016,銘傳大學,03211063,新聞與大眾傳播學士學位學程,學士班(日間),英語,39,5,34,75,29,46
108,私立,一般大學,1016,銘傳大學,06134068,資訊科技應用學士學位學程,學士班(日間),英語,28,13,15,37,30,7
108,私立,一般大學,1017,實踐大學,04131023,管理學院國際企業英語碩士學位學程,碩士班(日間),英語,5,3,2,15,5,10
108,私立,一般大學,1017,實踐大學,04131023,管理學院國際企業英語學士學位學程,學士班(日間),英語,160,44,116,42,23,19
108,私立,一般大學,1019,高雄醫學大學,09121020,轉譯醫學博士學位學程,博士班,英語,6,4,2,0,0,0
108,私立,一般大學,1020,南華大學,10151048,管理學院旅遊管理越南境外學士班(越南外貿大學河內校區),學士班(日間),英語,0,0,0,19,4,15
108,私立,一般大學,1020,南華大學,10151048,管理學院旅遊管理越南境外學士班(越南外貿大學胡志明校區),學士班(日間),英語,0,0,0,23,5,18
108,私立,技專校院,1023,南臺學校財團法人南臺科技大學,04199064,全球經營管理碩士班,碩士班(日間),英語,12,3,9,41,20,21
108,私立,技專校院,1023,南臺學校財團法人南臺科技大學,04121022,國際金融學士學位學程,學士班(日間),英語,21,7,14,16,6,10
108,私立,技專校院,1023,南臺學校財團法人南臺科技大學,04131020,國際商務學士學位學程,學士班(日間),英語,46,14,32,45,19,26
108,私立,技專校院,1023,南臺學校財團法人南臺科技大學,04131016,經營管理博士學位學程,博士班,英語,0,0,0,33,18,15
108,私立,技專校院,1023,南臺學校財團法人南臺科技大學,07141039,電機工程系,博士班,英語,0,0,0,15,12,3
108,私立,技專校院,1023,南臺學校財團法人南臺科技大學,07141039,電機工程系,碩士班(日間),英語,0,0,0,13,7,6
108,私立,技專校院,1023,南臺學校財團法人南臺科技大學,07141039,電機工程系_自動化國際學生產學合作專班,學士班(日間),英語,0,0,0,20,20,0
108,私立,技專校院,1023,南臺學校財團法人南臺科技大學,07151045,機械工程系,碩士班(日間),英語,0,0,0,4,4,0
108,私立,技專校院,1023,南臺學校財團法人南臺科技大學,07151045,機械工程系機電科技博士班,博士班,英語,10,9,1,11,10,1
108,私立,技專校院,1024,崑山科技大學,04131015,企業管理系_企業管理研究所外國學生專班,碩士班(日間),英語,0,0,0,5,4,1
108,私立,技專校院,1024,崑山科技大學,07151030,機械工程系_外國學生專班,學士班(日間),英語,0,0,0,10,6,4
108,私立,技專校院,1024,崑山科技大學,07151030,機械工程系_機械工程碩士學程外國學生專班,碩士班(日間),英語,0,0,0,5,4,1
108,私立,技專校院,1024,崑山科技大學,07151030,機械工程系_機械工程學士學程外國學生專班,學士班(日間),英語,0,0,0,54,45,9
108,私立,技專校院,1025,嘉藥學校財團法人嘉南藥理大學,10152021,休閒保健管理系,碩士班(日間),英語,22,8,14,0,0,0
108,私立,技專校院,1025,嘉藥學校財團法人嘉南藥理大學,06111006,資訊管理系,學士班(日間),英語,0,0,0,80,77,3
108,私立,技專校院,1025,嘉藥學校財團法人嘉南藥理大學,02311002,應用外語系,學士班(日間),英語,294,104,190,3,0,3
108,私立,技專校院,1025,嘉藥學校財團法人嘉南藥理大學,07121009,環境工程與科學系,碩士班(日間),英語,14,14,0,3,1,2
108,私立,技專校院,1025,嘉藥學校財團法人嘉南藥理大學,04133003,醫務管理系,碩士班(日間),英語,28,4,24,0,0,0
108,私立,技專校院,1026,樹德科技大學,04131050,國際經營管理全英語學士學位學程,學士班(日間),英語,130,42,88,25,4,21
108,私立,一般大學,1028,臺北醫學大學,03131057,心智意識與腦科學研究所,碩士班(日間),英語,2,1,1,3,1,2
108,私立,一般大學,1028,臺北醫學大學,03131057,心智意識與腦科學研究博士學位學程,博士班,英語,0,0,0,3,2,1
108,私立,一般大學,1028,臺北醫學大學,07193053,生醫光機電研究所,碩士班(日間),英語,5,4,1,1,1,0
108,私立,一般大學,1028,臺北醫學大學,09191023,全球衛生暨發展碩士學位學程,碩士班(日間),英語,5,3,2,7,6,1
108,私立,一般大學,1028,臺北醫學大學,09191056,全球衛生暨衛生安全博士學位學程,博士班,英語,2,1,1,9,6,3
108,私立,一般大學,1028,臺北醫學大學,07193011,國際生醫工程博士學位學程,博士班,英語,0,0,0,8,4,4
108,私立,一般大學,1028,臺北醫學大學,09121019,國際醫學研究博士學位學程,博士班,英語,0,0,0,38,29,9
108,私立,一般大學,1028,臺北醫學大學,09121019,國際醫學研究碩士學位學程,碩士班(日間),英語,0,0,0,10,4,6
108,私立,一般大學,1028,臺北醫學大學,09121054,細胞治療與再生醫學國際博士學位學程,博士班,英語,2,2,0,10,3,7
108,私立,一般大學,1028,臺北醫學大學,09161028,癌症生物學與藥物研發研究所,碩士班(日間),英語,4,3,1,1,0,1
108,私立,技專校院,1031,輔英科技大學,09131019,護理系_越南境外碩士在職護理專班,碩士在職專班,英語,0,0,0,30,5,25
108,私立,一般大學,1033,長榮大學,04191022,國際財務與商務管理學士學位學程,學士班(日間),英語,37,8,29,14,7,7
108,私立,一般大學,1035,中國醫藥大學,09191026,公共衛生國際碩士學位學程,碩士班(日間),英語,0,0,0,1,0,1
108,私立,一般大學,1035,中國醫藥大學,09121020,國際生物醫學碩士學位學程,碩士班(日間),英語,0,0,0,13,5,8
108,私立,一般大學,1035,中國醫藥大學,09171048,國際針灸碩士學位學程,碩士班(日間),英語,0,0,0,6,2,4
108,私立,技專校院,1041,明志科技大學,07132021,能源電池科技博士學位學程,博士班,英語,2,2,0,16,13,3
108,私立,技專校院,1041,明志科技大學,04131030,國際企業管理碩士學位學程(IMBA),碩士班(日間),英語,0,0,0,21,7,14
108,私立,一般大學,1048,亞洲大學,03131013,心理學系,碩士班(日間),英語,0,0,0,91,40,51
108,私立,一般大學,1048,亞洲大學,02311002,外國語文學系,學士班(日間),英語,88,15,73,6,1,5
108,私立,一般大學,1048,亞洲大學,05121028,生物科技學系,碩士班(日間),英語,0,0,0,65,39,26
108,私立,一般大學,1048,亞洲大學,07193029,生物資訊與醫學工程學系,碩士班(日間),英語,2,1,1,20,13,7
108,私立,一般大學,1048,亞洲大學,04121019,財務金融學系,學士班(日間),英語,19,13,6,308,190,118
108,私立,一般大學,1048,亞洲大學,04212027,財經法律學系,學士班(日間),英語,80,50,30,118,51,67
108,私立,一般大學,1048,亞洲大學,04212027,財經法律學系,碩士班(日間),英語,39,22,17,86,46,40
108,私立,一般大學,1048,亞洲大學,09191021,健康產業管理學系,博士班,英語,2,1,1,13,8,5
108,私立,一般大學,1048,亞洲大學,09191021,健康產業管理學系,碩士班(日間),英語,1,1,0,42,9,33
108,私立,一般大學,1048,亞洲大學,04121020,國際財務金融管理學士學位學程,學士班(日間),英語,37,10,27,78,47,31
108,私立,一般大學,1048,亞洲大學,04111015,會計與資訊學系,學士班(日間),英語,33,5,28,489,139,350
108,私立,一般大學,1048,亞洲大學,04131017,經營管理學系,博士班,英語,12,5,7,224,112,112
108,私立,一般大學,1048,亞洲大學,04131017,經營管理學系,碩士班(日間),英語,3,1,2,55,23,32
108,私立,一般大學,1048,亞洲大學,06134037,資訊工程學系,博士班,英語,24,20,4,185,150,35
108,私立,一般大學,1048,亞洲大學,06134037,資訊工程學系,碩士班(日間),英語,0,0,0,17,11,6
108,私立,一般大學,1049,開南大學,04131031,商學院國際榮譽學士學位學程,學士班(日間),英語,0,0,0,52,29,23
108,私立,技專校院,1052,遠東科技大學,99999Z01,通識教育中心,學士班(日間),英語,82,30,52,0,0,0
108,私立,技專校院,1052,遠東科技大學,10131002,觀光英語系,學士班(日間),英語,82,26,56,0,0,0
108,私立,技專校院,1064,美和學校財團法人美和科技大學,05121008,生物科技系_四技日間部(越南胡志明食品工業大學),學士班(日間),英語,0,0,0,17,8,9
108,私立,技專校院,1064,美和學校財團法人美和科技大學,05121008,生物科技系_越南境外四技日間部專班,學士班(日間),英語,0,0,0,8,2,6
108,私立,技專校院,1064,美和學校財團法人美和科技大學,04131004,企業管理系_越南境外四技專班,學士班(日間),英語,0,0,0,13,4,9
108,私立,技專校院,1064,美和學校財團法人美和科技大學,04131004,企業管理系_越南境外專班,學士班(日間),英語,0,0,0,11,3,8
108,私立,技專校院,1064,美和學校財團法人美和科技大學,04131004,企業管理系_境外專班,學士班(日間),英語,0,0,0,24,11,13
108,私立,技專校院,1064,美和學校財團法人美和科技大學,05191012,食品營養系_日間學士境外專班,學士班(日間),英語,0,0,0,19,5,14
108,私立,技專校院,1064,美和學校財團法人美和科技大學,05191012,食品營養系_越南境外四技日間部專班,學士班(日間),英語,0,0,0,18,4,14
108,私立,技專校院,1064,美和學校財團法人美和科技大學,06121011,資訊管理系_國際學生產學合作專班,學士班(日間),英語,0,0,0,26,10,16
108,私立,技專校院,1075,文藻學校財團法人文藻外語大學,02311005,外語文教事業發展研究所,碩士班(日間),英語,13,2,11,7,3,4
108,私立,技專校院,1075,文藻學校財團法人文藻外語大學,02311007,英國語文系,碩士班(日間),英語,13,3,10,7,0,7
108,私立,技專校院,1075,文藻學校財團法人文藻外語大學,03122016,國際事務碩士學位學程,碩士班(日間),英語,8,3,5,4,3,1
108,私立,技專校院,1166,亞東技術學院,07141010,電子工程系,學士班(日間),英語,100,96,4,0,0,0
108,私立,技專校院,1166,亞東技術學院,07151014,機械工程系,學士班(日間),英語,26,24,2,0,0,0
108,私立,技專校院,1166,亞東技術學院,04133005,醫務管理系,學士班(日間),英語,37,11,26,0,0,0
109,公立,一般大學,0001,國立政治大學,03143040,亞太研究英語博士學位學程,博士班,英語,15,8,7,72,39,33
109,公立,一般大學,0001,國立政治大學,03143040,亞太研究英語碩士學位學程,碩士班(日間),英語,14,4,10,56,27,29
109,公立,一般大學,0001,國立政治大學,06131082,社群網路與人智計算國際研究生博士學位學程,博士班,英語,4,3,1,10,8,2
109,公立,一般大學,0001,國立政治大學,03122046,國際研究英語碩士學位學程,碩士班(日間),英語,14,3,11,44,26,18
109,公立,一般大學,0001,國立政治大學,03211050,國際傳播英語碩士學位學程,碩士班(日間),英語,32,6,26,35,9,26
109,公立,一般大學,0001,國立政治大學,04131064,國際經營管理英語碩士學位學程,碩士班(日間),英語,94,45,49,58,26,32
109,公立,一般大學,0001,國立政治大學,03111025,應用經濟與社會發展英語碩士學位學程,碩士班(日間),英語,12,4,8,22,10,12
109,公立,一般大學,0002,國立清華大學,05311035,分子科學與技術學程,博士班,英語,1,1,0,10,9,1
109,公立,一般大學,0002,國立清華大學,05311036,化學生物學與分子生物物理學學程,博士班,英語,8,7,1,19,10,9
109,公立,一般大學,0002,國立清華大學,05121031,生物資訊學學程,博士班,英語,1,0,1,2,2,0
109,公立,一般大學,0002,國立清華大學,07199070,全球營運管理碩士雙聯學位學程,碩士班(日間),英語,15,8,7,0,0,0
109,公立,一般大學,0002,國立清華大學,07194067,奈米科學與技術學程,博士班,英語,13,10,3,17,13,4
109,公立,一般大學,0002,國立清華大學,06134048,社群網路與人智計算國際研究生博士學位學程,博士班,英語,1,1,0,19,13,6
109,公立,一般大學,0002,國立清華大學,01131105,英語教學系,碩士班(日間),英語,24,3,21,6,2,4
109,公立,一般大學,0002,國立清華大學,04121020,計量財務金融學系,博士班,英語,4,2,2,1,1,0
109,公立,一般大學,0002,國立清華大學,06134045,計算語言學與中文語言處理學程,博士班,英語,1,1,0,0,0,0
109,公立,一般大學,0002,國立清華大學,04131018,國際專業管理碩士班,碩士班(日間),英語,15,5,10,57,22,35
109,公立,一般大學,0002,國立清華大學,06134047,國際資訊科技與應用碩士學程,碩士班(日間),英語,0,0,0,10,5,5
109,公立,一般大學,0002,國立清華大學,99999074,跨院國際博士班學位學程,博士班,英語,79,58,21,34,16,18
109,公立,一般大學,0002,國立清華大學,05199034,跨領域神經科學博士學位學程(台灣聯合大學系統),博士班,英語,0,0,0,1,0,1
109,公立,一般大學,0002,國立清華大學,05211041,環境科技博士學位學程(台灣聯合大學系統),博士班,英語,0,0,0,5,4,1
109,公立,一般大學,0003,國立臺灣大學,07112154,分子科學與技術國際研究生博士學位學程,博士班,英語,9,8,1,8,5,3
109,公立,一般大學,0003,國立臺灣大學,05124155,生物資訊學國際研究生博士學位學程,博士班,英語,6,3,3,1,1,0
109,公立,一般大學,0003,國立臺灣大學,08192164,全球農業科技與基因體科學碩士學位學程,碩士班(日間),英語,0,0,0,5,4,1
109,公立,一般大學,0003,國立臺灣大學,09191163,全球衛生博士學位學程,博士班,英語,0,0,0,7,4,3
109,公立,一般大學,0003,國立臺灣大學,09191163,全球衛生碩士學位學程,碩士班(日間),英語,0,0,0,28,10,18
109,公立,一般大學,0003,國立臺灣大學,09199159,國際三校農業生技與健康醫療碩士學位學程,碩士班(日間),英語,10,5,5,0,0,0
109,公立,一般大學,0003,國立臺灣大學,05199156,跨領域神經科學國際研究生博士學位學程,博士班,英語,9,6,3,4,3,1
109,公立,一般大學,0003,國立臺灣大學,04131028,管理學院企業管理碩士專班,碩士班(日間),英語,82,34,48,82,46,36
109,公立,一般大學,0003,國立臺灣大學,09121119,轉譯醫學博士學位學程,博士班,英語,4,2,2,0,0,0
109,公立,一般大學,0004,國立臺灣師範大學,05111057,生物多樣性國際研究生博士學位學程,博士班,英語,13,6,7,15,12,3
109,公立,一般大學,0004,國立臺灣師範大學,04191054,國際人力資源發展研究所,碩士班(日間),英語,35,11,24,28,6,22
109,公立,一般大學,0005,國立成功大學,07193061,生物醫學工程學系醫療器材創新國際碩士班,碩士班(日間),英語,14,5,9,17,5,12
109,公立,一般大學,0005,國立成功大學,07112065,尖端材料國際碩士學位學程,碩士班(日間),英語,0,0,0,13,6,7
109,公立,一般大學,0005,國立成功大學,05291025,自然災害減災及管理國際碩士學位學程,碩士班(日間),英語,9,8,1,12,6,6
109,公立,一般大學,0005,國立成功大學,07132052,能源工程國際博士學位學程,博士班,英語,1,1,0,3,2,1
109,公立,一般大學,0005,國立成功大學,07132052,能源工程國際碩士學位學程,碩士班(日間),英語,19,15,4,13,12,1
109,公立,一般大學,0005,國立成功大學,07132052,能源工程國際學士學位學程,學士班(日間),英語,70,53,17,49,33,16
109,公立,一般大學,0005,國立成功大學,04131125,國際經營管理研究所(IMBA),博士班,英語,2,1,1,11,5,6
109,公立,一般大學,0005,國立成功大學,04131125,國際經營管理研究所(IMBA),碩士班(日間),英語,0,0,0,110,44,66
109,公立,一般大學,0005,國立成功大學,04131125,國際經營管理研究所(IMBA),碩士在職專班,英語,89,34,55,0,0,0
109,公立,一般大學,0005,國立成功大學,02122112,創意產業設計研究所,博士班,英語,21,8,13,22,6,16
109,公立,一般大學,0005,國立成功大學,02122112,創意產業設計研究所,碩士班(日間),英語,39,13,26,22,7,15
109,公立,一般大學,0005,國立成功大學,07151133,智慧製造國際碩士學位學程,碩士班(日間),英語,8,8,0,1,1,0
109,公立,一般大學,0005,國立成功大學,05199016,跨領域神經科學國際博士學位學程,博士班,英語,9,6,3,9,8,1
109,公立,一般大學,0006,國立中興大學,08193078,國際農企業學士學位學程,學士班(日間),英語,45,23,22,25,19,6
109,公立,一般大學,0006,國立中興大學,08111064,國際農學碩士學位學程,碩士班(日間),英語,5,3,2,27,13,14
109,公立,一般大學,0007,國立陽明交通大學,05311039,永續化學科技國際研究生博士學位學程,博士班,英語,2,1,1,45,37,8
109,公立,一般大學,0007,國立陽明交通大學,07141054,光電博士學位學程(台灣聯合大學系統),博士班,英語,0,0,0,2,1,1
109,公立,一般大學,0007,國立陽明交通大學,07141066,國際半導體產業學院博士班,博士班,英語,36,32,4,38,31,7
109,公立,一般大學,0007,國立陽明交通大學,07141066,國際半導體產業學院越南境外碩士專班,碩士班(日間),英語,0,0,0,5,1,4
109,公立,一般大學,0007,國立陽明交通大學,07141066,國際半導體產業學院碩士班,碩士班(日間),英語,52,40,12,11,10,1
109,公立,一般大學,0007,國立陽明交通大學,09191141,國際衛生碩士學位學程,碩士班(日間),英語,2,0,2,25,10,15
109,公立,一般大學,0007,國立陽明交通大學,05199035,跨領域神經科學國際研究生博士學位學程,博士班,英語,9,2,7,8,4,4
109,公立,一般大學,0007,國立陽明交通大學,07141068,電機資訊國際博士學位學程,博士班,英語,0,0,0,87,74,13
109,公立,一般大學,0007,國立陽明交通大學,07141068,電機資訊國際碩士學位學程,碩士班(日間),英語,0,0,0,57,42,15
109,公立,一般大學,0007,國立陽明交通大學,04131016,管理學院企業管理碩士學位學程,碩士班(日間),英語,36,9,27,28,11,17
109,公立,一般大學,0007,國立陽明交通大學,05211043,環境科技博士學位學程(台灣聯合大學系統),博士班,英語,0,0,0,3,2,1
109,公立,一般大學,0008,國立中央大學,05321041,地球系統科學國際研究生博士學位學程,博士班,英語,10,6,4,32,21,11
109,公立,一般大學,0008,國立中央大學,02299012,亞際文化研究國際碩士學位學程(台灣聯合大學系統),碩士班(日間),英語,4,1,3,12,4,8
109,公立,一般大學,0008,國立中央大學,07121073,國際永續發展碩士在職專班,碩士在職專班,英語,0,0,0,13,8,5
109,公立,一般大學,0008,國立中央大學,05211048,遙測科技碩士學位學程,碩士班(日間),英語,20,13,7,6,4,2
109,公立,一般大學,0008,國立中央大學,07112071,應用材料科學國際研究生碩士學位學程,碩士班(日間),英語,0,0,0,4,3,1
109,公立,一般大學,0008,國立中央大學,05211049,環境科技博士學位學程（台灣聯合大學系統）,博士班,英語,0,0,0,17,12,5
109,公立,一般大學,0009,國立中山大學,04131028,人力資源管理全英語碩士學位學程,碩士班(日間),英語,28,9,19,34,15,19
109,公立,一般大學,0009,國立中山大學,03122019,亞太事務英語碩士學位學程,碩士班(日間),英語,0,0,0,18,11,7
109,公立,一般大學,0009,國立中山大學,01111072,教育與人類發展研究全英語博士學位學程,博士班,英語,0,0,0,18,9,9
109,公立,一般大學,0009,國立中山大學,01111072,教育與人類發展研究全英語碩士學位學程,碩士班(日間),英語,0,0,0,2,0,2
109,公立,一般大學,0009,國立中山大學,05399070,理學國際博士學位學程,博士班,英語,10,5,5,12,7,5
109,公立,一般大學,0009,國立中山大學,07141056,電信工程國際碩士學位學程,碩士班(日間),英語,0,0,0,14,13,1
109,公立,一般大學,0009,國立中山大學,07141058,電機電力工程國際碩士學位學程,碩士班(日間),英語,0,0,0,8,6,2
109,公立,一般大學,0009,國立中山大學,04131022,管理學院國際經營管理碩士學程,碩士班(日間),英語,80,29,51,59,27,32
109,公立,一般大學,0012,國立臺灣海洋大學,08312046,水產養殖學系,博士班,英語,1,1,0,3,1,2
109,公立,一般大學,0012,國立臺灣海洋大學,08312046,水產養殖學系,碩士班(日間),英語,24,18,6,11,3,8
109,公立,一般大學,0013,國立中正大學,07151071,前瞻製造系統碩士學位學程,碩士班(日間),英語,6,5,1,6,4,2
109,公立,一般大學,0013,國立中正大學,04121035,國際財務金融管理碩士學位學程,碩士班(日間),英語,3,1,2,7,5,2
109,公立,一般大學,0013,國立中正大學,01114007,教育領導與管理發展國際博士學位學程,博士班,英語,0,0,0,6,3,3
109,公立,一般大學,0013,國立中正大學,01114007,教育領導與管理發展國際碩士學位學程,碩士班(日間),英語,1,1,0,25,10,15
109,公立,一般大學,0013,國立中正大學,03199022,認知科學博士學位學程,博士班,英語,2,2,0,5,1,4
109,公立,一般大學,0013,國立中正大學,07199076,環境智能及智慧系統博士學位學程,博士班,英語,1,1,0,1,1,0
109,公立,一般大學,0014,國立高雄師範大學,02311021,英語學系,博士班,英語,4,1,3,1,1,0
109,公立,一般大學,0014,國立高雄師範大學,02311021,英語學系,碩士班(日間),英語,18,5,13,2,1,1
109,公立,一般大學,0017,國立臺北大學,04134040,城市治理英語碩士學位學程,碩士班(日間),英語,0,0,0,5,3,2
109,公立,一般大學,0017,國立臺北大學,04121020,財務金融英語碩士學位學程,碩士班(日間),英語,0,0,0,17,7,10
109,公立,一般大學,0018,國立嘉義大學,01111006,師範學院教學專業國際碩士學位學程,碩士班(日間),英語,0,0,0,58,11,47
109,公立,一般大學,0018,國立嘉義大學,08192094,農學院農業科技全英碩士學位學程,碩士班(日間),英語,0,0,0,11,0,11
109,公立,一般大學,0018,國立嘉義大學,10151110,管理學院外籍生全英文授課觀光暨管理碩士學位學程,碩士班(日間),英語,0,0,0,36,6,30
109,公立,一般大學,0019,國立高雄大學,04131010,國際商業管理碩士學位學程,碩士班(日間),英語,4,4,0,21,7,14
109,公立,一般大學,0019,國立高雄大學,05499037,應用科學碩士學位學程,碩士班(日間),英語,0,0,0,1,1,0
109,公立,一般大學,0020,國立東華大學,03191111,人文社會科學學院亞太區域研究博士班,博士班,英語,0,0,0,7,6,1
109,公立,一般大學,0020,國立東華大學,05211100,人文與環境碩士學位學程,碩士班(日間),英語,2,2,0,9,4,5
109,公立,一般大學,0020,國立東華大學,05311071,化學系,博士班,英語,0,0,0,6,3,3
109,公立,一般大學,0020,國立東華大學,04131059,企業管理學系,碩士班(日間),英語,0,0,0,16,11,5
109,公立,一般大學,0020,國立東華大學,07112090,材料科學與工程學系,博士班,英語,0,0,0,6,4,2
109,公立,一般大學,0020,國立東華大學,05331072,物理學系應用物理博士班,博士班,英語,0,0,0,22,12,10
109,公立,一般大學,0020,國立東華大學,05331072,物理學系應用物理碩士班,碩士班(日間),英語,0,0,0,5,4,1
109,公立,一般大學,0020,國立東華大學,06131086,資訊工程學系,學士班(日間),英語,57,42,15,89,69,20
109,公立,一般大學,0020,國立東華大學,06131086,資訊工程學系,碩士班(日間),英語,0,0,0,22,17,5
109,公立,一般大學,0020,國立東華大學,06134081,資訊管理學系,碩士班(日間),英語,0,0,0,3,0,3
109,公立,一般大學,0020,國立東華大學,04191066,管理學院管理科學與財金國際學士學位學程,學士班(日間),英語,51,23,28,31,13,18
109,公立,技專校院,0022,國立臺灣科技大學,07199033,工程學院_大學部先進科技全英語外國學生專班,學士班(日間),英語,0,0,0,72,51,21
109,公立,技專校院,0022,國立臺灣科技大學,07191012,工業管理系博士班,博士班,英語,0,0,0,35,25,10
109,公立,技專校院,0022,國立臺灣科技大學,07191012,工業管理系碩士班,碩士班(日間),英語,0,0,0,48,24,24
109,公立,技專校院,0022,國立臺灣科技大學,07111026,化學工程系,學士班(日間),英語,0,0,0,28,17,11
109,公立,技專校院,0022,國立臺灣科技大學,07111026,化學工程系博士班,博士班,英語,0,0,0,56,37,19
109,公立,技專校院,0022,國立臺灣科技大學,07111026,化學工程系碩士班,碩士班(日間),英語,0,0,0,45,21,24
109,公立,技專校院,0022,國立臺灣科技大學,04131008,企業管理系,博士班,英語,0,0,0,24,15,9
109,公立,技專校院,0022,國立臺灣科技大學,04131008,企業管理系碩士班,碩士班(日間),英語,0,0,0,12,2,10
109,公立,技專校院,0022,國立臺灣科技大學,07141019,光電工程研究所,博士班,英語,0,0,0,3,2,1
109,公立,技專校院,0022,國立臺灣科技大學,07141019,光電工程研究所,碩士班(日間),英語,0,0,0,4,1,3
109,公立,技專校院,0022,國立臺灣科技大學,07194040,先進科技全英語學士學位學程,學士班(日間),英語,0,0,0,2,0,2
109,公立,技專校院,0022,國立臺灣科技大學,07151024,自動化及控制研究所,博士班,英語,0,0,0,1,1,0
109,公立,技專校院,0022,國立臺灣科技大學,07151024,自動化及控制研究所,碩士班(日間),英語,0,0,0,6,5,1
109,公立,技專校院,0022,國立臺灣科技大學,07141022,色彩與照明科技研究所,碩士班(日間),英語,0,0,0,2,1,1
109,公立,技專校院,0022,國立臺灣科技大學,07112028,材料科學與工程系博士班,博士班,英語,0,0,0,40,32,8
109,公立,技專校院,0022,國立臺灣科技大學,07112028,材料科學與工程系碩士班,碩士班(日間),英語,0,0,0,14,12,2
109,公立,技專校院,0022,國立臺灣科技大學,07311038,建築系博士班,博士班,英語,0,0,0,6,1,5
109,公立,技專校院,0022,國立臺灣科技大學,07311038,建築系碩士班,碩士班(日間),英語,0,0,0,19,8,11
109,公立,技專校院,0022,國立臺灣科技大學,04199011,科技管理研究所,碩士班(日間),英語,0,0,0,5,5,0
109,公立,技專校院,0022,國立臺灣科技大學,04121010,財務金融研究所,碩士班(日間),英語,0,0,0,13,6,7
109,公立,技專校院,0022,國立臺灣科技大學,06131020,資訊工程系博士班,博士班,英語,0,0,0,28,22,6
109,公立,技專校院,0022,國立臺灣科技大學,06131020,資訊工程系碩士班,碩士班(日間),英語,0,0,0,18,14,4
109,公立,技專校院,0022,國立臺灣科技大學,06131016,資訊管理系博士班,博士班,英語,0,0,0,16,10,6
109,公立,技專校院,0022,國立臺灣科技大學,06131016,資訊管理系碩士班,碩士班(日間),英語,0,0,0,26,21,5
109,公立,技專校院,0022,國立臺灣科技大學,07141018,電子工程系博士班,博士班,英語,0,0,0,37,32,5
109,公立,技專校院,0022,國立臺灣科技大學,07141018,電子工程系碩士班,碩士班(日間),英語,0,0,0,27,22,5
109,公立,技專校院,0022,國立臺灣科技大學,07141017,電機工程系博士班,博士班,英語,0,0,0,23,21,2
109,公立,技專校院,0022,國立臺灣科技大學,07141017,電機工程系碩士班,碩士班(日間),英語,0,0,0,26,19,7
109,公立,技專校院,0022,國立臺灣科技大學,04199013,管理學院MBA,碩士班(日間),英語,0,0,0,59,24,35
109,公立,技專校院,0022,國立臺灣科技大學,01116002,數位學習與教育研究所,博士班,英語,0,0,0,21,12,9
109,公立,技專校院,0022,國立臺灣科技大學,01116002,數位學習與教育研究所,碩士班(日間),英語,0,0,0,9,4,5
109,公立,技專校院,0022,國立臺灣科技大學,07151023,機械工程系_新南向精密機械及創新工程技術國際學生產學合作專班,學士班(日間),英語,0,0,0,19,13,6
109,公立,技專校院,0022,國立臺灣科技大學,07151023,機械工程系博士班,博士班,英語,0,0,0,57,51,6
109,公立,技專校院,0022,國立臺灣科技大學,07151023,機械工程系碩士班,碩士班(日間),英語,0,0,0,25,22,3
109,公立,技專校院,0022,國立臺灣科技大學,02311003,應用外語系碩士班,碩士班(日間),英語,0,0,0,17,4,13
109,公立,技專校院,0022,國立臺灣科技大學,05399015,應用科技研究所,博士班,英語,0,0,0,56,38,18
109,公立,技專校院,0022,國立臺灣科技大學,05399015,應用科技研究所,碩士班(日間),英語,0,0,0,12,8,4
109,公立,技專校院,0022,國立臺灣科技大學,07321025,營建工程系,學士班(日間),英語,0,0,0,2,2,0
109,公立,技專校院,0022,國立臺灣科技大學,07321025,營建工程系博士班,博士班,英語,0,0,0,31,24,7
109,公立,技專校院,0022,國立臺灣科技大學,07321025,營建工程系碩士班,碩士班(日間),英語,0,0,0,52,41,11
109,公立,技專校院,0022,國立臺灣科技大學,09171034,醫學工程研究所,碩士班(日間),英語,0,0,0,5,2,3
109,公立,技專校院,0023,國立雲林科技大學,04131019,企業管理系碩士班,碩士班(日間),英語,9,1,8,22,8,14
109,公立,技專校院,0023,國立雲林科技大學,04131022,國際管理學士學位學程,學士班(日間),英語,108,34,74,7,4,3
109,公立,技專校院,0023,國立雲林科技大學,02311004,應用外語系碩士在職專班,碩士在職專班,英語,38,5,33,0,0,0
109,公立,技專校院,0023,國立雲林科技大學,02311004,應用外語系碩士班,碩士班(日間),英語,49,13,36,0,0,0
109,公立,技專校院,0024,國立屏東科技大學,07321022,土壤與水工程國際碩士學位學程,碩士班(日間),英語,3,2,1,6,2,4
109,公立,技專校院,0024,國立屏東科技大學,07211037,食品科學國際碩士學位學程,碩士班(日間),英語,4,3,1,17,6,11
109,公立,技專校院,0024,國立屏東科技大學,04121007,財務金融國際學士學位學程,學士班(日間),英語,72,19,53,3,0,3
109,公立,技專校院,0024,國立屏東科技大學,05121050,動物用疫苗國際學位專班,博士班,英語,7,0,7,4,0,4
109,公立,技專校院,0024,國立屏東科技大學,05121050,動物用疫苗國際學位專班,碩士班(日間),英語,3,2,1,5,4,1
109,公立,技專校院,0024,國立屏東科技大學,08193036,農企業管理國際碩士學位學程,碩士班(日間),英語,2,2,0,8,5,3
109,公立,技專校院,0024,國立屏東科技大學,08199030,熱帶農業暨國際合作系,學士班(日間),英語,120,58,62,48,29,19
109,公立,技專校院,0024,國立屏東科技大學,08199030,熱帶農業暨國際合作系_國際熱帶農業科技國際學生產學合作專班,學士班(日間),英語,0,0,0,33,13,20
109,公立,技專校院,0024,國立屏東科技大學,08199030,熱帶農業暨國際合作系博士班,博士班,英語,18,13,5,82,48,34
109,公立,技專校院,0024,國立屏東科技大學,08199030,熱帶農業暨國際合作系碩士班,碩士班(日間),英語,9,5,4,32,14,18
109,公立,技專校院,0024,國立屏東科技大學,08312068,觀賞魚科技及水生動物健康國際學位專班,博士班,英語,2,1,1,5,2,3
109,公立,技專校院,0024,國立屏東科技大學,08312068,觀賞魚科技及水生動物健康國際學位專班,碩士班(日間),英語,2,2,0,4,2,2
109,公立,技專校院,0025,國立臺北科技大學,06131075,人工智慧與大數據高階管理雙聯碩士學位學程,碩士在職專班,英語,39,24,15,0,0,0
109,公立,技專校院,0025,國立臺北科技大學,07112067,工程學院_能源與光電材料外國學生專班,博士班,英語,0,0,0,41,25,16
109,公立,技專校院,0025,國立臺北科技大學,02112007,互動設計系_互動設計與創新外國學生專班,碩士班(日間),英語,0,0,0,18,12,6
109,公立,技專校院,0025,國立臺北科技大學,07132068,能源與冷凍空調工程系_能源冷凍空調與車輛外國學生專班,碩士班(日間),英語,0,0,0,5,4,1
109,公立,技專校院,0025,國立臺北科技大學,04131072,高階管理碩士雙聯學位學程,碩士在職專班,英語,32,14,18,0,0,0
109,公立,技專校院,0025,國立臺北科技大學,07141036,電資學院_外國學生專班,學士班(日間),英語,0,0,0,37,32,5
109,公立,技專校院,0025,國立臺北科技大學,07141036,電資學院_外國學生專班,博士班,英語,0,0,0,16,13,3
109,公立,技專校院,0025,國立臺北科技大學,07141036,電資學院_外國學生專班,碩士班(日間),英語,0,0,0,21,17,4
109,公立,技專校院,0025,國立臺北科技大學,04199021,管理學院_外國學生專班IMBA專班,碩士班(日間),英語,0,0,0,45,18,27
109,公立,技專校院,0025,國立臺北科技大學,04199021,管理學院_金融科技與創新創業外國學生(IMFI)專班,碩士班(日間),英語,0,0,0,20,9,11
109,公立,技專校院,0025,國立臺北科技大學,07151038,機電學院_機械與自動化碩士外國學生專班,碩士班(日間),英語,0,0,0,6,5,1
109,公立,技專校院,0025,國立臺北科技大學,07151040,機電學院_機電科技博士班外國學生專班,博士班,英語,0,0,0,6,6,0
109,公立,技專校院,0025,國立臺北科技大學,02311002,應用英文系碩士班,碩士班(日間),英語,34,12,22,10,5,5
109,公立,一般大學,0028,國立臺北藝術大學,02192026,文創產業國際藝術碩士學位學程,碩士班(日間),英語,4,0,4,20,5,15
109,公立,一般大學,0030,國立臺東大學,02311015,英美語文學系,碩士班(日間),英語,3,0,3,0,0,0
109,公立,一般大學,0037,國立臺北教育大學,02192027,當代藝術評論與策展研究全英語碩士學位學程,碩士班(日間),英語,8,0,8,25,6,19
109,公立,一般大學,0037,國立臺北教育大學,01115047,學習與教學國際碩士學位學程,碩士班(日間),英語,3,0,3,12,5,7
109,公立,一般大學,0039,國立臺中教育大學,04131040,管理學院國際經營管理碩士學位學程,碩士班(日間),英語,0,0,0,13,4,9
109,公立,技專校院,0043,國立勤益科技大學,07132026,冷凍空調與能源系_機械工程專班,學士班(日間),英語,0,0,0,36,24,12
109,公立,技專校院,0046,國立臺北護理健康大學,10142017,人類發展與健康學院_國際運動科學外國學生專班,碩士班(日間),英語,0,0,0,3,3,0
109,公立,技專校院,0046,國立臺北護理健康大學,04133004,健康科技學院_國際健康科技碩士學程外國學生專班,碩士班(日間),英語,0,0,0,3,2,1
109,公立,技專校院,0046,國立臺北護理健康大學,01121020,國際蒙特梭利碩士專班,碩士班(日間),英語,2,0,2,7,1,6
109,公立,技專校院,0046,國立臺北護理健康大學,09131012,護理助產研究所_外國學生專班,碩士班(日間),英語,0,0,0,3,0,3
109,公立,技專校院,0046,國立臺北護理健康大學,09131009,護理系_外國學生專班,碩士班(日間),英語,0,0,0,11,1,10
109,公立,技專校院,0046,國立臺北護理健康大學,09131009,護理系_國際護理博士外國學生專班,博士班,英語,0,0,0,16,7,9
109,公立,技專校院,0047,國立高雄餐旅大學,10131009,國際廚藝學士學位學程,學士班(日間),英語,64,31,33,50,17,33
109,公立,技專校院,0047,國立高雄餐旅大學,10151016,國際觀光學士學位學程,學士班(日間),英語,97,22,75,42,9,33
109,公立,技專校院,0047,國立高雄餐旅大學,10151031,國際觀光餐旅全英文碩士學位學程,碩士班(日間),英語,5,1,4,13,6,7
109,公立,一般大學,0049,國立臺灣體育運動大學,04199010,運動事業管理學系東南亞博士班,博士班,英語,0,0,0,5,2,3
109,公立,技專校院,0050,國立臺中科技大學,04123027,保險金融管理系,學士班(日間),英語,86,28,58,0,0,0
109,公立,技專校院,0051,國立臺北商業大學,04199021,貿易實務法律暨談判碩士學位學程,碩士班(日間),英語,20,7,13,1,0,1
109,公立,一般大學,0052,國立屏東大學,06131070,國際資訊科技與應用碩士學位學程,碩士班(日間),英語,0,0,0,6,4,2
109,公立,技專校院,0053,國立高雄科技大學,04131031,國際管理碩士學位學程,碩士班(日間),英語,10,2,8,30,11,19
109,私立,一般大學,1001,東海大學,05211056,永續科學與工程學士學位學程,學士班(日間),英語,74,46,28,27,15,12
109,私立,一般大學,1001,東海大學,05123060,生醫暨材料科學國際博士學位學程,博士班,英語,0,0,0,2,2,0
109,私立,一般大學,1001,東海大學,04131059,國際企業管理碩士學位學程,碩士班(日間),英語,11,3,8,11,5,6
109,私立,一般大學,1001,東海大學,04131021,國際學院國際經營管理學位學程,學士班(日間),英語,166,61,105,80,44,36
109,私立,一般大學,1002,輔仁大學,02122029,品牌與時尚經營管理碩士學位學程,碩士班(日間),英語,13,3,10,8,0,8
109,私立,一般大學,1002,輔仁大學,04131044,國際經營管理碩士學位學程,碩士班(日間),英語,8,8,0,17,6,11
109,私立,一般大學,1004,中原大學,07191041,工業與系統工程學系國際碩士班,碩士班(日間),英語,0,0,0,6,2,4
109,私立,一般大學,1004,中原大學,04191057,中原大學與美國天普大學商學管理雙學士學位學程,學士班(日間),英語,34,19,15,4,2,2
109,私立,一般大學,1004,中原大學,07111049,化學工程與材料科學國際碩士學位學程,碩士班(日間),英語,0,0,0,1,1,0
109,私立,一般大學,1004,中原大學,07193044,生物醫學材料與科技國際碩士學位學程,碩士班(日間),英語,0,0,0,1,0,1
109,私立,一般大學,1004,中原大學,04191017,國際商學碩士學位學程,碩士班(日間),英語,5,0,5,16,7,9
109,私立,一般大學,1004,中原大學,04191017,國際商學學士學位學程,學士班(日間),英語,0,0,0,50,25,25
109,私立,一般大學,1004,中原大學,07141031,資訊工程學系資訊科技與雲端運算國際碩士班,碩士班(日間),英語,0,0,0,2,1,1
109,私立,一般大學,1004,中原大學,07141029,電機工程學系國際碩士班,碩士班(日間),英語,0,0,0,4,4,0
109,私立,一般大學,1005,淡江大學學校財團法人淡江大學,03122059,外交與國際關係學系全英語學士班,學士班(日間),英語,154,49,105,112,41,71
109,私立,一般大學,1005,淡江大學學校財團法人淡江大學,03121074,全球政治經濟學系全英語學士班,學士班(日間),英語,130,47,83,16,9,7
109,私立,一般大學,1005,淡江大學學校財團法人淡江大學,03143064,拉丁美洲研究所亞太研究數位學習碩士在職專班,碩士在職專班,西班牙語,0,0,0,24,10,14
109,私立,一般大學,1005,淡江大學學校財團法人淡江大學,03143065,美洲研究所,博士班,英語,5,3,2,0,0,0
109,私立,一般大學,1005,淡江大學學校財團法人淡江大學,03143065,美洲研究所亞太研究數位學習碩士在職專班,碩士在職專班,西班牙語,0,0,0,4,2,2
109,私立,一般大學,1005,淡江大學學校財團法人淡江大學,02311079,英美語言文化學系全英語學士班,學士班(日間),英語,124,48,76,4,0,4
109,私立,一般大學,1005,淡江大學學校財團法人淡江大學,04121035,商管學院全球財務管理全英語學士學位學程,學士班(日間),英語,184,76,108,82,39,43
109,私立,一般大學,1005,淡江大學學校財團法人淡江大學,04131045,商管學院經營管理全英語碩士學位學程,碩士班(日間),英語,2,0,2,21,11,10
109,私立,一般大學,1005,淡江大學學校財團法人淡江大學,04131040,國際企業學系,學士班(日間),英語,182,82,100,181,83,98
109,私立,一般大學,1005,淡江大學學校財團法人淡江大學,10151005,國際觀光管理學系全英語學士班,學士班(日間),英語,295,99,196,33,6,27
109,私立,一般大學,1005,淡江大學學校財團法人淡江大學,04121037,淡江大學暨澳洲昆士蘭理工大學財金全英語雙碩士學位學程,碩士班(日間),英語,5,3,2,5,1,4
109,私立,一般大學,1005,淡江大學學校財團法人淡江大學,06131018,資訊工程學系全英語碩士班,碩士班(日間),英語,4,2,2,2,2,0
109,私立,一般大學,1005,淡江大學學校財團法人淡江大學,06132022,資訊創新與科技學系,學士班(日間),英語,206,147,59,28,24,4
109,私立,一般大學,1005,淡江大學學校財團法人淡江大學,03143063,臺灣與亞太研究全英語碩士學位學程,碩士班(日間),英語,0,0,0,10,6,4
109,私立,一般大學,1006,中國文化大學,04191014,全球商務碩士學位學程,碩士班(日間),英語,1,1,0,37,19,18
109,私立,一般大學,1006,中國文化大學,04191014,全球商務學士學位學程,學士班(日間),英語,162,77,85,84,44,40
109,私立,一般大學,1007,逢甲大學,07141107,美國加州聖荷西州立大學工程雙學士學位學程,學士班(日間),英語,36,31,5,0,0,0
109,私立,一般大學,1007,逢甲大學,04199092,美國加州聖荷西州立大學商學大數據分析雙學士學位學程,學士班(日間),英語,108,61,47,1,0,1
109,私立,一般大學,1007,逢甲大學,06131048,美國加州舊金山州立大學資訊工程雙學士學位學程,學士班(日間),英語,29,20,9,2,2,0
109,私立,一般大學,1007,逢甲大學,07141095,美國普渡大學電機資訊雙學士學位學程,學士班(日間),英語,61,50,11,0,0,0
109,私立,一般大學,1007,逢甲大學,04141024,國際經營與貿易學系國際企業管理全英語學士班,學士班(日間),英語,145,45,100,97,41,56
109,私立,一般大學,1007,逢甲大學,04199035,澳洲墨爾本皇家理工大學商學與創新雙學士學位學程,學士班(日間),英語,82,42,40,12,7,5
109,私立,一般大學,1008,靜宜大學,04131010,寰宇管理碩士學位學程,碩士班(日間),英語,6,1,5,58,27,31
109,私立,一般大學,1009,長庚大學,05123032,分子醫學全英語碩士學位學程,碩士班(日間),英語,0,0,0,1,0,1
109,私立,一般大學,1009,長庚大學,07141052,奈米工程及設計碩士學位學程,碩士班(日間),英語,6,6,0,20,18,2
109,私立,一般大學,1009,長庚大學,09121034,顯微手術國際碩士學位學程,碩士班(日間),英語,0,0,0,22,17,5
109,私立,一般大學,1011,中華大學學校財團法人中華大學,04131007,英國西英格蘭大學企業管理雙學士學位學程,學士班(日間),英語,19,11,8,0,0,0
109,私立,一般大學,1011,中華大學學校財團法人中華大學,10151056,國際觀光與酒店管理雙學士學位學程,學士班(日間),英語,10,4,6,1,1,0
109,私立,一般大學,1011,中華大學學校財團法人中華大學,06134059,應用外語暨智慧商務學士學位學程,學士班(日間),英語,0,0,0,20,15,5
109,私立,一般大學,1012,大葉大學,02311008,文創產業國際人才學士學位學程,學士班(日間),英語,4,4,0,0,0,0
109,私立,一般大學,1014,義守大學,04131010,企業管理學系,碩士班(日間),英語,32,15,17,64,28,36
109,私立,一般大學,1014,義守大學,10199058,娛樂事業管理學系,學士班(日間),英語,89,24,65,27,8,19
109,私立,一般大學,1014,義守大學,04131013,國際企業經營學系,學士班(日間),英語,75,34,41,80,48,32
109,私立,一般大學,1014,義守大學,04121017,國際財務金融學系,學士班(日間),英語,83,39,44,29,14,15
109,私立,一般大學,1014,義守大學,10151055,國際觀光餐旅學系,學士班(日間),英語,117,41,76,75,28,47
109,私立,一般大學,1014,義守大學,07194062,智慧化自動控制英語學士學位學程,學士班(日間),英語,28,23,5,24,21,3
109,私立,一般大學,1014,義守大學,03214063,傳播產製英語學士學位學程,學士班(日間),英語,14,2,12,11,6,5
109,私立,一般大學,1014,義守大學,09121011,學士後醫學系外國學生專班,學士班(日間),英語,0,0,0,102,37,65
109,私立,一般大學,1016,銘傳大學,04131036,企業管理學系,碩士班(日間),英語,0,0,0,20,5,15
109,私立,一般大學,1016,銘傳大學,10151008,旅遊與觀光學士學位學程,學士班(日間),英語,26,5,21,43,20,23
109,私立,一般大學,1016,銘傳大學,04199027,時尚創意管理學士學位學程,學士班(日間),英語,26,5,21,16,0,16
109,私立,一般大學,1016,銘傳大學,02125095,時尚與創新管理學士學位學程,學士班(日間),英語,23,2,21,15,0,15
109,私立,一般大學,1016,銘傳大學,04131017,國際企業與貿易學士學位學程,學士班(日間),英語,126,48,78,384,153,231
109,私立,一般大學,1016,銘傳大學,04131061,國際企業學系,碩士班(日間),英語,0,0,0,27,14,13
109,私立,一般大學,1016,銘傳大學,03122004,國際事務碩士學位學程(外國學生專班),碩士班(日間),英語,0,0,0,16,7,9
109,私立,一般大學,1016,銘傳大學,03122005,國際事務與外交學士學位學程,學士班(日間),英語,109,39,70,48,18,30
109,私立,一般大學,1016,銘傳大學,04141097,國際商務管理泰國境外學士學位學程,學士班(日間),英語,0,0,0,4,2,2
109,私立,一般大學,1016,銘傳大學,02323042,華語文教學碩士學位學程,碩士班(日間),英語,0,0,0,11,2,9
109,私立,一般大學,1016,銘傳大學,03213064,新媒體暨傳播管理碩士學位學程,碩士班(日間),英語,0,0,0,4,2,2
109,私立,一般大學,1016,銘傳大學,03211063,新聞與大眾傳播學士學位學程,學士班(日間),英語,50,8,42,82,29,53
109,私立,一般大學,1016,銘傳大學,06134096,資訊科技應用與管理學士學位學程,學士班(日間),英語,15,4,11,13,11,2
109,私立,一般大學,1016,銘傳大學,06134068,資訊科技應用學士學位學程,學士班(日間),英語,23,10,13,29,22,7
109,私立,一般大學,1017,實踐大學,04131023,國際企業英語碩士學位學程,碩士班(日間),英語,7,4,3,9,3,6
109,私立,一般大學,1017,實踐大學,04131023,國際企業英語學士學位學程,學士班(日間),英語,167,48,119,50,23,27
109,私立,一般大學,1017,實踐大學,10131054,智慧服務管理英語學士學位學程,學士班(日間),英語,30,13,17,0,0,0
109,私立,技專校院,1018,朝陽科技大學,10152036,休閒事業管理系,碩士班(日間),英語,0,0,0,11,10,1
109,私立,技專校院,1018,朝陽科技大學,04131008,企業管理系,碩士班(日間),英語,0,0,0,3,1,2
109,私立,技專校院,1018,朝陽科技大學,04131008,企業管理系台灣產業策略發展博士班,博士班,英語,0,0,0,7,4,3
109,私立,技專校院,1018,朝陽科技大學,06131019,資訊管理系,學士班(日間),英語,0,0,0,23,15,8
109,私立,技專校院,1018,朝陽科技大學,06131019,資訊管理系,博士班,英語,5,5,0,13,9,4
109,私立,技專校院,1018,朝陽科技大學,05121017,應用化學系生化科技博士班,博士班,英語,0,0,0,6,1,5
109,私立,一般大學,1019,高雄醫學大學,09121020,轉譯醫學博士學位學程,博士班,英語,3,2,1,0,0,0
109,私立,一般大學,1020,南華大學,10151048,管理學院旅遊管理越南境外學士班(越南外貿大學河內校區),學士班(日間),英語,0,0,0,76,24,52
109,私立,一般大學,1020,南華大學,10151048,管理學院旅遊管理越南境外學士班(越南外貿大學胡志明校區),學士班(日間),英語,0,0,0,70,15,55
109,私立,技專校院,1023,南臺學校財團法人南臺科技大學,04199064,全球經營管理碩士班,碩士班(日間),英語,14,5,9,30,19,11
109,私立,技專校院,1023,南臺學校財團法人南臺科技大學,04121022,國際金融學士學位學程,學士班(日間),英語,14,5,9,16,5,11
109,私立,技專校院,1023,南臺學校財團法人南臺科技大學,04131020,國際商務學士學位學程,學士班(日間),英語,40,13,27,48,23,25
109,私立,技專校院,1023,南臺學校財團法人南臺科技大學,02112008,視覺傳達設計系碩士班,碩士班(日間),英語,0,0,0,3,1,2
109,私立,技專校院,1023,南臺學校財團法人南臺科技大學,04131016,經營管理博士學位學程,博士班,英語,0,0,0,36,17,19
109,私立,技專校院,1023,南臺學校財團法人南臺科技大學,07141039,電機工程系博士班,博士班,英語,0,0,0,13,10,3
109,私立,技專校院,1023,南臺學校財團法人南臺科技大學,07141039,電機工程系碩士班,碩士班(日間),英語,0,0,0,14,9,5
109,私立,技專校院,1023,南臺學校財團法人南臺科技大學,07151045,機械工程系碩士班,碩士班(日間),英語,0,0,0,10,9,1
109,私立,技專校院,1023,南臺學校財團法人南臺科技大學,07151045,機械工程系機電科技博士班,博士班,英語,11,9,2,11,10,1
109,私立,技專校院,1024,崑山科技大學,04131015,企業管理系_企業管理研究所外國學生專班,碩士班(日間),英語,0,0,0,1,0,1
109,私立,技專校院,1024,崑山科技大學,07151030,機械工程系_機械工程碩士學程外國學生專班,碩士班(日間),英語,0,0,0,1,1,0
109,私立,技專校院,1024,崑山科技大學,07151030,機械工程系_機械工程學士學程外國學生專班,學士班(日間),英語,0,0,0,75,61,14
109,私立,技專校院,1026,樹德科技大學,04131050,國際經營管理全英語學士學位學程,學士班(日間),英語,239,81,158,50,17,33
109,私立,一般大學,1028,臺北醫學大學,03131057,心智意識與腦科學研究所,碩士班(日間),英語,3,0,3,6,1,5
109,私立,一般大學,1028,臺北醫學大學,03131057,心智意識與腦科學研究博士學位學程,博士班,英語,1,1,0,4,3,1
109,私立,一般大學,1028,臺北醫學大學,07151053,生醫光機電研究所,碩士班(日間),英語,9,6,3,2,1,1
109,私立,一般大學,1028,臺北醫學大學,09191023,全球衛生暨發展碩士學位學程,碩士班(日間),英語,2,1,1,4,3,1
109,私立,一般大學,1028,臺北醫學大學,09191056,全球衛生暨衛生安全博士學位學程,博士班,英語,2,1,1,11,7,4
109,私立,一般大學,1028,臺北醫學大學,04199061,國際生技醫療管理博士學位學程,博士班,英語,0,0,0,2,2,0
109,私立,一般大學,1028,臺北醫學大學,07193011,國際生醫工程博士學位學程,博士班,英語,0,0,0,10,4,6
109,私立,一般大學,1028,臺北醫學大學,09121062,國際轉譯科學博士學位學程,博士班,英語,0,0,0,3,1,2
109,私立,一般大學,1028,臺北醫學大學,09121019,國際醫學研究博士學位學程,博士班,英語,0,0,0,49,35,14
109,私立,一般大學,1028,臺北醫學大學,09121019,國際醫學研究碩士學位學程,碩士班(日間),英語,0,0,0,8,4,4
109,私立,一般大學,1028,臺北醫學大學,09121054,細胞治療與再生醫學國際博士學位學程,博士班,英語,4,4,0,15,7,8
109,私立,一般大學,1028,臺北醫學大學,09161028,癌症生物學與藥物研發研究所,碩士班(日間),英語,6,2,4,4,2,2
109,私立,技專校院,1031,輔英科技大學,09131019,護理系_越南境外碩士在職護理專班,碩士在職專班,英語,0,0,0,28,5,23
109,私立,一般大學,1033,長榮大學,04191022,國際財務與商務管理學士學位學程,學士班(日間),英語,18,5,13,13,7,6
109,私立,一般大學,1035,中國醫藥大學,09191026,公共衛生國際碩士學位學程,碩士班(日間),英語,0,0,0,1,1,0
109,私立,一般大學,1035,中國醫藥大學,09121020,國際生物醫學碩士學位學程,碩士班(日間),英語,0,0,0,12,4,8
109,私立,一般大學,1035,中國醫藥大學,09171048,國際針灸碩士學位學程,碩士班(日間),英語,0,0,0,7,2,5
109,私立,技專校院,1037,正修學校財團法人正修科技大學,07191018,工業工程與管理系_外國學生專班,碩士班(日間),英語,0,0,0,4,2,2
109,私立,技專校院,1037,正修學校財團法人正修科技大學,07191018,工業工程與管理系_經營管理組外國學生專班,學士班(日間),英語,0,0,0,37,32,5
109,私立,技專校院,1037,正修學校財團法人正修科技大學,04131005,企業管理系_外國學生專班,學士班(日間),英語,0,0,0,32,13,19
109,私立,技專校院,1041,明志科技大學,07132021,能源電池科技博士學位學程,博士班,英語,2,2,0,21,18,3
109,私立,技專校院,1041,明志科技大學,04131030,國際企業管理碩士學位學程(IMBA),碩士班(日間),英語,0,0,0,23,10,13
109,私立,技專校院,1041,明志科技大學,07193031,創新科技應用於生物醫學暨醫療照護產品研發國際博士學位學程,博士班,英語,3,3,0,0,0,0
109,私立,一般大學,1048,亞洲大學,03131013,心理學系,碩士班(日間),英語,4,0,4,11,1,10
109,私立,一般大學,1048,亞洲大學,02311002,外國語文學系,學士班(日間),英語,0,0,0,6,4,2
109,私立,一般大學,1048,亞洲大學,07193029,生物資訊與醫學工程學系,博士班,英語,1,1,0,3,3,0
109,私立,一般大學,1048,亞洲大學,04121019,財務金融學系,學士班(日間),英語,220,102,118,300,143,157
109,私立,一般大學,1048,亞洲大學,04212027,財經法律學系,碩士班(日間),英語,0,0,0,7,6,1
109,私立,一般大學,1048,亞洲大學,09191021,健康產業管理學系,博士班,英語,2,0,2,9,4,5
109,私立,一般大學,1048,亞洲大學,09191021,健康產業管理學系,碩士班(日間),英語,0,0,0,2,1,1
109,私立,一般大學,1048,亞洲大學,04121020,國際財務金融管理學士學位學程,學士班(日間),英語,0,0,0,20,13,7
109,私立,一般大學,1048,亞洲大學,04111015,會計與資訊學系,學士班(日間),英語,4,4,0,19,6,13
109,私立,一般大學,1048,亞洲大學,04131017,經營管理學系,博士班,英語,4,1,3,0,0,0
109,私立,一般大學,1048,亞洲大學,06134037,資訊工程學系,博士班,英語,1,1,0,2,2,0
109,私立,一般大學,1048,亞洲大學,06134037,資訊工程學系,碩士班(日間),英語,1,1,0,9,6,3
109,私立,一般大學,1048,亞洲大學,06134037,資訊工程學系,碩士在職專班,英語,1,1,0,0,0,0
109,私立,一般大學,1049,開南大學,04131031,商學院國際榮譽學士學位學程,學士班(日間),英語,0,0,0,45,25,20
109,私立,技專校院,1052,遠東科技大學,99999Z01,通識教育中心,學士班(日間),英語,7,4,3,1,1,0
109,私立,技專校院,1064,美和學校財團法人美和科技大學,04131004,企業管理系_越南境外四技專班,學士班(日間),英語,0,0,0,34,13,21
109,私立,技專校院,1064,美和學校財團法人美和科技大學,04131004,企業管理系_境外專班,學士班(日間),英語,0,0,0,24,11,13
109,私立,技專校院,1064,美和學校財團法人美和科技大學,09131013,護理系_境外專班,碩士在職專班,英語,0,0,0,82,14,68
109,私立,技專校院,1075,文藻學校財團法人文藻外語大學,02311007,英國語文系碩士班,碩士班(日間),英語,17,3,14,5,2,3
109,私立,技專校院,1075,文藻學校財團法人文藻外語大學,03122016,國際事務碩士學位學程,碩士班(日間),英語,6,3,3,10,5,5
